key,neuron,oligo,microglia,other,astrocyte,n_cells
ACGCCTGACACGCGCT-1_V12D07-332_D1,1,0,0,0,0,1
TACCGATCCAACACTT-1_V12D07-332_D1,0,0,0,1,0,1
ATTAAAGCGGACGAGC-1_V12D07-332_D1,5,1,0,0,0,6
GATAAGGGACGATTAG-1_V12D07-332_D1,1,1,0,0,0,2
GTGCAAATCACCAATA-1_V12D07-332_D1,0,0,0,0,0,0
TGTTGGCTGGCGGAAG-1_V12D07-332_D1,2,0,0,0,0,2
GCATCCTCTCCTATTA-1_V12D07-332_D1,0,0,0,0,0,0
GCGAGGGACTGCTAGA-1_V12D07-332_D1,0,0,0,0,0,0
TGGTACCGGCACAGCC-1_V12D07-332_D1,2,0,0,1,0,3
GCGCGTTTAAATCGTA-1_V12D07-332_D1,3,3,0,0,0,6
TGCCTTGCCCTTACGG-1_V12D07-332_D1,0,0,0,0,0,0
GACGACTTTCCAAGAA-1_V12D07-332_D1,1,4,0,0,0,5
CCAGTGAGCTCCTTGT-1_V12D07-332_D1,0,1,0,0,0,1
ATACCCTGGCTCAAAT-1_V12D07-332_D1,0,1,0,1,0,2
GGGTTTCCGGCTTCCA-1_V12D07-332_D1,0,0,0,1,0,1
TAACCGTCCAGTTCAT-1_V12D07-332_D1,0,4,1,0,0,5
AAACAACGAATAGTTC-1_V12D07-332_D1,1,1,0,1,0,3
CAAGGGAGTGTATTTG-1_V12D07-332_D1,0,0,0,3,0,3
CCAAGCTTGATCTCCT-1_V12D07-332_D1,0,3,0,0,0,3
TTATTTCATCCCAAAC-1_V12D07-332_D1,0,1,0,0,0,1
GAGCGCTATGTCAGGC-1_V12D07-332_D1,0,5,0,1,0,6
TATGGCAGACTTTCGA-1_V12D07-332_D1,0,1,0,1,0,2
CTTCGTGCCCGCATCG-1_V12D07-332_D1,0,3,0,2,0,5
AAACGGGTTGGTATCC-1_V12D07-332_D1,0,2,0,1,0,3
TGCAAACCCACATCAA-1_V12D07-332_D1,0,0,0,0,0,0
GACGGGATGTCTTATG-1_V12D07-332_D1,0,2,0,0,0,2
GGCGAGCATCGAGGAC-1_V12D07-332_D1,0,1,1,0,0,2
CGCGTGCTATCAACGA-1_V12D07-332_D1,0,2,0,2,0,4
TGAAACCTCAACTCAC-1_V12D07-332_D1,0,1,0,2,0,3
CACATAAGGCGACCGT-1_V12D07-332_D1,0,2,0,2,0,4
TGACCCAACTCACATT-1_V12D07-332_D1,0,1,0,1,0,2
ATACGCCGATCTACCG-1_V12D07-332_D1,0,0,0,0,0,0
ACTTATCTGATCTATA-1_V12D07-332_D1,0,1,0,0,0,1
GTGTGAGCCGAGGTGC-1_V12D07-332_D1,0,3,0,0,0,3
GATGATTTGAAACTGG-1_V12D07-332_D1,0,4,1,2,0,7
GGGAACCACCTGTTTC-1_V12D07-332_D1,0,4,0,0,0,4
GTTCGTTGCGGACCAG-1_V12D07-332_D1,0,3,0,0,0,3
TGAGGTTGATCCCAAG-1_V12D07-332_D1,0,4,0,1,0,5
GATGCCACACTACAGC-1_V12D07-332_D1,0,2,0,0,0,2
AGGCAAAGAGGAATCA-1_V12D07-332_D1,0,2,0,0,0,2
AAGTAAGCTTCCAAAC-1_V12D07-332_D1,0,0,0,0,0,0
AACGTAGTCTACCCAT-1_V12D07-332_D1,0,3,1,0,0,4
GTTTGAGCGGTTATGT-1_V12D07-332_D1,0,1,0,3,0,4
GAAGCAAGGCAATGTT-1_V12D07-332_D1,0,4,0,0,0,4
TCACTCAGCGCATTAG-1_V12D07-332_D1,0,0,0,1,0,1
TACAATGAAACCAGCA-1_V12D07-332_D1,0,4,0,2,0,6
GTGCGCTTACAAATGA-1_V12D07-332_D1,0,2,0,3,0,5
GCACTCCCACAGTCCC-1_V12D07-332_D1,0,2,0,1,0,3
CGAAGACTGCCCGGGA-1_V12D07-332_D1,0,1,1,1,0,3
CAGGATCCGCCCGACC-1_V12D07-332_D1,0,2,0,2,0,4
CACGATTGGTCGTTAA-1_V12D07-332_D1,0,3,2,0,0,5
GGTTGTATCGTGAAAT-1_V12D07-332_D1,0,2,0,0,0,2
TCTTATGGGTAGTACC-1_V12D07-332_D1,0,0,0,0,0,0
TACAAGCTGTTCACTG-1_V12D07-332_D1,0,1,0,3,0,4
GTATCTTGTTGCTCAC-1_V12D07-332_D1,0,0,0,0,0,0
ATACCAGGTGAGCGAT-1_V12D07-332_D1,0,1,0,0,0,1
CCTAAACAGGGTCCGT-1_V12D07-332_D1,0,0,0,0,0,0
ATGGTGCTCAAAGCCA-1_V12D07-332_D1,0,0,0,0,0,0
CAAATGCGGAGTGTTC-1_V12D07-332_D1,0,3,0,1,0,4
CGTGCCCGACATTTGT-1_V12D07-332_D1,0,0,0,0,0,0
GTATCTCCCTAACTGT-1_V12D07-332_D1,0,0,0,0,0,0
ATTTGCCTAGTTACGA-1_V12D07-332_D1,0,0,0,0,0,0
ACGTCCTAAACGAGAT-1_V12D07-332_D1,0,1,0,1,0,2
CTGGGATCGCCCAGAT-1_V12D07-332_D1,0,1,0,0,0,1
CTGCAAATGGGCTCCA-1_V12D07-332_D1,0,0,0,2,0,2
CATTATAACAGGGTCC-1_V12D07-332_D1,0,2,1,0,0,3
ACCTTTCCTTTAGAAG-1_V12D07-332_D1,0,1,0,0,0,1
ATAGATTTGCAGTCGG-1_V12D07-332_D1,0,2,0,0,0,2
CTCGGGCATCGTCGGG-1_V12D07-332_D1,1,1,0,1,0,3
GTGGCGGGCCGTAGCT-1_V12D07-332_D1,0,1,0,0,1,2
CAACAGTGCCAAACGG-1_V12D07-332_D1,0,1,0,0,0,1
TGCGGGTATTGGGATC-1_V12D07-332_D1,0,0,0,0,0,0
GTCTCGCCAACACGCC-1_V12D07-332_D1,0,0,0,0,2,2
CTGGGCGGCCAAATGT-1_V12D07-332_D1,0,0,0,0,0,0
TAAAGGAGAAACTAGT-1_V12D07-332_D1,0,0,0,0,0,0
TCCCACGGAGGGAGCT-1_V12D07-332_D1,0,0,0,0,0,0
AGACGGGATTGGTATA-1_V12D07-332_D1,1,0,0,0,1,2
AACCTAAAGCCGTCCG-1_V12D07-332_D1,0,0,0,0,1,1
TACAAATTGCGGAGGT-1_V12D07-332_D1,0,0,0,0,0,0
CCCGCTAGAGGGTTAA-1_V12D07-332_D1,0,0,0,0,0,0
CATTGCAAAGCATAAT-1_V12D07-332_D1,0,2,0,0,0,2
TGTACGCTATCAGCTT-1_V12D07-332_D1,0,0,0,0,0,0
TTCTTCGCAATAGAGC-1_V12D07-332_D1,0,0,0,1,1,2
TGTGATTCCAGCGCTT-1_V12D07-332_D1,0,0,0,0,0,0
ATTCAGGATCGCCTCT-1_V12D07-332_D1,0,0,0,0,1,1
GCCCATGGGTGCAATG-1_V12D07-332_D1,0,0,0,0,0,0
TTCCCGACGCTTCACT-1_V12D07-332_D1,0,0,0,0,0,0
AGCGGTTGAGATGTAC-1_V12D07-332_D1,0,0,0,0,0,0
GCTGTCTGTGATCGAC-1_V12D07-332_D1,0,0,0,0,0,0
AAAGACATGAAGTTTA-1_V12D07-332_D1,0,0,0,1,0,1
CAACAGAATAACGCTA-1_V12D07-332_D1,0,0,0,0,0,0
TGCGGTCTACGAGTAA-1_V12D07-332_D1,0,1,0,0,1,2
AAGACTCACGCCCACT-1_V12D07-332_D1,0,1,0,2,2,5
CTTTGAAACATATTCC-1_V12D07-332_D1,1,0,0,1,1,3
CTGGGCACTAGTCGGA-1_V12D07-332_D1,0,0,0,0,1,1
CGCCCTTACATCCACC-1_V12D07-332_D1,0,0,0,0,2,2
CACGACCACAGACTTT-1_V12D07-332_D1,0,0,0,0,0,0
CAATCCATTATCCGTT-1_V12D07-332_D1,0,0,0,0,0,0
GTGGCGTGCACCAGAG-1_V12D07-332_D1,0,0,0,0,0,0
CGGAGTCCTAACCTGG-1_V12D07-332_D1,0,0,0,0,2,2
GGTCCCATAACATAGA-1_V12D07-332_D1,0,0,0,0,0,0
ATCTCATAAACCTACC-1_V12D07-332_D1,0,0,0,1,0,1
TGCATGGCAGTCTTGC-1_V12D07-332_D1,0,0,0,0,0,0
TTGCAGGTCATGAAGT-1_V12D07-332_D1,0,0,0,0,0,0
AGCTGCATTTGAGGTG-1_V12D07-332_D1,0,0,0,0,0,0
TAATCAGGAATGCTGC-1_V12D07-332_D1,0,0,0,0,3,3
CCATCATAAGAACAGG-1_V12D07-332_D1,0,0,0,0,0,0
TCGTATCACCAAGCTA-1_V12D07-332_D1,0,2,0,0,0,2
ATTCAGATGAATCCCT-1_V12D07-332_D1,0,0,0,0,0,0
AAAGGTCAACGACATG-1_V12D07-332_D1,0,1,0,0,0,1
AGCTGCTGTGCCGAAT-1_V12D07-332_D1,0,0,0,0,0,0
CTAGCGCCAATCCTAC-1_V12D07-332_D1,0,0,0,0,1,1
GCTCGACCGAACTGAA-1_V12D07-332_D1,0,0,0,1,1,2
ACAGTGCAGCGCATTT-1_V12D07-332_D1,0,0,0,0,1,1
CGGCTGAAGGTTACGC-1_V12D07-332_D1,1,1,0,0,0,2
CACCTCTACGAGTGTG-1_V12D07-332_D1,0,0,0,0,0,0
ATACGACAGATGGGTA-1_V12D07-332_D1,0,0,0,0,1,1
ACTTCCTGTCGTGCGA-1_V12D07-332_D1,0,4,0,0,0,4
CGTAACGGAACGATCA-1_V12D07-332_D1,0,0,0,0,0,0
AAATCACTCCTAAACG-1_V12D07-332_D1,0,1,0,0,1,2
CTCCGAGTAAATCCGC-1_V12D07-332_D1,0,0,0,0,0,0
ACGCTAGTATCAGTGC-1_V12D07-332_D1,0,0,0,0,0,0
AGAGTGAACAGACACC-1_V12D07-332_D1,0,0,0,0,0,0
ACACCCGTAAATCTGT-1_V12D07-332_D1,0,0,0,0,0,0
GCTTTGCTGCCGGGTA-1_V12D07-332_D1,0,0,0,0,0,0
ACAGGAGGCGCAGCCG-1_V12D07-332_D1,0,0,0,0,0,0
AGGCAATACGGAGGAC-1_V12D07-332_D1,3,1,1,0,0,5
TGGTGTGACAGACGAT-1_V12D07-332_D1,2,0,1,0,0,3
ATCTATCGATGATCAA-1_V12D07-332_D1,0,0,0,1,0,1
CGGTAACAAGATACAT-1_V12D07-332_D1,0,0,0,0,0,0
TCGCCGGAGAGTCTTA-1_V12D07-332_D1,1,0,0,0,0,1
GGAGGAGTGTGTTTAT-1_V12D07-332_D1,0,0,0,0,0,0
TTAGGTGTGACTGGTC-1_V12D07-332_D1,0,1,0,0,0,1
CAGGGCTAACGAAACC-1_V12D07-332_D1,0,2,0,0,0,2
CCCGTGGGTTAATTGA-1_V12D07-332_D1,3,0,0,0,0,3
GACCGACCGCTAATAT-1_V12D07-332_D1,2,3,0,1,0,6
GGTATCAAGCATAGAA-1_V12D07-332_D1,1,0,0,3,0,4
TGCATGAGTAGATTCG-1_V12D07-332_D1,0,5,0,0,0,5
AATTCCAACTTGGTGA-1_V12D07-332_D1,1,0,0,1,0,2
TGCCGATGTCATCAAT-1_V12D07-332_D1,0,2,0,1,0,3
GCTGGGTCCGCTGTTA-1_V12D07-332_D1,1,2,0,0,0,3
TGAACACCCGAAGCAG-1_V12D07-332_D1,0,2,0,1,0,3
AACATTGGTCAGCCGT-1_V12D07-332_D1,0,0,0,0,0,0
GTGGGTCTTCTTTGCG-1_V12D07-332_D1,0,1,0,1,0,2
CATCGAATGGATCTCT-1_V12D07-332_D1,0,2,1,0,0,3
GCTACACTGTCCGAAC-1_V12D07-332_D1,0,1,0,1,0,2
CGGGTTGTAGCTTTGG-1_V12D07-332_D1,0,1,1,0,0,2
CCTAAGTGTCTAACCG-1_V12D07-332_D1,0,1,0,1,0,2
TCTGTGACTGACCGTT-1_V12D07-332_D1,0,5,0,0,0,5
TTATCATACTCGCAAA-1_V12D07-332_D1,0,1,0,1,0,2
AGCGTAGCGCTAGACC-1_V12D07-332_D1,0,9,1,1,0,11
TCCCTCCGAAATCGTT-1_V12D07-332_D1,0,3,0,0,0,3
AGGTCGCCACTTCGGT-1_V12D07-332_D1,0,6,0,0,0,6
CTAGCAACTAATTTAC-1_V12D07-332_D1,0,2,2,1,0,5
TTGCTAGCTACCAATC-1_V12D07-332_D1,0,6,0,1,0,7
GCCGGTTTGGGCGGAT-1_V12D07-332_D1,0,1,0,1,0,2
TGTAACTTGTCAACCT-1_V12D07-332_D1,0,5,1,1,0,7
CGAGATGTTGCCTATA-1_V12D07-332_D1,0,5,0,0,0,5
GTTACGAAATCCACGC-1_V12D07-332_D1,0,3,1,0,0,4
CTTGTCGTACGTGTCA-1_V12D07-332_D1,0,6,2,0,0,8
GCGTCCAGCTCGTGGC-1_V12D07-332_D1,0,3,0,1,0,4
CCCTTCTCGTACGCGA-1_V12D07-332_D1,0,3,1,0,0,4
CCAAAGTCCCGCTAAC-1_V12D07-332_D1,0,5,2,1,0,8
CCGCTTCGCGGTTAAC-1_V12D07-332_D1,0,9,1,0,0,10
GTTACGGCCCGACTGC-1_V12D07-332_D1,1,5,0,0,0,6
CCCGCTTGCCCTCGTC-1_V12D07-332_D1,0,1,2,0,0,3
TAGTGAGAAGTGGTTG-1_V12D07-332_D1,0,4,0,1,0,5
CGCTACCGCCCTATGA-1_V12D07-332_D1,0,1,2,2,0,5
AAACAATCTACTAGCA-1_V12D07-332_D1,0,3,0,0,0,3
GCGCGATGGGTCAAGT-1_V12D07-332_D1,0,2,1,0,0,3
ATAAACCATTGGACGG-1_V12D07-332_D1,0,4,0,1,0,5
TCGGGCACTTCTGGAT-1_V12D07-332_D1,0,1,1,0,0,2
TCTGTGGCTACATTTC-1_V12D07-332_D1,0,3,0,1,0,4
CTCTGTGCCTGCTATG-1_V12D07-332_D1,0,4,2,0,0,6
CACGACTAAAGTTCTG-1_V12D07-332_D1,0,4,0,1,0,5
GAGGAGTAATTCCTAC-1_V12D07-332_D1,0,2,1,1,0,4
AGAGGTATCTCGGTCC-1_V12D07-332_D1,0,1,0,1,0,2
GGCGTACCCTATATAA-1_V12D07-332_D1,0,3,0,0,0,3
GCCGGAAACACATCTT-1_V12D07-332_D1,0,5,0,1,0,6
AAATGTGGGTGCTCCT-1_V12D07-332_D1,0,2,2,2,0,6
ACCAGGAGTGTGATCT-1_V12D07-332_D1,0,5,0,1,0,6
TGTGGAGGAAGCTTAA-1_V12D07-332_D1,0,2,0,3,0,5
AAGGAGAACTTATAAG-1_V12D07-332_D1,0,3,0,0,0,3
CCCTCGGGAGCCTTGT-1_V12D07-332_D1,0,2,0,2,0,4
ACTGTTTAGTGTAGGC-1_V12D07-332_D1,0,2,0,4,0,6
CGTCAGTTTATCGTCT-1_V12D07-332_D1,0,4,0,8,0,12
GCGTGTATGTCGTATT-1_V12D07-332_D1,0,0,0,17,6,23
ACAATCGATCTTTATA-1_V12D07-332_D1,0,0,3,2,0,5
CAGCCCTCACAGGCAG-1_V12D07-332_D1,0,1,1,0,1,3
CGCGTCATATTAAACC-1_V12D07-332_D1,0,3,0,0,0,3
GAAGACTTCAATGCCG-1_V12D07-332_D1,0,0,0,0,1,1
TTGCGGCGACTCATGC-1_V12D07-332_D1,0,1,0,0,0,1
ACCAAACTAGAAATCC-1_V12D07-332_D1,2,4,1,2,0,9
TTACTGTTTCTCTACG-1_V12D07-332_D1,0,1,0,0,0,1
GACCAGGTCATTCATA-1_V12D07-332_D1,0,0,0,0,0,0
TTCTTCCCTTTGATAT-1_V12D07-332_D1,0,2,1,0,0,3
ACGCCCAGCTGTCGAT-1_V12D07-332_D1,0,4,1,0,0,5
AGTAGCGTGAACGAAC-1_V12D07-332_D1,0,0,0,0,0,0
CCTCGACCCACTGCCT-1_V12D07-332_D1,0,0,0,0,0,0
AGTTATTGAAAGGTAA-1_V12D07-332_D1,0,0,1,0,0,1
TCAGTTACGGAATGAT-1_V12D07-332_D1,0,0,0,0,1,1
GAATCTATACTCGGAC-1_V12D07-332_D1,0,0,0,0,0,0
TCGGCTAACTTCCCTT-1_V12D07-332_D1,0,0,0,0,0,0
ACGTGGTCGAATGTGC-1_V12D07-332_D1,0,0,0,0,0,0
ATATCGTGCCAGACCC-1_V12D07-332_D1,0,1,0,1,3,5
GTAGCTAGTAAGCGCG-1_V12D07-332_D1,0,1,0,0,0,1
ACGCTTAGTGTCTCTC-1_V12D07-332_D1,0,0,0,0,1,1
TCCGGCCTGCATCGAT-1_V12D07-332_D1,0,0,0,3,0,3
TAGTGGAACTCATACA-1_V12D07-332_D1,0,0,0,0,1,1
ATCATCTGCCCAGTGT-1_V12D07-332_D1,0,0,0,0,0,0
GTTATTAAATACGACC-1_V12D07-332_D1,0,2,0,1,2,5
GCGCTAAGTATGCATG-1_V12D07-332_D1,0,2,0,0,1,3
CCTGACGCAACCTTTA-1_V12D07-332_D1,0,2,1,0,0,3
CCCAAGAATGCACGGT-1_V12D07-332_D1,0,0,0,0,0,0
AACTGGGTTCGAGCCG-1_V12D07-332_D1,0,0,0,0,0,0
GGTTCCACCCGCTTCT-1_V12D07-332_D1,0,1,0,1,2,4
CATGCACGTGTTACTG-1_V12D07-332_D1,1,0,0,1,0,2
AGCGTTCCGATTTAAA-1_V12D07-332_D1,0,0,0,0,0,0
CCTACGCGACCTTACA-1_V12D07-332_D1,0,0,0,1,0,1
CGAATTACATGGTGTT-1_V12D07-332_D1,0,0,0,0,0,0
GAGGTCTTAGTGGGTC-1_V12D07-332_D1,0,0,0,0,0,0
GCCGCTAGATACGCAG-1_V12D07-332_D1,0,2,0,0,0,2
GTCACCTGTCTATGTC-1_V12D07-332_D1,0,0,0,1,0,1
CCGATTGGTCAATGAA-1_V12D07-332_D1,0,0,0,0,0,0
CCTGTGCGGATTGTAA-1_V12D07-332_D1,0,1,0,2,0,3
TTACGTAGCGCGTGCT-1_V12D07-332_D1,1,0,0,0,0,1
GGAGGCGAAGAACCGC-1_V12D07-332_D1,0,0,0,0,1,1
GGGTCACGTGCTTATG-1_V12D07-332_D1,0,0,0,1,2,3
GCTCCGGACGTTGATA-1_V12D07-332_D1,0,0,0,1,0,1
ATGTTTGTAAGATCAT-1_V12D07-332_D1,0,0,0,2,0,2
TGACCCAGCATTCCCG-1_V12D07-332_D1,1,1,0,0,0,2
TGGTCGTTTGATAGAT-1_V12D07-332_D1,0,0,0,0,0,0
TGTAATGCCTTCGGAC-1_V12D07-332_D1,2,2,0,0,1,5
TGCTCACACAACAACC-1_V12D07-332_D1,0,0,0,1,0,1
TACGATCCAAGCCACT-1_V12D07-332_D1,0,0,0,2,2,4
TTGTAACTTCATAGCG-1_V12D07-332_D1,1,0,1,0,0,2
AGATTCAAGCGGGTCG-1_V12D07-332_D1,0,0,0,1,0,1
CTCAGCAGACTGCCGA-1_V12D07-332_D1,1,2,0,0,0,3
GTAACATCAGCTCATC-1_V12D07-332_D1,0,0,0,0,1,1
ATGGAACAGAATAAAC-1_V12D07-332_D1,0,0,0,0,0,0
GGGCCTATACAACCGG-1_V12D07-332_D1,0,0,0,0,0,0
TCAAACAATTAGGACA-1_V12D07-332_D1,0,0,1,0,1,2
AAACCACTACACAGAT-1_V12D07-332_D1,0,0,0,0,1,1
AAACGACAGTCTTGCC-1_V12D07-332_D1,0,1,1,0,1,3
TTGAGGGTCGAACGCG-1_V12D07-332_D1,0,0,0,0,1,1
TGTTGATCACTGTTTA-1_V12D07-332_D1,1,0,0,0,1,2
AGGGTGTGCTACACGC-1_V12D07-332_D1,0,0,0,1,0,1
GTAGTTAGACAATATA-1_V12D07-332_D1,0,0,0,2,1,3
AATGGCCGCCAATGCG-1_V12D07-332_D1,1,1,0,0,0,2
TCGGCGGTATTAGATT-1_V12D07-332_D1,1,0,0,0,0,1
GGGTCACTGAGTAGTG-1_V12D07-332_D1,1,0,0,0,0,1
GAATTATGCAACCTAC-1_V12D07-332_D1,0,0,0,0,0,0
GATCTTAGTGAACGTG-1_V12D07-332_D1,0,1,0,2,1,4
CTAATGCGCCCAACAA-1_V12D07-332_D1,0,0,0,0,0,0
GCCACCCATTCCACTT-1_V12D07-332_D1,0,0,0,0,0,0
TACTCACAACGTAGTA-1_V12D07-332_D1,0,0,0,0,0,0
GTTCGGTGTGGATTTA-1_V12D07-332_D1,2,3,0,0,0,5
TCTTTCGGCGGGACAC-1_V12D07-332_D1,3,0,0,0,0,3
GGAGACATTCACGGGC-1_V12D07-332_D1,4,0,0,1,0,5
GGGATTATCTCACAAC-1_V12D07-332_D1,1,0,0,0,0,1
TAGAACGCCAGTAACG-1_V12D07-332_D1,0,0,0,0,0,0
ACGAGTCGCCGGCGTT-1_V12D07-332_D1,0,1,0,0,0,1
TGATGGGACTAAGTCA-1_V12D07-332_D1,2,0,0,0,0,2
TGCGAGAAACGTTACG-1_V12D07-332_D1,4,0,0,1,0,5
TCGCCTCGACCTGTTG-1_V12D07-332_D1,5,3,1,0,0,9
AACTCGATAAACACGT-1_V12D07-332_D1,0,1,0,0,0,1
AGGAAAGCCTCTGATG-1_V12D07-332_D1,2,0,0,0,0,2
GAAGGACTAAATTGAA-1_V12D07-332_D1,0,1,1,1,0,3
GTATCGGGACGAGCTG-1_V12D07-332_D1,2,0,0,1,0,3
CCTGTGCATAGGAGAC-1_V12D07-332_D1,1,3,1,3,0,8
CATACGGGTGCATGAT-1_V12D07-332_D1,0,0,0,2,0,2
CCACTAAACTGAATCG-1_V12D07-332_D1,2,0,0,0,0,2
AAATTGCGGCGGTTCT-1_V12D07-332_D1,0,3,0,1,0,4
AGTCCAGCGGGTACGT-1_V12D07-332_D1,0,2,0,0,0,2
CATTCAGGTCAGTGCG-1_V12D07-332_D1,0,3,0,0,0,3
CTAAAGTCCGAAGCTA-1_V12D07-332_D1,0,2,1,0,0,3
AATCAGACTGCAGGAC-1_V12D07-332_D1,0,4,1,0,0,5
AGTATCCATAATAACG-1_V12D07-332_D1,0,2,4,1,0,7
CTGGCTGCTAACGTAA-1_V12D07-332_D1,0,5,3,0,0,8
GTTCCAAGACAGCGAC-1_V12D07-332_D1,0,5,1,0,0,6
AAGACTAACCCGTTGT-1_V12D07-332_D1,0,4,1,0,0,5
GATTAATCCTGGCTCA-1_V12D07-332_D1,0,2,0,0,0,2
CGCGCAAGGAACTACA-1_V12D07-332_D1,0,3,1,0,0,4
CAGTAGCGAGGTAGTA-1_V12D07-332_D1,0,5,0,0,0,5
ACGGCGGGTTGCCCTG-1_V12D07-332_D1,0,3,0,0,0,3
CTAGGCGGCAGAGAAT-1_V12D07-332_D1,0,6,1,0,0,7
GTGCGCAGCTTGCTCC-1_V12D07-332_D1,0,7,0,0,0,7
TCACTATCGTGCAATC-1_V12D07-332_D1,0,3,3,0,0,6
TATGATTCTGCTTGGT-1_V12D07-332_D1,0,5,0,0,0,5
TAAGATTTAGCGGGAG-1_V12D07-332_D1,0,4,0,0,0,4
TTACGGTGTCACCGAG-1_V12D07-332_D1,0,5,1,1,0,7
CTACACTAGCTTGTTC-1_V12D07-332_D1,0,4,3,0,0,7
TGAGCAGTCGTGAAGT-1_V12D07-332_D1,0,7,0,0,0,7
CGCTGAGGACGTCCAA-1_V12D07-332_D1,0,2,2,0,0,4
GTGTATGACTTTAAAG-1_V12D07-332_D1,0,0,3,0,0,3
CTAAACGGGTGTAATC-1_V12D07-332_D1,0,2,1,0,0,3
TGTACTGTGCCAAAGT-1_V12D07-332_D1,0,7,0,1,0,8
GGCCACAAGCGATGGC-1_V12D07-332_D1,0,2,0,0,0,2
GTCAATTGTACTGAAG-1_V12D07-332_D1,0,5,0,1,0,6
AGGGACAGCACGGCGG-1_V12D07-332_D1,0,2,0,2,0,4
AGCTTATAGAGACCTG-1_V12D07-332_D1,0,2,1,1,0,4
AACTAGCGTATCGCAC-1_V12D07-332_D1,0,2,1,0,0,3
AACTTTAGCTGCTGAG-1_V12D07-332_D1,0,5,0,0,0,5
CCCAAGACAGAGTATG-1_V12D07-332_D1,0,3,0,2,0,5
GGCATCAACGAGCACG-1_V12D07-332_D1,0,2,5,1,0,8
ATGCATTCCGTGATGG-1_V12D07-332_D1,0,2,1,1,0,4
TTATAGATGCACATTA-1_V12D07-332_D1,0,6,1,2,0,9
GAACCATCTGGGAGAC-1_V12D07-332_D1,0,3,0,1,0,4
TGCTATACAAACGGAC-1_V12D07-332_D1,0,6,0,0,0,6
ACTTGCCATATTGTAC-1_V12D07-332_D1,0,4,0,0,0,4
TATTCCGGCAGTCCTA-1_V12D07-332_D1,0,0,0,0,0,0
GACGGACCGCGTTCCT-1_V12D07-332_D1,0,2,0,1,0,3
ATGTGTAGTTTAGTCA-1_V12D07-332_D1,0,1,0,14,5,20
ATACCAGCAAATTGCT-1_V12D07-332_D1,0,1,0,14,2,17
AAGTTTACTAATGGCA-1_V12D07-332_D1,0,2,0,0,3,5
CTCTCGATGTGCGCCT-1_V12D07-332_D1,0,4,0,0,0,4
GATTGACACTCTGCTC-1_V12D07-332_D1,0,3,0,1,0,4
TATCACAGCACGGGCA-1_V12D07-332_D1,0,0,0,0,1,1
ACCGTTCCCGCTCTGA-1_V12D07-332_D1,0,1,0,0,0,1
CCGCCACCACAATCCA-1_V12D07-332_D1,0,0,0,0,0,0
CATTCACTGACAGCTA-1_V12D07-332_D1,0,5,1,0,1,7
CGGCTGCAAGATTAAG-1_V12D07-332_D1,0,0,0,0,0,0
CATGAACCTCTTATCA-1_V12D07-332_D1,0,2,0,0,1,3
TTAATGCGAGGTAACT-1_V12D07-332_D1,0,1,1,0,1,3
AATAAGTCCTCGAGAC-1_V12D07-332_D1,0,0,0,0,1,1
ACCAGCCCGGTCTTTG-1_V12D07-332_D1,0,0,0,0,1,1
CTACGAACTAGGTCGA-1_V12D07-332_D1,0,0,0,0,1,1
ACATCTCAACGCGTAA-1_V12D07-332_D1,0,1,0,0,0,1
CACTACTCAGTTCTGT-1_V12D07-332_D1,1,0,0,0,1,2
CCGACTCGCATAGTCT-1_V12D07-332_D1,0,0,0,3,0,3
CATTTATCGTTCAAGA-1_V12D07-332_D1,0,0,0,0,0,0
CAAACGTGGTCTTGCG-1_V12D07-332_D1,0,0,0,0,0,0
TAGAAACCACTAAGTA-1_V12D07-332_D1,0,0,0,0,1,1
ACTGATTTAGTGATTC-1_V12D07-332_D1,1,0,0,0,0,1
TCGTATTTCGTCCGGA-1_V12D07-332_D1,0,0,0,0,0,0
CGGAAATTTCACATCC-1_V12D07-332_D1,0,1,0,0,0,1
ATCCACGCTAAATGTT-1_V12D07-332_D1,0,0,0,1,0,1
GTTCAATCTATGTCAA-1_V12D07-332_D1,0,1,0,1,0,2
ATAAAGGTCAAGTACG-1_V12D07-332_D1,1,0,0,1,0,2
CAACTCCAACGTTTAG-1_V12D07-332_D1,0,1,0,1,0,2
TAGGAACAGCCTCCAG-1_V12D07-332_D1,0,0,0,1,0,1
ATGGGAACGGAAGCGG-1_V12D07-332_D1,0,0,0,0,0,0
CACACGTTTCAATGGG-1_V12D07-332_D1,0,0,0,1,0,1
GGTGTTCTGTTTCTAC-1_V12D07-332_D1,0,0,0,0,0,0
AGTAACGTTCATCCTG-1_V12D07-332_D1,1,0,0,2,0,3
GTATAGTGGCCCATGT-1_V12D07-332_D1,0,1,0,0,0,1
TCTACACGTTCATGCA-1_V12D07-332_D1,0,1,0,3,0,4
AATCTGGGTAGACCCT-1_V12D07-332_D1,0,0,0,1,0,1
TCGGTTAGCCATGTAG-1_V12D07-332_D1,0,1,0,2,1,4
TGCCATGGCTTATAAG-1_V12D07-332_D1,1,1,1,1,0,4
TAAGTAAATGTGCCGC-1_V12D07-332_D1,0,0,0,1,0,1
GTGTCCGATAAGGCAT-1_V12D07-332_D1,0,0,0,0,0,0
TGGCACGAGCTCGAGT-1_V12D07-332_D1,0,0,0,0,0,0
ACCGGTCTGAGTACGG-1_V12D07-332_D1,0,1,0,0,0,1
GAACTTAGCGCCCGGT-1_V12D07-332_D1,0,0,0,0,0,0
AGTAGCTAGACGCCGA-1_V12D07-332_D1,0,0,0,1,0,1
ATAGGAATCTAAGCTT-1_V12D07-332_D1,1,0,0,0,0,1
CTTCCTGCATATTTAC-1_V12D07-332_D1,0,1,0,1,0,2
CAATATGTAGATTTAC-1_V12D07-332_D1,0,0,0,0,0,0
ACAAGGCCTACCAGCC-1_V12D07-332_D1,0,0,0,1,0,1
TTATAGTCCAAGGTGC-1_V12D07-332_D1,0,1,0,1,0,2
AAACGCCCGAGATCGG-1_V12D07-332_D1,1,1,0,4,1,7
CCTCGTTACGCCTGTT-1_V12D07-332_D1,0,0,0,0,0,0
GAACGGTGTAAAGCAG-1_V12D07-332_D1,0,0,1,0,0,1
ACGCATAAATGACATG-1_V12D07-332_D1,0,0,0,1,0,1
GGTTCGATGCTGAGTT-1_V12D07-332_D1,0,0,0,0,0,0
CTTTGGCAGACAGAGT-1_V12D07-332_D1,0,0,0,0,0,0
TTCGTGGGCTGGAAGC-1_V12D07-332_D1,0,0,0,0,1,1
CAAAGGTTAAATTCAG-1_V12D07-332_D1,1,2,1,1,1,6
GTTTGGCGTCAGGCAC-1_V12D07-332_D1,0,0,0,0,1,1
GCTTTCTATCTCAACT-1_V12D07-332_D1,0,0,0,0,0,0
TGCATCTCCGGATCTT-1_V12D07-332_D1,1,0,0,0,0,1
CTGAAACGGCCCTCAG-1_V12D07-332_D1,0,0,0,0,0,0
TAGCAGTAAATACGCG-1_V12D07-332_D1,1,0,0,0,0,1
CGGGCTACTTAAATTG-1_V12D07-332_D1,0,0,0,0,0,0
ATTATGCTCAGTATTG-1_V12D07-332_D1,0,0,0,0,0,0
TGATGCTCACGTAGTC-1_V12D07-332_D1,0,1,0,1,0,2
GTCTAAGATGCCCAGC-1_V12D07-332_D1,0,0,0,0,0,0
AACCCGATAGGGCTTC-1_V12D07-332_D1,0,1,0,0,0,1
CGCTATCGTGGCTTTA-1_V12D07-332_D1,0,0,0,0,0,0
CGTCTCTCGCCGAGGC-1_V12D07-332_D1,0,0,0,0,0,0
AGTGGGAGTATACACG-1_V12D07-332_D1,2,0,0,0,0,2
GGTCTTGGTGTTAACT-1_V12D07-332_D1,4,1,0,0,0,5
GGCTGGCAGCTTTATG-1_V12D07-332_D1,1,1,1,1,0,4
CGCCAATTATTGCGTT-1_V12D07-332_D1,0,0,0,0,0,0
GGTAACCGGCAAAGGT-1_V12D07-332_D1,2,0,0,0,0,2
TGGGACCATTGGGAGT-1_V12D07-332_D1,1,0,0,0,0,1
CTGCAGGTGCTCGGCC-1_V12D07-332_D1,2,0,0,0,0,2
CCGGTGCGAGTGATAG-1_V12D07-332_D1,0,1,0,1,0,2
GGGTACACTCTGGAGG-1_V12D07-332_D1,2,0,0,0,0,2
TAGCCAGAGGGTCCGG-1_V12D07-332_D1,1,4,0,1,0,6
CTTGTGAGGACAGCGG-1_V12D07-332_D1,2,1,1,1,0,5
GAAGGGCATAACCATG-1_V12D07-332_D1,5,3,3,2,0,13
CAACATGGCCTGATAA-1_V12D07-332_D1,2,0,0,0,0,2
CAATTTGACCGGGAAG-1_V12D07-332_D1,1,1,0,2,0,4
TCTGACTGTAATGGTT-1_V12D07-332_D1,3,0,1,0,0,4
TTCATAGCCTTGTAAC-1_V12D07-332_D1,0,0,0,0,0,0
TGGAAACGGAGTGAAC-1_V12D07-332_D1,0,0,0,1,0,1
ATCGCACGATTGTTCA-1_V12D07-332_D1,2,2,0,0,0,4
CGCCACCCGCATTAAC-1_V12D07-332_D1,2,1,1,2,0,6
TGGACCACGGCGTTGA-1_V12D07-332_D1,0,3,0,3,0,6
GTATATGTTACGGCGG-1_V12D07-332_D1,0,0,0,0,0,0
GTATTCTTACCGTGCT-1_V12D07-332_D1,1,0,0,1,0,2
TTCAGAGTAACCTGAC-1_V12D07-332_D1,0,3,1,2,0,6
GCGGTAACCCAAATGA-1_V12D07-332_D1,0,8,2,0,0,10
CTACGTGTTGCCACCA-1_V12D07-332_D1,0,5,0,1,0,6
CTAGATAAACTCCTCG-1_V12D07-332_D1,0,4,1,1,0,6
TCCATTAGTTGGATAG-1_V12D07-332_D1,0,4,0,0,0,4
CTGGCTCCTGCGGGAT-1_V12D07-332_D1,0,4,0,0,0,4
CAGTCTCTCGGCTAAT-1_V12D07-332_D1,0,4,0,0,0,4
GTATGACGTGGGAAAC-1_V12D07-332_D1,0,5,2,1,0,8
AGTCACTCCGCCTCAT-1_V12D07-332_D1,0,4,2,1,0,7
GCAGCGGTGGGCATTA-1_V12D07-332_D1,0,6,0,2,0,8
TATGGAGTTTCTCGTT-1_V12D07-332_D1,0,2,1,0,0,3
ACTCAACGAATGTATT-1_V12D07-332_D1,0,4,2,0,0,6
AACACGCGGCCGCGAA-1_V12D07-332_D1,0,2,4,1,0,7
CGATATTAGCCGCAGG-1_V12D07-332_D1,0,7,1,0,0,8
AGCGTCTGAACCCGCA-1_V12D07-332_D1,0,3,1,0,0,4
GATGTCCGGATCACAT-1_V12D07-332_D1,2,5,2,0,0,9
GGTCACGTTAGATTCA-1_V12D07-332_D1,0,6,0,1,0,7
TTAAGGATACGGAGGT-1_V12D07-332_D1,0,4,1,1,0,6
GTGCGGGACCATCGGC-1_V12D07-332_D1,0,3,0,1,0,4
CCATCTTGTTCACAAT-1_V12D07-332_D1,0,4,1,0,0,5
TCCGAGAAGGCTAAGC-1_V12D07-332_D1,0,3,3,1,0,7
TGGCGGTGTGCGATTG-1_V12D07-332_D1,0,4,0,0,0,4
ATCCTGCTGCAGATAG-1_V12D07-332_D1,0,3,0,0,0,3
TTATGCGTCCCGGTCC-1_V12D07-332_D1,0,3,0,2,0,5
CATAATGAGCGGGCGA-1_V12D07-332_D1,0,6,0,0,0,6
AGACATAGATCCTTCC-1_V12D07-332_D1,0,1,1,0,0,2
GGTGAAACCGGGAATG-1_V12D07-332_D1,0,3,0,0,0,3
AACTGGTGTGGGCCTT-1_V12D07-332_D1,0,2,0,2,0,4
GTAGCGCTGTTGTAGT-1_V12D07-332_D1,0,1,5,3,0,9
TTGTTTGTGTAAATTC-1_V12D07-332_D1,0,2,0,0,0,2
GGATCAAAGGACGAGG-1_V12D07-332_D1,0,3,1,3,0,7
CGTAGCGCCGACGTTG-1_V12D07-332_D1,0,1,0,1,0,2
CAAGTGAACTTTGGTT-1_V12D07-332_D1,0,1,2,1,0,4
GTAGACAACCGATGAA-1_V12D07-332_D1,0,1,2,2,0,5
CAATGGTCGGCCTGGG-1_V12D07-332_D1,0,1,0,4,0,5
ACAGATTAGGTTAGTG-1_V12D07-332_D1,0,0,4,12,0,16
GTTATCACCTTCTGAA-1_V12D07-332_D1,0,2,1,17,5,25
TGGTATCGGTCTGTAT-1_V12D07-332_D1,0,2,1,0,1,4
GGAATAACCTCAAGAA-1_V12D07-332_D1,0,0,0,0,0,0
ATTATCTCGACAGATC-1_V12D07-332_D1,0,0,0,0,2,2
CCGAGGGATGTTAGGC-1_V12D07-332_D1,0,1,1,0,0,2
TGAGATCAAATACTCA-1_V12D07-332_D1,0,2,0,0,1,3
AAACGAAGAACATACC-1_V12D07-332_D1,0,1,0,0,1,2
CTGGTCCTAACTTGGC-1_V12D07-332_D1,0,6,0,1,0,7
TGCACGAGTCGGCAGC-1_V12D07-332_D1,0,0,0,0,2,2
ATAGTCTTTGACGTGC-1_V12D07-332_D1,0,3,0,0,0,3
TGGAGCTAAAGTTCCC-1_V12D07-332_D1,0,6,0,0,1,7
GGGTGGTCCAGCCTGT-1_V12D07-332_D1,0,0,0,0,0,0
CATGCATGGAGACCCT-1_V12D07-332_D1,0,0,0,0,0,0
ACACGGCACTATGCAT-1_V12D07-332_D1,0,1,0,0,0,1
CCCTGGTATGGGCGGC-1_V12D07-332_D1,0,1,0,1,0,2
GGAGGATTGAAAGGAG-1_V12D07-332_D1,0,2,0,0,1,3
CCGCTGGTGCCATTCA-1_V12D07-332_D1,0,0,0,0,0,0
GTTAGAGTGTGCCGCT-1_V12D07-332_D1,0,0,0,1,0,1
TCGGAATGACCATCAA-1_V12D07-332_D1,0,0,0,0,0,0
TTCAATTAGCCATAAT-1_V12D07-332_D1,0,0,0,0,0,0
GATGTGTTGTCACAAG-1_V12D07-332_D1,0,0,0,0,0,0
TCTTTCTCTTAAGGAG-1_V12D07-332_D1,2,0,0,0,0,2
ACCCTTTAGTTCTCCA-1_V12D07-332_D1,0,0,0,0,0,0
ACCACAACTCAGAACA-1_V12D07-332_D1,0,0,0,0,0,0
TATGATAAATCTAACG-1_V12D07-332_D1,0,0,0,1,0,1
GATCCTCTTGCGCTTA-1_V12D07-332_D1,0,0,0,0,0,0
TTCTACCTTTATGTTG-1_V12D07-332_D1,0,1,0,0,0,1
GAAATACCTGCTGGCT-1_V12D07-332_D1,0,0,0,1,0,1
ATTCTGAGTATGAACT-1_V12D07-332_D1,2,0,0,3,0,5
GGATTAAGCTAAGGTC-1_V12D07-332_D1,0,0,0,0,0,0
AGTACGTGGCCTGTCT-1_V12D07-332_D1,0,0,0,0,0,0
TCAGGGTGCACGAAAC-1_V12D07-332_D1,1,0,0,0,0,1
AAATTTACCGAAATCC-1_V12D07-332_D1,0,1,0,1,0,2
TTGAGGCATTTAACTC-1_V12D07-332_D1,0,0,0,1,0,1
AACCAGTATCACTCTT-1_V12D07-332_D1,0,0,0,1,0,1
CACCGGAGATATCTCC-1_V12D07-332_D1,0,0,0,0,0,0
GACTGGGCGCCGCAAC-1_V12D07-332_D1,0,0,0,3,0,3
CACGTCTATGATGTGG-1_V12D07-332_D1,1,1,0,0,0,2
TTAAGACGAACGAACC-1_V12D07-332_D1,0,0,0,0,0,0
TGACCAGCTTCAAAGT-1_V12D07-332_D1,0,0,0,1,0,1
AGAGTTAGAGACCGAT-1_V12D07-332_D1,0,0,0,0,0,0
TTCGGACTGATGCCTT-1_V12D07-332_D1,0,0,0,0,0,0
CTCGAATGGAACGTAT-1_V12D07-332_D1,0,0,0,0,0,0
GGACGGCTTGCGCAAC-1_V12D07-332_D1,0,1,0,0,0,1
CTAAGTACAGGGCTAC-1_V12D07-332_D1,0,0,0,0,0,0
ACAAATTCAGATCTGA-1_V12D07-332_D1,0,0,0,4,0,4
CATGGAAATGGGACCA-1_V12D07-332_D1,0,0,0,0,0,0
GGTGGACCACGTGTTA-1_V12D07-332_D1,0,0,0,2,0,2
CACGACGTAATAGTAA-1_V12D07-332_D1,0,0,0,1,0,1
CGGGTTCGGCACGTAT-1_V12D07-332_D1,0,0,0,0,0,0
CTGGGCTATCCTTTGG-1_V12D07-332_D1,1,0,1,0,0,2
GTATTAGGGTTCGCGT-1_V12D07-332_D1,0,0,0,0,0,0
TCATTCGTATAATTTG-1_V12D07-332_D1,1,2,0,0,0,3
AATAGCAAGCCTCCTG-1_V12D07-332_D1,0,0,0,0,0,0
CATCTACCCGAGAACG-1_V12D07-332_D1,0,1,0,0,0,1
GCTTCAGTGGGATTAC-1_V12D07-332_D1,0,1,0,2,0,3
TCTGTGATGGAGGTTG-1_V12D07-332_D1,1,0,0,0,0,1
ATCCACTTTCAGACTA-1_V12D07-332_D1,0,0,0,1,0,1
ATGGTTACGAAACATG-1_V12D07-332_D1,1,0,0,1,0,2
GGCCCAATCTAGAGGG-1_V12D07-332_D1,0,1,0,2,0,3
GATGGTGAAATAACCC-1_V12D07-332_D1,0,0,0,2,0,2
AGAGGGACAATTGTCC-1_V12D07-332_D1,1,1,1,0,0,3
CGCGTACATTCTGGAA-1_V12D07-332_D1,0,0,0,0,0,0
CAAGAAACCCTAAACT-1_V12D07-332_D1,0,0,0,0,0,0
TTGGTGCGGTGTTGAA-1_V12D07-332_D1,0,0,0,0,0,0
GGTTCCCTAGTGTCTC-1_V12D07-332_D1,1,1,0,1,0,3
CGATAACCAATTTGAG-1_V12D07-332_D1,0,0,0,0,0,0
GCCCACTGGTCCACAA-1_V12D07-332_D1,1,1,0,3,0,5
GAGGGCCGGCAGAGTC-1_V12D07-332_D1,0,0,0,0,0,0
CGACACGGATGCCCAC-1_V12D07-332_D1,0,0,0,3,0,3
CTGTCTGTGGCTGGCT-1_V12D07-332_D1,0,0,0,1,0,1
ATATTATCCCGTATTT-1_V12D07-332_D1,4,0,0,0,0,4
GCGCTGGCGGAAAGTC-1_V12D07-332_D1,3,1,0,0,0,4
ATCTAACGTCCCTATG-1_V12D07-332_D1,7,1,0,0,0,8
GTCAGACAGCGTTGGA-1_V12D07-332_D1,1,0,0,0,0,1
GCCAGGCTTAGTGGTA-1_V12D07-332_D1,0,0,0,1,0,1
ATTCAAAGTACCTGTT-1_V12D07-332_D1,2,0,0,1,0,3
TGGACGTAGGCGAATC-1_V12D07-332_D1,1,1,1,0,0,3
ACACATTGACGCAACA-1_V12D07-332_D1,1,0,0,0,0,1
GATATCAGTATGTATC-1_V12D07-332_D1,0,2,0,2,0,4
TGGGCCTTGCCTGCAT-1_V12D07-332_D1,2,2,0,1,0,5
CAAAGTCAGGTTAGCT-1_V12D07-332_D1,3,1,0,1,0,5
GGATCCCTACCAGCTA-1_V12D07-332_D1,2,2,1,1,0,6
ATCGTCCAATCGAGTC-1_V12D07-332_D1,1,0,0,0,0,1
ACATGGCTCAATTTAG-1_V12D07-332_D1,0,0,0,2,0,2
AGGCCCAGTGACTGGT-1_V12D07-332_D1,2,2,0,1,0,5
GCTTCCAGCTTAGATT-1_V12D07-332_D1,1,1,0,0,0,2
TGCTTGAAACCATGCA-1_V12D07-332_D1,2,3,0,0,0,5
CAATATTGGACTAGTG-1_V12D07-332_D1,1,1,2,1,0,5
CGTGCTGGCCTAGTCG-1_V12D07-332_D1,1,2,0,0,0,3
CCTGCGATAGAACTGT-1_V12D07-332_D1,0,2,0,0,0,2
GGGTAATGCTGTGTTT-1_V12D07-332_D1,0,2,0,0,0,2
AACGCGAACGGCAACA-1_V12D07-332_D1,0,2,0,1,0,3
TGTCGGCATGGTGGAA-1_V12D07-332_D1,0,3,0,1,0,4
AGCGTACGAGAGCTAG-1_V12D07-332_D1,0,1,1,1,0,3
ATACTCTCGCCACTCT-1_V12D07-332_D1,0,6,1,0,0,7
AATCCATGCAAGGGTG-1_V12D07-332_D1,0,7,4,1,0,12
TTAAACAGAGTCCCGC-1_V12D07-332_D1,0,8,1,1,0,10
CCACAGCTGAAATCAT-1_V12D07-332_D1,1,6,0,0,0,7
CGGTTCCGGCTTCTTG-1_V12D07-332_D1,0,6,0,1,0,7
GACGTGAGACTCCATG-1_V12D07-332_D1,0,3,1,0,0,4
TCGTTGGCTCGTCAAT-1_V12D07-332_D1,0,4,1,0,0,5
GGTGAACGGGCTAGCC-1_V12D07-332_D1,0,2,1,0,0,3
GCACTGTGCAAATGTA-1_V12D07-332_D1,0,6,0,0,0,6
ACGAGAACCCATCACG-1_V12D07-332_D1,0,6,0,1,0,7
CCAGCTACGCCTCATA-1_V12D07-332_D1,0,5,2,0,0,7
TCCCGGTCAGGAATTT-1_V12D07-332_D1,0,5,2,0,0,7
TCGCATTCAATGACTT-1_V12D07-332_D1,0,4,0,1,0,5
CTGGTTCAACGCATCA-1_V12D07-332_D1,0,2,0,2,0,4
GGTGATTTCATCTTGT-1_V12D07-332_D1,0,4,0,0,0,4
CACCCTTTCCTCGCTC-1_V12D07-332_D1,0,3,1,2,0,6
CAACTTGTAGTGGGCA-1_V12D07-332_D1,0,6,1,0,0,7
AATATCAAGGTCGGAT-1_V12D07-332_D1,0,7,1,0,0,8
ACTCAGACCTGCTTCT-1_V12D07-332_D1,0,3,1,1,0,5
TTGGAGTCTCCCTTCT-1_V12D07-332_D1,0,2,1,1,0,4
GGATACTCATGAATTG-1_V12D07-332_D1,0,3,0,0,0,3
TGGGCACAAACAGAAC-1_V12D07-332_D1,0,3,1,0,0,4
GAGCCACGGTAGTAGG-1_V12D07-332_D1,0,3,0,0,0,3
TCGATAGGCTAGTCGC-1_V12D07-332_D1,0,4,0,0,0,4
TAACCGCCCGCAGTGC-1_V12D07-332_D1,0,6,1,0,0,7
GCCTATTTGCTACACA-1_V12D07-332_D1,0,2,0,2,0,4
TTGACGATTCAGCACG-1_V12D07-332_D1,0,4,0,0,0,4
TTAAACCGGTAGCGAC-1_V12D07-332_D1,0,3,1,0,0,4
ACCGAAAGGGCCCTGC-1_V12D07-332_D1,0,0,1,4,0,5
ACGTTCCGCGCTCCGT-1_V12D07-332_D1,0,5,1,2,0,8
ATACCAGGCTAATAGA-1_V12D07-332_D1,0,0,1,15,0,16
CGGCTTTGTATGATAA-1_V12D07-332_D1,0,1,1,7,0,9
CTTGACCCGAAAGATA-1_V12D07-332_D1,0,4,1,0,2,7
CGCAGAAACATTTGCG-1_V12D07-332_D1,0,3,0,0,0,3
GACCCGTCGCCGGCTA-1_V12D07-332_D1,0,2,0,0,0,2
AATCGGGACACTACGA-1_V12D07-332_D1,0,0,0,0,0,0
GTCACAAAGTTTCCAA-1_V12D07-332_D1,0,2,0,0,0,2
TATATTCGCGTCGATA-1_V12D07-332_D1,0,1,0,0,2,3
CCTCCCGACAATCCCT-1_V12D07-332_D1,0,2,1,0,2,5
CGACATGCGATCTTCT-1_V12D07-332_D1,0,1,0,0,2,3
AACACGACTGTACTGA-1_V12D07-332_D1,0,2,0,0,0,2
CCCAACCACACTAACA-1_V12D07-332_D1,0,1,0,0,1,2
CACCGCCGACCAGCGA-1_V12D07-332_D1,0,3,0,0,0,3
TGGTATCGCATCCCAA-1_V12D07-332_D1,0,1,0,0,1,2
CAGAGTGATTTAACGT-1_V12D07-332_D1,0,0,0,0,1,1
AACCCTGGTGGAACCA-1_V12D07-332_D1,0,0,0,0,0,0
GTCAGTTGTGCTCGTT-1_V12D07-332_D1,0,0,0,0,0,0
ATTGACGTAACTCGGT-1_V12D07-332_D1,0,1,0,2,0,3
GATGTCGGTCAACTGC-1_V12D07-332_D1,0,0,0,1,0,1
AGGGCAGCGGCGTGGT-1_V12D07-332_D1,0,0,0,1,0,1
ACATCGTTAACCTAGT-1_V12D07-332_D1,0,0,0,0,1,1
TCCATTGTGACCTCGT-1_V12D07-332_D1,0,2,0,2,0,4
TGTTTAATACTTCATC-1_V12D07-332_D1,0,0,0,1,0,1
TTGCTGGCCGGGCTTC-1_V12D07-332_D1,0,1,0,1,0,2
CATATTATTTGCCCTA-1_V12D07-332_D1,0,0,0,1,1,2
CTGCCTAGCCACCAAG-1_V12D07-332_D1,0,1,0,2,0,3
ACGAGATATTTGCTTA-1_V12D07-332_D1,0,0,0,1,0,1
GACTACAATTGCTCGT-1_V12D07-332_D1,0,0,0,0,0,0
AACGTGATGAAGGACA-1_V12D07-332_D1,0,0,0,0,0,0
ACTCTCTTATACACGA-1_V12D07-332_D1,0,0,0,2,1,3
CGCATCATGGCTTCAG-1_V12D07-332_D1,0,1,0,1,0,2
CGGCTCTTCGTCGAAC-1_V12D07-332_D1,2,1,0,1,0,4
ATTCTTCGTACTTATG-1_V12D07-332_D1,0,0,0,0,0,0
AGTGAGGGTTTCTGAC-1_V12D07-332_D1,0,0,0,0,0,0
GCCAGGCGTTCGCATG-1_V12D07-332_D1,1,0,0,2,0,3
GACTAACACAGCACCT-1_V12D07-332_D1,0,0,0,0,0,0
CAATGGAATCTACATA-1_V12D07-332_D1,0,1,1,1,0,3
GTGGTCAGCGAAGTAT-1_V12D07-332_D1,0,0,0,1,0,1
ATGGCTGGAAATGGCC-1_V12D07-332_D1,0,0,0,1,0,1
ATCAGGTCGCCATTGC-1_V12D07-332_D1,0,1,0,0,0,1
TATCACCATGTAAAGT-1_V12D07-332_D1,0,0,0,0,0,0
AGCGCTTATGGGCAAG-1_V12D07-332_D1,0,0,0,0,0,0
AAGCGGCGTCATGGGT-1_V12D07-332_D1,0,0,0,1,0,1
ACTAATACGTCAGGCG-1_V12D07-332_D1,0,0,0,0,0,0
GGCTGAGCATCGTAAG-1_V12D07-332_D1,0,0,0,2,0,2
CGGTTGGGTTCAAGTT-1_V12D07-332_D1,0,0,0,1,0,1
GACTGATTGGTCACAA-1_V12D07-332_D1,0,2,0,0,0,2
AGACGGGCCGATTTAA-1_V12D07-332_D1,0,2,0,2,1,5
ACCAGTGCCCGGTCAA-1_V12D07-332_D1,0,1,0,0,0,1
GTCCTTTAATGACTTC-1_V12D07-332_D1,0,1,0,0,0,1
CCTACAAGTCCGGAAT-1_V12D07-332_D1,0,0,0,0,0,0
GCCTGCTACACTGAGA-1_V12D07-332_D1,0,1,1,0,0,2
GACTCGGTCGGCGGAT-1_V12D07-332_D1,0,2,0,1,0,3
CTAGACATATATGTAG-1_V12D07-332_D1,0,1,0,2,0,3
TCGCCCAACTGACTCC-1_V12D07-332_D1,0,1,2,1,0,4
AAACTAACGTGGCGAC-1_V12D07-332_D1,0,1,0,0,0,1
AACTGAGGTCAGCGTC-1_V12D07-332_D1,0,0,0,0,0,0
ACAATGATTCTTCTAC-1_V12D07-332_D1,0,0,0,0,0,0
ATAAGTACCCGATTGT-1_V12D07-332_D1,0,0,0,1,0,1
ATTGGGAGTTCTGTAA-1_V12D07-332_D1,0,0,0,1,0,1
CGAACATAGTCAGAAA-1_V12D07-332_D1,0,1,1,1,0,3
TAGCTCAGATCCTAGT-1_V12D07-332_D1,0,0,0,0,0,0
GTGTCGTATTCACCTT-1_V12D07-332_D1,0,1,1,0,0,2
CTCACCGATCCAAACT-1_V12D07-332_D1,0,0,0,0,0,0
ATATGTGCACAAACCA-1_V12D07-332_D1,0,0,0,1,0,1
CAGTCCAACGCCTTCT-1_V12D07-332_D1,0,0,0,0,0,0
TCGTCCGGGTACACTC-1_V12D07-332_D1,0,0,0,0,0,0
GCAGAAACGTAATCCA-1_V12D07-332_D1,0,0,0,1,0,1
TTCGAGCCGGCGCTAC-1_V12D07-332_D1,1,1,0,0,0,2
GGAAGATAAGACTGTA-1_V12D07-332_D1,0,0,0,3,0,3
ATAAGCAAACACCGAG-1_V12D07-332_D1,1,0,0,0,0,1
GCATAAATTGAACGCC-1_V12D07-332_D1,1,1,1,1,0,4
CGCCGGTGTCGCAGTA-1_V12D07-332_D1,0,1,0,2,0,3
GACCTGGTCTGGGCGT-1_V12D07-332_D1,0,0,0,0,0,0
AGCCGCTTGATTAGCG-1_V12D07-332_D1,1,1,0,0,0,2
CCCGGCTAGGTGAGAA-1_V12D07-332_D1,1,0,0,0,0,1
CGAGCCGAGCACTCGA-1_V12D07-332_D1,1,0,1,0,0,2
TAGTGCTTGAATCCTT-1_V12D07-332_D1,2,0,0,0,0,2
CAACCGCACCTAGACA-1_V12D07-332_D1,0,2,0,0,0,2
ACCACTGTTCAAGAAG-1_V12D07-332_D1,0,3,0,0,0,3
AGATGCTATAACGAGC-1_V12D07-332_D1,0,0,0,1,0,1
AATTACTCGTACGCTC-1_V12D07-332_D1,1,1,0,1,0,3
CGTCAATCTTTAACAT-1_V12D07-332_D1,0,1,0,2,0,3
CCAAAGCAGTTGGTTG-1_V12D07-332_D1,6,5,1,0,0,12
CCATATTGGATCATGA-1_V12D07-332_D1,8,2,0,0,0,10
CGTACCGAAAGTCTAG-1_V12D07-332_D1,1,1,1,2,0,5
CTCGAGATCCAAAGCA-1_V12D07-332_D1,0,1,0,2,0,3
TGGATAGAGTAACAGA-1_V12D07-332_D1,0,2,0,2,0,4
TCACAGATCCTCAAAC-1_V12D07-332_D1,0,1,0,0,0,1
AGAGCTACGAAAGCAT-1_V12D07-332_D1,2,0,0,0,0,2
TGCGTGATTGGGTGTC-1_V12D07-332_D1,0,0,0,0,0,0
CACATGTTTGGACATG-1_V12D07-332_D1,0,0,0,1,0,1
TTCGCATCCGGAAGCA-1_V12D07-332_D1,0,0,0,1,0,1
CCCTAGTGTCAGGTGT-1_V12D07-332_D1,0,3,0,0,0,3
TTACCGCCTTAGGGAA-1_V12D07-332_D1,0,4,0,0,0,4
CCAGTCCATTATTCGA-1_V12D07-332_D1,0,2,1,0,0,3
CGTAAACGCTTGAGTG-1_V12D07-332_D1,0,4,0,2,0,6
ATTCCTTCCAGGCGGT-1_V12D07-332_D1,0,6,0,1,0,7
TTCCTTTCTGTGTTGC-1_V12D07-332_D1,0,4,0,1,0,5
AGTTGACATCGGCTGG-1_V12D07-332_D1,0,4,1,1,0,6
AACTCGATGGCGCAGT-1_V12D07-332_D1,0,4,2,0,0,6
GATAAGGCAGATGCAA-1_V12D07-332_D1,0,7,0,2,0,9
GGCTGGCTAGCTTAAA-1_V12D07-332_D1,0,5,0,0,0,5
CCTCATGCAGCTACGA-1_V12D07-332_D1,0,8,1,0,0,9
GACGCCTGTTGCAGGG-1_V12D07-332_D1,0,3,1,2,0,6
TAATTAGATGGATATG-1_V12D07-332_D1,0,4,1,1,0,6
GAGGGCATCGCGTATC-1_V12D07-332_D1,0,2,1,0,0,3
CTTGTGAGTCTTTGAC-1_V12D07-332_D1,0,5,0,1,0,6
TCAACACATTGGGTAA-1_V12D07-332_D1,0,7,0,0,0,7
ACTGTATACGCGAGCA-1_V12D07-332_D1,0,2,0,0,1,3
GTGAAACGTGCTCCAC-1_V12D07-332_D1,0,2,0,0,0,2
CGAGTGCTATAGTTCG-1_V12D07-332_D1,0,5,0,1,0,6
GTACTGCATGAAGCGT-1_V12D07-332_D1,0,2,0,0,0,2
GTAACTTGCGGCAGTC-1_V12D07-332_D1,0,3,1,0,0,4
GAATCGCCGGACACGG-1_V12D07-332_D1,0,2,1,1,0,4
GGGAGTAATGGCTGGC-1_V12D07-332_D1,0,3,0,0,0,3
CATGAACCGACATTTG-1_V12D07-332_D1,0,1,0,2,0,3
TCTGTCATACAAGAGC-1_V12D07-332_D1,0,1,1,0,0,2
GTCGTCAATTATAAGG-1_V12D07-332_D1,0,1,0,0,0,1
TAAAGAGCCCGAAACC-1_V12D07-332_D1,0,3,0,0,0,3
GTACTGAGGTCGTAAC-1_V12D07-332_D1,0,1,0,2,0,3
AAAGACCCAAGTCGCG-1_V12D07-332_D1,0,1,0,1,0,2
CGTCAGTGCGCACAAG-1_V12D07-332_D1,0,4,0,2,0,6
TGTATCCTTATTCCAT-1_V12D07-332_D1,0,2,0,2,0,4
ATTCTCGTCTCTTTAG-1_V12D07-332_D1,1,2,1,5,0,9
AAAGTCACTGATGTAA-1_V12D07-332_D1,0,4,0,0,0,4
TGTCTACAGTTTCTGT-1_V12D07-332_D1,0,2,0,0,0,2
TTAACGTCGCAAGACC-1_V12D07-332_D1,0,0,0,5,0,5
CTATGTCTATTGAAAC-1_V12D07-332_D1,0,1,0,5,2,8
TCGGGTGAAACTGCTA-1_V12D07-332_D1,0,1,3,6,3,13
TGTCCCGACATAGCAC-1_V12D07-332_D1,0,4,0,0,0,4
ACAGCATAGAGCCAGT-1_V12D07-332_D1,0,2,0,0,0,2
ATATTCCCACAGGTCA-1_V12D07-332_D1,0,5,1,0,0,6
TTGGATCGACTTCTGG-1_V12D07-332_D1,0,2,1,0,0,3
CACCATCGGAGGAGAC-1_V12D07-332_D1,0,2,0,0,0,2
TCGTTCGTTATTATGT-1_V12D07-332_D1,0,1,0,1,0,2
CTTAACTTCGAAGTAC-1_V12D07-332_D1,0,3,0,1,2,6
GCACAAGTGTCGGAAG-1_V12D07-332_D1,0,2,0,0,1,3
TACCAGCTAGGTTTAA-1_V12D07-332_D1,0,0,0,0,1,1
ACGTACAGATTTCTCT-1_V12D07-332_D1,0,1,0,0,0,1
AATTTGGTTCCAAAGA-1_V12D07-332_D1,0,0,0,0,1,1
GTAAGGATTTGTCGGA-1_V12D07-332_D1,0,0,0,0,1,1
CATCATCTACCCGGAC-1_V12D07-332_D1,2,2,0,0,0,4
ACGATGGATCCGATGC-1_V12D07-332_D1,0,1,0,0,0,1
CACTCAGCTCTTGAGG-1_V12D07-332_D1,0,0,0,0,0,0
TAGATCCGAAGTCGCA-1_V12D07-332_D1,0,1,0,0,0,1
TGAAACTTATGCAAGC-1_V12D07-332_D1,0,0,0,0,0,0
GCGATTCTGGAAGCAG-1_V12D07-332_D1,0,1,0,1,0,2
CAAACTATTGAGCTTC-1_V12D07-332_D1,0,0,0,0,1,1
TAGAATTAAGGGCAAC-1_V12D07-332_D1,0,0,0,1,0,1
CGAAACATAGATGGCA-1_V12D07-332_D1,0,0,0,1,0,1
GATGGTGCCCTAGGCA-1_V12D07-332_D1,0,2,0,4,1,7
CCCGCAGGGCCCAAAG-1_V12D07-332_D1,0,0,0,0,0,0
ACAGCGCACCCGCAGC-1_V12D07-332_D1,0,4,0,3,0,7
GGTAAATGTGCGTTAC-1_V12D07-332_D1,0,0,0,1,0,1
GTCCTTCTAGTGGGTT-1_V12D07-332_D1,0,0,0,1,0,1
GGAAGCTCGCTTACAG-1_V12D07-332_D1,1,3,0,1,0,5
CACCGATACACCGAGC-1_V12D07-332_D1,0,0,0,0,0,0
CAGCCGGGCCCTCTAT-1_V12D07-332_D1,0,1,0,1,0,2
CGGAGCTTATAACACC-1_V12D07-332_D1,0,1,0,0,0,1
ATTACAACTACCGGCC-1_V12D07-332_D1,0,0,0,0,0,0
TCCTCTGGCCCATTAG-1_V12D07-332_D1,0,0,0,1,0,1
CGGCACCGTTAGCGCC-1_V12D07-332_D1,0,0,0,1,0,1
TCGGTCCCTGACTCCA-1_V12D07-332_D1,0,1,0,2,0,3
TGGTTGGAGGATCCTG-1_V12D07-332_D1,0,0,0,0,0,0
CTGCGGTAGTCACGTG-1_V12D07-332_D1,0,1,0,1,0,2
GTGCCTCAGTGTACGG-1_V12D07-332_D1,0,2,0,0,0,2
ATCGTTCACTTTCGCC-1_V12D07-332_D1,0,2,0,0,0,2
ACTTACCGGGCGCGCA-1_V12D07-332_D1,0,0,0,0,0,0
CTAGACTGCATTTCGT-1_V12D07-332_D1,0,0,0,1,0,1
TTGCCGGTGATCCCTC-1_V12D07-332_D1,0,0,0,0,0,0
CTGTCACGCCAGGCGC-1_V12D07-332_D1,0,1,0,1,0,2
CGGTATAGGTATTAGC-1_V12D07-332_D1,0,1,0,1,0,2
CCAACGCTTGCCAGGG-1_V12D07-332_D1,0,1,0,1,0,2
CGTTGAGTAATTGCGT-1_V12D07-332_D1,0,2,0,1,1,4
TGTATTTACCTAATGC-1_V12D07-332_D1,0,0,0,1,0,1
TAAATGCCGTCTCATG-1_V12D07-332_D1,0,2,0,0,0,2
CGGTTTATGAAGGAAC-1_V12D07-332_D1,0,1,0,0,0,1
GCAAGATGTGTTCGCG-1_V12D07-332_D1,0,1,0,0,0,1
AAAGGTAAGCTGTACC-1_V12D07-332_D1,0,2,0,0,0,2
GTACGTCACGTATTAA-1_V12D07-332_D1,0,6,1,0,0,7
AGTACCTTCGAGTGCT-1_V12D07-332_D1,0,4,0,2,0,6
ATTGTGACTTCGCTGC-1_V12D07-332_D1,0,0,0,0,0,0
TGTATCAGACTGAAGC-1_V12D07-332_D1,0,0,0,2,0,2
GAGACCCTGCAACGCC-1_V12D07-332_D1,0,0,0,0,0,0
TGGGTGGGATGTCATT-1_V12D07-332_D1,0,0,0,1,0,1
GGCTAATGATTGAAAT-1_V12D07-332_D1,1,2,0,1,0,4
ATAACGTTACCTCCAC-1_V12D07-332_D1,0,0,0,1,0,1
TGCGAGATGGCGGCCA-1_V12D07-332_D1,0,0,0,0,0,0
CACACTTGTATTGCGA-1_V12D07-332_D1,0,0,0,0,0,0
GCTGGTGACTCGTAGT-1_V12D07-332_D1,0,1,0,0,0,1
CGACACCGCTTAAGGA-1_V12D07-332_D1,0,1,0,0,0,1
GTAACAACTGACCTTG-1_V12D07-332_D1,0,1,0,0,0,1
CAACTGAGGGTATGAC-1_V12D07-332_D1,0,0,0,0,0,0
CTAATTATGAAGCGTA-1_V12D07-332_D1,0,0,0,0,0,0
CCGATCTTAAGAGGCT-1_V12D07-332_D1,0,1,0,0,0,1
CGACTCGGTACACGGT-1_V12D07-332_D1,0,1,0,1,0,2
TGCTGCGTCAGAGTTA-1_V12D07-332_D1,0,1,0,1,0,2
AGAGTTGCAGGCCTCC-1_V12D07-332_D1,0,0,0,1,0,1
ACTGGCGAACCTGCGT-1_V12D07-332_D1,2,0,0,0,0,2
ACTAAGGACGCACACC-1_V12D07-332_D1,0,0,0,0,0,0
CGTCCAGATGGCTCCA-1_V12D07-332_D1,1,0,0,2,0,3
ACTATCGCCGGCTAAA-1_V12D07-332_D1,0,2,2,2,0,6
GATAGCGTACCACGCG-1_V12D07-332_D1,0,1,0,1,0,2
AGGACTTATAGGAGAA-1_V12D07-332_D1,3,1,0,0,0,4
TAGTCGGGATTCTTCG-1_V12D07-332_D1,3,0,0,0,0,3
ACCATTAAGGGTGTCA-1_V12D07-332_D1,1,0,0,1,0,2
TTAATGTGTTTGCAGG-1_V12D07-332_D1,1,1,0,0,0,2
TCCGCAGCCACCTAGC-1_V12D07-332_D1,2,1,0,0,0,3
GAGGAGATCCTCATGC-1_V12D07-332_D1,1,0,0,3,0,4
GGTCCTTCATACGACT-1_V12D07-332_D1,1,2,0,0,0,3
CCCTGTTGGCAAAGAC-1_V12D07-332_D1,2,3,0,0,0,5
GTGCCTAGCTATGCTT-1_V12D07-332_D1,5,2,1,0,0,8
GTCATCTCCTACAGCT-1_V12D07-332_D1,1,1,1,2,0,5
GCGAGAAACGGGAGTT-1_V12D07-332_D1,2,4,1,3,0,10
CGTCGCGGCGGGATTT-1_V12D07-332_D1,3,1,1,0,0,5
CATTGTGTGCTAGATC-1_V12D07-332_D1,0,1,0,0,0,1
CGCGGCAGTATTACGG-1_V12D07-332_D1,0,1,0,1,0,2
GAAATGGGATGTAAAC-1_V12D07-332_D1,0,2,1,1,0,4
CATTCCCTAAGTACAA-1_V12D07-332_D1,0,2,0,0,0,2
AGTTCTGCGTTGTATC-1_V12D07-332_D1,0,4,0,0,0,4
ACCCTATAGGACTGAG-1_V12D07-332_D1,0,3,0,0,0,3
TTAGATAGGTCGATAC-1_V12D07-332_D1,2,6,0,0,0,8
ATTGATAGCAACGAGA-1_V12D07-332_D1,0,6,1,0,0,7
TCTCGGCTCCAGGACT-1_V12D07-332_D1,0,2,2,1,0,5
CTTGAGGTTATCCCGA-1_V12D07-332_D1,0,7,0,0,0,7
AAGAAGGATCAGTTAG-1_V12D07-332_D1,0,3,1,1,0,5
GTACGACGGCGCTGCG-1_V12D07-332_D1,0,4,0,1,0,5
CTTATGTTGACTACCA-1_V12D07-332_D1,0,7,1,0,0,8
CGGCACTCAAGAAAGT-1_V12D07-332_D1,0,5,1,0,0,6
GTCAAAGTTTACATAG-1_V12D07-332_D1,0,6,1,0,0,7
CTCCTAAGTTATGTCT-1_V12D07-332_D1,0,3,2,0,0,5
ACTGTGCTAGTAGATC-1_V12D07-332_D1,0,5,1,0,0,6
GTTTGGCCGCTCAGCG-1_V12D07-332_D1,0,1,1,0,0,2
TTATCCAATCGAACTC-1_V12D07-332_D1,0,5,1,0,0,6
CCGTACCCAAGCGCCA-1_V12D07-332_D1,0,4,1,0,0,5
CATACAAAGCCGAACC-1_V12D07-332_D1,0,3,0,0,0,3
GGTCGGTAATTAGACA-1_V12D07-332_D1,0,6,2,1,0,9
AGCGGGAAGGGTCCAT-1_V12D07-332_D1,0,6,0,0,0,6
GCCCACCAAGGCTGTC-1_V12D07-332_D1,0,3,0,0,0,3
GTAGACGTCGTTACAT-1_V12D07-332_D1,0,4,0,2,0,6
GAGCATCATCCCTGGG-1_V12D07-332_D1,0,3,0,2,0,5
AGGTAACCTCCTATTC-1_V12D07-332_D1,0,3,2,0,0,5
GGTTTGAGTGCTGGAA-1_V12D07-332_D1,0,2,1,0,0,3
GCACTAGTCGCGCTAT-1_V12D07-332_D1,0,3,1,0,0,4
GGTAACTATGTATCTG-1_V12D07-332_D1,0,4,2,1,0,7
GCGGTCCCTAGACGCA-1_V12D07-332_D1,0,2,0,0,0,2
CGAGCGTTGATCAGCC-1_V12D07-332_D1,0,3,0,0,0,3
AATCCAAGGGCCTGAG-1_V12D07-332_D1,0,1,1,5,0,7
CCGTGCCCATGACGGC-1_V12D07-332_D1,0,1,1,1,0,3
GAAATTCACATCGCTG-1_V12D07-332_D1,0,3,0,0,0,3
CTCTGCGAAGCAAGCA-1_V12D07-332_D1,0,3,0,1,0,4
AGTAGGTAACATACAT-1_V12D07-332_D1,0,2,0,1,0,3
ATTGGGAATATCTTGG-1_V12D07-332_D1,0,1,0,7,0,8
TAGAGCTACGAAGAAC-1_V12D07-332_D1,0,1,2,11,1,15
TGCGGCATAGTTCAAC-1_V12D07-332_D1,0,2,0,10,0,12
CCGCCGGTCAACACAC-1_V12D07-332_D1,0,0,0,0,0,0
TCGTATAGTGCAATTA-1_V12D07-332_D1,0,3,2,0,0,5
TAGTTTATTCTTGCTT-1_V12D07-332_D1,0,2,0,1,0,3
GATATCTCATGCAATA-1_V12D07-332_D1,0,0,0,1,0,1
CGTTTAAGCGGAGCAC-1_V12D07-332_D1,0,2,1,0,1,4
CATGCTGGCTCCAATT-1_V12D07-332_D1,0,6,0,0,0,6
GAAACAGCCATGCAGT-1_V12D07-332_D1,0,0,0,0,0,0
AGTTTCGCAGGTCGGA-1_V12D07-332_D1,0,3,1,0,1,5
CTCATGGCTCACAATC-1_V12D07-332_D1,0,1,0,0,0,1
AACCGTTGTGTTTGCT-1_V12D07-332_D1,0,1,0,0,1,2
ACCCTTCATCTGCGAA-1_V12D07-332_D1,0,0,0,0,0,0
TGCGGTGAAATTTCAT-1_V12D07-332_D1,0,0,0,4,0,4
CAAATTGTCAGCAAGC-1_V12D07-332_D1,0,0,0,0,0,0
GAGGTACATCCATCTT-1_V12D07-332_D1,0,0,0,0,0,0
AAATGGCATGTCTTGT-1_V12D07-332_D1,0,0,0,0,0,0
TCATCCCAGAGGGTGG-1_V12D07-332_D1,2,0,0,0,0,2
CGTAGCGAATTGTCAG-1_V12D07-332_D1,0,0,0,0,0,0
CCTAGTTAGTCGCATG-1_V12D07-332_D1,1,0,0,2,0,3
GAAACTCTAATGAAGG-1_V12D07-332_D1,1,0,0,0,0,1
TTGTATCACACAGAAT-1_V12D07-332_D1,0,0,0,0,0,0
TTCAAGCCGAGCTGAG-1_V12D07-332_D1,1,0,0,0,0,1
AGGTACGATATTGCCA-1_V12D07-332_D1,0,0,0,3,0,3
TTAAGCCGACAACTTC-1_V12D07-332_D1,0,0,0,1,0,1
GTCTTAGTACAGCCGG-1_V12D07-332_D1,0,0,0,1,0,1
TGGGTAAGGTTCCCGC-1_V12D07-332_D1,1,1,0,2,0,4
CTACGCCATTTCCGAT-1_V12D07-332_D1,0,2,0,4,0,6
GACCGTCAGGTCGTGA-1_V12D07-332_D1,0,0,0,0,0,0
TAGTTAAGATAGGATA-1_V12D07-332_D1,0,1,0,0,0,1
GAATATTCGGAGTCCC-1_V12D07-332_D1,0,0,0,0,0,0
CAAACTACGATAGAGA-1_V12D07-332_D1,0,0,0,0,0,0
CAGGAAGACTTTATAT-1_V12D07-332_D1,0,0,0,0,0,0
TTCGTAATCCCAGCGG-1_V12D07-332_D1,0,0,0,0,0,0
GTGAGGAGCGGTTGAG-1_V12D07-332_D1,0,0,0,0,0,0
CAATCCCTATACCAGC-1_V12D07-332_D1,0,1,0,2,0,3
AGGGAAACGAGGTACT-1_V12D07-332_D1,0,0,0,0,0,0
TCCTGCCAACTGGAGA-1_V12D07-332_D1,0,0,0,0,0,0
AATTTGGGACATAGTA-1_V12D07-332_D1,0,0,0,1,0,1
AACTCCTAATCCCATG-1_V12D07-332_D1,0,0,0,0,0,0
GCTCATTACTGCATGT-1_V12D07-332_D1,0,0,0,1,0,1
TCTCGAACGAGGTCAC-1_V12D07-332_D1,0,1,0,1,0,2
TCACTACGACCAATGC-1_V12D07-332_D1,0,2,0,0,0,2
GTGATGCACAACATCT-1_V12D07-332_D1,0,0,0,0,0,0
CCGACGTAAACACAAC-1_V12D07-332_D1,0,0,0,0,0,0
TGGGATGCACTCATTC-1_V12D07-332_D1,1,2,0,0,0,3
TTCCATCATGCGGTGA-1_V12D07-332_D1,0,2,0,0,0,2
TGCACAGTGAAGTTAT-1_V12D07-332_D1,0,0,0,0,0,0
CTATTGTGTTTGGTCA-1_V12D07-332_D1,0,2,0,0,1,3
TGCGAGCCCTTCCGCG-1_V12D07-332_D1,0,0,0,0,1,1
TTGAAAGGTGTAAAGG-1_V12D07-332_D1,0,0,0,0,0,0
GGTGCAGAGCCTATCG-1_V12D07-332_D1,0,2,0,0,0,2
ACTATATGCTGTGTTC-1_V12D07-332_D1,0,4,1,0,0,5
TCCTGGCGCTGCCTGG-1_V12D07-332_D1,0,1,0,0,0,1
GAGCCGAGCGTTTATT-1_V12D07-332_D1,0,6,0,1,1,8
AGAATGCGGGTTCGGA-1_V12D07-332_D1,0,0,0,0,0,0
ATGCGACAATTGGTCC-1_V12D07-332_D1,0,6,1,1,0,8
TTCCGGCTCGACTTCT-1_V12D07-332_D1,0,2,0,0,0,2
TGATTATGGCACGCAG-1_V12D07-332_D1,0,0,0,0,0,0
GGTTTGACAAGAAGCT-1_V12D07-332_D1,0,3,0,1,0,4
GCAGCTATGGACAGGT-1_V12D07-332_D1,0,0,0,0,0,0
CACCATGATCGCAAAG-1_V12D07-332_D1,0,2,0,1,0,3
GTCGGAAGGATACCAG-1_V12D07-332_D1,0,1,0,0,0,1
GGCCCAGTTATCAGCA-1_V12D07-332_D1,0,0,0,1,0,1
GGGCCTATTTAAGTAT-1_V12D07-332_D1,0,1,0,1,0,2
GTTGTTACATTGCGCT-1_V12D07-332_D1,0,1,0,0,0,1
CAACTCCGTAACTTGC-1_V12D07-332_D1,0,0,1,0,0,1
GATCTTTGCTCAAAGA-1_V12D07-332_D1,0,2,0,1,1,4
TCGCTTAATTACGAAG-1_V12D07-332_D1,0,0,0,0,0,0
CGATCATTAGAGGCAC-1_V12D07-332_D1,0,0,0,0,0,0
TGTTCTCTACTCCCTA-1_V12D07-332_D1,0,0,0,0,0,0
GCTTAGGGAAGCGGTA-1_V12D07-332_D1,0,0,0,1,0,1
CAGGTTTAGTACTACA-1_V12D07-332_D1,0,1,1,0,0,2
AAGCGGAGTGCGCGCA-1_V12D07-332_D1,1,0,0,0,0,1
TCAGATGGAGACGTAG-1_V12D07-332_D1,0,2,0,1,0,3
TCGCACTAACGTTTGT-1_V12D07-332_D1,2,4,0,0,0,6
CACGTCGGGTTCTAGA-1_V12D07-332_D1,4,1,3,2,0,10
GGAGTACACATGAGCT-1_V12D07-332_D1,4,0,0,1,0,5
GTGTGTCGACGTCGCT-1_V12D07-332_D1,2,1,1,0,0,4
GAAGCTCTTTGCTTAG-1_V12D07-332_D1,1,0,0,0,0,1
ACACCGAGCGCTCTTT-1_V12D07-332_D1,4,0,0,0,0,4
CGTAATAATTACGAGT-1_V12D07-332_D1,0,4,0,0,0,4
CATCAACACCTACTAA-1_V12D07-332_D1,0,1,0,2,0,3
CCAAGTTTCTACAGAT-1_V12D07-332_D1,1,0,1,1,0,3
ACGGGTCATGTGACTT-1_V12D07-332_D1,2,1,1,1,0,5
AGTGTGCTAAGATCGC-1_V12D07-332_D1,5,2,1,0,0,8
GGCGGTTTGCCGGTGC-1_V12D07-332_D1,3,2,1,2,0,8
GTATAATCTCCCGGAT-1_V12D07-332_D1,3,3,2,0,0,8
TAGTCCGTATGCATAA-1_V12D07-332_D1,6,5,1,2,0,14
CACTTCGTCTTATCTC-1_V12D07-332_D1,4,0,0,2,0,6
CATCCGCAGGCCCGAA-1_V12D07-332_D1,0,0,1,0,0,1
CCCTGATGTAACTCGT-1_V12D07-332_D1,1,0,0,0,0,1
CCATAGTCAGTAACCC-1_V12D07-332_D1,0,1,0,2,0,3
CGGGCCATAGCCGCAC-1_V12D07-332_D1,0,2,0,1,0,3
CTCCGGCTTGTAGACA-1_V12D07-332_D1,0,3,0,1,0,4
AACTTGCGTTCTCGCG-1_V12D07-332_D1,0,2,0,2,0,4
AATGAGTTCGCATATG-1_V12D07-332_D1,0,2,0,1,0,3
CGAGGCCAGGCATTGG-1_V12D07-332_D1,0,3,0,2,0,5
TCTGCGTCCGGTTTCT-1_V12D07-332_D1,0,1,0,0,0,1
CAATCCTGCCGTGGAG-1_V12D07-332_D1,0,7,3,2,0,12
CTGAGCAAGTAACAAG-1_V12D07-332_D1,1,5,1,0,0,7
GGGTACCCACGGTCCT-1_V12D07-332_D1,0,7,0,0,0,7
ACGGAATTTAGCAAAT-1_V12D07-332_D1,0,2,1,0,0,3
GGGCGGTCCTATTGTC-1_V12D07-332_D1,0,3,1,0,0,4
ATGTTACGAGCAATAC-1_V12D07-332_D1,0,4,0,1,0,5
AACCATGGGATCGCTA-1_V12D07-332_D1,0,3,0,0,0,3
TCGCATCCCTAAGTGT-1_V12D07-332_D1,0,5,0,0,0,5
ACTTAGTACGACAAGA-1_V12D07-332_D1,0,2,2,0,0,4
GAGCTCTCGGACCTAA-1_V12D07-332_D1,0,5,2,1,0,8
TCTATTACGCTGGCGA-1_V12D07-332_D1,0,5,0,0,0,5
AGATACGACTTCATAT-1_V12D07-332_D1,0,4,2,1,0,7
CGCTATACCGCCCACT-1_V12D07-332_D1,0,5,1,1,0,7
CAGTGTCCGCAGAATG-1_V12D07-332_D1,0,3,1,0,0,4
CCATCCATACCAAGTC-1_V12D07-332_D1,0,2,1,1,0,4
AACCCAGAGACGGAGA-1_V12D07-332_D1,0,2,0,2,0,4
GAAGAACGGTGCAGGT-1_V12D07-332_D1,0,1,0,2,0,3
GATAAATCGGTGGATG-1_V12D07-332_D1,0,1,0,2,0,3
CAGCTCGTGCTTGTGT-1_V12D07-332_D1,0,6,0,1,0,7
GAGTACGGGTATACAA-1_V12D07-332_D1,0,2,0,0,0,2
CATCGCCCGCGGCCAA-1_V12D07-332_D1,0,1,0,1,0,2
TCTTACAGAGGTACCG-1_V12D07-332_D1,0,1,1,1,0,3
TGGAAGACGAACACCA-1_V12D07-332_D1,0,4,0,2,0,6
GTTGTCGTGTTAGTTG-1_V12D07-332_D1,0,2,1,0,0,3
CCAAGGAACAGAGAGG-1_V12D07-332_D1,0,1,0,0,0,1
CTGCACCTGGAACCGC-1_V12D07-332_D1,0,2,0,0,0,2
CGCTTTCATACCGGTG-1_V12D07-332_D1,0,2,0,2,0,4
GTTCTTCCCTCGATGT-1_V12D07-332_D1,1,2,0,7,0,10
ATTTAACTCGTATTAC-1_V12D07-332_D1,0,0,0,5,0,5
AACGATAGAAGGGCCG-1_V12D07-332_D1,0,1,0,2,0,3
TATCCTGCATGGGAAT-1_V12D07-332_D1,0,0,0,4,0,4
AGGCCCATTGTACAGG-1_V12D07-332_D1,0,1,0,1,0,2
CCGGCGCATATTGGAT-1_V12D07-332_D1,0,2,1,0,0,3
ATCTGTAATTGTACCC-1_V12D07-332_D1,0,4,0,0,0,4
GAGCGAGGGAGTACCG-1_V12D07-332_D1,0,2,0,0,0,2
TTATTAGGGAAGCATC-1_V12D07-332_D1,0,2,1,4,0,7
CTTCTTACGTCGTATA-1_V12D07-332_D1,0,0,2,4,3,9
GAAGTGCTGGATAGCT-1_V12D07-332_D1,0,2,0,0,0,2
GTGCAACAAATGTGGC-1_V12D07-332_D1,0,2,0,0,2,4
CATGCGTTAGACAGAA-1_V12D07-332_D1,0,2,0,3,1,6
ACACACTTTCTACACG-1_V12D07-332_D1,0,1,0,0,0,1
AGCCCTAAGCGAAGTT-1_V12D07-332_D1,0,2,0,0,0,2
ATTAATTCGGTCACTC-1_V12D07-332_D1,0,1,0,2,0,3
AACAGGAAATCGAATA-1_V12D07-332_D1,0,0,0,0,0,0
ACGTTTAGTTGTGATC-1_V12D07-332_D1,0,1,0,0,0,1
TCCTTCAGTGGTCGAA-1_V12D07-332_D1,0,0,0,0,0,0
CGAACGCCCAGTGCCG-1_V12D07-332_D1,0,0,0,0,0,0
CCTCGAAGTGGACGGG-1_V12D07-332_D1,0,0,0,1,0,1
CTCTGTTTGAGGATTC-1_V12D07-332_D1,0,0,0,3,0,3
TGGGCACGTTCTATGG-1_V12D07-332_D1,1,1,0,0,0,2
ACTATTCGTCCGTGGT-1_V12D07-332_D1,0,0,0,0,0,0
CCTCTGGCCTAGACGG-1_V12D07-332_D1,1,2,1,1,0,5
CCATAAACAACCCGAC-1_V12D07-332_D1,0,0,0,0,0,0
CATAGTACATTGAGAG-1_V12D07-332_D1,0,0,0,0,0,0
ATTTCATTATTTCGCG-1_V12D07-332_D1,0,0,0,0,0,0
CAACTATATCGAATGC-1_V12D07-332_D1,0,0,0,1,0,1
CTAGTATTCGGAATTA-1_V12D07-332_D1,0,0,0,0,0,0
GTGGAACCTACATGCG-1_V12D07-332_D1,0,0,0,0,0,0
CCTAAAGGCTGACGCT-1_V12D07-332_D1,0,0,0,0,0,0
CGTGACATTGGGTCGT-1_V12D07-332_D1,1,1,0,0,0,2
CCAATCGGTAGATCGA-1_V12D07-332_D1,0,0,0,0,0,0
ATTGTCGCAATACCTT-1_V12D07-332_D1,0,0,0,0,0,0
AAATTACACGACTCTG-1_V12D07-332_D1,0,0,0,1,0,1
CACTCCTCTCGGTCGG-1_V12D07-332_D1,0,2,0,0,0,2
AAATAACCATACGGGA-1_V12D07-332_D1,0,0,0,0,0,0
AGTTACTCTATCGTGG-1_V12D07-332_D1,0,0,0,0,0,0
CGTTAGCTCACAACTG-1_V12D07-332_D1,0,2,0,0,0,2
GAATGTATGGCAGGTC-1_V12D07-332_D1,0,0,0,0,0,0
GCAACCACCAGACCGG-1_V12D07-332_D1,0,0,0,0,0,0
TCACTCGTGCAACGGC-1_V12D07-332_D1,0,0,0,1,0,1
AAACAGAGCGACTCCT-1_V12D07-332_D1,0,0,0,0,0,0
CAGCCTCTCCTCAAGA-1_V12D07-332_D1,0,2,0,0,0,2
TTGCGTGAACGCTTAG-1_V12D07-332_D1,0,0,0,0,1,1
CCGCCTGCGAATTGGT-1_V12D07-332_D1,0,4,0,0,0,4
AGATGAGGGTTGCGAT-1_V12D07-332_D1,0,0,0,0,0,0
CGGTGGGCTCCAGCCT-1_V12D07-332_D1,0,2,0,0,1,3
GGCAGCGGTAATCCTA-1_V12D07-332_D1,0,0,0,0,0,0
GCTAGCAGGGAGTGGG-1_V12D07-332_D1,0,0,0,1,0,1
CTCAAGACATTAGCGC-1_V12D07-332_D1,0,1,0,3,0,4
CACGGCGCGCCAAAGG-1_V12D07-332_D1,0,0,0,0,1,1
TGCAATTTGGGCACGG-1_V12D07-332_D1,0,0,0,1,0,1
ATGCCAATCGCTCTGC-1_V12D07-332_D1,0,1,0,1,0,2
GCTGGACCCAAAGTGG-1_V12D07-332_D1,0,0,0,0,0,0
ATTCCTAAGACGTGGA-1_V12D07-332_D1,0,0,0,0,1,1
TCCGGAGGAAGGGCTG-1_V12D07-332_D1,0,0,0,0,0,0
TCGGTGACCGCTCCGG-1_V12D07-332_D1,0,0,0,0,0,0
TCCGAAGTAGTCACCA-1_V12D07-332_D1,0,4,0,0,0,4
CATGTAGGAGCGCCAA-1_V12D07-332_D1,0,4,0,0,0,4
CACAAGAAAGATATTA-1_V12D07-332_D1,0,0,0,0,0,0
AGGGTCAGTAACCCTA-1_V12D07-332_D1,0,0,1,0,0,1
TAAGCCCTTACGACCA-1_V12D07-332_D1,1,0,0,1,0,2
ATACCGTCATCCATAA-1_V12D07-332_D1,0,0,0,1,0,1
GGACGTCCATAGTTGG-1_V12D07-332_D1,0,2,0,1,0,3
CATCAAACTGGCGCCC-1_V12D07-332_D1,0,1,0,0,0,1
AAACGTGTTCGCCCTA-1_V12D07-332_D1,0,0,0,0,0,0
AAATTGGTGAGAAGCA-1_V12D07-332_D1,0,1,0,0,0,1
GGTCATTGTAGTCATA-1_V12D07-332_D1,0,0,0,1,0,1
TGCAGTGAGGCTCGGG-1_V12D07-332_D1,0,1,0,1,0,2
GAACATTAGTATGTTA-1_V12D07-332_D1,0,0,0,1,0,1
GGTTTGCGAACACGTA-1_V12D07-332_D1,0,1,0,1,0,2
ACACAAATATTCCTAG-1_V12D07-332_D1,0,0,0,0,0,0
TTGGGTTTATTCAGCG-1_V12D07-332_D1,0,4,0,1,0,5
ATTCGCAGAGGACACT-1_V12D07-332_D1,0,0,0,1,0,1
GATTTAGTGCGTACTG-1_V12D07-332_D1,1,2,0,2,0,5
TAGAAACACAATAGTG-1_V12D07-332_D1,0,1,3,0,0,4
CAGTAGATGATGTCCG-1_V12D07-332_D1,5,2,1,2,0,10
TCTTAACTCGGATGTA-1_V12D07-332_D1,2,0,0,0,0,2
TACATCTTGTTTCTTG-1_V12D07-332_D1,6,0,0,0,0,6
TTCATAGGGTGTCCAT-1_V12D07-332_D1,3,0,0,0,0,3
TGAAGTAGCTTACGGA-1_V12D07-332_D1,0,1,0,0,0,1
GCACAAGTGGATCATA-1_V12D07-332_D1,2,0,0,1,0,3
GGGCGAATTTCTCCAC-1_V12D07-332_D1,1,0,0,0,0,1
ATGTTCCTGCCCACCT-1_V12D07-332_D1,0,0,0,0,0,0
GCTCAACCTCTTAGAG-1_V12D07-332_D1,2,2,1,0,0,5
ATAGCTGCTCTTGTTA-1_V12D07-332_D1,1,3,0,2,0,6
CGTCAGCTATTTACTC-1_V12D07-332_D1,2,0,0,0,0,2
ATCTGATAGTGTCTTA-1_V12D07-332_D1,5,1,1,0,0,7
TGCACTATGTGAGTGC-1_V12D07-332_D1,6,3,1,2,0,12
CCGACAAACACATGAG-1_V12D07-332_D1,3,2,0,1,0,6
GCCTTGTATATGCAGT-1_V12D07-332_D1,1,1,1,0,0,3
ATAATACCGTTAGCCG-1_V12D07-332_D1,0,4,0,0,0,4
ACACTCCAATGTCACT-1_V12D07-332_D1,0,1,0,0,0,1
AGTTGCTGACTGATAT-1_V12D07-332_D1,0,1,0,0,0,1
GGCGCTCCTCATCAAT-1_V12D07-332_D1,0,1,2,1,0,4
TGCCTGACATCGGTCA-1_V12D07-332_D1,0,4,2,0,0,6
TTGGCCATCTTGCGCT-1_V12D07-332_D1,0,4,1,0,0,5
CAGTGGTTGCACATGA-1_V12D07-332_D1,0,4,1,0,0,5
AGAATTGTTTGACATA-1_V12D07-332_D1,0,5,1,0,0,6
AAATGCTCGTTACGTT-1_V12D07-332_D1,0,2,1,0,0,3
CACCTAATAGAGTCGT-1_V12D07-332_D1,0,6,0,0,0,6
CATTTCTAGCAGACTA-1_V12D07-332_D1,0,2,1,1,0,4
CCGAAAGTGGTGAGCA-1_V12D07-332_D1,0,3,2,0,0,5
AGTCAGCCACCGCCTG-1_V12D07-332_D1,0,3,1,0,0,4
TCATCACTCGAGCTCG-1_V12D07-332_D1,0,4,0,1,0,5
CTCAGGACTCACCTGT-1_V12D07-332_D1,0,3,0,0,0,3
CGGTGTACTTGATCCC-1_V12D07-332_D1,0,5,0,0,0,5
CCTACGGCTCAGTCGA-1_V12D07-332_D1,0,5,2,0,0,7
GTACTTGGGCACTTCT-1_V12D07-332_D1,0,2,0,1,0,3
TGATTTCCTCCTGACG-1_V12D07-332_D1,0,6,0,1,0,7
CCTCACCAATCTTGAC-1_V12D07-332_D1,0,5,1,0,0,6
GGTGAGATGCAGATAA-1_V12D07-332_D1,0,3,0,1,0,4
GCTAGTTTCATTGAGG-1_V12D07-332_D1,0,4,0,0,0,4
AGGACATCGCACGTCG-1_V12D07-332_D1,0,1,0,0,0,1
GTGGACGTGCTGAGAC-1_V12D07-332_D1,0,4,2,0,0,6
TAAGGAACTTGTGGGA-1_V12D07-332_D1,0,7,0,0,0,7
TCGCTGTGCGTAAATC-1_V12D07-332_D1,0,3,2,0,0,5
GCATCCCTAACTTTGA-1_V12D07-332_D1,0,1,0,1,0,2
CACCCACACGTCACCC-1_V12D07-332_D1,0,4,1,1,0,6
CCCTCATTCTGGAATT-1_V12D07-332_D1,0,1,1,0,0,2
AGGGCGTGATCGGCTA-1_V12D07-332_D1,0,2,1,4,0,7
GGTGCGGATAAGTGGC-1_V12D07-332_D1,0,5,0,0,0,5
TAATATTGAAATTCGC-1_V12D07-332_D1,0,3,0,3,0,6
CTTACACTGGGAAATA-1_V12D07-332_D1,0,2,0,1,0,3
ACCAAGAACGCGTGTC-1_V12D07-332_D1,0,1,1,2,0,4
GCCTTCAGCCCTACCG-1_V12D07-332_D1,0,1,0,8,0,9
GATGCTACAAGCGCCT-1_V12D07-332_D1,0,1,0,1,0,2
CCGGGACCCGCAGAGA-1_V12D07-332_D1,0,1,0,2,2,5
GTTCCAGTCTGACCAT-1_V12D07-332_D1,0,0,1,1,0,2
ATGATCGGGAATAGAC-1_V12D07-332_D1,0,2,0,0,0,2
TTGGATTGGGTACCAC-1_V12D07-332_D1,0,6,0,0,0,6
TACCTCACGCTTGTAC-1_V12D07-332_D1,0,3,1,0,0,4
CATGGCAGGAAGATCG-1_V12D07-332_D1,0,1,2,0,0,3
ATGACGCCGGCTCTAA-1_V12D07-332_D1,0,0,0,2,1,3
AGCGACATCCCATTCA-1_V12D07-332_D1,0,1,0,0,0,1
AGTAATGTCTTGCCGC-1_V12D07-332_D1,0,3,0,0,1,4
TTCTTAGTGGCTCAGA-1_V12D07-332_D1,1,1,0,1,0,3
CGTCTGGAAGGGCCCG-1_V12D07-332_D1,0,0,0,1,0,1
ACGTGCGCCTCGTGCA-1_V12D07-332_D1,0,0,0,0,0,0
AGAGCGGGCTAATCAT-1_V12D07-332_D1,0,0,0,1,1,2
GCGTCGAAATGTCGGT-1_V12D07-332_D1,0,0,0,0,0,0
AACTGATATTAGGCCT-1_V12D07-332_D1,0,1,0,1,0,2
CGAGCTGGGCTTTAGG-1_V12D07-332_D1,0,0,0,0,0,0
GGGTGTTTCAGCTATG-1_V12D07-332_D1,0,0,0,1,0,1
TTAATTTCAGACGCGG-1_V12D07-332_D1,1,0,0,0,0,1
ACTGCCGTCGTAACTC-1_V12D07-332_D1,0,0,0,0,1,1
GTGCACGAAAGTGACT-1_V12D07-332_D1,0,1,0,0,0,1
ATCTCCCTGCAATCTA-1_V12D07-332_D1,0,0,0,1,0,1
ACGCCAGATGATTTCT-1_V12D07-332_D1,0,0,0,1,0,1
AGCTATTTAATCCAAC-1_V12D07-332_D1,0,0,0,0,0,0
CCACGAGAAGAGAATC-1_V12D07-332_D1,0,1,0,3,0,4
GATTCCGCGTTTCCGT-1_V12D07-332_D1,0,0,0,3,0,3
GTCGGATGTAGCGCGC-1_V12D07-332_D1,1,0,0,2,0,3
TATTTATACCGAGTAG-1_V12D07-332_D1,1,0,0,6,0,7
GTAGGTGATCCGTGTA-1_V12D07-332_D1,0,0,0,0,0,0
AGTTAAGCGGTCCCGG-1_V12D07-332_D1,0,0,0,0,0,0
CTGGCGACATAAGTCC-1_V12D07-332_D1,0,1,0,1,0,2
TTGGCCTAGAATTTCG-1_V12D07-332_D1,0,0,0,1,0,1
GGCATATCGGTTCTGC-1_V12D07-332_D1,0,1,0,3,0,4
GGGCGTCCACTGGCTC-1_V12D07-332_D1,1,1,0,0,0,2
TTACCCATTGCCGGGT-1_V12D07-332_D1,0,0,0,0,0,0
TTAGACACGATCGTTG-1_V12D07-332_D1,0,0,0,1,0,1
GCGCTGATCCAGACTC-1_V12D07-332_D1,0,1,0,0,0,1
TTCGGCAACCCGCTGA-1_V12D07-332_D1,0,3,0,0,0,3
GATATTTCCTACATGG-1_V12D07-332_D1,0,0,0,1,0,1
CTGCGTTACGATATAA-1_V12D07-332_D1,0,0,0,0,0,0
TAATAAACAAGGAGAT-1_V12D07-332_D1,0,0,0,0,0,0
AACCTTTACGACGTCT-1_V12D07-332_D1,0,0,0,0,0,0
AGTCCCGCCTTTAATT-1_V12D07-332_D1,0,2,0,0,0,2
TGAGATTAGGCCCTAA-1_V12D07-332_D1,0,0,0,0,0,0
AGTGTATTGCGCATTG-1_V12D07-332_D1,0,0,0,0,0,0
GTTGGATTCAGTGGCT-1_V12D07-332_D1,0,2,0,0,1,3
TAAAGCTGCAATAGGG-1_V12D07-332_D1,0,1,0,0,2,3
AGTAGGAAGGAAGTTG-1_V12D07-332_D1,0,1,0,0,2,3
TATCACTTCGAGTAAC-1_V12D07-332_D1,0,0,0,0,1,1
TGATCTACGCTGATCT-1_V12D07-332_D1,1,1,0,0,0,2
GGATCATCCCGTACGC-1_V12D07-332_D1,0,2,0,0,0,2
TGACACTTCTCTTTGC-1_V12D07-332_D1,0,1,0,0,0,1
AGCCCTTCTAATCCGA-1_V12D07-332_D1,0,0,0,0,1,1
CACCGCGTCCACTCTA-1_V12D07-332_D1,0,0,0,0,1,1
TAATTGGAATCGGGAA-1_V12D07-332_D1,0,1,0,0,0,1
TCGTAAGCTCCGAGGA-1_V12D07-332_D1,1,2,0,2,1,6
TATATTACAAATGTCG-1_V12D07-332_D1,0,1,0,0,0,1
CGCGAGAGGGACTTGT-1_V12D07-332_D1,1,3,0,1,0,5
GGACCTACGGTAACGT-1_V12D07-332_D1,0,0,0,0,0,0
GAAATATGCTTGAATG-1_V12D07-332_D1,0,3,0,0,0,3
CCGTATTAGCGCAGTT-1_V12D07-332_D1,0,0,0,0,0,0
AGGCGTCTATGGACGG-1_V12D07-332_D1,0,1,0,0,0,1
AACATCGATACGTCTA-1_V12D07-332_D1,0,0,0,0,0,0
TGAATATGCTATAAAC-1_V12D07-332_D1,0,1,0,0,0,1
ACCAAACACCCAGCGA-1_V12D07-332_D1,0,1,0,0,0,1
TGGCTTGTACAAGCTT-1_V12D07-332_D1,0,1,0,0,0,1
GAATGAAGGTCTTCAG-1_V12D07-332_D1,0,4,0,1,0,5
AGATACCAGCACTTCA-1_V12D07-332_D1,0,4,0,2,0,6
GCGGTCCCGGTGAAGG-1_V12D07-332_D1,0,1,0,0,0,1
GAGGCATTTGCAGCAG-1_V12D07-332_D1,0,0,0,0,0,0
GGCAAGCCAGGGATAG-1_V12D07-332_D1,0,0,0,1,0,1
TCTACGGGCTCAGTTG-1_V12D07-332_D1,0,3,1,1,0,5
TCTGCGAATCGTTCGC-1_V12D07-332_D1,0,0,0,0,0,0
AGCTCGTTGATGGAAA-1_V12D07-332_D1,0,1,0,0,0,1
TGAATGAGATACAGCA-1_V12D07-332_D1,0,0,0,0,0,0
ACCCTTGCCTGGGTCG-1_V12D07-332_D1,0,1,0,2,0,3
GGCGAACCGTTCTGAT-1_V12D07-332_D1,0,4,0,0,0,4
GCGATGTCTGTGCTTG-1_V12D07-332_D1,0,1,0,1,0,2
ATTAACACCTGAGATA-1_V12D07-332_D1,2,0,0,0,0,2
GAAATCTGACCAAGTT-1_V12D07-332_D1,1,1,0,0,0,2
CCTGACAAACTCGCGC-1_V12D07-332_D1,5,0,0,0,0,5
ATGTCATTTCCCATTG-1_V12D07-332_D1,4,0,0,0,0,4
GCGGTGCGGAGCATCG-1_V12D07-332_D1,1,0,0,0,0,1
CGGAAAGCAAATGTGC-1_V12D07-332_D1,0,0,0,1,0,1
GCTGAGCAACGGTTCT-1_V12D07-332_D1,1,1,0,0,0,2
TCACTCTTCGTCTGTC-1_V12D07-332_D1,3,1,0,0,0,4
GATCTTCATTGTCCTC-1_V12D07-332_D1,1,0,0,1,0,2
ACTCGATGTATTTCAT-1_V12D07-332_D1,3,1,0,0,0,4
TGAAGAGCGGTCCTAG-1_V12D07-332_D1,4,2,0,1,0,7
TAAACGTCGTCAATGA-1_V12D07-332_D1,2,2,1,1,0,6
ACGTTATTGGTCACTC-1_V12D07-332_D1,3,2,1,1,0,7
ATAGCCTCAGTACCCA-1_V12D07-332_D1,3,3,0,1,0,7
CGGGAGTATACCGCCG-1_V12D07-332_D1,0,0,1,0,0,1
GTCCTACAGGCGGCTC-1_V12D07-332_D1,0,0,1,0,0,1
CGGATAAGCGGACATG-1_V12D07-332_D1,0,0,1,0,0,1
AACTTCTGCGTCTATC-1_V12D07-332_D1,0,1,1,0,0,2
GGGTTCAGACGAACAA-1_V12D07-332_D1,0,3,0,0,0,3
AGTCTGGACATCCTTG-1_V12D07-332_D1,0,2,0,2,0,4
TTGAACGAATCCTTTG-1_V12D07-332_D1,0,4,0,0,0,4
GAAATACTAAACGTTT-1_V12D07-332_D1,0,2,1,2,0,5
CCCGCGCAATGCACCC-1_V12D07-332_D1,0,6,0,0,0,6
TTCGGCTAGAGATGGT-1_V12D07-332_D1,0,5,1,0,0,6
GACACGAGTTAGAGGA-1_V12D07-332_D1,0,4,1,0,0,5
GAGGTCCCAAAGATCT-1_V12D07-332_D1,1,4,1,0,0,6
TAACTCCATGGAGGCT-1_V12D07-332_D1,0,6,0,0,0,6
CTTGTTTATGTAGCCA-1_V12D07-332_D1,0,3,1,0,0,4
GATGGCGCACACATTA-1_V12D07-332_D1,0,3,0,0,0,3
ATAATAGTGTAGGGAC-1_V12D07-332_D1,0,8,0,1,0,9
CGCTATTCAATGTATG-1_V12D07-332_D1,0,3,0,0,0,3
ATATTGCTGTCAAAGT-1_V12D07-332_D1,0,5,0,0,0,5
GGATTCAGTACGGTGG-1_V12D07-332_D1,0,2,0,2,0,4
TTCTTAGTGAACGGTG-1_V12D07-332_D1,0,3,2,1,0,6
AATGGTTCTCACAAGC-1_V12D07-332_D1,0,4,1,2,0,7
TATACACGCAAAGTAT-1_V12D07-332_D1,0,5,0,0,0,5
CTTCATAGCTCAAGAA-1_V12D07-332_D1,0,1,0,0,0,1
CAACGGTTCTTGATAC-1_V12D07-332_D1,0,4,0,1,0,5
ACACCCGAGAAATCCG-1_V12D07-332_D1,0,3,2,1,0,6
TCTATCATGCAGTTAC-1_V12D07-332_D1,0,5,2,1,0,8
CCCGCCATGCTCCCGT-1_V12D07-332_D1,0,1,2,0,0,3
CGCTTCCACTGAAATC-1_V12D07-332_D1,0,2,1,1,0,4
CACTGTCCAAGTGAGA-1_V12D07-332_D1,0,2,0,1,0,3
ATTACTAGCCTCTTGC-1_V12D07-332_D1,0,4,0,0,0,4
CATAGTAGCATAGTAG-1_V12D07-332_D1,0,2,1,1,0,4
CAACTCCTTGATCCCG-1_V12D07-332_D1,0,4,0,0,0,4
AAGTAGAAGACCGGGT-1_V12D07-332_D1,0,2,0,1,0,3
GCGGGAACCAGGCCCT-1_V12D07-332_D1,0,4,0,1,0,5
ATTAGATTGATAGCGG-1_V12D07-332_D1,0,0,0,0,0,0
CTCGGTCCGTAGCCTG-1_V12D07-332_D1,0,1,0,0,0,1
TGGCTTTGGGTAGACA-1_V12D07-332_D1,0,3,0,0,0,3
TATCCATATCATGCGA-1_V12D07-332_D1,0,1,0,0,0,1
GGAGTGCCGCCCTGGA-1_V12D07-332_D1,0,3,0,0,0,3
TGAGAATGCTTTACCG-1_V12D07-332_D1,0,2,0,1,0,3
TTAACCAACCCTCCCT-1_V12D07-332_D1,0,0,1,0,0,1
TGTTTCGGTACTTCTC-1_V12D07-332_D1,0,1,0,2,0,3
TTGCTGAAGGAACCAC-1_V12D07-332_D1,0,0,0,6,0,6
TATTTAGTCTAGATCG-1_V12D07-332_D1,0,2,0,3,1,6
CTCCGGCCTAATATGC-1_V12D07-332_D1,0,0,0,0,0,0
TTGTGGCCCTGACAGT-1_V12D07-332_D1,0,0,0,0,1,1
TCGCCGGTCGATCCGT-1_V12D07-332_D1,0,1,0,0,0,1
CCATAGGTTGGCGTGG-1_V12D07-332_D1,0,0,0,0,1,1
GAACGACCGAATGATA-1_V12D07-332_D1,0,0,0,0,0,0
TCCGATAATTGCCATA-1_V12D07-332_D1,0,2,0,0,0,2
CATTACGTCGGCCCGT-1_V12D07-332_D1,0,0,0,0,0,0
CAAGCACCAAATGCCT-1_V12D07-332_D1,1,0,0,0,0,1
TGCATGGATCGGATCT-1_V12D07-332_D1,0,5,0,1,0,6
GAAATCGCGCGCAACT-1_V12D07-332_D1,0,0,0,1,0,1
CTGAAAGAGATCCGAC-1_V12D07-332_D1,0,1,0,2,0,3
CACCTCGATGGTGGAC-1_V12D07-332_D1,0,0,0,0,0,0
ATTTGTTCCAGGGCTC-1_V12D07-332_D1,0,0,0,0,0,0
TGGGCCACAAGAGCGC-1_V12D07-332_D1,2,1,0,0,0,3
CCTTCTTGATCCAGTG-1_V12D07-332_D1,0,2,0,3,0,5
CCTCGCCAGCAAATTA-1_V12D07-332_D1,0,1,0,2,0,3
TTCATGGCGCAACAGG-1_V12D07-332_D1,0,0,0,2,0,2
TTAATCAGTACGTCAG-1_V12D07-332_D1,0,0,0,1,0,1
CCTATCTATATCGGAA-1_V12D07-332_D1,0,0,0,1,0,1
ATTATACTTTGCTCGT-1_V12D07-332_D1,0,0,0,0,0,0
ATGGATCCGGCGTCCG-1_V12D07-332_D1,0,2,0,3,0,5
CGCCCGCTTCCGTACA-1_V12D07-332_D1,1,1,0,0,0,2
GGATTCCGCTATACCC-1_V12D07-332_D1,0,0,0,1,0,1
CGGTCTATCAACCCGT-1_V12D07-332_D1,0,0,0,0,0,0
ATGCCGGTTGATGGGA-1_V12D07-332_D1,0,0,0,0,0,0
TCATGCAGGTTCTCAT-1_V12D07-332_D1,0,0,0,0,0,0
TGAGCTTTAATGACGC-1_V12D07-332_D1,0,0,0,2,0,2
TCCCTTAGATTACTCG-1_V12D07-332_D1,0,1,0,0,0,1
ATATCTCCCTCGTTAA-1_V12D07-332_D1,0,1,0,2,0,3
AGCTCTTCCCAGTGCA-1_V12D07-332_D1,0,2,0,0,0,2
TCGCTAAACCGCTATC-1_V12D07-332_D1,0,2,0,0,0,2
CACATTCTTTCGATGG-1_V12D07-332_D1,0,4,0,0,1,5
GATATGCGGTAGCCAA-1_V12D07-332_D1,0,1,0,0,0,1
CGTTTCACTTCGGGCG-1_V12D07-332_D1,0,3,0,0,0,3
CCAATTACGGGTCGAG-1_V12D07-332_D1,0,0,0,0,0,0
GCAGGTAGAGTATGGT-1_V12D07-332_D1,0,2,1,0,3,6
GTCGTATTGGCGTACA-1_V12D07-332_D1,0,1,0,0,3,4
GAAATTAGCACGGATA-1_V12D07-332_D1,0,1,0,0,2,3
AATGCACCAAGCAATG-1_V12D07-332_D1,0,0,0,0,0,0
AGGACGCTCGATGTTG-1_V12D07-332_D1,0,0,0,0,2,2
GGCTAAAGGGCGGGTC-1_V12D07-332_D1,0,2,0,1,0,3
CATCTATCCCGTGTCT-1_V12D07-332_D1,0,2,0,1,0,3
CAGTAACTATTTATTG-1_V12D07-332_D1,0,2,0,0,0,2
CATATACTACTGATAA-1_V12D07-332_D1,0,0,0,0,1,1
GCGTTCGGAGACCGGG-1_V12D07-332_D1,0,1,0,0,1,2
AAGTTCAGTCTGCGTA-1_V12D07-332_D1,0,1,0,0,1,2
CGAAGCTATAAATTCA-1_V12D07-332_D1,1,3,0,0,0,4
CGCGGTCACAAACCAA-1_V12D07-332_D1,0,1,0,0,0,1
GGGAATGAGCCCTCAC-1_V12D07-332_D1,0,0,0,0,0,0
ACGGAGCGCAAATTAC-1_V12D07-332_D1,0,1,0,0,0,1
CGTTCTTCGCACACCT-1_V12D07-332_D1,0,2,0,0,0,2
GAATAGCCCTGCGGTC-1_V12D07-332_D1,0,1,0,0,0,1
AATAGCTACCGCGTGC-1_V12D07-332_D1,0,0,0,0,0,0
CCGAGCTGTGCTTGTC-1_V12D07-332_D1,0,3,0,0,0,3
GATGACGATGATCGCG-1_V12D07-332_D1,0,0,0,1,0,1
GCCTATGCTGGGCCTT-1_V12D07-332_D1,0,1,0,0,0,1
TTACTGTCTAGAGCTC-1_V12D07-332_D1,0,0,0,0,0,0
AGCGGTTGCCGCTCTG-1_V12D07-332_D1,0,0,0,1,0,1
GCTTGCAGCACAATTG-1_V12D07-332_D1,0,1,0,4,0,5
CCGGAGGTCTTATGGT-1_V12D07-332_D1,0,2,0,1,0,3
ACAGTATACCGTGGGA-1_V12D07-332_D1,0,1,0,0,0,1
GGGATCCCAATACAAA-1_V12D07-332_D1,0,0,0,0,0,0
ATTACGACTCCACAGT-1_V12D07-332_D1,1,1,0,1,0,3
CTCACACGCAAGCCTA-1_V12D07-332_D1,0,1,0,1,0,2
CCAGATGTAAATGGGT-1_V12D07-332_D1,0,6,0,0,1,7
GAACTTGTGCACGGGA-1_V12D07-332_D1,0,1,0,0,0,1
AAGCCGCTTTACCTTG-1_V12D07-332_D1,0,3,0,0,0,3
TCCATTCCCACTAGAG-1_V12D07-332_D1,0,2,0,1,0,3
AGAGCGCTTGTAACGG-1_V12D07-332_D1,0,2,0,0,0,2
TGGGTTCCCGGACGGA-1_V12D07-332_D1,1,0,1,1,0,3
GCTGCGCCTCCCACGT-1_V12D07-332_D1,3,3,0,0,0,6
CTGTTGGCTCTTCTGA-1_V12D07-332_D1,6,2,0,0,0,8
TTGTTCTAGATACGCT-1_V12D07-332_D1,5,1,1,0,0,7
CCCTCAAGCTCTTAGT-1_V12D07-332_D1,6,0,0,0,0,6
TGGTCTAGCTTACATG-1_V12D07-332_D1,4,2,0,0,0,6
ATGCACCTTCCTTAAT-1_V12D07-332_D1,0,1,0,2,0,3
GGGATACGGTAATAAT-1_V12D07-332_D1,3,0,0,2,0,5
AGTTCACCGGTTGGAC-1_V12D07-332_D1,1,2,0,1,0,4
GACATACTGTCGCAGA-1_V12D07-332_D1,5,0,0,1,0,6
TGGACACCGTTGCTTG-1_V12D07-332_D1,1,2,0,0,0,3
TGCGATGCTAATGGCT-1_V12D07-332_D1,6,4,0,0,0,10
TTCTGTTTCCTGTCGC-1_V12D07-332_D1,2,6,0,0,0,8
CGTTGTAAACGTCAGG-1_V12D07-332_D1,4,3,0,0,0,7
GATCGGCGATAAGTCG-1_V12D07-332_D1,2,2,2,1,0,7
AGCCTTAAAGCGGAAG-1_V12D07-332_D1,0,1,0,1,0,2
TCCGTAACCACAATCC-1_V12D07-332_D1,0,3,0,2,0,5
GAATGCCGAAATGACC-1_V12D07-332_D1,0,4,0,0,0,4
TATACTCATGCGGCAA-1_V12D07-332_D1,0,6,1,0,0,7
TAGTGTCAGAAACGGC-1_V12D07-332_D1,0,2,0,2,0,4
CGTCATACCATATCCA-1_V12D07-332_D1,0,4,0,0,0,4
TAGTACCTTAGTGGTC-1_V12D07-332_D1,2,5,1,1,0,9
CTGGCGGGAATAAGTA-1_V12D07-332_D1,0,6,0,0,0,6
AGTGTGGTCTATTGTG-1_V12D07-332_D1,0,4,1,0,0,5
GCTATCGCGGCGCAAC-1_V12D07-332_D1,0,10,1,0,0,11
CAGTAATCCCTCCCAG-1_V12D07-332_D1,0,2,0,1,0,3
GTATTAAGGCGTCTAA-1_V12D07-332_D1,0,5,0,0,0,5
CTAATTTCAACAACAC-1_V12D07-332_D1,0,2,0,0,0,2
TTAGCAACATGGATGT-1_V12D07-332_D1,0,2,1,0,0,3
ATGCTCAGTGTTGCAT-1_V12D07-332_D1,0,4,3,0,0,7
GATGTTTGTGCGAGAT-1_V12D07-332_D1,0,7,2,1,0,10
CACTTCGCCACAGGCT-1_V12D07-332_D1,0,1,1,0,0,2
CTGTATGGTGTAGAAA-1_V12D07-332_D1,0,1,0,1,0,2
TACGTGCACTATGCTG-1_V12D07-332_D1,0,4,0,0,0,4
GTATCAGCTTGGGTTC-1_V12D07-332_D1,0,0,1,0,0,1
TAACAAAGGGAGAAGC-1_V12D07-332_D1,0,4,0,0,0,4
TTACATCGTGGCCTGG-1_V12D07-332_D1,0,2,0,0,0,2
TCTGAACCGGTCGGCT-1_V12D07-332_D1,0,1,0,1,0,2
GGCTCGTGCCACCAGC-1_V12D07-332_D1,0,4,0,1,0,5
TATAAGTGAGGATAGC-1_V12D07-332_D1,0,5,0,0,0,5
GCCCGCGCGTTTGACA-1_V12D07-332_D1,0,2,0,0,0,2
TGCTGGTTGGACAATT-1_V12D07-332_D1,0,6,0,0,0,6
GCCTAGCGATCTGACC-1_V12D07-332_D1,0,2,0,2,0,4
CCATGCTCTGCAGGAA-1_V12D07-332_D1,0,5,0,1,0,6
TATAAATCCACAAGCT-1_V12D07-332_D1,0,6,0,0,0,6
CGCTCGACATAATGAT-1_V12D07-332_D1,0,4,0,1,0,5
CCAATTGAATGTTAAT-1_V12D07-332_D1,0,4,0,2,0,6
GCTAATACCGAATGCC-1_V12D07-332_D1,0,0,0,4,0,4
TTCAACGACCCGACCG-1_V12D07-332_D1,0,0,0,0,0,0
TTCCTCGAGGGTGTCT-1_V12D07-332_D1,0,1,0,4,0,5
CAACGACCCGTTTACA-1_V12D07-332_D1,0,3,0,0,0,3
CTTGTACTTGTTGACT-1_V12D07-332_D1,0,1,1,1,0,3
TCTCTAATAGCTGGTA-1_V12D07-332_D1,0,1,1,0,0,2
ATTATGCCATAGGGAG-1_V12D07-332_D1,0,4,0,1,0,5
GACAACGCAGCTTACG-1_V12D07-332_D1,0,3,0,1,0,4
AGATGACTCGCCCACG-1_V12D07-332_D1,0,1,0,1,0,2
GTGCGGGTCTCCAAAT-1_V12D07-332_D1,0,1,0,4,1,6
GTACGAGATTGCGACA-1_V12D07-332_D1,0,0,0,0,0,0
GTATAGGACTCAGTAG-1_V12D07-332_D1,0,1,0,0,0,1
TTGCACGGAGCAGCAC-1_V12D07-332_D1,0,0,0,0,0,0
CACAGCTAGGGAGTGA-1_V12D07-332_D1,0,0,0,0,1,1
ATACTAGCATGACCCT-1_V12D07-332_D1,0,0,0,1,2,3
CCAAGACTTCTGCGAA-1_V12D07-332_D1,0,0,0,0,0,0
ACATAATAAGGCGGTG-1_V12D07-332_D1,0,2,0,2,1,5
TAATACACAGTAGTAT-1_V12D07-332_D1,1,1,0,0,2,4
TCTTGGTAACACCAAA-1_V12D07-332_D1,0,0,0,0,0,0
AACTGGGTCCCGACGT-1_V12D07-332_D1,0,0,0,0,0,0
ATCACTTCATCCTCGC-1_V12D07-332_D1,0,0,0,0,0,0
TGGAAGGATAAAGATG-1_V12D07-332_D1,0,0,0,0,0,0
CATGATGCACAATTCT-1_V12D07-332_D1,0,1,0,0,0,1
TGCCTGATCAAACGAT-1_V12D07-332_D1,0,0,0,1,0,1
ATAGGGATATCCTTGA-1_V12D07-332_D1,0,0,2,1,1,4
CACCTAATCAGTTTAC-1_V12D07-332_D1,0,0,0,0,0,0
TGTGACTACGCCAGTC-1_V12D07-332_D1,0,0,0,0,0,0
CCCGACCATAGTCCGC-1_V12D07-332_D1,0,0,0,0,0,0
CGCGCCCGACTTAATA-1_V12D07-332_D1,0,1,0,0,0,1
TGCCACCTGGCGAAAC-1_V12D07-332_D1,0,0,0,0,0,0
CTGCCAAGGTTGGAAG-1_V12D07-332_D1,1,1,0,1,0,3
TCTCCAACGTAGGTTA-1_V12D07-332_D1,0,0,0,0,0,0
TTCTTGGAGTAATGAG-1_V12D07-332_D1,0,0,0,2,0,2
GTCTCGATCTGCTTTC-1_V12D07-332_D1,0,0,0,2,0,2
TACTCTCCGAACAAAT-1_V12D07-332_D1,0,0,0,0,0,0
ATCACATTAGAATATC-1_V12D07-332_D1,0,0,0,0,0,0
TACGGGATGCTAGCAG-1_V12D07-332_D1,0,0,0,0,0,0
AGCTGAAGTAAACCAA-1_V12D07-332_D1,0,1,0,3,0,4
CATGGGTCGGGTGTGG-1_V12D07-332_D1,0,0,0,0,0,0
CACCCACGAGGCAATT-1_V12D07-332_D1,0,0,0,1,0,1
TGCCATTACTAAAGAA-1_V12D07-332_D1,0,0,0,0,0,0
CCGTTACGTTAGAACA-1_V12D07-332_D1,0,2,0,1,1,4
GCCAGGAGTAACCGAT-1_V12D07-332_D1,0,4,0,0,0,4
GGAAAGTGCCCATGCC-1_V12D07-332_D1,0,1,0,1,0,2
TCTTACCGGAACTCGT-1_V12D07-332_D1,0,1,0,0,2,3
TATGTCAAGACCGACT-1_V12D07-332_D1,1,0,0,0,0,1
CCTAACTAAGGCTCTA-1_V12D07-332_D1,0,0,0,0,0,0
GCGGTGAACTGCGCTC-1_V12D07-332_D1,0,0,0,0,1,1
CCTCGCGCGATATAGG-1_V12D07-332_D1,0,0,1,0,2,3
ATCGGCAAGCAGTCCA-1_V12D07-332_D1,0,1,0,1,4,6
AGATCGTGCATAAGAT-1_V12D07-332_D1,0,1,0,0,1,2
ATTCAGGACCTATTTC-1_V12D07-332_D1,0,0,0,0,1,1
AGCTAGAAGCAGAAGT-1_V12D07-332_D1,0,3,0,0,1,4
TTCGCTATCTGACGTG-1_V12D07-332_D1,0,2,0,0,1,3
TTCCGCAGAGAAATAT-1_V12D07-332_D1,0,4,0,0,0,4
CAGTACATTCTCTAAA-1_V12D07-332_D1,0,1,0,0,1,2
GTGAAGATTTCAAGTG-1_V12D07-332_D1,0,1,0,0,0,1
AACGCATGATCTGGGT-1_V12D07-332_D1,0,0,0,0,2,2
CCCAGAGGAGGGCGTA-1_V12D07-332_D1,0,3,0,0,0,3
GGAAACCTTGTTGAAT-1_V12D07-332_D1,0,0,0,0,0,0
GTGAAGCCGTATAGTC-1_V12D07-332_D1,0,3,0,3,0,6
GAGCTGTCGTCTCGGA-1_V12D07-332_D1,0,0,0,1,0,1
TGTCATTTGTTGGGAA-1_V12D07-332_D1,0,0,0,0,0,0
ACCAACACCACACACT-1_V12D07-332_D1,0,3,0,4,0,7
AAATGATTCGATCAGC-1_V12D07-332_D1,0,0,0,0,0,0
CTGCTTTATGTCCGCG-1_V12D07-332_D1,0,1,0,1,0,2
GCGAGAGGCCATGTAA-1_V12D07-332_D1,0,1,0,2,0,3
ATTGACCGGCGATGAC-1_V12D07-332_D1,0,2,0,1,1,4
ACCCTGGTAACGCCCT-1_V12D07-332_D1,0,3,0,0,0,3
GTTGGACCGCATCAGG-1_V12D07-332_D1,0,1,0,0,0,1
CGTTTACAAGGCAGCT-1_V12D07-332_D1,0,0,0,0,0,0
CGGTCCATGAGACTCC-1_V12D07-332_D1,0,0,0,0,0,0
GTTCGTCTGGGTCCCT-1_V12D07-332_D1,0,0,0,0,0,0
TGTACTACTCTCACGG-1_V12D07-332_D1,0,3,0,2,0,5
AGTGAAGATGGTGTCC-1_V12D07-332_D1,0,2,0,1,0,3
GAGGGCCATAATATTA-1_V12D07-332_D1,0,1,0,0,0,1
ACTCCCGTAGACTAGG-1_V12D07-332_D1,0,4,0,0,0,4
CGTCAAATGGTCGCAG-1_V12D07-332_D1,0,0,0,0,0,0
AAGTCTAGTAGCTGCC-1_V12D07-332_D1,0,1,0,0,0,1
AAGAAATCACCAGATT-1_V12D07-332_D1,1,3,0,0,0,4
GAGTGCACGGACAACA-1_V12D07-332_D1,0,2,0,1,0,3
GTTCAAATCAGATGTC-1_V12D07-332_D1,1,0,0,0,0,1
CATGGCTCCCTATGTC-1_V12D07-332_D1,2,0,2,0,0,4
GGCCACACGAAAGCCT-1_V12D07-332_D1,3,2,0,0,0,5
GAAGCCGGGTAAGCTC-1_V12D07-332_D1,0,1,0,0,0,1
TTGCGCTCTCTCGCTT-1_V12D07-332_D1,3,3,1,0,0,7
TACATGACCTTATCCG-1_V12D07-332_D1,1,0,1,0,0,2
GTCCTTCTACAACCCA-1_V12D07-332_D1,0,0,0,3,0,3
TATATGCTGGGTTGCC-1_V12D07-332_D1,1,0,0,1,0,2
GTTTATGGGATTTAGA-1_V12D07-332_D1,1,2,0,2,0,5
GGAACCCGAACAAGAA-1_V12D07-332_D1,1,2,0,0,0,3
AACGTTATCAGCACCT-1_V12D07-332_D1,3,2,0,0,0,5
CATCGTCCGGTTACTA-1_V12D07-332_D1,3,1,3,0,0,7
AGACAGCTCAGAATCC-1_V12D07-332_D1,4,2,1,0,0,7
GCAGATCCTCGCAAAT-1_V12D07-332_D1,5,2,0,1,0,8
GGGTCATGCGTACCAT-1_V12D07-332_D1,5,1,1,0,0,7
CTGGTCATTCCAATCC-1_V12D07-332_D1,2,3,2,0,0,7
TCAGGGCGCAAACTCG-1_V12D07-332_D1,0,1,1,0,0,2
GATGCCAGCAGAAGGC-1_V12D07-332_D1,0,3,0,0,0,3
GTTATTAACGTGGGAG-1_V12D07-332_D1,0,5,0,1,0,6
AATACAATGTTTCAGG-1_V12D07-332_D1,0,2,1,0,0,3
TTGCTGCACCTATCCA-1_V12D07-332_D1,0,8,0,0,0,8
CCAGAGACAAAGCCGG-1_V12D07-332_D1,0,4,1,1,0,6
CCGAAGTATATTGTTC-1_V12D07-332_D1,0,5,1,0,0,6
GCTAAACCTGAGGTGA-1_V12D07-332_D1,0,7,0,1,0,8
TCATACTTACAGATCC-1_V12D07-332_D1,0,4,0,0,0,4
CGAGCACTTCAAGTTT-1_V12D07-332_D1,0,3,6,2,0,11
TAGCAACCTGTCACAA-1_V12D07-332_D1,0,4,0,0,0,4
TGGGAAATGCCTTTCC-1_V12D07-332_D1,0,2,1,0,0,3
AGACCATGGGATACAA-1_V12D07-332_D1,0,6,1,1,0,8
TAAATGAATCCGTTTC-1_V12D07-332_D1,0,7,0,0,0,7
ACAACGGTCCCTGCGA-1_V12D07-332_D1,0,1,0,0,0,1
GTCACTCTCCAAATCT-1_V12D07-332_D1,0,5,0,0,0,5
TTCTACTTGCGAGGGC-1_V12D07-332_D1,0,4,1,0,0,5
CGCAATTACTTTCGGT-1_V12D07-332_D1,0,5,0,2,0,7
CTGTTCATCTCACGGG-1_V12D07-332_D1,0,3,0,0,0,3
TTCTTGTAACCTAATG-1_V12D07-332_D1,0,5,1,1,0,7
GCTTGATGATAATCAG-1_V12D07-332_D1,0,1,0,1,0,2
TTGGCTCGCATGAGAC-1_V12D07-332_D1,0,2,1,0,0,3
GCCCAGTTGGTATGCC-1_V12D07-332_D1,0,1,2,2,0,5
ATTCCTCCGCCAGTGC-1_V12D07-332_D1,2,6,0,0,0,8
TCGTCCGCTGGCGTCT-1_V12D07-332_D1,0,1,0,0,0,1
GGAGAAGTCATTGGCA-1_V12D07-332_D1,1,1,0,0,0,2
TTGTTAGCAAATTCGA-1_V12D07-332_D1,0,2,0,3,0,5
TCTAGCATCTTCGATG-1_V12D07-332_D1,0,5,0,0,0,5
TTCTAGGCCAATTGTG-1_V12D07-332_D1,0,0,3,0,0,3
TCACGGTCATCGCACA-1_V12D07-332_D1,0,5,0,1,0,6
ATGAAGCCAAGGAGCC-1_V12D07-332_D1,0,3,0,6,0,9
AATGACTGTCAGCCGG-1_V12D07-332_D1,0,2,0,5,0,7
CCAAACAGAACCCTCG-1_V12D07-332_D1,0,0,0,3,0,3
TATCGATGATTAAACG-1_V12D07-332_D1,0,3,0,1,0,4
GAACACACATCAACCA-1_V12D07-332_D1,0,0,0,0,0,0
CCCGTCAGCGTCTGAC-1_V12D07-332_D1,0,2,0,2,0,4
AGCATCGTCGATAATT-1_V12D07-332_D1,0,4,0,0,0,4
GACTAAGATCATGCAC-1_V12D07-332_D1,0,2,3,0,0,5
TAGGGTGTTTCAAGAG-1_V12D07-332_D1,0,4,0,0,0,4
TGGTTCGTAGCAAAGG-1_V12D07-332_D1,0,2,1,0,0,3
CTGTTCACTGCCTGTG-1_V12D07-332_D1,0,4,1,0,0,5
ATGTGCATCCGACGCA-1_V12D07-332_D1,0,2,0,0,0,2
TTGTCGTTCAGTTACC-1_V12D07-332_D1,0,2,0,0,0,2
CGGGATCAATGTAAGA-1_V12D07-332_D1,0,1,0,1,1,3
TTATCTGTATCATAAC-1_V12D07-332_D1,0,4,0,2,0,6
ATCGACTCTTTCCGTT-1_V12D07-332_D1,0,0,0,2,0,2
CTCATTTGATGGGCGG-1_V12D07-332_D1,0,1,0,0,0,1
GTAAGCGGGCAGTCAG-1_V12D07-332_D1,1,0,0,1,0,2
TCTATCGGTCGCAACA-1_V12D07-332_D1,0,0,0,0,0,0
AACGCGGTCTCCAGCC-1_V12D07-332_D1,0,0,0,1,0,1
ATTAATACTACGCGGG-1_V12D07-332_D1,0,0,0,2,0,2
CTTTAACTTTCAAAGG-1_V12D07-332_D1,0,0,0,2,0,2
CGTACCTGATAGGCCT-1_V12D07-332_D1,0,0,0,0,0,0
GAATGTTGGGTAATCT-1_V12D07-332_D1,0,2,0,0,0,2
TGCGGAGTAAAGGTGC-1_V12D07-332_D1,0,0,0,2,0,2
CCTGAATATTTACATA-1_V12D07-332_D1,0,0,0,1,0,1
TTGCTCCCATACCGGA-1_V12D07-332_D1,0,2,1,0,0,3
CCTCTAATCTGCCAAG-1_V12D07-332_D1,0,1,0,0,0,1
AGGTTGAGGCACGCTT-1_V12D07-332_D1,0,0,0,0,0,0
TCCCGTCAGTCCCGCA-1_V12D07-332_D1,0,0,0,0,0,0
TCCGATGACTGAGCTC-1_V12D07-332_D1,0,0,0,2,0,2
CAGCCTCCTGCAGAGG-1_V12D07-332_D1,0,1,0,0,0,1
CTTAGCCTTCCACATG-1_V12D07-332_D1,1,0,0,0,0,1
ATTAATGAACCAGTCG-1_V12D07-332_D1,0,0,0,1,0,1
ACGATACATAGAACTA-1_V12D07-332_D1,0,1,2,3,0,6
AGCCACTCCCGTGCTT-1_V12D07-332_D1,0,0,0,1,0,1
ATACGGGTTTCGATTG-1_V12D07-332_D1,0,4,0,0,0,4
CTGTCAAATGGCTCGG-1_V12D07-332_D1,0,0,0,1,0,1
GCTCGGAATTTAAAGC-1_V12D07-332_D1,0,0,0,0,0,0
TAGGCATGTTACGCCA-1_V12D07-332_D1,0,1,0,1,0,2
TGGCAACTCGCGCGCC-1_V12D07-332_D1,0,1,0,0,0,1
ATCAGTAGGCAGGGAT-1_V12D07-332_D1,0,5,0,1,0,6
TATCGATCTATGCATA-1_V12D07-332_D1,0,3,0,0,0,3
CGACTCAGGATGTTAT-1_V12D07-332_D1,0,2,0,2,1,5
GCCATATTGCACACAG-1_V12D07-332_D1,1,0,0,0,0,1
AATTCATAAGGGATCT-1_V12D07-332_D1,0,0,0,0,1,1
CGGTAGAGGTGCAGGT-1_V12D07-332_D1,0,0,0,0,1,1
AATGATGATACGCTAT-1_V12D07-332_D1,0,0,0,0,3,3
CTTGTGCTCACCGATT-1_V12D07-332_D1,0,2,0,0,1,3
TTCCAATCAGAGCTAG-1_V12D07-332_D1,0,1,0,0,1,2
CGATGGACCCTACGCC-1_V12D07-332_D1,0,4,0,1,1,6
GGTCGGATAAACGGCG-1_V12D07-332_D1,0,1,0,0,1,2
TTAGCTAATACGATCT-1_V12D07-332_D1,0,2,0,1,0,3
CTCGATATTTGCGAGC-1_V12D07-332_D1,0,5,0,2,0,7
ATTACTTACTGGGCAT-1_V12D07-332_D1,0,2,0,2,0,4
CTAGCCGATGTTATGA-1_V12D07-332_D1,0,3,0,0,0,3
TACTGCAATCAATTAC-1_V12D07-332_D1,0,2,0,1,1,4
TAGTCTGTGACGTTGC-1_V12D07-332_D1,0,2,0,2,0,4
CTCGTTTCTAATGTTT-1_V12D07-332_D1,0,2,0,0,0,2
TTCGTTCAACGAAGTT-1_V12D07-332_D1,0,2,0,2,0,4
CTGAATTTATTGCCAG-1_V12D07-332_D1,1,3,0,1,0,5
TGGAATATCCTTGACC-1_V12D07-332_D1,0,5,0,1,0,6
CAGATCATTTAAAGTC-1_V12D07-332_D1,0,1,0,0,0,1
CTCCTTTACGCAAGTC-1_V12D07-332_D1,0,2,1,2,0,5
TCCCAAACAGACAACG-1_V12D07-332_D1,0,1,0,0,0,1
ATCGCTGCGTGCAGCA-1_V12D07-332_D1,1,2,0,1,0,4
TTAGTTCAAGTGTTCG-1_V12D07-332_D1,0,0,0,2,0,2
AAACTCGTGATATAAG-1_V12D07-332_D1,0,0,0,0,0,0
TTAACGAACAAGCAGT-1_V12D07-332_D1,0,1,0,0,0,1
GTTATATCAGGAGCCA-1_V12D07-332_D1,0,2,0,2,0,4
CAAATTGGATTATGCC-1_V12D07-332_D1,0,0,0,0,0,0
CGAGGAGCTTCCATAT-1_V12D07-332_D1,0,2,0,1,0,3
GGAGACCAATGTGCTT-1_V12D07-332_D1,0,1,0,0,0,1
CATTGATGAACACGCC-1_V12D07-332_D1,0,0,0,0,0,0
GTCAATGCTATAATTT-1_V12D07-332_D1,0,1,0,1,0,2
ACCACCCTCTCTTCTA-1_V12D07-332_D1,0,1,0,2,0,3
TGGAGGGAAACACCTC-1_V12D07-332_D1,0,2,0,0,2,4
CACGGACGTGGATGGC-1_V12D07-332_D1,0,0,0,0,0,0
AACTTTCTCGATCATG-1_V12D07-332_D1,0,4,0,0,0,4
CGTATTGTTTCCTAAT-1_V12D07-332_D1,0,0,0,0,0,0
CCTACTGCGGCGGCCA-1_V12D07-332_D1,0,1,0,0,0,1
CTTAGGTCCCAATCGT-1_V12D07-332_D1,1,0,0,0,0,1
CGCAATCGATCATTAG-1_V12D07-332_D1,1,0,0,0,0,1
TGGTTATGCTTGCGGT-1_V12D07-332_D1,1,2,0,0,0,3
GGCTTGGCTCTCACCT-1_V12D07-332_D1,5,0,0,0,0,5
ATTGGTAGGATCCGCT-1_V12D07-332_D1,3,1,1,0,0,5
TCAGGGCGACTTCCTT-1_V12D07-332_D1,5,1,0,0,0,6
TCTGCAGATTCGAGTC-1_V12D07-332_D1,1,1,0,0,0,2
CTCTCGCTGTACTATG-1_V12D07-332_D1,1,1,0,0,0,2
AATAGTCGCGAGTCGG-1_V12D07-332_D1,3,0,0,6,0,9
AGTTACCCTTAAGACT-1_V12D07-332_D1,0,0,1,1,0,2
CTTAAATAAGACCCAT-1_V12D07-332_D1,0,0,0,1,0,1
GGTTGTGCTCTTGTCC-1_V12D07-332_D1,5,3,0,0,0,8
GTGAGTCTAAGACGGA-1_V12D07-332_D1,3,5,0,0,0,8
CGCGACACTGCGCAGC-1_V12D07-332_D1,2,2,1,0,0,5
GCTCGCGGTTCCGCTC-1_V12D07-332_D1,2,1,3,1,0,7
TTAACTCACGCGTGGA-1_V12D07-332_D1,3,6,1,0,0,10
GGAACGGCCTGCAGCC-1_V12D07-332_D1,1,5,0,1,0,7
GTAGAAACGGGTGGAG-1_V12D07-332_D1,0,3,0,1,0,4
TAATGAAAGACCCTTG-1_V12D07-332_D1,1,3,0,0,0,4
AGGCTTGCTAGACACC-1_V12D07-332_D1,0,1,0,2,0,3
TTGCGTAGTTTGAGGA-1_V12D07-332_D1,1,4,0,1,0,6
CGCCCTTGAAGGCTGA-1_V12D07-332_D1,0,3,1,0,0,4
CCCGGTGGAAGAACCT-1_V12D07-332_D1,0,4,0,1,0,5
TTAACACCTCGAACAT-1_V12D07-332_D1,0,7,0,1,0,8
GATTCCTATACGGCGC-1_V12D07-332_D1,0,7,0,0,0,7
TTACCCTAACAGTCCT-1_V12D07-332_D1,0,0,2,0,0,2
ACCCACCTACATGCTC-1_V12D07-332_D1,0,3,0,0,0,3
AAAGGGCAGCTTGAAT-1_V12D07-332_D1,0,8,2,0,0,10
CACACAGGGATAGATT-1_V12D07-332_D1,0,6,1,1,0,8
AGAGCGTACAAGCTCG-1_V12D07-332_D1,0,3,0,0,0,3
TCTTACGGCATCCGAC-1_V12D07-332_D1,0,6,1,0,0,7
GCCTATTCCGATATAG-1_V12D07-332_D1,0,6,0,0,0,6
GAAAGTGACTAACTGC-1_V12D07-332_D1,0,2,0,0,0,2
CCGGAATGGTTTCAGT-1_V12D07-332_D1,0,3,0,0,0,3
AGTATAATACTAGGCA-1_V12D07-332_D1,0,2,0,0,0,2
TAACTATCGAAGGTCC-1_V12D07-332_D1,0,4,0,1,0,5
ATGAGGAGTGTTAATC-1_V12D07-332_D1,0,5,3,0,0,8
TGTGTCGCGAGTTGCA-1_V12D07-332_D1,0,4,0,0,0,4
ATCCAACGCAGTCATA-1_V12D07-332_D1,0,4,0,2,0,6
AAGGCGCGTAAAGCTT-1_V12D07-332_D1,4,1,0,0,0,5
AGTCGGCCCAAACGAC-1_V12D07-332_D1,2,2,0,0,0,4
AACGTCAGACTAGTGG-1_V12D07-332_D1,0,6,0,0,0,6
ACTACCAGCTCTCTGG-1_V12D07-332_D1,1,0,1,3,0,5
GCAAGTGCACAGAGAA-1_V12D07-332_D1,0,1,0,0,0,1
ACACCTTAAGTAGGGC-1_V12D07-332_D1,0,3,0,1,0,4
TTCGACGGGAAGGGCG-1_V12D07-332_D1,0,1,0,1,0,2
TTCGCACTCGCGTGCT-1_V12D07-332_D1,0,2,0,0,0,2
TATTTGTTACCCTTTA-1_V12D07-332_D1,0,0,0,4,0,4
CGCTGTGACGCCGCAC-1_V12D07-332_D1,0,1,0,1,0,2
GTTGCACGGAGTTTCG-1_V12D07-332_D1,0,1,0,1,0,2
GTTTCCTGGAGGGTGA-1_V12D07-332_D1,0,4,0,0,0,4
ACACCCAGCATGCAGC-1_V12D07-332_D1,0,5,0,1,0,6
TCAACCATGTTCGGGC-1_V12D07-332_D1,0,1,0,1,0,2
TTACAACTACGCATCC-1_V12D07-332_D1,0,3,1,0,0,4
TCCGATGGTGCGACAT-1_V12D07-332_D1,0,3,1,1,0,5
GGGCGTACATTTATAT-1_V12D07-332_D1,0,3,0,1,0,4
AGCGACCAACGATATT-1_V12D07-332_D1,0,1,0,0,0,1
ACACAAAGACGGGTGG-1_V12D07-332_D1,1,6,0,0,0,7
ATCGCACGCCGGGAGA-1_V12D07-332_D1,0,1,0,1,1,3
GCTCTAAACCCTGACG-1_V12D07-332_D1,0,0,0,0,1,1
AATGCAACCGGGTACC-1_V12D07-332_D1,0,0,0,1,0,1
TCAAACAACCGCGTCG-1_V12D07-332_D1,0,1,0,0,0,1
TATGCTCCCTACTTAC-1_V12D07-332_D1,0,1,0,1,0,2
AAAGGGATGTAGCAAG-1_V12D07-332_D1,0,0,0,1,0,1
ACGATCATACATAGAG-1_V12D07-332_D1,0,0,0,0,2,2
TTGTTCAGTGTGCTAC-1_V12D07-332_D1,0,2,0,2,0,4
ATGCATGATCCAGGAT-1_V12D07-332_D1,0,1,0,1,0,2
AGTCTTCTCCTCAAAT-1_V12D07-332_D1,0,0,0,2,0,2
GATTCCCTTGTCGCAG-1_V12D07-332_D1,1,0,0,1,0,2
CTCGCACCTATATAGT-1_V12D07-332_D1,0,1,0,1,0,2
ACTCAATAAAGGCACG-1_V12D07-332_D1,0,0,0,0,0,0
AACCGAGCTTGGTCAT-1_V12D07-332_D1,0,0,0,1,0,1
TAAGGCAACATAAGAT-1_V12D07-332_D1,0,0,0,2,0,2
CACGCACAGCGCAGCT-1_V12D07-332_D1,1,1,0,1,0,3
GGTTTACAATCTCAAT-1_V12D07-332_D1,0,0,0,4,0,4
TGCAGGATCGGCAAAG-1_V12D07-332_D1,0,0,0,1,0,1
ATAACGGAGTCCAACG-1_V12D07-332_D1,0,0,0,1,0,1
AACGATATGTCAACTG-1_V12D07-332_D1,0,0,0,0,0,0
GACAACGACCATTGAA-1_V12D07-332_D1,0,1,0,1,0,2
TTGACCATGTTCTCCG-1_V12D07-332_D1,0,0,0,0,0,0
AGTACGGGCACCTGGC-1_V12D07-332_D1,0,0,0,0,0,0
CGCCATCCGATTATGA-1_V12D07-332_D1,0,1,0,1,0,2
AAGGTATCCTAATATA-1_V12D07-332_D1,0,0,0,1,0,1
TGTTGTCAAGAAGTCT-1_V12D07-332_D1,0,1,0,1,0,2
CAGTGAATAAATGACT-1_V12D07-332_D1,0,0,0,0,0,0
CACCTTGCGAAACTCG-1_V12D07-332_D1,0,0,1,0,0,1
CATTTAGCGGACCATG-1_V12D07-332_D1,0,1,0,1,0,2
CCAGTCTAGACGGCGC-1_V12D07-332_D1,0,0,0,0,0,0
TCGCTTTAAACGTTTG-1_V12D07-332_D1,0,0,0,0,0,0
GTGAAACGGCGCCACC-1_V12D07-332_D1,0,1,0,2,0,3
GGGCTCATCGAACCCA-1_V12D07-332_D1,0,0,0,0,1,1
TTGATGTGTAGTCCCG-1_V12D07-332_D1,0,1,0,0,0,1
CAGTAGCCCACGCGGT-1_V12D07-332_D1,0,1,0,0,1,2
AGCGCGGGTGCCAATG-1_V12D07-332_D1,0,1,0,0,1,2
TAATCGATCCGTACGT-1_V12D07-332_D1,0,1,0,1,2,4
AGTGGCGGCAATTTGA-1_V12D07-332_D1,0,0,0,0,0,0
CCTTTCAATGAAGAAA-1_V12D07-332_D1,0,2,0,0,1,3
CTCAGTCACGACAAAT-1_V12D07-332_D1,0,3,0,0,0,3
ATAGGCTAGCTTCGCA-1_V12D07-332_D1,1,6,0,0,0,7
CGGTTCAAGTAGGTGT-1_V12D07-332_D1,0,5,0,1,0,6
CAGTCGAGGATGCAAT-1_V12D07-332_D1,0,3,0,1,0,4
TATCACCCAACCGACC-1_V12D07-332_D1,0,4,0,1,0,5
AATGATGCGACTCCTG-1_V12D07-332_D1,0,3,0,1,0,4
TGGAACCACTGACACA-1_V12D07-332_D1,0,2,0,2,0,4
GCCAATAGGGCATCTC-1_V12D07-332_D1,0,2,0,5,0,7
TTCTTTGGTCGCGACG-1_V12D07-332_D1,2,6,0,0,0,8
ATTAGATTCCTCAGCA-1_V12D07-332_D1,0,2,0,0,0,2
CCGTGGAACGATCCAA-1_V12D07-332_D1,0,3,0,1,0,4
GGGTCGTGGCAAGTGT-1_V12D07-332_D1,0,6,0,3,0,9
TCGCTCGGCACCAGCG-1_V12D07-332_D1,0,5,0,0,0,5
ACGCAATCACTACAGC-1_V12D07-332_D1,0,2,1,1,0,4
CTCTAATGCATTGATC-1_V12D07-332_D1,0,0,0,1,0,1
GTCTCGACTAAGTTTG-1_V12D07-332_D1,0,4,0,0,0,4
TGGTTTAAACGTGGGT-1_V12D07-332_D1,1,3,0,0,0,4
CGCAGATCTTCACCCG-1_V12D07-332_D1,0,1,0,2,0,3
TCCAGATGTACGCCAA-1_V12D07-332_D1,0,4,1,1,0,6
CATTGCGGGTCAATTC-1_V12D07-332_D1,0,4,0,0,0,4
GACGTTCGTAAATACA-1_V12D07-332_D1,0,1,0,1,0,2
TACACCGTCGTTAGTC-1_V12D07-332_D1,0,1,0,1,0,2
ACGGGCGTATGCGACA-1_V12D07-332_D1,0,2,0,1,0,3
GAAGGCTACCATTGTT-1_V12D07-332_D1,0,0,0,1,0,1
TAAATCTTTACACCTC-1_V12D07-332_D1,0,0,0,2,0,2
AGTTTATGTAAAGACA-1_V12D07-332_D1,0,2,0,1,0,3
AGGAGACATCCACAGT-1_V12D07-332_D1,0,1,0,0,0,1
CAACCTGAACCTGCCA-1_V12D07-332_D1,0,0,0,1,0,1
AGTCCCTCGCAGAAAG-1_V12D07-332_D1,0,2,0,1,2,5
TGTATACGGATGATGA-1_V12D07-332_D1,0,2,0,0,0,2
TTGTGGTATAGGTATG-1_V12D07-332_D1,0,1,0,0,0,1
TCTGCACCATTAGTAA-1_V12D07-332_D1,0,1,1,0,0,2
AAATGTATCTTATCCC-1_V12D07-332_D1,0,0,0,0,0,0
ACTCTAAACCTGGGAT-1_V12D07-332_D1,0,2,1,0,0,3
GCTGGCAGGTGCCGTG-1_V12D07-332_D1,2,1,0,0,0,3
CTCATTCGTGAACATC-1_V12D07-332_D1,1,1,0,0,0,2
TCGCCGGATGGGCAAG-1_V12D07-332_D1,6,0,0,1,0,7
GGACTAAGTCAGGAGT-1_V12D07-332_D1,1,0,0,0,0,1
TATCAAAGGTCTGTAA-1_V12D07-332_D1,1,0,0,2,0,3
TTCAGTTTGTGGCAGC-1_V12D07-332_D1,0,0,0,1,0,1
TGTTCATAAATGTGCT-1_V12D07-332_D1,0,0,0,0,0,0
CTTAGCCCGGATAGTG-1_V12D07-332_D1,0,1,0,1,0,2
GATGCGAATGGTATTA-1_V12D07-332_D1,1,1,1,1,0,4
TCTAACTGTATGTAAA-1_V12D07-332_D1,1,1,0,2,0,4
TTAAACCTGGTTCCTT-1_V12D07-332_D1,1,0,1,4,0,6
GCTAAGTAAAGGCGAT-1_V12D07-332_D1,2,1,1,1,0,5
AGTTACCGCACATGGT-1_V12D07-332_D1,4,2,1,0,0,7
GACTGCGGCACGTGTA-1_V12D07-332_D1,2,4,0,0,0,6
TGGTGATCGTATTTGT-1_V12D07-332_D1,0,4,0,0,0,4
TTATCGCCTGCGAAGC-1_V12D07-332_D1,1,4,1,0,0,6
TGGAATTAGACGCTTT-1_V12D07-332_D1,0,4,1,0,0,5
TCGTCACACTGTTAGC-1_V12D07-332_D1,0,1,3,0,0,4
TTATGTTTGCGATAGA-1_V12D07-332_D1,0,4,0,0,0,4
GGTGCTGATCACAAAG-1_V12D07-332_D1,0,2,3,1,0,6
CATAGCCGCCCGGGAT-1_V12D07-332_D1,0,3,0,1,0,4
GGTTAGTTACGGCGCC-1_V12D07-332_D1,0,6,0,0,0,6
ATTCCCACATAAACAA-1_V12D07-332_D1,0,3,0,0,0,3
ATTCAGTAGCAGGGTC-1_V12D07-332_D1,0,6,0,0,0,6
CAGTTCCGCGGGTCGA-1_V12D07-332_D1,0,5,0,1,0,6
AAGAGATGAATCGGTA-1_V12D07-332_D1,0,6,0,1,0,7
CGCAATTCTACAATAA-1_V12D07-332_D1,0,3,0,0,0,3
TAACGCTTTGAGAGCG-1_V12D07-332_D1,0,2,2,0,0,4
AGGCTATGGTTAGCTT-1_V12D07-332_D1,0,7,0,1,0,8
GAGGAATGGAGAGGTT-1_V12D07-332_D1,0,3,2,1,0,6
TCCTCTACGAGATGGC-1_V12D07-332_D1,0,2,0,0,0,2
TTGATTATGCAGATGA-1_V12D07-332_D1,0,5,0,3,0,8
TCAGTACTGACCCGCG-1_V12D07-332_D1,0,4,0,0,0,4
TTATGACAAACTGGAT-1_V12D07-332_D1,0,1,1,0,0,2
GTAAGTAGGGTATACC-1_V12D07-332_D1,0,9,0,0,0,9
CGCAAACACGAGTTAC-1_V12D07-332_D1,0,1,1,0,0,2
TGGCCGTATATTGACC-1_V12D07-332_D1,0,2,0,1,0,3
ACTGTAGCACTTTGGA-1_V12D07-332_D1,0,1,0,0,0,1
GCTCTATGTTACGTGC-1_V12D07-332_D1,0,1,1,0,0,2
TGCGCGATTAACGGAG-1_V12D07-332_D1,0,0,0,4,0,4
GAATCGACATGGTCAC-1_V12D07-332_D1,0,4,1,1,0,6
GACTAAGTAGGCTCAC-1_V12D07-332_D1,0,6,0,1,0,7
ATCTTGACCTGCAACG-1_V12D07-332_D1,0,2,0,2,0,4
ATGCACTACCGCATTG-1_V12D07-332_D1,0,1,0,3,0,4
CAGATACTAACATAGT-1_V12D07-332_D1,0,2,1,3,0,6
GATCGACACTATCTGA-1_V12D07-332_D1,0,6,0,1,0,7
ATAGAGTACTGGGACA-1_V12D07-332_D1,7,1,1,0,0,9
CCTACTGCTTACACTT-1_V12D07-332_D1,0,2,0,1,0,3
CCTGCTATTTGAGAAG-1_V12D07-332_D1,0,5,0,0,0,5
CGCGTTCATGAAATAC-1_V12D07-332_D1,0,0,1,1,0,2
CATTATGCTTGTTGTG-1_V12D07-332_D1,0,2,0,0,0,2
CCAGGGACGTGGCCTC-1_V12D07-332_D1,0,2,1,1,0,4
TATGGATGTGCTACGC-1_V12D07-332_D1,0,4,0,0,0,4
GTACTAAGATTTGGAG-1_V12D07-332_D1,0,1,0,0,2,3
AGACCCGCCCTCCTCG-1_V12D07-332_D1,0,0,0,0,1,1
CGCATTAGCTAATAGG-1_V12D07-332_D1,1,0,1,0,1,3
GCTCTCGGGTACCGAA-1_V12D07-332_D1,0,3,0,1,0,4
CACCGCCAGAAGGTTT-1_V12D07-332_D1,0,0,0,1,0,1
TCCCAAAGACGAAGGA-1_V12D07-332_D1,0,0,0,1,1,2
ATGGATTGACCAAACG-1_V12D07-332_D1,0,1,0,0,0,1
GTCATGGACATGACTA-1_V12D07-332_D1,0,0,0,0,0,0
CTACTGCCACCTGACC-1_V12D07-332_D1,0,1,0,2,0,3
TTATATTTGGCAATCC-1_V12D07-332_D1,0,0,0,1,0,1
AGCACCAGTACTCACG-1_V12D07-332_D1,0,0,0,1,0,1
CATGGTCTAGATACCG-1_V12D07-332_D1,0,1,0,1,0,2
TCTACCGTCCACAAGC-1_V12D07-332_D1,0,0,0,0,0,0
CTAGTTGGGCCCGGTA-1_V12D07-332_D1,0,0,0,1,0,1
TCCCGCGTACTCCTGG-1_V12D07-332_D1,0,0,0,2,0,2
CAGAGCATGAGCTTGC-1_V12D07-332_D1,0,0,0,1,0,1
ACACGGGAACTTAGGG-1_V12D07-332_D1,0,0,0,0,0,0
GGCTCTGCTCCAACGC-1_V12D07-332_D1,1,1,0,3,0,5
AGAACGTGGTACATTC-1_V12D07-332_D1,0,0,0,1,0,1
CAATAAACCTTGGCCC-1_V12D07-332_D1,0,0,0,0,0,0
ACTTCGCCATACGCAC-1_V12D07-332_D1,1,0,0,0,0,1
ATCTGGTTAAGACTGT-1_V12D07-332_D1,0,0,0,1,0,1
TCGTAAGACGACATTG-1_V12D07-332_D1,0,0,0,2,0,2
GTGTACCTTGGCTACG-1_V12D07-332_D1,0,0,0,1,0,1
GCCCGTAATACCTTCT-1_V12D07-332_D1,0,0,0,0,0,0
CGGTCAAGTGGGAACC-1_V12D07-332_D1,0,0,0,1,0,1
TTGTAAGGCCAGTTGG-1_V12D07-332_D1,0,1,0,2,1,4
GGAGCACCAAGAACTA-1_V12D07-332_D1,0,0,0,0,0,0
TAATAGTGACGACCAG-1_V12D07-332_D1,0,0,0,0,1,1
CTAAATCCTATTCCGG-1_V12D07-332_D1,0,1,0,0,0,1
CGAGTTCTGTCCCACC-1_V12D07-332_D1,0,0,0,0,0,0
AGGCAGATGCGTAAAC-1_V12D07-332_D1,0,1,0,1,0,2
AAGGATGAGGGACCTC-1_V12D07-332_D1,0,0,0,0,0,0
AGAGAACCGTCTAGGA-1_V12D07-332_D1,0,0,0,0,1,1
GAGGGCGCAGCTCTGC-1_V12D07-332_D1,0,0,0,0,2,2
AAGATTGGCGGAACGT-1_V12D07-332_D1,0,0,0,0,1,1
CCAGTAGTCTGATCCA-1_V12D07-332_D1,0,0,0,0,0,0
AAGGGACAGATTCTGT-1_V12D07-332_D1,0,3,0,1,0,4
ATAGAGTTATCAACTT-1_V12D07-332_D1,0,0,0,0,0,0
AAATTACCTATCGATG-1_V12D07-332_D1,0,4,0,1,0,5
GATCCTAAATCGGGAC-1_V12D07-332_D1,0,2,0,0,2,4
TTACAGACCTAAATGA-1_V12D07-332_D1,0,2,0,0,1,3
CCTCACCTTAGCATCG-1_V12D07-332_D1,0,0,1,1,0,2
CATGCGACCAGTTTAA-1_V12D07-332_D1,0,0,0,2,0,2
AACATATCAACTGGTG-1_V12D07-332_D1,0,5,0,0,3,8
CTATAAGAGCCAATCG-1_V12D07-332_D1,0,8,1,1,0,10
AATATCGAGGGTTCTC-1_V12D07-332_D1,0,1,0,2,0,3
GTACTCCTGGGTATGC-1_V12D07-332_D1,0,6,0,2,0,8
ATAAGTAGGATTCAGA-1_V12D07-332_D1,0,7,1,3,0,11
AGGTCGCGGAGTTACT-1_V12D07-332_D1,0,7,1,2,0,10
CTAATTCTCAGATATT-1_V12D07-332_D1,0,4,2,3,0,9
GCCAACCATTTCCGGA-1_V12D07-332_D1,0,5,0,3,0,8
TGATCCCAGCATTAGT-1_V12D07-332_D1,0,2,0,1,0,3
CGTTGTAAGATTGATT-1_V12D07-332_D1,0,7,0,2,0,9
GAAACCATGGTGCGCT-1_V12D07-332_D1,0,4,1,2,0,7
AATCTATGCCGGAGCC-1_V12D07-332_D1,0,3,0,0,0,3
GACTCCCAGAATAAGG-1_V12D07-332_D1,0,2,0,3,0,5
TATGATCCGGCACGCC-1_V12D07-332_D1,0,5,0,1,0,6
CCGCTTGCTGACATGG-1_V12D07-332_D1,0,3,0,1,0,4
TGGTTAAGGGCGCTGG-1_V12D07-332_D1,0,2,0,0,0,2
TTGATAGTCAATACAT-1_V12D07-332_D1,0,0,0,0,0,0
GGTTTAATTGAGCAGG-1_V12D07-332_D1,0,4,0,2,0,6
CATTACATAGATTGTG-1_V12D07-332_D1,0,3,0,1,0,4
GGTACACCAGATTTAT-1_V12D07-332_D1,0,0,1,0,0,1
GGCCCGTATACCATGC-1_V12D07-332_D1,0,1,0,1,0,2
ATCTTTCGTATAACCA-1_V12D07-332_D1,0,3,0,1,0,4
GAGATGACAATCCTTA-1_V12D07-332_D1,0,2,0,0,0,2
AAAGCTTGCCTACATA-1_V12D07-332_D1,0,1,0,1,0,2
GAACGATAAGTTAAAG-1_V12D07-332_D1,0,1,1,1,0,3
TAATAGCTAAATGATG-1_V12D07-332_D1,0,1,0,0,0,1
TATGGCTAGGCTAATT-1_V12D07-332_D1,0,2,0,1,0,3
AGGAGAGTCTGGCTAC-1_V12D07-332_D1,0,0,1,1,0,2
TGCTCTGCCGGTTCAC-1_V12D07-332_D1,0,1,0,1,0,2
CCAATAGATTTCATCT-1_V12D07-332_D1,0,1,1,0,0,2
GGGCACGAATTGGCCG-1_V12D07-332_D1,5,0,0,0,0,5
TCGTTGACAGGGTCCC-1_V12D07-332_D1,5,0,0,1,0,6
ATCGTATTCCGAGAAC-1_V12D07-332_D1,6,2,0,0,0,8
GGGAATTCTGTCCAGT-1_V12D07-332_D1,0,1,0,0,0,1
ACGCGTTTCTTAAGAG-1_V12D07-332_D1,1,2,0,0,0,3
AAGTGCAAAGGTAGAC-1_V12D07-332_D1,1,0,0,1,0,2
AGGGTGGATAGTGCAT-1_V12D07-332_D1,1,1,1,1,0,4
TGATAGCGGGATTCTA-1_V12D07-332_D1,2,5,1,1,0,9
GTCAGTTTGGTAGTCG-1_V12D07-332_D1,2,4,2,9,0,17
GCATTCGAAATGAACA-1_V12D07-332_D1,3,5,1,1,0,10
AAAGACTGGGCGCTTT-1_V12D07-332_D1,6,0,0,1,0,7
TAACAATATTTGTTGC-1_V12D07-332_D1,0,2,0,0,0,2
CCAGCTTCCGCCCGCA-1_V12D07-332_D1,0,1,0,0,0,1
TCACATCTTATCTGAT-1_V12D07-332_D1,0,3,0,0,0,3
TATGAAGACAGGTGCG-1_V12D07-332_D1,0,3,0,0,0,3
TACCTGCTGCACTGTG-1_V12D07-332_D1,0,8,0,1,0,9
TAGGTCCAAGTAAGGA-1_V12D07-332_D1,0,3,0,0,0,3
GAAACTCGTGCGATGC-1_V12D07-332_D1,0,3,0,0,0,3
AACAATTACTCTACGC-1_V12D07-332_D1,0,6,0,1,0,7
CCGCACGTGACCTCGG-1_V12D07-332_D1,0,6,1,0,0,7
AACTTGCCCGTATGCA-1_V12D07-332_D1,0,3,3,0,0,6
GGGTATGTATGCACTT-1_V12D07-332_D1,0,4,0,1,0,5
TTCGTACTCCAGAACG-1_V12D07-332_D1,0,4,1,0,0,5
GAATTTCTCGCTGCAG-1_V12D07-332_D1,0,7,1,1,0,9
AACAGGATGGGCCGCG-1_V12D07-332_D1,0,0,0,1,0,1
GACGTGTAGGGATTAT-1_V12D07-332_D1,0,5,1,1,0,7
TAGGTGAGCCCTACTC-1_V12D07-332_D1,0,3,0,1,0,4
CTAATTCGCACGCGCT-1_V12D07-332_D1,0,1,0,0,0,1
GAAGCTTGCTGACCGC-1_V12D07-332_D1,0,4,3,0,0,7
GGTTAGGCTTGGAGAA-1_V12D07-332_D1,0,4,1,1,0,6
ACAAGGACAAGAGGTT-1_V12D07-332_D1,0,2,0,0,0,2
AGGCCACCCGTTATGA-1_V12D07-332_D1,0,0,1,1,0,2
GTGGGCTTAGACACAC-1_V12D07-332_D1,0,2,1,1,0,4
CGTGTCCCATTCGCGA-1_V12D07-332_D1,0,3,0,2,0,5
TGGAGTGATGCGATGA-1_V12D07-332_D1,0,2,0,1,0,3
AACAACTGGTAGTTGC-1_V12D07-332_D1,0,2,0,4,0,6
CCTGGCTAGACCCGCC-1_V12D07-332_D1,0,2,0,0,0,2
CGCAATTAGGGTAATA-1_V12D07-332_D1,0,6,1,1,0,8
TCGAAATTTAGGACCA-1_V12D07-332_D1,0,4,0,1,0,5
AGACTAGCCTTCCAGA-1_V12D07-332_D1,0,2,0,5,0,7
TTGATCTAACTTTGTC-1_V12D07-332_D1,0,6,0,0,0,6
AAGGAGCGGTTGGTGC-1_V12D07-332_D1,0,0,1,0,0,1
ACTTGGGACCCGGTGG-1_V12D07-332_D1,0,1,0,3,0,4
TGATCTCCGGCGCCAG-1_V12D07-332_D1,0,4,0,1,0,5
CAGTTCAAATTGACAC-1_V12D07-332_D1,0,1,0,2,0,3
GTCCGGCTGAATTGCG-1_V12D07-332_D1,1,3,0,0,0,4
CTGGAAATGGATGCTT-1_V12D07-332_D1,0,0,0,0,0,0
TGATCGGTTTGACCCT-1_V12D07-332_D1,1,0,0,1,1,3
TAGAGTCTAAGCGAAC-1_V12D07-332_D1,0,1,0,0,1,2
GAGACTGATGGGTAGA-1_V12D07-332_D1,0,2,0,2,0,4
TAGCTAAGTCCGGGAG-1_V12D07-332_D1,0,1,0,2,0,3
GGGCGATATGTGTGAA-1_V12D07-332_D1,2,1,5,0,0,8
CTCGAGGTCGAACAGT-1_V12D07-332_D1,0,0,0,0,0,0
GATCCCTTTATACTGC-1_V12D07-332_D1,0,0,0,0,0,0
GTCATGCACCTCCGTT-1_V12D07-332_D1,0,0,0,0,0,0
ACTTTCCTATAGCTTC-1_V12D07-332_D1,0,0,0,3,0,3
TCGCTCGATATATTCC-1_V12D07-332_D1,0,0,0,0,0,0
ATAGGTTGGGCAGATG-1_V12D07-332_D1,0,0,0,1,0,1
CAATTAAGGGTGATGA-1_V12D07-332_D1,1,0,0,0,0,1
ACCGACTGAGTCCCAC-1_V12D07-332_D1,1,0,0,2,0,3
CCTGTCACCCGGGCTC-1_V12D07-332_D1,0,0,0,0,0,0
GATCGGTGGCCATAAC-1_V12D07-332_D1,0,0,0,0,0,0
CCTATGGGTTACCGTC-1_V12D07-332_D1,0,0,0,0,0,0
TTGGGACACTGCCCGC-1_V12D07-332_D1,0,0,0,0,0,0
CGAGGCTAAATATGGC-1_V12D07-332_D1,0,0,0,0,0,0
TCAGGGTGTAACGTAA-1_V12D07-332_D1,0,1,0,0,0,1
CGAGAGATGTGAACCT-1_V12D07-332_D1,0,1,0,1,0,2
TCGCTGGGCGGATTGT-1_V12D07-332_D1,0,1,0,2,0,3
AGATCTCAGGTGTGAT-1_V12D07-332_D1,0,0,0,0,0,0
TGGCCAAACTGAAGTA-1_V12D07-332_D1,0,1,0,4,0,5
GCTTCCGTCCCTAGAC-1_V12D07-332_D1,0,0,0,1,0,1
CAGCAGCCCGTTCCTT-1_V12D07-332_D1,0,0,0,1,0,1
TGTATAACAGATCCTG-1_V12D07-332_D1,0,0,0,0,0,0
CGCGGGAATTAGGCAG-1_V12D07-332_D1,0,0,0,0,0,0
TGCATGTGGTAATCTA-1_V12D07-332_D1,0,1,0,1,0,2
ACAATTTGAGCAGTGG-1_V12D07-332_D1,0,0,0,0,0,0
GAGCTAAGGGCATATC-1_V12D07-332_D1,0,1,0,0,1,2
CCAGATAGTTGAGTGA-1_V12D07-332_D1,0,0,0,0,0,0
CCACAATGTACGTCTT-1_V12D07-332_D1,0,0,0,0,0,0
CAATGGATCTCTACCA-1_V12D07-332_D1,0,1,0,0,0,1
TGTGGCAAAGCGTATG-1_V12D07-332_D1,0,0,0,2,1,3
TAAAGCGTTAGGAGAA-1_V12D07-332_D1,0,3,0,1,0,4
TCCGTTTAGCCTTGAA-1_V12D07-332_D1,0,1,0,0,0,1
CAGCTCGACAAGTTAA-1_V12D07-332_D1,1,2,0,0,0,3
GCCTATAGTGTCAGGG-1_V12D07-332_D1,0,1,0,1,2,4
ATAGACAACGGGACCT-1_V12D07-332_D1,0,2,0,1,4,7
CTACTATCTTTCAGAG-1_V12D07-332_D1,0,0,0,2,0,2
GCGCTGCTTTGCATTT-1_V12D07-332_D1,0,1,0,0,1,2
GCGCATCCAGTCAGCA-1_V12D07-332_D1,0,5,0,0,0,5
GACTCGCGGGAATGAC-1_V12D07-332_D1,0,5,0,0,0,5
CTGGTAACGAGCTCTT-1_V12D07-332_D1,0,4,0,0,0,4
TCCGGCCTAGCGTACA-1_V12D07-332_D1,0,4,0,2,1,7
TCTAGGTGGCGACGCT-1_V12D07-332_D1,1,5,2,4,0,12
ACGCTAGTGATACACT-1_V12D07-332_D1,0,5,0,2,0,7
ATCTGCACCTCTGCGA-1_V12D07-332_D1,1,5,0,1,0,7
CCTCACCTGAGGGAGC-1_V12D07-332_D1,0,4,2,5,1,12
AGTGAGCCTCGCCGCC-1_V12D07-332_D1,0,0,0,2,0,2
ACGAGTACGGATGCCC-1_V12D07-332_D1,0,4,0,3,0,7
GGTACCATTAAGACGG-1_V12D07-332_D1,0,0,0,4,0,4
TTCTGCTAGACTCCAA-1_V12D07-332_D1,0,1,0,5,0,6
TAACTATTACGCCAAA-1_V12D07-332_D1,0,2,1,5,0,8
GCATTCAAGGCAACGC-1_V12D07-332_D1,0,7,0,3,0,10
AGTACATCATTTATCA-1_V12D07-332_D1,0,5,0,2,0,7
GTCGTGTCTGGTCATC-1_V12D07-332_D1,0,8,0,2,0,10
AGTCTAAAGTATACTC-1_V12D07-332_D1,0,3,1,3,0,7
CGGCCCAACCTGTAGT-1_V12D07-332_D1,0,2,0,1,0,3
AGGGAGACATACTTCG-1_V12D07-332_D1,0,3,0,1,0,4
TCCCTAGATCAATAGG-1_V12D07-332_D1,0,3,0,1,0,4
TCCCGTCGCGTCATAG-1_V12D07-332_D1,0,3,0,0,0,3
CGCATCCATCAGCCAG-1_V12D07-332_D1,0,2,0,1,0,3
CTGCACCTAGTCCACA-1_V12D07-332_D1,0,0,0,0,0,0
CGAGGATCGGGAACGA-1_V12D07-332_D1,0,5,0,1,0,6
CAATGAGGTTCGACTA-1_V12D07-332_D1,0,2,0,2,1,5
TCTGACGGGCTAACCC-1_V12D07-332_D1,0,8,0,2,0,10
TTCTATGCCTTTCGCA-1_V12D07-332_D1,0,3,0,0,0,3
AGAGTATAGTGTTACG-1_V12D07-332_D1,0,2,0,3,0,5
CCATTGTTTCCTCCAT-1_V12D07-332_D1,0,0,0,1,0,1
CTCATCACTTAGTGAT-1_V12D07-332_D1,0,5,0,1,0,6
CCGAAGGGCGTACCGC-1_V12D07-332_D1,0,2,2,0,1,5
TCAAGCTGCCTTGAAA-1_V12D07-332_D1,0,3,0,0,0,3
CTCATTAACGTTGCCC-1_V12D07-332_D1,0,3,0,0,0,3
GTCTTCCTCACCTAAG-1_V12D07-332_D1,0,0,0,0,0,0
GGTGATGAAGGAAGTG-1_V12D07-332_D1,6,2,0,0,0,8
TCAATACAATTGCTGC-1_V12D07-332_D1,5,1,0,0,0,6
GCAACCCAAGTTGTTT-1_V12D07-332_D1,6,0,0,0,0,6
ATGAAGTGGACCCAGC-1_V12D07-332_D1,3,2,0,1,0,6
GAGAATCTCACGATCA-1_V12D07-332_D1,1,0,0,2,0,3
TATATCATTGATCAGT-1_V12D07-332_D1,0,2,1,2,0,5
AACTTTACGGGAGCTT-1_V12D07-332_D1,1,0,0,2,0,3
ACAATTTAGGAGGCTC-1_V12D07-332_D1,0,2,0,0,0,2
ATACTTGTTCTCGAGC-1_V12D07-332_D1,5,4,0,2,0,11
CACGGGATTGAGGGTT-1_V12D07-332_D1,3,11,1,0,0,15
GTTAATGTCTATCTTA-1_V12D07-332_D1,0,4,0,0,0,4
GCGTTATATTTGGAAC-1_V12D07-332_D1,1,3,2,2,0,8
CGTCAAGGCTATAAAT-1_V12D07-332_D1,4,0,2,3,0,9
TTAGCTCTGTAATCCG-1_V12D07-332_D1,1,5,1,1,0,8
AATGGTCCACCGTTCA-1_V12D07-332_D1,2,2,0,0,0,4
GTCATTGCATTGACCC-1_V12D07-332_D1,0,4,0,0,0,4
TGTCCGTGGCGCCTTT-1_V12D07-332_D1,0,7,0,1,0,8
TCAACTAACGTATAAC-1_V12D07-332_D1,0,3,1,0,0,4
TCCTCTCCAGTTGTCC-1_V12D07-332_D1,0,2,1,2,0,5
TGTGTTCGTATCCAAG-1_V12D07-332_D1,0,7,1,0,0,8
CCGCGTAGGTAAGGGC-1_V12D07-332_D1,0,3,0,0,0,3
CTGCGGGTGAAATGTT-1_V12D07-332_D1,0,2,0,0,0,2
TATCTACAGAGGTAAT-1_V12D07-332_D1,0,5,1,0,0,6
CTACTCTAGGCCCGGC-1_V12D07-332_D1,0,1,0,0,0,1
ACAAGCAGTGCCTAGC-1_V12D07-332_D1,0,1,1,1,0,3
TACAAGTCTCGTGCAT-1_V12D07-332_D1,0,4,0,1,0,5
TCGGAATGCGCTCTGA-1_V12D07-332_D1,0,5,0,0,0,5
TCGCGTCCAGAAGGTC-1_V12D07-332_D1,0,2,0,1,0,3
TATGGCCCGGCCTCGC-1_V12D07-332_D1,0,2,1,0,0,3
GCTGGCATATTCACCT-1_V12D07-332_D1,0,3,0,0,0,3
GTCAGAATAGTCTATG-1_V12D07-332_D1,0,2,0,2,0,4
GGCGTCCTATCCGCTG-1_V12D07-332_D1,0,2,0,0,0,2
CGGAGTTTGAGAGACA-1_V12D07-332_D1,0,1,0,1,0,2
AGCACTTAAGGACGCC-1_V12D07-332_D1,0,1,1,2,0,4
TCCACAATGGTTTACG-1_V12D07-332_D1,0,1,1,2,0,4
CCAACGATGCACTGAT-1_V12D07-332_D1,0,1,1,0,0,2
ATTTACAGTTTACTGG-1_V12D07-332_D1,0,3,0,0,0,3
CCCTGAAATGAGTTGA-1_V12D07-332_D1,0,4,4,2,0,10
CAAACGGTCGCACTTT-1_V12D07-332_D1,0,1,1,0,0,2
TGATTCGTCTATCACT-1_V12D07-332_D1,0,5,0,3,0,8
TCAGGTTCTTTGAGAA-1_V12D07-332_D1,0,2,0,0,0,2
CACGCAGCGAGGCTTT-1_V12D07-332_D1,0,1,0,2,0,3
TTAAGCGCCTGACCCA-1_V12D07-332_D1,0,2,2,1,0,5
CTTACACGGTATTCCA-1_V12D07-332_D1,0,4,1,0,0,5
AAGGCTGTGCTCATCG-1_V12D07-332_D1,0,1,0,1,0,2
GACCAGAGCCCTGTAG-1_V12D07-332_D1,0,1,1,2,0,4
TCCCAGGCTTAGCTAA-1_V12D07-332_D1,0,3,0,1,0,4
ATTGAAGATCTTAGTG-1_V12D07-332_D1,0,5,0,0,0,5
AGTTCCTACAGAATTA-1_V12D07-332_D1,0,2,0,0,0,2
GGGCTGGTTAGTCGCG-1_V12D07-332_D1,0,3,0,1,0,4
GAAATGGCGGTGTTAG-1_V12D07-332_D1,0,5,0,0,0,5
TACGAACACGACTTCA-1_V12D07-332_D1,0,0,0,0,1,1
ACCACAAGTTTCTATC-1_V12D07-332_D1,0,2,0,0,0,2
ATATTTAACCCTCAAG-1_V12D07-332_D1,0,0,0,0,0,0
GATCATTCCAAACATT-1_V12D07-332_D1,0,3,1,2,0,6
TCCAGGCGAGTACGGT-1_V12D07-332_D1,0,0,0,0,0,0
GTTTGACCAAATCCTA-1_V12D07-332_D1,0,0,0,1,0,1
CACAGCACCCACGGCA-1_V12D07-332_D1,0,0,0,1,0,1
TGCAAGAATGACGTAA-1_V12D07-332_D1,0,0,0,0,0,0
GCGAAGCCATACCCGT-1_V12D07-332_D1,0,0,0,2,0,2
TCCTTTCTTACGCTTA-1_V12D07-332_D1,0,0,0,0,0,0
GCTGCTCTCCGGACAC-1_V12D07-332_D1,0,0,0,0,0,0
ACTGTCTTCTTTAGAA-1_V12D07-332_D1,0,0,0,3,0,3
TCAAACTTAGATTGTT-1_V12D07-332_D1,0,1,0,2,0,3
CTATGTCACTAGCCCA-1_V12D07-332_D1,0,0,0,1,0,1
TGCGCAAAGCATTTGG-1_V12D07-332_D1,0,0,0,1,0,1
TTAATGTAGACCAGGT-1_V12D07-332_D1,0,0,0,1,0,1
GGCGGTAGGATCATTG-1_V12D07-332_D1,1,1,0,0,0,2
GGCAATAGTCAATGAG-1_V12D07-332_D1,0,0,0,0,0,0
ACACGAGACTCCTTCT-1_V12D07-332_D1,1,1,0,2,0,4
GACACAAGGGAAGAAA-1_V12D07-332_D1,0,0,0,0,0,0
TCAGCAAATGCATCTC-1_V12D07-332_D1,0,0,0,1,0,1
GAGATCTGTCACTCCG-1_V12D07-332_D1,0,0,0,0,0,0
ATGCCGGTCTTGCATA-1_V12D07-332_D1,0,0,0,0,0,0
TTGGGCGGCGGTTGCC-1_V12D07-332_D1,0,0,0,0,0,0
TTGTTGTGTGTCAAGA-1_V12D07-332_D1,0,0,0,0,0,0
ACTGTACGATACACAT-1_V12D07-332_D1,0,0,0,0,0,0
TCCACTTTATCTAGGT-1_V12D07-332_D1,0,0,0,1,0,1
GGTCTGAGAATCTGGA-1_V12D07-332_D1,0,0,0,0,1,1
TAGAAAGGTGGCGCTA-1_V12D07-332_D1,0,0,0,0,0,0
TATGTCTCATTGTGCC-1_V12D07-332_D1,0,1,0,1,0,2
GGATTTCACTTCTATA-1_V12D07-332_D1,0,0,1,0,1,2
TGAGTGGTCCGTGACG-1_V12D07-332_D1,0,2,0,0,0,2
CGCTTTCTTGCATTCG-1_V12D07-332_D1,0,0,0,0,0,0
ACCCAACGCCCGTGGC-1_V12D07-332_D1,0,0,0,0,0,0
GAACGTCTCATGGTCG-1_V12D07-332_D1,1,0,0,0,0,1
AGGGTTCCCTTTGGTT-1_V12D07-332_D1,0,1,0,0,1,2
GTAGCTTCCTCTTGTT-1_V12D07-332_D1,1,3,0,0,3,7
GCATGAGGGACGCGGC-1_V12D07-332_D1,0,1,1,0,3,5
CTACCCTAAGGTCATA-1_V12D07-332_D1,0,0,0,0,2,2
TCACCGCTCGGCACTC-1_V12D07-332_D1,1,3,0,1,2,7
GGCTCGCGTTGAGGTA-1_V12D07-332_D1,0,0,0,1,0,1
CTAACGAAACTTGCTG-1_V12D07-332_D1,0,2,0,1,1,4
TTAAACTCGAATTCAT-1_V12D07-332_D1,0,2,0,0,4,6
TACTTTACTGAGCCGG-1_V12D07-332_D1,0,5,1,0,1,7
GCTTGGATCGATTAGG-1_V12D07-332_D1,0,3,0,0,2,5
CGGTTATCCAACAGTG-1_V12D07-332_D1,0,0,0,1,1,2
CAGACCTGTAAGTGTT-1_V12D07-332_D1,0,2,1,1,1,5
GACGGTCAATAGAAGC-1_V12D07-332_D1,0,2,0,7,0,9
CTGACTGCGCAGCTCG-1_V12D07-332_D1,0,2,0,3,0,5
CCATACCTTTACTTGT-1_V12D07-332_D1,0,12,1,2,0,15
GTAATAAAGGGCTCCC-1_V12D07-332_D1,1,4,0,2,0,7
GTGAACTCCCATTCGA-1_V12D07-332_D1,0,0,1,2,1,4
GTGGTTACTTCTTTCG-1_V12D07-332_D1,0,1,0,0,0,1
TCAGAACCTCCACAGG-1_V12D07-332_D1,0,5,2,3,0,10
TCCCACTCTCTTCCGG-1_V12D07-332_D1,0,7,0,1,0,8
ATCTTGACTTGTCCAA-1_V12D07-332_D1,1,11,1,0,0,13
TCGGGAACGTGCCTAG-1_V12D07-332_D1,0,4,0,0,1,5
GTTAGCCGTAAATCAA-1_V12D07-332_D1,0,2,0,2,0,4
ATTTACTAAGTCCATT-1_V12D07-332_D1,0,1,2,0,1,4
GGGTGCATATGAAAGC-1_V12D07-332_D1,0,2,0,1,0,3
TCCGAATGGTCCTGAG-1_V12D07-332_D1,0,2,0,0,1,3
TGATGGCTGTTTCTGA-1_V12D07-332_D1,0,3,0,1,0,4
AAATAAGGTAGTGCCC-1_V12D07-332_D1,0,1,0,0,0,1
CCACTATCCGGGTCAC-1_V12D07-332_D1,0,1,0,4,0,5
ACACCACATAATTAGC-1_V12D07-332_D1,0,2,1,1,0,4
CGCGGTAAGTCTAGCT-1_V12D07-332_D1,0,3,0,3,0,6
GCGGGCATTACGATGC-1_V12D07-332_D1,0,0,0,1,0,1
AGGATTGCTTACGACA-1_V12D07-332_D1,0,2,0,1,1,4
CTCGGGATAACACCTA-1_V12D07-332_D1,0,1,0,0,0,1
GTCGTCTGGTTGGCTA-1_V12D07-332_D1,0,1,1,0,1,3
GCAATTAGTCGCACCG-1_V12D07-332_D1,0,0,0,2,1,3
GTGACCTAAAGAATAA-1_V12D07-332_D1,0,3,0,1,0,4
CTGAGCGAGACTTATT-1_V12D07-332_D1,0,1,0,2,0,3
CAAGACTCAGAAGCGC-1_V12D07-332_D1,0,4,0,1,0,5
ACTTCGCTAGCGAGTG-1_V12D07-332_D1,0,2,0,0,0,2
CCATACTCGCCTCTCC-1_V12D07-332_D1,1,1,0,0,0,2
ACGATACCTATCCTGA-1_V12D07-332_D1,3,2,0,0,0,5
CTCACCAGTACAAGTG-1_V12D07-332_D1,3,0,0,0,0,3
CGAAGACGGTGAGTGC-1_V12D07-332_D1,4,1,0,0,0,5
AAATTAATAAGCGCGA-1_V12D07-332_D1,3,0,0,1,0,4
GGGCCCTTATCTATAC-1_V12D07-332_D1,0,2,0,0,0,2
CTGCCCACGAAGCGTT-1_V12D07-332_D1,1,0,0,0,0,1
GGACAAGTTGCAGTGA-1_V12D07-332_D1,2,0,0,0,0,2
GTCCGAGAGCAATCAT-1_V12D07-332_D1,1,1,0,0,0,2
ATGGCAGCCGAGAAAC-1_V12D07-332_D1,0,1,0,0,0,1
CCTCGGATGCTACCTG-1_V12D07-332_D1,1,2,1,2,0,6
ATACGGTGAAGATGCA-1_V12D07-332_D1,1,0,1,0,0,2
ACATCAGCTGGGACGC-1_V12D07-332_D1,0,3,1,0,0,4
GGTTGTGTAGCCTGGC-1_V12D07-332_D1,0,4,2,0,0,6
CCTGCGTTCTACGCTT-1_V12D07-332_D1,0,9,1,0,0,10
GAACGTTAGGAAGACG-1_V12D07-332_D1,4,4,2,0,0,10
CTGATAGTGTATCTCA-1_V12D07-332_D1,1,4,0,0,0,5
TTCTGCGAGCGCCCTT-1_V12D07-332_D1,0,1,1,1,0,3
CTTTGGCGCTTTATAC-1_V12D07-332_D1,0,3,0,1,0,4
TCCGAACTTGGCTTAC-1_V12D07-332_D1,0,4,1,1,0,6
TAGATTCCTGGTTATT-1_V12D07-332_D1,0,4,2,0,0,6
CCGACAAAGGGAGTGC-1_V12D07-332_D1,0,3,1,0,0,4
CCATGGCCCTTGTACC-1_V12D07-332_D1,0,2,0,1,0,3
GAAATATCACCATCAG-1_V12D07-332_D1,0,3,0,0,0,3
ACGAAATGGGCGGCAC-1_V12D07-332_D1,0,4,2,0,0,6
GTGAGCGTGCTGCACT-1_V12D07-332_D1,0,2,0,0,0,2
CCGCGGGTACGAAGAA-1_V12D07-332_D1,0,3,0,1,0,4
TCCCTGGCTCGCTGGA-1_V12D07-332_D1,0,1,0,0,0,1
CAGCTTAGTAGGTAGC-1_V12D07-332_D1,0,1,0,1,0,2
CACGAAAGTTAGTCCC-1_V12D07-332_D1,0,4,1,0,0,5
ACCTAATCGACTTCCT-1_V12D07-332_D1,0,2,0,1,0,3
AAGTAGTGACGCGAGG-1_V12D07-332_D1,0,3,0,0,0,3
TCCGATTACATTGCCG-1_V12D07-332_D1,0,7,0,0,0,7
CCTCCGACAATTCAAG-1_V12D07-332_D1,1,3,0,0,0,4
GTTCACAGGAGTCTAG-1_V12D07-332_D1,0,2,1,0,0,3
CGAAGTTGCTCTGTGT-1_V12D07-332_D1,0,0,0,1,0,1
GTCGGATATCTCAGAC-1_V12D07-332_D1,0,2,1,0,0,3
CGCTCTCCGTAGATTA-1_V12D07-332_D1,0,4,0,0,0,4
CAAGCAACGTCGGAGT-1_V12D07-332_D1,0,4,0,0,0,4
CCATTCCCTGCCCACA-1_V12D07-332_D1,0,6,0,0,0,6
CTTTGGCTTTAGTAAA-1_V12D07-332_D1,0,2,0,0,0,2
GGCTATTAAGTTGTAT-1_V12D07-332_D1,0,4,0,0,0,4
CCATTAGCGATAATCC-1_V12D07-332_D1,0,3,0,0,0,3
TGTTCTTCCATTGACT-1_V12D07-332_D1,0,6,0,0,0,6
AGATAACTTCAGGGCC-1_V12D07-332_D1,0,2,1,3,0,6
ATAGACGAAGAGAAAG-1_V12D07-332_D1,0,3,1,2,0,6
GGCGGAGTAATATTAG-1_V12D07-332_D1,0,3,1,2,0,6
TGACCCACGTTAGACA-1_V12D07-332_D1,0,1,0,2,0,3
TCACAGGTTATTGGGC-1_V12D07-332_D1,0,1,0,2,0,3
TCACGCATTGTAGATC-1_V12D07-332_D1,0,1,0,0,0,1
TTGAAGAATTCCCAGG-1_V12D07-332_D1,0,2,0,0,0,2
AAATGGTCAATGTGCC-1_V12D07-332_D1,1,0,0,1,0,2
TAGTGCCCTCCAGAGT-1_V12D07-332_D1,0,1,0,2,0,3
GGTATTGCCGAGTTTA-1_V12D07-332_D1,0,0,0,2,0,2
CGTATTAAGAGATCTA-1_V12D07-332_D1,0,0,0,2,0,2
ACTGTCCAGGATTATA-1_V12D07-332_D1,0,0,0,1,0,1
CGGGCAGCTAAACCGC-1_V12D07-332_D1,0,0,0,2,1,3
TTGCTGATCATGTTCG-1_V12D07-332_D1,0,2,0,0,0,2
TATGGGTACGTATCGT-1_V12D07-332_D1,0,1,0,1,0,2
CAGCTCACTGAGACAT-1_V12D07-332_D1,0,0,0,2,0,2
GGGACTGCATAGATAG-1_V12D07-332_D1,0,0,0,2,0,2
ACGCATTCGTGAGTAC-1_V12D07-332_D1,0,0,0,4,0,4
CTCTGGACGCCTGGTG-1_V12D07-332_D1,1,0,0,0,0,1
AGGGTTTAGTTCGGGA-1_V12D07-332_D1,0,0,1,2,0,3
GGGAGAACTCACAGTA-1_V12D07-332_D1,0,1,0,3,0,4
ATCAATCTGGGCTGCA-1_V12D07-332_D1,0,0,0,0,0,0
TCTTCGATACCAATAA-1_V12D07-332_D1,0,1,0,1,0,2
ACGTAGATTGCTGATG-1_V12D07-332_D1,0,0,1,0,0,1
TCTTGATGCGTAGCGA-1_V12D07-332_D1,1,1,0,0,0,2
GGGCTGCCTAGGGCGA-1_V12D07-332_D1,0,0,0,0,0,0
CTCTCACAATCGATGA-1_V12D07-332_D1,0,0,0,1,0,1
CCAAGCGTAACTCGTA-1_V12D07-332_D1,0,0,0,3,0,3
ACAACAGCATGAGCTA-1_V12D07-332_D1,1,0,0,0,0,1
GTCCCAACGTAAAGTA-1_V12D07-332_D1,0,0,0,1,0,1
TCGGAGTACATGAGTA-1_V12D07-332_D1,0,0,0,1,0,1
GGGAGTTAATGAGGCG-1_V12D07-332_D1,1,1,0,0,0,2
CCGGGCGGTCTCGTCA-1_V12D07-332_D1,0,0,0,2,0,2
CCGTAAGTTGGTCCCA-1_V12D07-332_D1,0,0,0,0,0,0
GGAGGGCTTGGTTGGC-1_V12D07-332_D1,0,0,0,0,0,0
TCGGACGCCCAGCCCA-1_V12D07-332_D1,1,0,0,1,0,2
TCTGTGCCATCATAGT-1_V12D07-332_D1,0,1,0,1,0,2
GTACTGGAGTTAGACC-1_V12D07-332_D1,0,0,0,0,0,0
GGAATGCGCTAGCGTG-1_V12D07-332_D1,0,1,0,2,1,4
GTGTGAATAACTTAGG-1_V12D07-332_D1,0,0,0,0,0,0
GGTCGGCCAGGAGCTT-1_V12D07-332_D1,0,1,0,0,0,1
TAGCCGGCGGTCAGCG-1_V12D07-332_D1,0,0,0,0,0,0
CGGGTGTACCCATTTA-1_V12D07-332_D1,0,0,0,0,0,0
AGTGATTCAAGCAGGA-1_V12D07-332_D1,0,1,0,0,1,2
GTTGGATTGAGAACAC-1_V12D07-332_D1,0,0,0,0,1,1
CACACGCGCTGTCTTA-1_V12D07-332_D1,0,1,0,0,1,2
TAGACGCCCGTACCGG-1_V12D07-332_D1,0,1,0,0,1,2
GGTTTCAATCGGTCAG-1_V12D07-332_D1,0,0,0,0,0,0
AATCTGCGTTGGGACG-1_V12D07-332_D1,0,2,0,1,2,5
TTACGGATGGTTCGAG-1_V12D07-332_D1,1,2,0,0,3,6
CGGCAGGGTCGGGTTG-1_V12D07-332_D1,1,5,0,0,1,7
GCTTTCAGAGGAGGTG-1_V12D07-332_D1,0,2,0,1,2,5
TCTTCCCATGGGCACA-1_V12D07-332_D1,0,4,0,1,1,6
TACCGCGGACTTGCAG-1_V12D07-332_D1,0,4,0,0,0,4
AGAATTATGGATTCGA-1_V12D07-332_D1,0,3,1,2,0,6
ATTGATGAGTCCTAAC-1_V12D07-332_D1,0,4,1,2,1,8
TAGGTCGCCGGAACTG-1_V12D07-332_D1,0,2,0,1,0,3
TAACCTACCGTCCGAG-1_V12D07-332_D1,0,0,0,1,0,1
CTTAGTAGGCCTACAG-1_V12D07-332_D1,0,2,0,2,0,4
CTAGATGTGAGTGTAA-1_V12D07-332_D1,0,3,0,0,0,3
ACTCCCGAATTCGTTT-1_V12D07-332_D1,0,2,0,1,0,3
GTTCATCGTTTGGCTG-1_V12D07-332_D1,1,1,1,0,0,3
ACTTTACCCTCATGAA-1_V12D07-332_D1,0,2,0,0,1,3
GCGAGAGTTGCGTCCA-1_V12D07-332_D1,0,1,0,0,1,2
GTTCGGGCGTACCATT-1_V12D07-332_D1,0,1,0,3,2,6
CGACTTTGTATAGCCT-1_V12D07-332_D1,0,0,0,0,2,2
GCCATCGATGCTGCAT-1_V12D07-332_D1,0,1,0,0,0,1
GCATTTCCAAGGCTCC-1_V12D07-332_D1,0,2,0,0,0,2
ATGTAAGGCTGCTCTT-1_V12D07-332_D1,0,0,0,1,0,1
ACGTTCGCAATCAATT-1_V12D07-332_D1,0,0,0,2,0,2
GTGACGAGGGTGACCC-1_V12D07-332_D1,0,4,2,1,0,7
ATTATAGCTACTTTAC-1_V12D07-332_D1,0,2,0,2,0,4
CGTGTGTTAAACCCTG-1_V12D07-332_D1,0,2,0,2,0,4
TTGGTATGGCTTGTGT-1_V12D07-332_D1,0,0,0,0,1,1
CATTCCCATTCCGTCG-1_V12D07-332_D1,0,1,0,1,0,2
TGCCGAAAGCGTATTC-1_V12D07-332_D1,0,0,0,0,0,0
CAACACATCTCCTGCC-1_V12D07-332_D1,0,0,0,0,1,1
CTGCCTCATATGCAAC-1_V12D07-332_D1,0,0,0,0,0,0
TCCCGCCTATGTGCGT-1_V12D07-332_D1,0,0,0,0,0,0
GGTTACCCGACACTTT-1_V12D07-332_D1,0,2,0,0,0,2
CCAGCGGGATCACCAG-1_V12D07-332_D1,0,0,0,0,0,0
ATGTTTCGGCCCGGAG-1_V12D07-332_D1,0,0,0,1,1,2
GCGTCTAACCTCCTAA-1_V12D07-332_D1,1,4,0,0,1,6
ATCAGGTAGCTGACAG-1_V12D07-332_D1,0,3,0,0,0,3
GGTATGAAAGAACTGA-1_V12D07-332_D1,0,0,0,0,0,0
GTGGCCTAATATCATT-1_V12D07-332_D1,4,3,0,0,0,7
CCTGTGAAACCGTAAC-1_V12D07-332_D1,4,4,0,0,0,8
GGCAGAGAGATCGGGA-1_V12D07-332_D1,3,0,0,0,0,3
TAGCGTCGAATATTGA-1_V12D07-332_D1,4,0,1,0,0,5
CGCCGACTATTCGCTA-1_V12D07-332_D1,2,1,0,0,0,3
TCTGGCGCAAGCCGGG-1_V12D07-332_D1,1,0,0,0,0,1
AGTGGTTGCGTATAGG-1_V12D07-332_D1,2,1,0,0,0,3
ATCGGTTACCTAGTAA-1_V12D07-332_D1,3,3,0,0,0,6
CCTGCCCGTTGTCTAG-1_V12D07-332_D1,1,0,0,1,0,2
GCACACGCCCATGGTC-1_V12D07-332_D1,3,6,1,0,0,10
AGTACGGCCCGTATCG-1_V12D07-332_D1,1,5,2,0,0,8
TATCTAGCCTAAAGGA-1_V12D07-332_D1,2,7,0,2,0,11
CACTCGGTTAGGAGGA-1_V12D07-332_D1,1,4,2,0,0,7
ATGTTCGTCGACCCAC-1_V12D07-332_D1,2,6,3,0,0,11
TTCCTCTGCCCGAATA-1_V12D07-332_D1,1,5,3,0,0,9
TTACTATCGGCTTCTC-1_V12D07-332_D1,0,4,0,1,0,5
GCCGCATTAGTCCGGC-1_V12D07-332_D1,0,5,0,0,0,5
TAAGGGCTGGGAGAGG-1_V12D07-332_D1,0,5,0,0,0,5
TAAGCAGGCGACACGC-1_V12D07-332_D1,0,5,2,0,0,7
AGCACTACCGGCCTGT-1_V12D07-332_D1,0,4,0,0,0,4
GAAAGCCCTTTGGACC-1_V12D07-332_D1,0,5,1,1,0,7
GACCGACTGAAGCGTC-1_V12D07-332_D1,0,4,0,1,0,5
CGGTGAAGACTAAAGT-1_V12D07-332_D1,0,7,0,2,0,9
CCCTGCGCTACGCATA-1_V12D07-332_D1,0,7,0,2,0,9
TACTGGACAGCTCGGC-1_V12D07-332_D1,0,6,1,0,0,7
TTAGTAGGGCGGCGGG-1_V12D07-332_D1,0,6,0,0,0,6
GAGGCTATCAAAGTCG-1_V12D07-332_D1,0,7,1,1,0,9
TTACCATTGATTACCC-1_V12D07-332_D1,0,4,0,0,0,4
ATACCACGGGCAACTT-1_V12D07-332_D1,0,4,0,1,0,5
TGTCCTAAGTCACCGC-1_V12D07-332_D1,0,1,0,0,0,1
AGGTAGGTACAAAGCT-1_V12D07-332_D1,0,2,0,0,0,2
GGCATACAGGTAGCGG-1_V12D07-332_D1,0,4,1,0,0,5
TGTAGTGATCTATAAT-1_V12D07-332_D1,0,5,3,2,0,10
TCCCGGGTGTGCTGCT-1_V12D07-332_D1,0,5,0,0,0,5
TACGATGTTGATCATC-1_V12D07-332_D1,0,2,0,0,0,2
CCTCTCTCCCATCTAG-1_V12D07-332_D1,0,3,0,2,0,5
GCAGGACTATAGAATA-1_V12D07-332_D1,0,7,0,1,0,8
CTAGTGAAGGACAGGA-1_V12D07-332_D1,0,3,0,0,0,3
TACGAGAACTTCACGT-1_V12D07-332_D1,0,4,0,1,0,5
CGTTGTTTCAATTCCC-1_V12D07-332_D1,0,2,0,0,0,2
GCAAATATTACGCTTT-1_V12D07-332_D1,0,1,0,1,0,2
CCAATAGTGCCGTCGA-1_V12D07-332_D1,0,5,0,0,0,5
ATTGCTGCTCCTCCAT-1_V12D07-332_D1,0,2,0,4,0,6
GAGATCTGCTTGGCAT-1_V12D07-332_D1,0,6,1,2,0,9
GCCGAAATTCCTACGT-1_V12D07-332_D1,0,5,0,0,0,5
GGCACTCCACTGGGCA-1_V12D07-332_D1,0,1,0,3,0,4
GGGTCACCGTGACGGT-1_V12D07-332_D1,0,3,0,0,0,3
CACTTAATCAGACGGA-1_V12D07-332_D1,0,2,0,0,0,2
CGTTTCGCTCATTACA-1_V12D07-332_D1,0,2,0,2,0,4
ATAAAGGCTCGGTCGT-1_V12D07-332_D1,0,1,0,0,0,1
CACTAAAGTTGCCTAT-1_V12D07-332_D1,0,0,0,0,0,0
GTGCTCAAGTACTGTC-1_V12D07-332_D1,0,0,0,0,0,0
CCATGCCTGTTTAGTA-1_V12D07-332_D1,0,3,0,2,1,6
TCTAGTTATCAGAAGA-1_V12D07-332_D1,0,0,0,0,0,0
TTGTAATCCGTACTCG-1_V12D07-332_D1,0,4,0,2,0,6
TCCCAGCTTTAGTCTG-1_V12D07-332_D1,0,0,0,1,0,1
CTACGCACGGAGTACC-1_V12D07-332_D1,0,0,0,0,0,0
AAATTAACGGGTAGCT-1_V12D07-332_D1,0,1,0,1,0,2
CGGCCACGCACAAAGT-1_V12D07-332_D1,0,2,0,0,3,5
GAAGCGTGAGGAATTT-1_V12D07-332_D1,0,0,0,1,0,1
ATATCTTAGGGCCTTC-1_V12D07-332_D1,0,0,0,2,0,2
ACGCGGGCCAAGGACA-1_V12D07-332_D1,0,1,0,3,0,4
GCGAGTTCTGCAAAGA-1_V12D07-332_D1,0,0,0,0,0,0
TATTCGTGCCAGAATA-1_V12D07-332_D1,0,0,0,2,0,2
AGGGCTGCAGTTACAG-1_V12D07-332_D1,0,0,0,0,0,0
CTAGCATAGTATAATG-1_V12D07-332_D1,0,0,0,0,0,0
TAGGTTCGAGTTCGTC-1_V12D07-332_D1,0,2,1,3,0,6
GAATTATAGTGAAAGG-1_V12D07-332_D1,2,1,0,0,0,3
CTATCGGGTCTCAACA-1_V12D07-332_D1,0,0,0,0,0,0
GCGCTAATTGAATAGA-1_V12D07-332_D1,1,0,0,0,0,1
ATGCGACAGTCCCATT-1_V12D07-332_D1,1,0,0,1,0,2
GGTAGTGCTCGCACCA-1_V12D07-332_D1,0,0,0,0,0,0
AAGCTCGTGCCAAGTC-1_V12D07-332_D1,0,0,0,0,0,0
TATTCAATTCTAATCC-1_V12D07-332_D1,0,0,0,3,0,3
TTCAAAGTCTCTAGCC-1_V12D07-332_D1,0,1,0,2,0,3
TTGAATATGGACTTTC-1_V12D07-332_D1,0,0,0,0,0,0
AAGAGCTCTTTATCGG-1_V12D07-332_D1,0,0,0,1,0,1
TTACTCCGGCCGGGAA-1_V12D07-332_D1,0,2,0,2,0,4
AAACGAGACGGTTGAT-1_V12D07-332_D1,0,0,0,0,0,0
GCTAAGTAGTTTCTCT-1_V12D07-332_D1,0,0,0,1,1,2
ATAACGCCGGAGGGTC-1_V12D07-332_D1,0,1,0,0,1,2
GGATCCGGAATATACT-1_V12D07-332_D1,0,2,0,0,0,2
TGAAAGGACCTGACTC-1_V12D07-332_D1,0,1,0,0,1,2
TCCGCGGCAGCATCTG-1_V12D07-332_D1,0,0,0,0,0,0
TGCATATGTCTGTCAC-1_V12D07-332_D1,0,0,0,0,0,0
TGTAGGAGAAATTTCC-1_V12D07-332_D1,0,0,0,0,0,0
AGTGAGACTTCCAGTA-1_V12D07-332_D1,0,0,0,0,2,2
CCCAAACATGCTGCTC-1_V12D07-332_D1,2,2,0,0,0,4
GCTTATGAAGCAGGAA-1_V12D07-332_D1,0,1,0,0,3,4
TTCTAACCGAAGCTTA-1_V12D07-332_D1,0,1,0,0,0,1
GGATGTCCTTACCGCA-1_V12D07-332_D1,0,1,1,0,1,3
AGGGTGCTCTCGAGGG-1_V12D07-332_D1,0,2,0,0,1,3
AACTCTCAATAGAGCG-1_V12D07-332_D1,1,3,0,0,0,4
TCTGAATTCCGTACAA-1_V12D07-332_D1,0,3,2,0,2,7
GCGTGGTACTGGGTTA-1_V12D07-332_D1,0,2,0,0,2,4
CGTCGGATAGTGTTGA-1_V12D07-332_D1,0,7,0,2,0,9
ATATGTCTCCCTAGCC-1_V12D07-332_D1,0,4,1,1,1,7
TCTTTAAGACTATGAA-1_V12D07-332_D1,0,0,1,0,1,2
TCATTTAAGTCTCCGA-1_V12D07-332_D1,1,0,0,2,0,3
GATATTGAGATTGGCG-1_V12D07-332_D1,0,1,1,0,0,2
TGACATCGAGCGGACC-1_V12D07-332_D1,0,0,0,2,1,3
GCGTAAATGGCCATAA-1_V12D07-332_D1,0,4,0,2,0,6
ATTGTACAACTCGGCT-1_V12D07-332_D1,0,0,0,1,0,1
TACGCTATAGAAACCT-1_V12D07-332_D1,0,1,0,0,0,1
CACCCAAATCTTATGT-1_V12D07-332_D1,0,1,0,0,0,1
AGATGATGGAGTCTGG-1_V12D07-332_D1,0,0,0,2,0,2
CCACGGTGCCCGGTAG-1_V12D07-332_D1,0,1,0,0,0,1
TCAAGAAATACTAGCT-1_V12D07-332_D1,0,1,0,0,0,1
AGGTATAATTGATAGT-1_V12D07-332_D1,0,0,0,0,0,0
CAAGGTCCTATAGGCT-1_V12D07-332_D1,0,0,0,2,0,2
CCGGCACGACCGTTTC-1_V12D07-332_D1,0,0,0,2,0,2
ACCTCCGTTATTCACC-1_V12D07-332_D1,0,0,0,0,0,0
GCAGCCTATATCACAT-1_V12D07-332_D1,0,0,0,1,0,1
GGTATAGTGACACATA-1_V12D07-332_D1,0,3,0,0,1,4
AAATTCCAGGTCCAAA-1_V12D07-332_D1,1,0,0,0,0,1
TCTTTAGCAGGCGAAC-1_V12D07-332_D1,0,1,0,0,1,2
TATTGACATTTCTGCC-1_V12D07-332_D1,0,1,0,1,0,2
TCTGATCGGGTGCTAG-1_V12D07-332_D1,0,0,0,2,0,2
GGCCCGGAGCATGTCT-1_V12D07-332_D1,0,0,0,1,0,1
GGGCGCAGCGTTACTC-1_V12D07-332_D1,0,2,0,3,0,5
TTGGCGATCCGAATAT-1_V12D07-332_D1,0,0,0,1,0,1
CCACGTAAATTAGACT-1_V12D07-332_D1,0,0,0,0,0,0
TCTGATTGGAAATGGA-1_V12D07-332_D1,0,0,0,0,0,0
ATGGCGGAATAGTCGC-1_V12D07-332_D1,0,1,0,0,0,1
ATCGCTTTACGTCTCA-1_V12D07-332_D1,0,1,0,1,0,2
TACGTGCAAGGTTCCT-1_V12D07-332_D1,0,0,0,1,0,1
CAGGACAGCTGCCCTT-1_V12D07-332_D1,0,0,0,0,0,0
CAAACCAGGTCTGCAT-1_V12D07-332_D1,2,0,0,0,0,2
ACAAGCTATATGGAAG-1_V12D07-332_D1,1,6,0,0,0,7
TCGCCCACTGCGAGAG-1_V12D07-332_D1,3,0,0,0,0,3
AGCCGCAAATTCAAAT-1_V12D07-332_D1,4,3,0,0,0,7
TTAACGTTAAAGCCTG-1_V12D07-332_D1,6,0,1,0,0,7
CAGCGCCAACACGATA-1_V12D07-332_D1,4,2,0,2,0,8
ATCCAATGGTACCGAA-1_V12D07-332_D1,1,1,0,2,0,4
GTGCTGCAGATAAGGA-1_V12D07-332_D1,1,0,0,0,0,1
GGCCTTTGCAACTGGC-1_V12D07-332_D1,1,0,0,1,0,2
GTCGTACCTACGATTG-1_V12D07-332_D1,1,1,0,0,0,2
TAGAAATTCACGTATA-1_V12D07-332_D1,0,0,4,0,0,4
AGAATAAATCTTCAGG-1_V12D07-332_D1,2,3,0,0,0,5
CATTGCGAAATGGGCG-1_V12D07-332_D1,1,6,2,1,0,10
GTCTACTCAATTACAA-1_V12D07-332_D1,0,7,2,0,0,9
TGTAATGACCACAATA-1_V12D07-332_D1,3,9,0,0,0,12
AAAGTCGACCCTCAGT-1_V12D07-332_D1,0,7,5,0,0,12
TACTCGGCACGCCGGG-1_V12D07-332_D1,2,2,1,1,0,6
AGGTGTATCGCCATGA-1_V12D07-332_D1,0,1,0,0,0,1
TGTGCTTTACGTAAGA-1_V12D07-332_D1,0,3,0,0,0,3
AAACCTCATGAAGTTG-1_V12D07-332_D1,0,5,0,2,0,7
TATAGGGTACTCATGA-1_V12D07-332_D1,0,4,0,0,0,4
CCAGCTGATGGTACTT-1_V12D07-332_D1,0,6,0,0,0,6
AATATTGGAGTATTGA-1_V12D07-332_D1,0,0,0,0,0,0
GGCCCTCACCCACTTA-1_V12D07-332_D1,0,5,0,2,0,7
AACCAAGACTTCTCTG-1_V12D07-332_D1,0,3,1,0,0,4
TCGTATTACCCATTGC-1_V12D07-332_D1,0,2,0,2,0,4
ATTCGACGCCGGGCCT-1_V12D07-332_D1,0,5,0,1,0,6
GGCGCAGGACATCTTC-1_V12D07-332_D1,0,4,1,0,0,5
GTACTCCCTTATCGCT-1_V12D07-332_D1,0,3,0,0,0,3
TGGTCTGTTGGGCGTA-1_V12D07-332_D1,1,2,1,0,0,4
AATAACAACGCTCGGC-1_V12D07-332_D1,1,2,0,1,0,4
CATACCCGTACCCAGT-1_V12D07-332_D1,0,8,0,0,0,8
ACAATCCATTTAAACC-1_V12D07-332_D1,0,3,0,0,0,3
GTTACAATTGGTGACG-1_V12D07-332_D1,0,5,1,1,0,7
TTGCCCTGATCACGGG-1_V12D07-332_D1,0,4,2,1,0,7
CTAACCGCGCGCCCGT-1_V12D07-332_D1,0,4,0,0,0,4
CTAAAGAATGCCTACT-1_V12D07-332_D1,0,8,2,0,0,10
ACCCATCTTGAGGGTA-1_V12D07-332_D1,0,0,0,1,0,1
GATCTTTGCAGGGTAT-1_V12D07-332_D1,0,1,0,0,0,1
GGGTACTTCATGAACT-1_V12D07-332_D1,0,1,1,0,0,2
GCCGCTTGTGAGAAAC-1_V12D07-332_D1,0,1,0,0,0,1
CCTGTAAGACATGATA-1_V12D07-332_D1,0,2,0,0,0,2
CGACAGTTCGCGTTAT-1_V12D07-332_D1,0,2,0,0,0,2
ACGATGCATATGTTAT-1_V12D07-332_D1,0,4,1,1,0,6
TGTTCCGCTTCCATGA-1_V12D07-332_D1,0,1,1,2,0,4
GGATGACGCGAGTTTA-1_V12D07-332_D1,0,3,0,1,0,4
GAAGTTTCCACTCAAT-1_V12D07-332_D1,0,1,0,1,0,2
GCGAGGCCCGAGCAGA-1_V12D07-332_D1,0,2,0,0,0,2
CATACTATGTAATTGT-1_V12D07-332_D1,0,0,0,1,0,1
CCAATGTCACAGCAAG-1_V12D07-332_D1,0,5,1,0,0,6
GTTGGATTTGCGTTGG-1_V12D07-332_D1,0,1,0,0,0,1
GGGAGGATGCCCGAAA-1_V12D07-332_D1,0,2,1,3,0,6
GATCGCGGGCTCTCCA-1_V12D07-332_D1,0,0,0,2,0,2
GTTCGCCATAAGTGCC-1_V12D07-332_D1,0,2,0,0,0,2
AGATTATAGGACGTTT-1_V12D07-332_D1,0,1,0,1,0,2
TCGAGACCAACACCGT-1_V12D07-332_D1,0,0,0,1,0,1
TATGGGACCGAGCAGG-1_V12D07-332_D1,0,1,0,0,1,2
GATGCGTCCTGCATTC-1_V12D07-332_D1,0,1,0,1,0,2
TATGGTCTGAGTAACA-1_V12D07-332_D1,0,0,0,0,0,0
GCATAGAGCACTCAGG-1_V12D07-332_D1,0,0,0,0,1,1
CTTCATTGTCAGTGGA-1_V12D07-332_D1,1,2,0,1,0,4
GCAGATTAGGGATATC-1_V12D07-332_D1,0,0,0,1,0,1
CCTGTCGCCCGTAAAT-1_V12D07-332_D1,0,1,0,1,0,2
CAATTTCGTATAAGGG-1_V12D07-332_D1,0,0,0,2,0,2
GTACACTTACCTGAAG-1_V12D07-332_D1,0,1,0,2,0,3
CCAGCCTGGACCAATA-1_V12D07-332_D1,0,0,0,2,0,2
ATGGAGCAGGCCGTGA-1_V12D07-332_D1,0,0,0,1,0,1
GTCATTAGAGCGAACG-1_V12D07-332_D1,0,0,0,0,0,0
AAGACTGCAAGCTACT-1_V12D07-332_D1,0,1,0,3,0,4
CTAGTCACGTCTTAAG-1_V12D07-332_D1,0,0,0,1,0,1
ACTCTTGTATAGTAAC-1_V12D07-332_D1,0,0,0,1,0,1
ATTAGGCGATGCTTTC-1_V12D07-332_D1,0,0,0,1,0,1
TTCGGGACTAATCGCG-1_V12D07-332_D1,0,0,0,3,0,3
TGGACTGTTCGCTCAA-1_V12D07-332_D1,0,1,0,2,0,3
AACGTGCGAAAGTCTC-1_V12D07-332_D1,0,1,0,1,0,2
CCACCCAAGGAAAGTG-1_V12D07-332_D1,0,0,0,0,0,0
CCGCACAAAGACCAAC-1_V12D07-332_D1,1,0,0,1,0,2
GCGATTGTTAACGTTA-1_V12D07-332_D1,0,0,0,0,0,0
ACTCGTCAGTAATCCC-1_V12D07-332_D1,0,0,0,1,0,1
GGTGATAAGGAGCAGT-1_V12D07-332_D1,1,0,0,3,0,4
AAGAGGCATGGATCGC-1_V12D07-332_D1,0,0,0,0,1,1
CACGTTCGTGCTCTAG-1_V12D07-332_D1,0,1,0,1,0,2
CTATTTGGTTACGGAT-1_V12D07-332_D1,0,0,0,0,0,0
GTACAGAGGCAAGGGT-1_V12D07-332_D1,1,3,0,1,0,5
GGGCCGGCCGAAGTAC-1_V12D07-332_D1,0,2,0,0,1,3
CCTGAACGATATATTC-1_V12D07-332_D1,0,0,0,0,0,0
CCGGGCTGCTCCATAC-1_V12D07-332_D1,0,2,0,0,0,2
TACTTGTTAGTAGTCC-1_V12D07-332_D1,0,1,0,0,1,2
CCTAGGCGTAGCGATC-1_V12D07-332_D1,0,1,0,0,1,2
CTGGCGCACAGGTCTG-1_V12D07-332_D1,0,2,0,0,4,6
ACTTATACTTACCCGG-1_V12D07-332_D1,0,6,0,0,3,9
GAAGTCTCCCTAGCGA-1_V12D07-332_D1,0,4,0,0,2,6
ACCGATGGTAGCATCG-1_V12D07-332_D1,0,1,0,0,0,1
CGAGTTTATCGGACTG-1_V12D07-332_D1,0,0,0,0,0,0
CATAACGGACAGTCGT-1_V12D07-332_D1,0,0,0,1,3,4
TGACGATGCACTAGAA-1_V12D07-332_D1,1,9,0,0,0,10
TAGGGAGCTTGGGATG-1_V12D07-332_D1,0,2,2,1,1,6
AGGGTCGATGCGAACT-1_V12D07-332_D1,0,0,0,1,0,1
TATATCCCTGGGAGGA-1_V12D07-332_D1,0,3,1,2,0,6
CATCTTACACCACCTC-1_V12D07-332_D1,0,1,0,0,1,2
GTGCGACAGGGAGTGT-1_V12D07-332_D1,0,1,0,1,0,2
CCGATCTCAACCTTAT-1_V12D07-332_D1,0,0,0,0,0,0
ACGATCATCTTGTAAA-1_V12D07-332_D1,0,0,0,1,0,1
GAAAGAACAGCGTTAT-1_V12D07-332_D1,0,0,0,0,0,0
CTAGGTCTGAAGGAAT-1_V12D07-332_D1,0,0,0,1,0,1
ATATCAACCTACAGAG-1_V12D07-332_D1,0,0,0,0,0,0
AAATAGCTTAGACTTT-1_V12D07-332_D1,0,0,0,0,1,1
GCGACATGTAAACATC-1_V12D07-332_D1,0,0,0,0,0,0
ATAAGTAGGGCGACTC-1_V12D07-332_D1,0,0,1,0,0,1
GCGAGCGCATGCTCCC-1_V12D07-332_D1,1,0,0,0,1,2
AGGGACCGGCTGCGTT-1_V12D07-332_D1,0,1,0,1,1,3
CCTATGAAGTGGTGCC-1_V12D07-332_D1,0,0,0,0,0,0
GCTTACGTAGTTAGTA-1_V12D07-332_D1,0,0,0,0,0,0
CATACTTAGGCAATAC-1_V12D07-332_D1,0,0,0,0,0,0
CCTGTCCCTCACGTTA-1_V12D07-332_D1,0,0,0,1,0,1
CAATGTGCCAACCCTT-1_V12D07-332_D1,5,0,0,1,0,6
GTTAAGTTAGAGTGGG-1_V12D07-332_D1,0,0,0,0,0,0
CTGGGATACGCTACCC-1_V12D07-332_D1,10,0,0,2,0,12
AACCTGTCACGGAATT-1_V12D07-332_D1,0,0,0,1,0,1
ACTGCGGACACACCGT-1_V12D07-332_D1,0,2,0,2,0,4
CCGTGAGGCATTCATG-1_V12D07-332_D1,0,0,0,1,0,1
GCCCAGATGCTGGAGA-1_V12D07-332_D1,0,1,0,0,0,1
TCTGGCCGTTCAAGTT-1_V12D07-332_D1,0,0,0,0,0,0
ATACGAAGGCTTTCCA-1_V12D07-332_D1,0,0,0,0,0,0
GATCCGAATATAAGTG-1_V12D07-332_D1,0,0,0,0,0,0
GTGGAGCATGTCGGCC-1_V12D07-332_D1,0,0,0,0,0,0
ACTCTTCAGCTCCCGC-1_V12D07-332_D1,0,0,0,2,0,2
CCCGATAGCCTCGCCT-1_V12D07-332_D1,0,0,0,0,0,0
ACAGGTGTGTTGTTGC-1_V12D07-332_D1,0,0,0,0,0,0
TGAACTGCTATGACTT-1_V12D07-332_D1,3,2,0,0,0,5
TGACATATATGACGAT-1_V12D07-332_D1,4,2,0,0,0,6
AAGTCTTCTGTGGCCT-1_V12D07-332_D1,4,2,0,0,0,6
ACCAGACCATAACAAC-1_V12D07-332_D1,4,3,0,0,0,7
TGAGACGTACCTCTCA-1_V12D07-332_D1,2,1,0,0,0,3
GACCGTTACATGCGAC-1_V12D07-332_D1,0,1,0,1,0,2
GGTTCGGATTATACTA-1_V12D07-332_D1,1,0,0,1,0,2
CCTCCTGAGCCCACAT-1_V12D07-332_D1,3,3,0,1,0,7
CCGCGATTTGGTAGGT-1_V12D07-332_D1,0,0,0,0,0,0
AATCTCTACTGTGGTT-1_V12D07-332_D1,0,2,1,1,0,4
ACTTTGACTGCATCCT-1_V12D07-332_D1,1,4,1,0,0,6
CCCTGACTAACAAATT-1_V12D07-332_D1,2,8,2,0,0,12
ACGCTGTGAGGCGTAG-1_V12D07-332_D1,0,4,1,0,0,5
GCATACGAGGTCTTTA-1_V12D07-332_D1,0,7,3,1,0,11
TCGGGATTCAAACATA-1_V12D07-332_D1,0,8,3,0,0,11
GGGCCCTACGAAAGGG-1_V12D07-332_D1,1,7,6,1,0,15
CGCCAAGAAGCCGAGT-1_V12D07-332_D1,0,2,0,3,0,5
GGTACATCTGGGACGA-1_V12D07-332_D1,0,2,0,3,0,5
GGATGCTGGCGTTCCT-1_V12D07-332_D1,0,2,0,2,0,4
CCGATTCGAGGGACCC-1_V12D07-332_D1,0,4,0,1,0,5
CCACTGGTGGCTGGTT-1_V12D07-332_D1,0,1,1,0,0,2
GACAGGCACACACTAT-1_V12D07-332_D1,0,3,0,0,0,3
TCAACGCGACCGGCAG-1_V12D07-332_D1,0,0,0,0,0,0
CTACGACTAGCTATAA-1_V12D07-332_D1,0,5,1,0,0,6
CGGTTGACCTGGCATA-1_V12D07-332_D1,0,6,0,1,0,7
ATCCTGAATCGCTGCG-1_V12D07-332_D1,0,6,0,0,0,6
GTTTCATATCGTCGCT-1_V12D07-332_D1,0,0,0,3,0,3
ATAAATATTAGCAGCT-1_V12D07-332_D1,0,0,0,0,0,0
AAGAGGATGTACGCGA-1_V12D07-332_D1,0,1,0,2,0,3
TCCTGCGTTGATACTC-1_V12D07-332_D1,0,3,0,1,0,4
CGTGCATTGTCGACGC-1_V12D07-332_D1,0,1,2,0,0,3
CCGGGTTCGAGGTTAC-1_V12D07-332_D1,0,3,0,0,0,3
CCCAATTTCACAACTT-1_V12D07-332_D1,0,1,0,1,0,2
TGATTTATTAGCTGTG-1_V12D07-332_D1,0,1,0,1,0,2
TGGAAGAAGGGAACGT-1_V12D07-332_D1,0,1,0,0,0,1
GACGCTTGCTTCTAAA-1_V12D07-332_D1,0,4,1,2,0,7
GGGAACGGGAGGTTAG-1_V12D07-332_D1,0,2,0,1,0,3
GCGGCTCTGACGTACC-1_V12D07-332_D1,0,4,0,0,0,4
ACGTTAGATTTGCCCG-1_V12D07-332_D1,0,1,1,0,0,2
GAGAGGGCGCGAGGTT-1_V12D07-332_D1,0,5,1,1,0,7
GCGTCTCTGCATTGGG-1_V12D07-332_D1,0,5,0,0,0,5
GCAGCACACAGCCCAG-1_V12D07-332_D1,0,4,0,1,0,5
CAGGCCGTTTGGGTGT-1_V12D07-332_D1,0,6,0,0,0,6
AACTCAAGTTAATTGC-1_V12D07-332_D1,0,2,0,1,0,3
CTTCGTAGATAGGTGA-1_V12D07-332_D1,0,5,0,0,0,5
TGCAGAGTACCGAGCA-1_V12D07-332_D1,0,5,0,0,0,5
GAAGTGATTTATCGTG-1_V12D07-332_D1,0,3,0,1,0,4
CGCTACGGGACATTTA-1_V12D07-332_D1,0,3,0,1,0,4
CCACACTGAGATATTA-1_V12D07-332_D1,1,4,0,0,0,5
CGATCCGACCCAGTGC-1_V12D07-332_D1,0,2,0,2,0,4
CTGTACTTCTTAGCAT-1_V12D07-332_D1,0,0,0,1,0,1
ACTTATTAGGATCGGT-1_V12D07-332_D1,0,0,0,3,0,3
TAGTCCGCAGAGAATG-1_V12D07-332_D1,0,0,0,1,0,1
TTCACGAAAGGATCAC-1_V12D07-332_D1,0,1,0,0,0,1
TACATTTCTAACGTGC-1_V12D07-332_D1,0,0,0,1,1,2
ACCATATCCGCAATAA-1_V12D07-332_D1,0,1,0,1,0,2
CACTCAAGAGCTATGG-1_V12D07-332_D1,0,0,0,0,0,0
TGTACGAACAAATCCG-1_V12D07-332_D1,0,0,0,0,0,0
ATCATCCAATATTTGT-1_V12D07-332_D1,0,2,0,0,0,2
CGCTATTCTTAGGCTC-1_V12D07-332_D1,0,1,0,0,0,1
TGGCAGCAGTAATAGT-1_V12D07-332_D1,0,1,0,1,0,2
TCACGTGCCCGATTCA-1_V12D07-332_D1,0,0,0,1,0,1
CATACGGCGTCTGGGC-1_V12D07-332_D1,0,0,0,0,0,0
CACATGATTCAGCAAC-1_V12D07-332_D1,0,0,0,0,0,0
GCTAGTAGAGCTTGTA-1_V12D07-332_D1,0,0,0,2,0,2
TGCTGTTGAAGAACTC-1_V12D07-332_D1,0,0,0,3,0,3
CGGAGCATGGCGATCC-1_V12D07-332_D1,0,0,0,1,0,1
TAGCGTTGGGTCTTAC-1_V12D07-332_D1,0,0,0,0,0,0
GTAGCGGCTATACACT-1_V12D07-332_D1,0,0,0,0,0,0
TAACATACAATGTGGG-1_V12D07-332_D1,0,0,0,1,0,1
TCTTCGAATAGACGTT-1_V12D07-332_D1,0,0,0,0,0,0
GATCGTGACTGATATC-1_V12D07-332_D1,0,0,0,4,0,4
GATCCGGGAATTAACA-1_V12D07-332_D1,0,1,0,1,0,2
TTATATACGCTGTCAC-1_V12D07-332_D1,1,1,0,1,0,3
GTCGCGTAACCCGTTG-1_V12D07-332_D1,0,1,0,0,0,1
AGCTCTAGACGTTCCA-1_V12D07-332_D1,0,0,0,0,0,0
GTCAAGCGGACTCGGG-1_V12D07-332_D1,0,0,0,1,0,1
CGAGGGACTGCGGTCG-1_V12D07-332_D1,0,0,0,5,0,5
AATCGCCTCAGCGCCA-1_V12D07-332_D1,0,0,0,0,0,0
CTTGTTGCTGAGTCAA-1_V12D07-332_D1,0,0,0,0,0,0
GATATGAGACACTAAC-1_V12D07-332_D1,0,0,0,0,0,0
TTATGATCTTAACGAA-1_V12D07-332_D1,0,0,0,0,0,0
CGCCGCCCATGCCTGT-1_V12D07-332_D1,0,0,0,1,0,1
CTGGGATAAATAATGG-1_V12D07-332_D1,0,0,0,0,1,1
GTGCCCGTTCGGATTC-1_V12D07-332_D1,0,0,0,0,0,0
TTCAATACTCTGAATC-1_V12D07-332_D1,0,0,0,0,0,0
CGCACATGTCCACTAC-1_V12D07-332_D1,0,2,0,0,1,3
AGAAGAGCGCCGTTCC-1_V12D07-332_D1,0,2,0,0,6,8
GATAACTCGCACTGTG-1_V12D07-332_D1,0,4,0,0,2,6
AGTCGACGGTCTCAAG-1_V12D07-332_D1,0,0,1,0,3,4
GTGACCGCACACTACG-1_V12D07-332_D1,0,1,0,0,4,5
GTATGTGGGTCTAGTT-1_V12D07-332_D1,0,1,0,0,1,2
CTTGAGTTAGGGTAAT-1_V12D07-332_D1,0,3,0,0,4,7
TTAGCTGATTTGCCGT-1_V12D07-332_D1,0,1,0,0,1,2
GCTGTTGCTACCGAAC-1_V12D07-332_D1,0,0,0,1,0,1
TATTACCATCCTGCTT-1_V12D07-332_D1,0,5,0,2,0,7
TTGAATTCACGTGAGG-1_V12D07-332_D1,0,3,0,1,0,4
CCATCTCACCAGTGAA-1_V12D07-332_D1,0,0,0,1,0,1
CGCACGTGCGCTATCA-1_V12D07-332_D1,0,0,0,1,0,1
ACCCGGATGACGCATC-1_V12D07-332_D1,0,0,0,1,0,1
CGCTAGAGACCGCTGC-1_V12D07-332_D1,1,0,0,0,0,1
ATAGTTCCACCCACTC-1_V12D07-332_D1,0,0,0,0,1,1
GCAGACCCAGCACGTA-1_V12D07-332_D1,1,0,0,1,0,2
TAGACTACCTAGCGTT-1_V12D07-332_D1,0,0,0,0,0,0
GGTTCTACTCGTCTGA-1_V12D07-332_D1,0,0,0,0,0,0
GACTCACCCACGTGAG-1_V12D07-332_D1,0,0,0,0,0,0
AGCTCTTCGTAACCTT-1_V12D07-332_D1,0,0,0,1,0,1
ACTATCCAGGGCATGG-1_V12D07-332_D1,0,1,0,0,1,2
AAGGATCGATCGCTTG-1_V12D07-332_D1,0,0,0,2,0,2
ATATCGGTAGGGAGAT-1_V12D07-332_D1,0,1,0,0,0,1
TTCCAGACGAGATTTA-1_V12D07-332_D1,1,0,0,0,0,1
GACCGACGTGAAAGCA-1_V12D07-332_D1,0,0,0,1,0,1
CCTGGAAACGTTCTGC-1_V12D07-332_D1,7,0,0,0,0,7
CCGGTAATGGCTAGTC-1_V12D07-332_D1,5,1,0,1,1,8
GCCGTGGAAGAAATGT-1_V12D07-332_D1,7,1,0,1,0,9
GTCTTGAGGAGCAGTG-1_V12D07-332_D1,10,0,0,1,0,11
TCCCAAAGCCCTAAAT-1_V12D07-332_D1,3,1,0,2,5,11
TTGAGCGCCACGTGAT-1_V12D07-332_D1,9,0,0,2,1,12
TTGAGTCCCGCTGCTG-1_V12D07-332_D1,7,0,0,2,0,9
ATGGAACCTTTGCACA-1_V12D07-332_D1,10,0,0,0,0,10
GCTAGCACCTGGGCCA-1_V12D07-332_D1,9,1,0,1,0,11
CGCCGTCTACCCATCG-1_V12D07-332_D1,0,0,0,0,0,0
GATAGGTGTCCCGGGC-1_V12D07-332_D1,0,1,0,1,0,2
AGGTATGCGGACATTA-1_V12D07-332_D1,0,0,0,1,0,1
TTGGTTCGCTCAAAGG-1_V12D07-332_D1,0,1,0,0,0,1
TCTGGAGCGTAAGAGT-1_V12D07-332_D1,0,0,0,0,0,0
TGCCTAAATTTAATAG-1_V12D07-332_D1,0,1,0,1,0,2
TAATTTCCGTCCAGTA-1_V12D07-332_D1,0,0,0,0,0,0
TCCTTCAATCCCTACG-1_V12D07-332_D1,0,1,2,0,0,3
TACCTATCCCTAGAGG-1_V12D07-332_D1,4,1,0,1,0,6
GCATGGGTACTGACGC-1_V12D07-332_D1,8,0,0,0,0,8
GTCGGGAACATGGTAG-1_V12D07-332_D1,3,3,0,0,0,6
GCAAATGAGGACACTT-1_V12D07-332_D1,2,0,0,0,0,2
GAATGGGCTTATCGAC-1_V12D07-332_D1,0,0,0,1,0,1
TGGTCGTGCAAGGCAA-1_V12D07-332_D1,1,5,0,0,0,6
CACCACGCCACACAGA-1_V12D07-332_D1,0,0,0,0,0,0
GAACCTCGACCTACAC-1_V12D07-332_D1,2,3,0,0,0,5
CAATACGCTCTGAGGC-1_V12D07-332_D1,0,0,0,0,0,0
TGGTAAGCAGGATTGA-1_V12D07-332_D1,1,1,0,0,0,2
AGTGGCTCCGTCGGCC-1_V12D07-332_D1,0,6,0,1,0,7
GATCGGATAGAACCAT-1_V12D07-332_D1,1,8,3,0,0,12
GCTACAGTACGGACCG-1_V12D07-332_D1,0,4,1,0,0,5
TCTATTACTAGAGGAT-1_V12D07-332_D1,0,4,0,0,0,4
TTCAGGCGTCAAAGCC-1_V12D07-332_D1,0,3,3,0,0,6
AGACCGGGAAACCCTG-1_V12D07-332_D1,0,4,1,0,0,5
AGAGATCTCTAAAGCG-1_V12D07-332_D1,0,3,0,0,0,3
CCCTGCCCAATCCGCT-1_V12D07-332_D1,0,3,1,0,0,4
GTGGCGGTCCCAGCGT-1_V12D07-332_D1,0,1,0,2,0,3
GCATTGTAATTCATAT-1_V12D07-332_D1,0,3,0,0,0,3
CCGTTCCGAATCTCGG-1_V12D07-332_D1,0,2,0,3,0,5
AGCTTGATCTTAACTT-1_V12D07-332_D1,0,3,0,0,0,3
CCTGTACTCACGCCCA-1_V12D07-332_D1,0,1,0,0,0,1
AAGTGACGACCGAATT-1_V12D07-332_D1,0,9,0,1,0,10
CTCACTTGGCTGGTAA-1_V12D07-332_D1,0,3,0,0,0,3
CGCCTGGCCTACGTAA-1_V12D07-332_D1,0,1,0,0,0,1
CCCGTAAGTCTAGGCC-1_V12D07-332_D1,0,0,0,0,0,0
TTGGACATGTGGCTTA-1_V12D07-332_D1,0,4,0,2,0,6
ATTACGCGCTGGCAGG-1_V12D07-332_D1,0,3,0,1,0,4
ACGCGCTACACAGGGT-1_V12D07-332_D1,0,3,0,0,0,3
TACGTTTACCGGCAAT-1_V12D07-332_D1,0,4,0,2,0,6
CGAAACGCAATTCATG-1_V12D07-332_D1,0,1,0,1,0,2
TAGTCTAACAACGAGA-1_V12D07-332_D1,0,3,0,1,0,4
TTGCATGCTGATCACG-1_V12D07-332_D1,0,1,0,0,0,1
TCTGGGTAGCGCTCAT-1_V12D07-332_D1,0,6,1,0,0,7
ACATCGGTCAGCCGCG-1_V12D07-332_D1,0,3,0,0,0,3
AGATACCGGTGTTCAC-1_V12D07-332_D1,0,2,0,1,0,3
GATTACTGAATTTGGG-1_V12D07-332_D1,0,0,0,3,0,3
TCCAACTTTAAATTCT-1_V12D07-332_D1,0,4,0,0,0,4
TCCTAGCAAAGAAGCT-1_V12D07-332_D1,0,1,2,3,0,6
GTCTATCTGAGTTTCT-1_V12D07-332_D1,0,3,0,2,0,5
GATGTTCAATCCACGA-1_V12D07-332_D1,0,1,0,1,0,2
AGTTAAACACTTGCGA-1_V12D07-332_D1,0,2,0,0,0,2
AGCTCTTTACTCAGTT-1_V12D07-332_D1,0,3,0,1,0,4
ATCCAGGATTCGTGAA-1_V12D07-332_D1,0,3,0,1,0,4
AGTCAACACCACCATC-1_V12D07-332_D1,0,1,0,4,0,5
CGATACCTCGCGGACA-1_V12D07-332_D1,0,4,0,1,0,5
TACAACGCACAACTCA-1_V12D07-332_D1,0,1,0,3,1,5
AATTAAAGGTCGGCGT-1_V12D07-332_D1,0,1,0,0,0,1
TACGCAGTTCTTTCCT-1_V12D07-332_D1,0,2,0,1,0,3
GACCGTGCTGACGGTG-1_V12D07-332_D1,0,1,0,0,1,2
GGCAAATTACTTTACT-1_V12D07-332_D1,0,2,0,0,0,2
GGTACAAACATGCTAT-1_V12D07-332_D1,2,2,0,0,0,4
CGGGCCTTCTTTGTAA-1_V12D07-332_D1,0,0,0,1,0,1
CGTGAAGTTAATTCAC-1_V12D07-332_D1,0,1,0,2,1,4
ATAGTGAAGCGTTCTC-1_V12D07-332_D1,0,2,0,0,0,2
TACGCCATATTCTAAT-1_V12D07-332_D1,0,0,0,0,0,0
GCCGGGTTAGGGTCGC-1_V12D07-332_D1,0,0,0,1,0,1
TACATAGGCATACACC-1_V12D07-332_D1,0,1,0,2,1,4
GCCGATTGGCCAAGCT-1_V12D07-332_D1,0,0,0,3,0,3
CTGCCATGCATCACAT-1_V12D07-332_D1,0,0,0,0,0,0
TTATGAATGAAAGGGA-1_V12D07-332_D1,0,0,0,0,0,0
GCTGAGGCGTGAGTAT-1_V12D07-332_D1,0,0,0,0,0,0
GCGCCGTTCCACGATA-1_V12D07-332_D1,0,0,0,0,0,0
CGCATGGTGCGATGCT-1_V12D07-332_D1,0,0,0,4,0,4
AGGTTTCACACACCTT-1_V12D07-332_D1,0,0,0,2,0,2
CAAGGATCGCATGTTC-1_V12D07-332_D1,0,0,0,2,0,2
ACGTTAATGTCGAAGA-1_V12D07-332_D1,0,0,0,1,0,1
TCCAGAGCACCGGTTC-1_V12D07-332_D1,0,0,0,1,0,1
GATTCGACGGTTCACG-1_V12D07-332_D1,0,0,0,2,0,2
GTTTCTGCAGTCTCCC-1_V12D07-332_D1,0,0,0,1,0,1
GCTGCACGGTTTCTTA-1_V12D07-332_D1,0,0,0,2,0,2
CGTGCAGACTGGGACA-1_V12D07-332_D1,0,0,0,1,0,1
GTGTTACTATGCGTCC-1_V12D07-332_D1,2,0,0,2,0,4
TCCTCGGGCTGGGCTT-1_V12D07-332_D1,0,1,1,2,0,4
GTGAGGACACTTAAGG-1_V12D07-332_D1,0,2,0,0,0,2
ATACGCCGGCGAAACC-1_V12D07-332_D1,0,1,0,0,4,5
TCTGCCAGAAACTGCA-1_V12D07-332_D1,0,1,2,0,0,3
TTCTGCGGGTTAGCGG-1_V12D07-332_D1,0,0,0,0,0,0
CTCGGTACCACTGCTC-1_V12D07-332_D1,0,0,0,1,0,1
GTAAGTAACAGTCTGG-1_V12D07-332_D1,0,0,0,1,0,1
GTGCGTGTATATGAGC-1_V12D07-332_D1,0,0,0,1,0,1
ATTTGTCTTGGGAGCT-1_V12D07-332_D1,0,2,0,0,0,2
CCTCGGACCGGGATAG-1_V12D07-332_D1,0,1,0,1,0,2
TAGGTGCTCGCCTAGC-1_V12D07-332_D1,0,0,0,1,1,2
CTTTAGGAACACTGTT-1_V12D07-332_D1,0,2,0,0,1,3
TCGGGCCGTCGTGGTA-1_V12D07-332_D1,0,1,0,0,1,2
AGTGCTTGCACGAATA-1_V12D07-332_D1,0,3,0,0,1,4
TGCAGTTTCCTCCCAT-1_V12D07-332_D1,0,2,1,0,3,6
TGAGAGATTTACCACG-1_V12D07-332_D1,0,6,0,1,2,9
GAAACAGATGACCACC-1_V12D07-332_D1,0,2,0,3,1,6
AGCAACATATCTTATT-1_V12D07-332_D1,0,2,0,1,1,4
CAAGTGTGGTTGCAAA-1_V12D07-332_D1,1,4,1,0,1,7
GCCTCATCTGGAAATA-1_V12D07-332_D1,0,2,0,3,0,5
AACCCTACTGTCAATA-1_V12D07-332_D1,0,1,0,2,0,3
ACGTATTACTCCGATC-1_V12D07-332_D1,0,0,0,2,0,2
TCTGGGAACCTTTGAA-1_V12D07-332_D1,1,0,0,1,0,2
GCTCGCTCATGTCCAA-1_V12D07-332_D1,0,0,0,1,0,1
GCGCAAGAGCGCGCTG-1_V12D07-332_D1,0,0,0,2,0,2
TTGACGCTCCATGAGC-1_V12D07-332_D1,0,1,0,1,0,2
TATAGATGGTCGCAGT-1_V12D07-332_D1,1,0,0,1,0,2
TTACATGCCACAACTA-1_V12D07-332_D1,4,0,1,0,0,5
ACATGGCGCCAAAGTA-1_V12D07-332_D1,2,0,0,0,1,3
TATGGTTAGTGGGAGA-1_V12D07-332_D1,3,0,0,0,0,3
CATGACTTCGCTGAAT-1_V12D07-332_D1,0,0,0,3,0,3
ACCACCAATGTAACAA-1_V12D07-332_D1,4,0,0,1,0,5
TCTTAGAGCTCCAATT-1_V12D07-332_D1,0,1,0,1,1,3
CCACGAATTTAACCTC-1_V12D07-332_D1,1,0,0,0,0,1
TTCTTGCTAGCATCTC-1_V12D07-332_D1,1,0,0,0,1,2
ACACCTTACTACTTGC-1_V12D07-332_D1,11,0,0,0,0,11
AGTCGGTTGCGTGAGA-1_V12D07-332_D1,5,1,0,1,0,7
ACCTACAGTATGTGGT-1_V12D07-332_D1,15,0,0,2,0,17
GAGGATAAACAGTGCT-1_V12D07-332_D1,12,0,0,0,1,13
TTCCGGTATCTGTGTC-1_V12D07-332_D1,4,0,0,2,1,7
GGAGGCCGAAGTCGTC-1_V12D07-332_D1,4,0,1,0,0,5
TTCGCTAGGAAGTTGT-1_V12D07-332_D1,0,0,0,1,1,2
TAAAGACAACCCTTTA-1_V12D07-332_D1,0,1,0,3,1,5
GTTGCGCTAACATTAC-1_V12D07-332_D1,1,1,1,4,0,7
GCTGAACTCTCCAGGG-1_V12D07-332_D1,7,0,0,1,0,8
AGCCCTGTCGCACCGT-1_V12D07-332_D1,0,0,0,3,0,3
AGCGCTAGAGCGATGT-1_V12D07-332_D1,13,0,0,5,0,18
TGCGCCGTTAATAACG-1_V12D07-332_D1,13,0,0,0,0,13
TGACAACGCATGTCGC-1_V12D07-332_D1,1,1,0,2,0,4
CGTCTTGAGTGTGACG-1_V12D07-332_D1,2,0,0,0,0,2
GATAGGATTAATTACA-1_V12D07-332_D1,0,1,0,1,0,2
GATACCGTGTCGGAGT-1_V12D07-332_D1,2,0,0,1,0,3
TGTGTCGAAGTCGAGG-1_V12D07-332_D1,0,0,0,0,0,0
GGATCAGAGCCATCAG-1_V12D07-332_D1,1,3,0,0,0,4
GTCCCAATCATCCCGC-1_V12D07-332_D1,3,1,0,0,0,4
TGCCACACTAGAGGAA-1_V12D07-332_D1,17,0,0,0,0,17
TGAATTTCACTTGCCT-1_V12D07-332_D1,6,1,0,0,0,7
CTCAGATTGTGATAAG-1_V12D07-332_D1,3,1,1,0,0,5
CGGACGTTACTTGAAG-1_V12D07-332_D1,1,0,0,0,0,1
CCGCCTTGCGATGTCG-1_V12D07-332_D1,0,0,1,1,0,2
CCAGTCAAATCTCTTA-1_V12D07-332_D1,2,1,4,0,0,7
AAACAGCTTTCAGAAG-1_V12D07-332_D1,0,2,0,0,0,2
TAGCTGATGTGAAGCG-1_V12D07-332_D1,1,1,0,0,0,2
CTTATGCGCTCAGGGC-1_V12D07-332_D1,2,5,2,0,0,9
TGGCTCTTGTCGCGTA-1_V12D07-332_D1,1,8,5,0,0,14
TTGTGAGGCATGACGC-1_V12D07-332_D1,1,2,3,0,0,6
CATAAGCTCTCCGTCT-1_V12D07-332_D1,0,5,4,0,0,9
CCTTCTCAGCGTTCCT-1_V12D07-332_D1,2,7,4,0,0,13
TGCAGCTACGTACTTC-1_V12D07-332_D1,0,7,1,1,0,9
CTCTACACTGGCGATT-1_V12D07-332_D1,0,5,5,0,0,10
TGCAGATCGTCCTAGG-1_V12D07-332_D1,0,6,1,1,0,8
TGCCAAAGTCAGACTT-1_V12D07-332_D1,0,3,1,1,0,5
ACAATAGTCGTACGTT-1_V12D07-332_D1,0,11,1,0,0,12
CATGCCAACTCGCAAA-1_V12D07-332_D1,0,4,1,0,0,5
TGCAGAACTATATCGT-1_V12D07-332_D1,0,3,0,0,0,3
TCGTGTCACGCTGACA-1_V12D07-332_D1,0,7,2,1,0,10
TGATCAGGGAACTGCT-1_V12D07-332_D1,0,5,0,0,0,5
CTTGCAACCGCCTCCT-1_V12D07-332_D1,0,4,2,1,0,7
AGCCCATACATGTAAG-1_V12D07-332_D1,0,3,0,0,0,3
ATCCAATGGAGGGTCC-1_V12D07-332_D1,0,4,0,0,0,4
AAACCGGGTAGGTACC-1_V12D07-332_D1,0,5,1,0,0,6
GCAACCACGGCCGCGT-1_V12D07-332_D1,0,4,2,0,0,6
CGCTTATTCCCGGTCG-1_V12D07-332_D1,0,4,1,0,0,5
TTACTCTGGTACGTAC-1_V12D07-332_D1,0,1,0,0,0,1
GTGGTTTCCGCCTTTC-1_V12D07-332_D1,0,1,0,0,0,1
ATAGGCGGCTATAGAA-1_V12D07-332_D1,0,6,1,1,0,8
GTGCCATCACACGGTG-1_V12D07-332_D1,0,3,0,1,0,4
CCCAACATACGTCGCG-1_V12D07-332_D1,1,2,0,1,0,4
CGGTGCAGATAGAACG-1_V12D07-332_D1,0,4,0,3,0,7
GGGCGGGTTCCCTACG-1_V12D07-332_D1,0,1,0,2,0,3
TGAGCCATACAGTCTC-1_V12D07-332_D1,0,3,1,0,0,4
CTCCGCCCACATGAGG-1_V12D07-332_D1,0,7,2,1,0,10
GTTGAACCGGTTCCAT-1_V12D07-332_D1,0,8,0,1,0,9
TTGACTACCATATGGT-1_V12D07-332_D1,0,1,0,4,0,5
ACCATCGTATATGGTA-1_V12D07-332_D1,0,2,0,1,0,3
TGCGTAAGAACCTGAT-1_V12D07-332_D1,0,3,1,1,0,5
AGAAGGTTGCCGAATT-1_V12D07-332_D1,0,3,0,0,0,3
AGGACGACCCATTAGA-1_V12D07-332_D1,0,1,0,0,1,2
GGTGCTGGTACACATT-1_V12D07-332_D1,0,7,1,0,0,8
GCGCTATGCCGAGGCA-1_V12D07-332_D1,0,5,1,2,0,8
ACCCGGTTACACTTCC-1_V12D07-332_D1,0,2,0,1,0,3
TAACTCATCCGCGCGG-1_V12D07-332_D1,1,0,0,1,0,2
CACAATGAGCTGCTAT-1_V12D07-332_D1,0,1,0,2,0,3
GTTACTTTGGGCCTAG-1_V12D07-332_D1,0,1,0,0,0,1
GGGCCCGTCTTAAACA-1_V12D07-332_D1,0,0,0,0,2,2
GAAATTGTCTCTATAA-1_V12D07-332_D1,1,4,0,0,0,5
GGCGCATGAATTGATG-1_V12D07-332_D1,0,2,0,0,2,4
CATATAGGTACAGTCA-1_V12D07-332_D1,0,1,0,0,3,4
TCAACGAGGAGACAAA-1_V12D07-332_D1,0,0,0,0,0,0
TTGCACAATTCAGAAA-1_V12D07-332_D1,0,0,0,1,0,1
CATCGGACGGGTTAAT-1_V12D07-332_D1,0,1,0,2,0,3
ATTAAACATGCGGACC-1_V12D07-332_D1,0,0,0,2,0,2
TATCTACCACAGCGGG-1_V12D07-332_D1,0,0,0,0,0,0
CGAGACCCTAGAGTGT-1_V12D07-332_D1,0,0,0,1,0,1
ACATCGATCGTTTACC-1_V12D07-332_D1,0,0,0,1,0,1
ATCGACCCAATACAGA-1_V12D07-332_D1,0,0,0,2,0,2
GAATCTGAACATTCTC-1_V12D07-332_D1,0,0,0,0,0,0
AGTTCCTATTTATGTT-1_V12D07-332_D1,0,0,0,0,0,0
CAGTCTGTATACTGGG-1_V12D07-332_D1,0,0,0,0,0,0
GGAGACGACACCTTTG-1_V12D07-332_D1,0,0,0,4,0,4
CCTAAATTAACGGTTC-1_V12D07-332_D1,0,0,0,1,0,1
GCTACGACTTATTGGG-1_V12D07-332_D1,0,0,1,1,0,2
CTGTGCAGGGTAGGTC-1_V12D07-332_D1,0,1,0,2,0,3
ACGCCGCTAGACGACC-1_V12D07-332_D1,0,0,0,2,0,2
ACTTGACTCCCTCTTT-1_V12D07-332_D1,0,0,0,0,0,0
CGCCTCCCTCCTCTAT-1_V12D07-332_D1,0,1,0,0,0,1
CTAGATTTACGACGGC-1_V12D07-332_D1,0,0,0,0,0,0
GATGCTGTATTTCATC-1_V12D07-332_D1,0,0,0,1,0,1
TGCGTTTGTTGACACT-1_V12D07-332_D1,0,0,0,1,0,1
CGTGCCCTCCCGAAGA-1_V12D07-332_D1,1,1,2,1,0,5
ACTCTCTGACTTAGGT-1_V12D07-332_D1,0,0,0,0,0,0
CTGGGTAGGCAGTTAA-1_V12D07-332_D1,0,1,0,2,0,3
GTTTGGCCCAAGTTAT-1_V12D07-332_D1,0,0,0,0,0,0
GAATGTGGTCCGGATT-1_V12D07-332_D1,0,0,0,1,1,2
CCCAGTTAAGGCGCCG-1_V12D07-332_D1,0,0,0,2,0,2
CGGTACTAGAATCAAA-1_V12D07-332_D1,0,2,0,0,0,2
GCTTAATGTAACTAAC-1_V12D07-332_D1,0,0,0,1,0,1
AGGACAGTCGAATCCC-1_V12D07-332_D1,0,2,0,0,0,2
GACAGCCAGACCTGAC-1_V12D07-332_D1,1,1,0,0,0,2
GGCGAAATCTAACTTG-1_V12D07-332_D1,0,1,0,0,1,2
CTGGTAACACATAGAA-1_V12D07-332_D1,0,0,0,0,2,2
TAGCCATTTCAAAGTC-1_V12D07-332_D1,0,5,0,0,4,9
GGGATTTACCGCACCT-1_V12D07-332_D1,0,4,2,0,3,9
ATGCCATTTGCGACCA-1_V12D07-332_D1,0,1,0,0,3,4
GAATAGACGCGACCCA-1_V12D07-332_D1,0,12,2,1,0,15
TGTATGGCGCAGACAG-1_V12D07-332_D1,0,4,0,1,1,6
GGATGAAGATCGCTGA-1_V12D07-332_D1,0,3,0,0,0,3
CGACAATTTGATCTAA-1_V12D07-332_D1,1,2,0,3,0,6
AAAGTTGACTCCCGTA-1_V12D07-332_D1,0,2,0,1,0,3
CGCGGCTCAACTTGAA-1_V12D07-332_D1,0,1,0,0,1,2
CACGCGGAACTGTTGC-1_V12D07-332_D1,0,0,0,0,0,0
TCTTAGAGTGAACTCT-1_V12D07-332_D1,1,0,0,1,0,2
AGTCCATTGGCTGATG-1_V12D07-332_D1,0,0,0,0,0,0
TTAAGATAGGATTGAC-1_V12D07-332_D1,4,1,0,1,0,6
ACATCCTGGTAACTGT-1_V12D07-332_D1,5,0,0,2,0,7
CACCTTGGCGCCTTTG-1_V12D07-332_D1,2,0,0,0,0,2
GCTAGACCGTCTACTG-1_V12D07-332_D1,5,0,1,0,0,6
CGGCCCAGGTATATCC-1_V12D07-332_D1,11,0,0,0,1,12
GTCCATTACTGCTACG-1_V12D07-332_D1,15,0,0,2,1,18
GGGTTTAGGATAGGAT-1_V12D07-332_D1,11,0,0,1,1,13
TAATTAGGACATCCGT-1_V12D07-332_D1,18,0,0,1,0,19
GCTCCCAGTCGGTCCA-1_V12D07-332_D1,19,0,0,1,0,20
ATTCGTGCTATCTCTT-1_V12D07-332_D1,4,1,0,1,2,8
GTTAACTATGTTGTCA-1_V12D07-332_D1,19,0,0,0,1,20
GCTCCGCTCGCTTCAG-1_V12D07-332_D1,10,0,0,0,1,11
GCAACGGCTAGTTATG-1_V12D07-332_D1,0,0,0,2,2,4
AATCGCGCAGAGGACT-1_V12D07-332_D1,0,0,0,2,1,3
AGGTTACACCATGCCG-1_V12D07-332_D1,0,1,0,3,0,4
CGAGATTTCGCTCGGG-1_V12D07-332_D1,1,3,0,3,0,7
CGATAATACTCAGGTT-1_V12D07-332_D1,0,0,0,0,0,0
AAGGCAGGCTGTCTCC-1_V12D07-332_D1,0,1,0,1,0,2
GTAAGTCCACACTCTA-1_V12D07-332_D1,0,0,0,3,0,3
ATGAGGGCAGCGGCTA-1_V12D07-332_D1,1,0,0,0,0,1
GCCGCACTCCGTTTCA-1_V12D07-332_D1,1,1,1,0,0,3
GAGCACGGCGCCTCTT-1_V12D07-332_D1,0,1,0,0,0,1
ACAATTTGGCCATATT-1_V12D07-332_D1,0,1,0,0,0,1
CTGGTTCGCGAGCTAC-1_V12D07-332_D1,0,1,0,1,0,2
GACGGTCCTAGGGTGT-1_V12D07-332_D1,1,0,0,1,0,2
ACTCGCGATCTGACGC-1_V12D07-332_D1,4,0,0,2,0,6
GTGTACGAACCGTTCC-1_V12D07-332_D1,0,2,0,2,0,4
CTTTGACGTCGCTTCT-1_V12D07-332_D1,0,0,0,0,0,0
CGTTATCATACTTCCA-1_V12D07-332_D1,0,2,1,0,0,3
GCTATGCCAGCTTATG-1_V12D07-332_D1,1,1,0,0,0,2
CAGTCGGCCTAGATAT-1_V12D07-332_D1,5,0,0,0,0,5
CCCGTGAGGGCGGTGA-1_V12D07-332_D1,8,2,0,0,0,10
TCTCGTGTTACGAGGA-1_V12D07-332_D1,6,1,1,0,0,8
ACGTCTCGTTCCGGGA-1_V12D07-332_D1,0,0,0,1,0,1
CGAGAGCGCGTAGATA-1_V12D07-332_D1,0,2,0,1,0,3
GACAGATTTCTGGCTC-1_V12D07-332_D1,2,1,0,0,0,3
GGGCCTAAATGGGCTA-1_V12D07-332_D1,1,0,0,0,0,1
ACTTGTAGTCCCTTCA-1_V12D07-332_D1,0,0,0,1,0,1
CCCGAAGTTTCGCGAA-1_V12D07-332_D1,0,5,2,0,0,7
ACCATCCGCCAACTAG-1_V12D07-332_D1,4,6,2,0,0,12
TGCGAATATGGGATTT-1_V12D07-332_D1,0,5,3,0,0,8
TACATCCCTATCCCTG-1_V12D07-332_D1,1,3,2,0,0,6
GTGGGAAGACTGAATC-1_V12D07-332_D1,0,7,1,0,0,8
TCAACATCGACCGAGA-1_V12D07-332_D1,0,10,2,0,0,12
CTATGTGAGTCACGGC-1_V12D07-332_D1,1,3,6,0,0,10
CCGAACACTGGGCCTC-1_V12D07-332_D1,0,5,1,1,0,7
AAACTTGCAAACGTAT-1_V12D07-332_D1,0,8,1,0,0,9
AGGGCGAGCAGCTGAT-1_V12D07-332_D1,0,3,2,1,0,6
AACACGAGACGCGGCC-1_V12D07-332_D1,0,3,0,1,0,4
TGACGAATATTTCCCT-1_V12D07-332_D1,0,2,0,0,0,2
TCGGAGAGTATCGGGA-1_V12D07-332_D1,0,4,2,0,0,6
CAAATCTCTCACAAGG-1_V12D07-332_D1,0,4,1,0,0,5
AGGCCCTAGAACGCCA-1_V12D07-332_D1,0,6,1,0,0,7
TAGAGATCATGCAACT-1_V12D07-332_D1,0,4,0,1,0,5
TTGTTTCCATACAACT-1_V12D07-332_D1,0,2,1,0,0,3
GAGAGGTGCATTCTGG-1_V12D07-332_D1,0,5,0,1,0,6
GTGGACCAACCCGATT-1_V12D07-332_D1,0,3,0,0,1,4
CTGGGCCTGCTATATC-1_V12D07-332_D1,0,4,0,1,1,6
CATAGTCCACAAGAAC-1_V12D07-332_D1,0,4,0,1,0,5
TTGACATGAACGTGGA-1_V12D07-332_D1,0,3,0,0,0,3
GGTTACCACCCTCGGG-1_V12D07-332_D1,0,4,0,0,0,4
TACCGGTCGTTTCCAT-1_V12D07-332_D1,0,5,0,0,0,5
CGAGTACTAAAGAGGA-1_V12D07-332_D1,0,6,0,0,0,6
GCAAGAATTCCTTGGC-1_V12D07-332_D1,0,3,1,0,0,4
TCGCCGAAGTTGCGTC-1_V12D07-332_D1,0,2,2,1,0,5
TTGAGAGTACTGCTAA-1_V12D07-332_D1,0,1,1,1,0,3
GCCACAATTTAAGGAC-1_V12D07-332_D1,0,2,1,1,0,4
ATATTCAGTTAAACCT-1_V12D07-332_D1,0,2,1,0,0,3
TGAGTGCCTCTTAAAT-1_V12D07-332_D1,0,4,1,3,0,8
ATCAGACGGCACGCCG-1_V12D07-332_D1,0,1,1,0,0,2
GTGCGAAATCGAACAC-1_V12D07-332_D1,0,2,0,3,0,5
GTGCCGCTTCAAAGGT-1_V12D07-332_D1,0,2,0,0,0,2
GATACGATGGGAGTCA-1_V12D07-332_D1,0,1,0,0,1,2
GACACTGAGTTCAGTG-1_V12D07-332_D1,0,2,0,1,0,3
ATCCTGCGTGGAATGG-1_V12D07-332_D1,0,4,2,0,0,6
ATCCTACCTAAGCTCT-1_V12D07-332_D1,4,2,0,2,0,8
AGTGATATGAGTAGTT-1_V12D07-332_D1,0,4,0,0,2,6
ATGATGCAATGGTACA-1_V12D07-332_D1,0,1,0,0,0,1
GAAACCGAATTACCTT-1_V12D07-332_D1,0,0,1,2,0,3
AGTGACCTACTTTACG-1_V12D07-332_D1,0,3,0,1,0,4
CAAATGTCCTTCCGTG-1_V12D07-332_D1,0,4,0,1,1,6
TTACTGGGATATTTCA-1_V12D07-332_D1,0,0,0,0,0,0
CTTGCCCAGGCTCTAC-1_V12D07-332_D1,0,1,0,1,0,2
AAATCGTGTACCACAA-1_V12D07-332_D1,0,0,0,3,0,3
GTGATCATAGATCTGC-1_V12D07-332_D1,0,2,0,0,0,2
TGGCAGATTACGATCA-1_V12D07-332_D1,0,0,0,1,0,1
TCACCCTCTTAAGATT-1_V12D07-332_D1,0,0,0,1,0,1
CAGGATATATCGTTGT-1_V12D07-332_D1,0,1,0,1,0,2
CCTGACCACCGATGGT-1_V12D07-332_D1,1,0,0,0,0,1
CTAAAGGGAAATAGGA-1_V12D07-332_D1,0,0,0,0,0,0
CCGCTATCAGCACCAG-1_V12D07-332_D1,0,0,0,0,0,0
CTTTAGTGCTATTATT-1_V12D07-332_D1,0,0,0,2,0,2
CGGGAATTTATGTAAA-1_V12D07-332_D1,0,0,0,1,0,1
TACGACTGCCTCTTAG-1_V12D07-332_D1,0,0,0,1,0,1
AAACTGCTGGCTCCAA-1_V12D07-332_D1,0,0,0,2,0,2
GTACGTTTGCCCGTCA-1_V12D07-332_D1,1,0,0,1,0,2
GGCAAGGCGAAATAGC-1_V12D07-332_D1,0,0,0,1,0,1
GATCTTGGAGGGCATA-1_V12D07-332_D1,0,1,0,1,0,2
AGCGTGGTATTCTACT-1_V12D07-332_D1,0,0,0,1,0,1
CTAAGGGAATGATTGG-1_V12D07-332_D1,0,0,0,1,0,1
CATGGTAAGTAGCGTT-1_V12D07-332_D1,0,0,0,2,0,2
CGTTGAGCGACCGTCG-1_V12D07-332_D1,0,0,0,1,0,1
TGCCCGTACCGTTAAA-1_V12D07-332_D1,0,0,0,1,0,1
ACAAGGGCAGGCTCTG-1_V12D07-332_D1,0,0,0,1,0,1
GAGATCTTCCATGACA-1_V12D07-332_D1,0,0,0,0,0,0
AATGACGTAGGATGTC-1_V12D07-332_D1,0,0,0,1,0,1
GTGGTGGCCAAGTGAA-1_V12D07-332_D1,0,0,0,0,0,0
TCCCGTGTGCAATTTG-1_V12D07-332_D1,0,0,0,0,0,0
ACATCGTATGCAATGG-1_V12D07-332_D1,0,1,0,0,0,1
GCGAAACTTAACTGGA-1_V12D07-332_D1,0,0,0,0,0,0
AATTGAACGCTCTGGT-1_V12D07-332_D1,0,0,0,0,1,1
ACAAATGGTAGTGTTT-1_V12D07-332_D1,1,0,0,0,1,2
ATGGTCGCGTGGTTTC-1_V12D07-332_D1,0,0,0,0,0,0
TGTTATTGTATGTGGC-1_V12D07-332_D1,0,0,0,0,0,0
TTCCGGTTACCCACTT-1_V12D07-332_D1,0,0,0,0,3,3
GAGTGTGCGGTACCCA-1_V12D07-332_D1,1,2,0,0,0,3
CAAGATATTATAACGT-1_V12D07-332_D1,0,1,0,0,2,3
ACACACCAGGACCAGT-1_V12D07-332_D1,0,1,0,0,2,3
ATGGGCCTCGGCCTCT-1_V12D07-332_D1,0,5,0,0,0,5
AAGGTGATAAACCAGC-1_V12D07-332_D1,0,1,0,1,1,3
TCTTACTTATGCCTCT-1_V12D07-332_D1,0,2,1,1,0,4
AAAGTGTGATTTATCT-1_V12D07-332_D1,0,4,0,1,0,5
TGCTCCACAGTTCTTA-1_V12D07-332_D1,0,2,2,0,0,4
CTGGCTGATTCATCCT-1_V12D07-332_D1,0,3,0,0,0,3
TAAGGCTGAATCCCTC-1_V12D07-332_D1,0,0,0,1,0,1
TCTAGTGATATCGTGG-1_V12D07-332_D1,0,0,0,1,0,1
TCGAAGAACCGAGCAC-1_V12D07-332_D1,0,0,0,0,0,0
GACAAACATATGCAGG-1_V12D07-332_D1,0,1,0,0,0,1
AAGTCAATTGTCGTCA-1_V12D07-332_D1,1,2,0,2,1,6
AGTGAACAAACTTCTC-1_V12D07-332_D1,3,0,0,0,0,3
CATGATGGAAGTTAGC-1_V12D07-332_D1,12,0,0,0,0,12
AAGTGCCTTGACTGTA-1_V12D07-332_D1,18,0,0,0,0,18
ATCGCCAGTCAACATT-1_V12D07-332_D1,8,0,1,0,0,9
ACCGCGGTGGAAGTCG-1_V12D07-332_D1,11,0,0,0,0,11
TCTTCTATAACCCGCC-1_V12D07-332_D1,4,0,0,1,2,7
CACATTTCTTGTCAGA-1_V12D07-332_D1,13,0,0,0,2,15
TAGCGTCCCTCGATTG-1_V12D07-332_D1,7,0,0,1,0,8
GTTCGGATCGGGAACA-1_V12D07-332_D1,11,0,1,1,1,14
CAAACTCGCGACGCCG-1_V12D07-332_D1,0,1,0,2,0,3
GTCTTGTAGCTATTCA-1_V12D07-332_D1,2,0,0,2,0,4
TCTCGACGTATCGCCG-1_V12D07-332_D1,1,3,0,2,0,6
TTGCCAAGCAGAACCC-1_V12D07-332_D1,2,0,0,2,0,4
AAACCCGAACGAAATC-1_V12D07-332_D1,1,0,1,0,0,2
TTGAGCAGCCCACGGT-1_V12D07-332_D1,0,0,1,1,0,2
CGCCTTTAGCATGCTC-1_V12D07-332_D1,0,1,0,5,0,6
TGTGGCTCCCACCAAC-1_V12D07-332_D1,0,2,0,1,0,3
CCGCCGTTGAGGATAA-1_V12D07-332_D1,0,0,0,3,0,3
CAATACGAGAGTCTGA-1_V12D07-332_D1,0,1,0,2,0,3
CATCTAGTGAAGGGAA-1_V12D07-332_D1,0,0,0,2,0,2
GGTGGAGGTTGATACG-1_V12D07-332_D1,0,0,0,0,0,0
CCGCACACGAACGTGT-1_V12D07-332_D1,1,1,0,3,0,5
AGAACCCAGCGTGACA-1_V12D07-332_D1,0,2,0,2,0,4
GCGCTCGATCACCTGT-1_V12D07-332_D1,0,1,0,1,0,2
ATCATGGACTACCGAC-1_V12D07-332_D1,0,1,1,0,0,2
TACGCCGCCTCAGAAG-1_V12D07-332_D1,0,2,0,2,0,4
CGACCTACTAGACAAT-1_V12D07-332_D1,0,0,0,0,0,0
GAGTCTTGTAAAGGAC-1_V12D07-332_D1,1,2,0,0,0,3
AATATCCTAGCAAACT-1_V12D07-332_D1,3,0,0,0,0,3
CCCTAGGCAACAAGAG-1_V12D07-332_D1,4,1,0,0,0,5
ACAAAGAAGGTAGGCC-1_V12D07-332_D1,3,0,0,0,0,3
CCCTGGCTGTTCCTTC-1_V12D07-332_D1,4,0,0,0,0,4
TCGCCGCACCGCGTGA-1_V12D07-332_D1,3,1,1,0,0,5
TATAGCGCACGTTATC-1_V12D07-332_D1,0,0,0,2,0,2
TTATCTGACATTAGGA-1_V12D07-332_D1,2,1,0,0,0,3
AGTGGTGTTACCCGTG-1_V12D07-332_D1,1,0,1,0,0,2
GCCAAGAATACTTCTG-1_V12D07-332_D1,1,1,0,1,0,3
CCGGCGTGAGACTCTG-1_V12D07-332_D1,1,6,3,0,0,10
TTCCCGGCGCCAATAG-1_V12D07-332_D1,0,4,2,0,0,6
AAACAGGGTCTATATT-1_V12D07-332_D1,2,7,6,0,0,15
ACAGTAATACAACTTG-1_V12D07-332_D1,0,3,7,0,0,10
CGAACGGCCGGACAAC-1_V12D07-332_D1,0,6,2,0,0,8
GCAACACACTAGAACT-1_V12D07-332_D1,1,6,2,0,0,9
ACTCCCATTCCTAAAG-1_V12D07-332_D1,0,5,3,0,0,8
ACCTGCGTGTCATGTT-1_V12D07-332_D1,1,9,2,0,0,12
TACTTTCCGCACGCCA-1_V12D07-332_D1,0,2,1,0,0,3
AGGTCAGGTGAGAGTG-1_V12D07-332_D1,0,5,0,0,0,5
TCCTCCTAAGACATTC-1_V12D07-332_D1,0,5,2,0,0,7
ATGTGAAAGCCTAATG-1_V12D07-332_D1,0,4,0,0,0,4
AGTCGGCTCAACTTTA-1_V12D07-332_D1,0,4,0,0,0,4
CGATCTGTTGGAGGAC-1_V12D07-332_D1,0,12,0,0,0,12
ACGGGAGTGTCGGCCC-1_V12D07-332_D1,0,8,0,0,0,8
TTAACTTCAGGTAGGA-1_V12D07-332_D1,0,5,1,1,0,7
CCACGGAGCCATAAGA-1_V12D07-332_D1,0,6,1,0,0,7
CTTCTATGTTGAAGTA-1_V12D07-332_D1,0,3,0,0,0,3
CACCGTTGCGCGATAT-1_V12D07-332_D1,0,4,2,1,0,7
TCTAGCAATCTCCGCC-1_V12D07-332_D1,0,3,0,1,0,4
AGTTTGGCCAGACCTA-1_V12D07-332_D1,0,2,0,0,0,2
TTGTAAGGACCTAAGT-1_V12D07-332_D1,0,2,0,0,0,2
AAATTTGCGGGTGTGG-1_V12D07-332_D1,0,4,0,0,0,4
AAGTTCGGCCAACAGG-1_V12D07-332_D1,0,8,0,1,0,9
CCGCTTACCTCACTCT-1_V12D07-332_D1,0,1,0,1,0,2
ATCACGTGCTAATTAA-1_V12D07-332_D1,0,0,2,0,0,2
GGTGAAGTACAGGGAT-1_V12D07-332_D1,0,2,1,2,0,5
GCTGTATTACTGGCCC-1_V12D07-332_D1,0,4,0,0,0,4
AACGGCCATCTCCGGT-1_V12D07-332_D1,0,1,1,1,0,3
TAAGTAACATCTTGAC-1_V12D07-332_D1,0,6,0,0,0,6
TTCTTGAGCCGCGCTA-1_V12D07-332_D1,0,2,0,1,0,3
AGTGCGTAGCTCGTAA-1_V12D07-332_D1,0,3,0,0,0,3
GGGATGGTCGTAACCG-1_V12D07-332_D1,0,1,3,0,0,4
GTCTGGGCGGTCGAGA-1_V12D07-332_D1,0,3,0,0,0,3
CGGAACGTAAACATAG-1_V12D07-332_D1,0,3,0,1,0,4
TGCGACACCCTAGTGC-1_V12D07-332_D1,0,1,0,1,0,2
CAAACGAGTATCGCAG-1_V12D07-332_D1,0,0,1,0,0,1
TCAGTAGGGACTATAA-1_V12D07-332_D1,0,0,0,0,1,1
GCGGTTCCCTATCATG-1_V12D07-332_D1,0,0,0,1,0,1
GTGACTTCAGTAGTGC-1_V12D07-332_D1,0,0,0,1,1,2
CGTCACGTCCATTGGT-1_V12D07-332_D1,0,1,0,1,0,2
ATAAGTTACCGCGACG-1_V12D07-332_D1,0,1,0,0,0,1
CTGAATCCGAGACCTC-1_V12D07-332_D1,1,2,0,0,0,3
TACGACGCTTGCTGCG-1_V12D07-332_D1,0,0,0,0,0,0
GAATTCACCCGGGTGT-1_V12D07-332_D1,0,0,0,0,0,0
GGGTGACACCTTAACT-1_V12D07-332_D1,0,0,0,1,0,1
TGAGTAAATTAGCGTA-1_V12D07-332_D1,0,1,0,1,0,2
GAGTCCGCTTACCGGA-1_V12D07-332_D1,1,1,0,0,0,2
GGCGCGTTCGAGTTTA-1_V12D07-332_D1,0,0,0,1,0,1
ATTCATATACTGTCCA-1_V12D07-332_D1,0,0,0,1,0,1
ATAAACGGACCCGTAA-1_V12D07-332_D1,0,0,0,1,0,1
GTCGTACCATCTCGGG-1_V12D07-332_D1,1,0,0,2,0,3
ATAATAGCTGTTGAAT-1_V12D07-332_D1,0,0,0,0,0,0
TTCCGCGTGAGGCGAT-1_V12D07-332_D1,0,0,0,0,0,0
TACCGGCTCACTGCCC-1_V12D07-332_D1,0,0,0,0,0,0
GTATCTTTCATAACCA-1_V12D07-332_D1,1,0,0,2,0,3
GTTACCTACAACTTGC-1_V12D07-332_D1,0,0,0,0,0,0
TGACTATAATCCTTTC-1_V12D07-332_D1,0,0,0,1,0,1
AAATACCTATAAGCAT-1_V12D07-332_D1,0,0,0,1,0,1
TTATTAGAGCGTGTTC-1_V12D07-332_D1,0,0,0,0,0,0
ATGTGGACATCTTGAT-1_V12D07-332_D1,0,1,0,1,0,2
GTACGCTTCATTGCAC-1_V12D07-332_D1,0,0,0,1,0,1
CACATATTAGCAGGAT-1_V12D07-332_D1,1,1,0,1,0,3
CAAGAGGGCGGAGTAC-1_V12D07-332_D1,0,0,0,1,0,1
TCGCAAAGATGCATTT-1_V12D07-332_D1,0,1,0,4,0,5
GTCGTTATTCGCTTAT-1_V12D07-332_D1,0,0,0,3,0,3
TCGTGTACTATGGATG-1_V12D07-332_D1,0,0,0,0,0,0
GCGGAGAGGGAGAACG-1_V12D07-332_D1,0,0,0,0,0,0
TCACAGGGAATCGCAA-1_V12D07-332_D1,0,0,0,0,0,0
GACTGCACCAGCCCAG-1_V12D07-332_D1,0,0,0,0,0,0
TCCGCTGTCATCCCGG-1_V12D07-332_D1,0,0,0,1,0,1
AGATACTCAAGATCGA-1_V12D07-332_D1,0,0,0,0,0,0
ACTGAATGGCGAAAGT-1_V12D07-332_D1,0,0,0,3,0,3
TCCTACATCCACGGCC-1_V12D07-332_D1,0,1,0,0,3,4
TTCAGCCCTGGTCCAC-1_V12D07-332_D1,0,1,0,1,1,3
TTAGAGTTTAGAAGGA-1_V12D07-332_D1,0,4,0,0,0,4
GGTTAGCTATATGTCT-1_V12D07-332_D1,1,2,0,0,2,5
CTGGTTTCGAGCAAGA-1_V12D07-332_D1,0,3,0,0,2,5
TGGGCCCATACTAATT-1_V12D07-332_D1,0,0,0,0,5,5
ACTTATTTATGTGCCA-1_V12D07-332_D1,0,3,0,0,2,5
TTAGTTATTCGTGGCA-1_V12D07-332_D1,0,3,0,1,1,5
AACCGCTAAGGGATGC-1_V12D07-332_D1,0,4,0,2,1,7
ATACGTCCACTCCTGT-1_V12D07-332_D1,0,5,0,0,0,5
CGACACGCTCCGACAG-1_V12D07-332_D1,0,2,0,2,0,4
TCTGAACTCGTACCCG-1_V12D07-332_D1,0,1,0,2,0,3
AGGATATAGGGATTTA-1_V12D07-332_D1,0,0,0,2,0,2
GTGATCACTAACGCCT-1_V12D07-332_D1,0,1,0,2,0,3
ACCGGGCCTTTGTTGA-1_V12D07-332_D1,0,0,0,0,0,0
TTGACAGGAGCTCCCG-1_V12D07-332_D1,0,0,0,0,0,0
CTCTTCTATTGACTGG-1_V12D07-332_D1,0,0,0,1,0,1
CGTGGCCGAATATCTA-1_V12D07-332_D1,0,1,0,1,0,2
GGTTTAGCCTTTCTTG-1_V12D07-332_D1,8,0,0,0,0,8
TCAAGGTTACTACACC-1_V12D07-332_D1,10,1,0,3,0,14
TTGACTATTGTCCGGC-1_V12D07-332_D1,14,1,0,0,0,15
CGGGAATATAGTATAC-1_V12D07-332_D1,8,0,0,1,1,10
GCAACAGCAGTATGCG-1_V12D07-332_D1,3,0,0,0,2,5
ATCAAACACTGTTCCA-1_V12D07-332_D1,0,0,0,0,1,1
TGGGCAATAGTTGGGT-1_V12D07-332_D1,0,0,0,0,1,1
TGAATGTCAGCCGGCC-1_V12D07-332_D1,0,0,0,1,1,2
CGGCTCTAAAGCTGCA-1_V12D07-332_D1,1,1,0,0,0,2
GGACACAAGTTTACAC-1_V12D07-332_D1,0,1,0,1,0,2
CCGAGAAGTCGCATAA-1_V12D07-332_D1,1,1,0,1,0,3
AACTACCCGTTTGTCA-1_V12D07-332_D1,1,3,0,1,0,5
GCACAAACGAGGCGTG-1_V12D07-332_D1,0,0,0,1,0,1
CACACAGCTTGCGCTC-1_V12D07-332_D1,0,0,0,2,0,2
GTGCTTACATCAGCGC-1_V12D07-332_D1,0,0,0,2,0,2
GCAAACGTCGCCAGGT-1_V12D07-332_D1,0,1,0,3,0,4
GAATAGCATTTAGGGT-1_V12D07-332_D1,0,1,0,4,0,5
TACTGTTTCTCTGGTA-1_V12D07-332_D1,0,0,0,0,0,0
TCCTATCATAGGTAAC-1_V12D07-332_D1,0,2,0,1,0,3
TTCGGTGGAGACGCCC-1_V12D07-332_D1,0,2,0,0,0,2
TGTTGCCGTCGTCCCA-1_V12D07-332_D1,0,1,0,3,0,4
CCAACTTGATAGATCC-1_V12D07-332_D1,0,0,0,1,0,1
CAAAGGTCATCTGAAA-1_V12D07-332_D1,0,0,0,3,0,3
CTAGCTTAATGGTCCC-1_V12D07-332_D1,0,0,0,1,0,1
AGGCCACATTGGTTAC-1_V12D07-332_D1,0,2,0,4,0,6
TTAGGATGGGAGGGTA-1_V12D07-332_D1,0,1,0,5,0,6
TGTGTGACCATGAATC-1_V12D07-332_D1,5,0,1,0,0,6
CCCACTCCACGGTATC-1_V12D07-332_D1,7,2,0,0,0,9
GGGCAGACGTCACTGC-1_V12D07-332_D1,7,2,0,0,0,9
TCAAAGAGCTATCTGT-1_V12D07-332_D1,2,2,0,0,0,4
AGATGCATCCTGTGTC-1_V12D07-332_D1,3,4,4,0,0,11
GTGAAGTCACGACTCG-1_V12D07-332_D1,1,2,1,1,0,5
TGATTCAGGTCCCGCG-1_V12D07-332_D1,0,0,1,0,0,1
CGCCACAGGTCGCGAT-1_V12D07-332_D1,0,1,0,0,0,1
TTGAATCGTTGTATAA-1_V12D07-332_D1,0,0,0,1,0,1
TGGCCAATTTGGTACT-1_V12D07-332_D1,0,1,0,1,0,2
CGACCCTTAACGCCGG-1_V12D07-332_D1,0,7,1,1,0,9
TCGGCGTACTGCACAA-1_V12D07-332_D1,1,4,5,0,0,10
GAGTAAGGCCACGGGA-1_V12D07-332_D1,0,7,3,0,0,10
ATCAGCTCGTCCACTA-1_V12D07-332_D1,0,7,7,0,0,14
AGGATCACGCGATCTG-1_V12D07-332_D1,9,3,1,0,0,13
AAATGGCCCGTGCCCT-1_V12D07-332_D1,1,5,5,0,0,11
CAGTACCAGTTTACGT-1_V12D07-332_D1,0,4,6,0,0,10
GGTCGTAAGCTCGCAC-1_V12D07-332_D1,0,4,1,0,0,5
CGTTCATGGTGCGCGT-1_V12D07-332_D1,0,6,3,0,0,9
GACTACAAAGCGGTGG-1_V12D07-332_D1,0,4,1,0,0,5
CAGCTGGCGTAACCGT-1_V12D07-332_D1,0,4,0,0,0,4
ACTCGTAACCCGTCCT-1_V12D07-332_D1,0,5,0,1,0,6
CATATGTCAGGCTACG-1_V12D07-332_D1,0,8,2,0,0,10
GCCCGACTTCTTCCCG-1_V12D07-332_D1,0,3,1,0,0,4
CTGGCATCCGAATGAG-1_V12D07-332_D1,0,4,0,2,0,6
AAGTGCGTTAGAATCT-1_V12D07-332_D1,0,2,2,0,0,4
AGAAGTGATTCGTGAT-1_V12D07-332_D1,0,1,1,1,0,3
TACCTTAAGATTTCCC-1_V12D07-332_D1,0,5,0,1,0,6
AATGACAGCAATGTCT-1_V12D07-332_D1,0,2,1,0,0,3
TCAACGCAGGAAATAA-1_V12D07-332_D1,0,9,0,0,0,9
TATTCCTCCGCCCACT-1_V12D07-332_D1,0,3,0,2,0,5
ATCAAACGAAGGTTTG-1_V12D07-332_D1,0,2,1,1,0,4
TTGATTAGCTGTTTCT-1_V12D07-332_D1,0,5,0,0,0,5
CTGCTGAGGCCACGAA-1_V12D07-332_D1,0,4,0,1,0,5
CCGTGTTAAATTCCAT-1_V12D07-332_D1,0,2,0,1,0,3
CACGTCGGCAACCTCT-1_V12D07-332_D1,0,4,0,0,0,4
GTATTCTGAGAAACGA-1_V12D07-332_D1,0,2,0,1,0,3
CGGTGCGCGTTGGTCC-1_V12D07-332_D1,0,7,0,0,0,7
GTGATTCGCCGCTCAA-1_V12D07-332_D1,0,2,0,2,0,4
GCCCGCGCGTAAACGG-1_V12D07-332_D1,0,3,0,1,0,4
AACGTACTGTGGGTAC-1_V12D07-332_D1,0,4,0,3,0,7
GAGTATGCCCGCCTTG-1_V12D07-332_D1,0,3,0,2,0,5
TGATTCTGTCGCCGGT-1_V12D07-332_D1,0,2,0,0,0,2
GGGCGGCAAATGAATT-1_V12D07-332_D1,0,1,0,1,0,2
TTCCAATCTGGCTATC-1_V12D07-332_D1,0,2,0,1,0,3
GGAACCGTGTAAATTG-1_V12D07-332_D1,0,1,0,0,0,1
TTGGTCACACTCGTAA-1_V12D07-332_D1,0,1,0,1,0,2
CGAACCCGCATGCGTC-1_V12D07-332_D1,0,1,0,3,0,4
GGGCGTCACCACGTAA-1_V12D07-332_D1,0,0,0,1,1,2
TACCAGAAGTAGGTTC-1_V12D07-332_D1,0,0,0,1,1,2
TTGGATATCGTCTACG-1_V12D07-332_D1,0,1,0,0,0,1
TAGATATGGACTGGAA-1_V12D07-332_D1,0,1,0,0,0,1
GCGACGATAGTTGTAC-1_V12D07-332_D1,0,0,0,0,0,0
CTGGATTTACACTTGA-1_V12D07-332_D1,0,0,0,0,0,0
GTTATATTATCTCCCT-1_V12D07-332_D1,0,2,0,2,0,4
TATTCCACTCAGCTCG-1_V12D07-332_D1,0,0,1,0,0,1
CTGTTACCCAATCTAG-1_V12D07-332_D1,0,1,0,1,0,2
ACGCGAAGTCAGACGA-1_V12D07-332_D1,0,0,0,0,0,0
GATAGGTAACGTTGAC-1_V12D07-332_D1,0,0,0,1,0,1
TGTTCGTATTGCGGTG-1_V12D07-332_D1,0,0,0,0,0,0
GGTCAGTGGGTCCCAC-1_V12D07-332_D1,0,0,0,1,0,1
AATTCTAGAGTTAGGC-1_V12D07-332_D1,0,0,2,0,0,2
GTTTACGTTCCATCTG-1_V12D07-332_D1,0,0,0,0,0,0
AGACCCACCGCTGATC-1_V12D07-332_D1,0,0,0,1,0,1
TCTAGCATGCCCAGAA-1_V12D07-332_D1,1,0,0,0,0,1
CCCGCAGCGCGAACTA-1_V12D07-332_D1,0,0,0,0,0,0
CTCTATTTGGCTGCAG-1_V12D07-332_D1,0,0,0,0,0,0
TTCTGCCGCGCCTAGA-1_V12D07-332_D1,0,1,0,0,0,1
ACTCCCTAGAATAGTA-1_V12D07-332_D1,0,0,0,1,0,1
CCGAACCTTCCCGGCC-1_V12D07-332_D1,0,0,0,0,0,0
TCAGACGCTATAGAAG-1_V12D07-332_D1,0,0,0,1,0,1
CAGGCGCCATGCTAGG-1_V12D07-332_D1,0,0,0,0,0,0
CACTCGAGCTGAACAA-1_V12D07-332_D1,0,1,0,5,0,6
ACAAGGAAATCCGCCC-1_V12D07-332_D1,0,0,0,0,0,0
ACCACGTGCAGCTATA-1_V12D07-332_D1,1,0,0,0,0,1
ACGGCGACGATGGGAA-1_V12D07-332_D1,1,0,0,0,0,1
TTACTAAAGGACTTTA-1_V12D07-332_D1,0,0,0,0,0,0
GGCTGAAATAGCAAAG-1_V12D07-332_D1,0,0,0,0,0,0
TTAGACGAGTCACCTC-1_V12D07-332_D1,0,0,0,4,0,4
GTAGTCGCGGGAATCA-1_V12D07-332_D1,0,0,0,1,0,1
GCAAACCCTACATTAT-1_V12D07-332_D1,0,1,0,0,0,1
GTTAAAGTAGGACTGG-1_V12D07-332_D1,0,3,0,0,0,3
ACCCTCCCTTGCTATT-1_V12D07-332_D1,0,0,0,0,0,0
CATGTCTCATTTATGG-1_V12D07-332_D1,0,1,0,0,2,3
AATAGAATCTGTTTCA-1_V12D07-332_D1,0,1,0,0,2,3
TCTCATGAGATAGGGT-1_V12D07-332_D1,0,0,0,0,0,0
ATGACTATGCGACATT-1_V12D07-332_D1,0,0,0,0,1,1
CCTAACCCAAACAAGT-1_V12D07-332_D1,0,2,0,0,2,4
AGTCAAGATGACACTT-1_V12D07-332_D1,0,1,0,0,1,2
CGGGAGCTTCAGTGTA-1_V12D07-332_D1,0,4,0,2,2,8
CCACAGTACCCATCCT-1_V12D07-332_D1,0,3,0,2,1,6
GAGCGCGCACGAGTAG-1_V12D07-332_D1,0,5,0,0,1,6
ACCAGTGCGGGAGACG-1_V12D07-332_D1,0,3,0,1,0,4
TCCTTACGACGGTCCG-1_V12D07-332_D1,0,2,0,1,0,3
TAGTCGATCACGGGTT-1_V12D07-332_D1,0,0,0,1,0,1
AGACGAAGTGCCGGTC-1_V12D07-332_D1,0,1,0,1,0,2
CGCTGGTGACTACCCT-1_V12D07-332_D1,0,2,0,1,0,3
AGGCATTGTCGTAGGG-1_V12D07-332_D1,0,3,0,1,0,4
TGGTAGAATATATGGG-1_V12D07-332_D1,0,0,0,1,0,1
TTCTTATCCGCTGGGT-1_V12D07-332_D1,0,0,0,1,0,1
AGTTTGGCACGGGTTG-1_V12D07-332_D1,5,0,0,1,1,7
GCATCGGCCGTGTAGG-1_V12D07-332_D1,7,0,0,1,0,8
ATGCGAGTCCCACCAC-1_V12D07-332_D1,7,0,0,0,0,7
TCGGCGAACCCAAACC-1_V12D07-332_D1,17,0,0,1,0,18
AGAGTAAACTTCACTA-1_V12D07-332_D1,7,1,0,3,2,13
AAGCCGAAGCGGTTTA-1_V12D07-332_D1,0,0,0,1,0,1
CCCGAGTTTCTCCGTA-1_V12D07-332_D1,1,0,1,1,0,3
AATATCGAATCAATGC-1_V12D07-332_D1,1,1,0,1,0,3
GCGCCTCCCACTCCGA-1_V12D07-332_D1,0,1,0,1,0,2
CGTTAAACTAGTTAGG-1_V12D07-332_D1,0,2,0,2,0,4
TGAGTTAAAGACATTC-1_V12D07-332_D1,0,0,0,2,0,2
AACAGGTAGTATGGAT-1_V12D07-332_D1,0,0,1,2,0,3
GAACGCGGGTCACACG-1_V12D07-332_D1,0,0,0,2,0,2
TGTTTGAGATCGTCAG-1_V12D07-332_D1,0,0,0,2,0,2
ATCTCGTGAGCGAAAC-1_V12D07-332_D1,0,1,0,2,0,3
CTGAGAAAGTTCGGCG-1_V12D07-332_D1,0,0,0,2,0,2
ATTACCACACTGCCTG-1_V12D07-332_D1,0,0,0,2,0,2
CTGCTGTCTAACGAGC-1_V12D07-332_D1,0,1,0,1,0,2
CGTGGAAGCCTCGTAC-1_V12D07-332_D1,0,0,0,0,0,0
GGACTCACAAATTAGG-1_V12D07-332_D1,0,1,1,1,0,3
CTTTGCTGTCATGGAT-1_V12D07-332_D1,0,1,0,2,0,3
GGTGTTGGGCGTCTTA-1_V12D07-332_D1,0,0,0,2,0,2
TACCATGTATTGATTT-1_V12D07-332_D1,0,1,0,3,0,4
GGTCTCCAAGTAGTGC-1_V12D07-332_D1,0,2,0,1,0,3
ATCCTTCTGAAAGAAC-1_V12D07-332_D1,0,0,0,0,0,0
CCGGAAGTTATCAGTC-1_V12D07-332_D1,0,0,0,0,0,0
GTGGGTACTGAGCGTA-1_V12D07-332_D1,1,3,1,0,0,5
CTTAAGCAGCGAGCCG-1_V12D07-332_D1,4,0,0,0,0,4
GCATTGACTTGCGGAA-1_V12D07-332_D1,3,2,0,0,0,5
CCATAACCTGTGCAGT-1_V12D07-332_D1,3,1,0,0,0,4
GGGCTACTATTTCGTG-1_V12D07-332_D1,4,2,0,0,0,6
GGCGAGCGAAACGGCA-1_V12D07-332_D1,1,2,1,0,0,4
GGAGACCATCTACATA-1_V12D07-332_D1,0,2,0,1,0,3
AGACCAAACCACACCT-1_V12D07-332_D1,2,2,0,2,0,6
CGACGCATCCGTACCT-1_V12D07-332_D1,0,0,0,0,0,0
CCTAGGTAAAGGTAGC-1_V12D07-332_D1,0,1,0,1,0,2
AGCGGCGGTTAGCGGT-1_V12D07-332_D1,0,3,3,0,0,6
CTGGACGCAGTCCGGC-1_V12D07-332_D1,0,4,10,0,0,14
AGCCTAATACCCACGT-1_V12D07-332_D1,2,3,5,0,0,10
AATCTGGCTTTCTAGT-1_V12D07-332_D1,1,3,9,0,0,13
CACCCTTGGTGAGACC-1_V12D07-332_D1,2,5,5,0,0,12
GGATCTTGACTCAACC-1_V12D07-332_D1,1,1,10,0,0,12
ACGAGGATACCACTCT-1_V12D07-332_D1,0,2,8,0,0,10
GAGTTGATGGCAATTT-1_V12D07-332_D1,0,9,1,0,0,10
GTGGCAAACAGCGGCA-1_V12D07-332_D1,0,4,2,0,0,6
GATGTAACGAACCACC-1_V12D07-332_D1,0,4,0,0,0,4
AGCCGTGGCTAAATGT-1_V12D07-332_D1,0,3,0,0,0,3
CTCCCTCCTTTCGATC-1_V12D07-332_D1,0,10,1,0,0,11
TTGGAAGAATACAGTC-1_V12D07-332_D1,0,3,3,0,0,6
AGTTAAGTCAACCGCT-1_V12D07-332_D1,0,7,0,0,0,7
CTCATGGTAATTTGCG-1_V12D07-332_D1,0,3,0,0,0,3
AAAGTAGCATTGCTCA-1_V12D07-332_D1,0,2,1,1,0,4
TTGTGGTAGGAGGGAT-1_V12D07-332_D1,0,3,1,0,0,4
AGTCGTGGGCATTACG-1_V12D07-332_D1,0,4,0,1,0,5
ACCTAAGTACCTTTCA-1_V12D07-332_D1,0,3,0,1,0,4
GTAGAGGGAGACAAGT-1_V12D07-332_D1,0,3,1,0,0,4
GATCCTCGACACTGGC-1_V12D07-332_D1,0,1,0,2,0,3
CCTACATTCACAGACG-1_V12D07-332_D1,0,1,1,0,0,2
TTGACCGTGTTAATGA-1_V12D07-332_D1,0,9,0,0,0,9
TCTGTTACCCAGCATA-1_V12D07-332_D1,1,3,1,3,0,8
CTAACTGGTCCGGTTC-1_V12D07-332_D1,0,2,0,1,0,3
AGCGACAGGAACGGTC-1_V12D07-332_D1,0,2,0,0,0,2
TAATAGAACAGAGTTA-1_V12D07-332_D1,0,6,1,1,0,8
ACAGGTGGAGGTGAGG-1_V12D07-332_D1,0,6,1,0,0,7
TGCGAGAATATTACCC-1_V12D07-332_D1,0,0,0,0,0,0
TTGCGTCGGCCAACCG-1_V12D07-332_D1,0,2,0,3,0,5
AGGCTTCCCGAAGAAG-1_V12D07-332_D1,0,2,0,0,0,2
GCGGACCGCGTTGTGG-1_V12D07-332_D1,0,3,0,0,0,3
GTAATCTGATTCTTCG-1_V12D07-332_D1,0,3,1,0,0,4
CCGCGGAATGCGTCAC-1_V12D07-332_D1,0,4,0,0,0,4
TTCCACACAGATTTGA-1_V12D07-332_D1,0,0,1,2,0,3
CTTCTATTAATGCTAG-1_V12D07-332_D1,0,2,1,0,0,3
CATTTGAGTGGTACGT-1_V12D07-332_D1,0,1,0,0,0,1
TCACAGCAAACTCGAA-1_V12D07-332_D1,0,0,0,0,0,0
CAGACGAACCTGATAC-1_V12D07-332_D1,0,3,0,1,0,4
TAGCTAGAAGGCATGA-1_V12D07-332_D1,0,0,0,0,0,0
ATCCAGAGCAACAACC-1_V12D07-332_D1,1,3,0,0,1,5
TCCGGTTCGTCCGGTC-1_V12D07-332_D1,0,0,1,2,0,3
CGCGCATGTTTGATTG-1_V12D07-332_D1,0,2,0,1,0,3
TGGCGATCAAGTTATG-1_V12D07-332_D1,0,0,0,0,0,0
CCCTTTGACAGGTCTT-1_V12D07-332_D1,1,0,0,0,0,1
CAGAGACGGTCACCCA-1_V12D07-332_D1,0,1,0,0,0,1
TAGCTCGCCTGATAAC-1_V12D07-332_D1,0,0,0,2,0,2
TTGTGTTTCCCGAAAG-1_V12D07-332_D1,0,0,0,1,0,1
TATACACAGACGCCTT-1_V12D07-332_D1,0,0,0,0,0,0
ACATTAGTTTATATCC-1_V12D07-332_D1,0,0,0,0,0,0
CCATCGCAGTTAAACT-1_V12D07-332_D1,0,0,0,3,0,3
AATTAGCGCTGCAGCG-1_V12D07-332_D1,0,0,0,0,0,0
TCCGCTTATCCCATTA-1_V12D07-332_D1,0,1,0,1,0,2
GTTTGGGCTTGTGAGC-1_V12D07-332_D1,0,0,0,1,0,1
CTTGTCAACATTCGAG-1_V12D07-332_D1,0,0,0,1,0,1
GGACCAACAGGATAAC-1_V12D07-332_D1,0,0,0,6,0,6
AAGCTAGATCGAGTAA-1_V12D07-332_D1,0,0,0,0,0,0
TACCGTGCCTCGGACC-1_V12D07-332_D1,0,1,0,5,0,6
GTAGCCAAACATGGGA-1_V12D07-332_D1,0,0,0,0,0,0
TGCCAGTACGTGGAGA-1_V12D07-332_D1,0,0,0,0,0,0
ATAAGGTGGAGAACAT-1_V12D07-332_D1,0,0,0,0,0,0
CTTTAATATTGGTCGA-1_V12D07-332_D1,1,0,0,1,0,2
TGGTTCAACGGGTAAT-1_V12D07-332_D1,0,0,0,1,0,1
GCTGCTACTGCGTAGC-1_V12D07-332_D1,0,0,0,0,0,0
CTGCACAACTACATAT-1_V12D07-332_D1,0,0,0,1,0,1
ATATTCCACATAGTGA-1_V12D07-332_D1,0,0,0,0,0,0
TGGCAAACTAAATTAC-1_V12D07-332_D1,0,0,0,0,0,0
ACCGCAATAACTGCCT-1_V12D07-332_D1,0,0,0,0,0,0
TCGCACCAGGAGGCAG-1_V12D07-332_D1,0,0,0,0,0,0
ACTTCAGGCTGATCCC-1_V12D07-332_D1,0,0,0,0,0,0
ACAAATCGCACCGAAT-1_V12D07-332_D1,0,0,0,1,0,1
TCTGATGTATTCTGTC-1_V12D07-332_D1,0,0,0,0,0,0
CTTTACCGAATAGTAG-1_V12D07-332_D1,0,0,0,0,1,1
GCAGATCCATAAGACT-1_V12D07-332_D1,0,4,1,0,3,8
TTCCTCGGACTAACCA-1_V12D07-332_D1,0,2,0,1,0,3
TTATCCGGGATCTATA-1_V12D07-332_D1,0,1,0,0,0,1
CTGGAAGACACGGTGG-1_V12D07-332_D1,0,0,0,0,2,2
GTTCGTCTAAAGAACT-1_V12D07-332_D1,0,0,0,0,2,2
GTCTATTGGTTCCGGT-1_V12D07-332_D1,0,3,0,0,1,4
CTAGGCGCCCTATCAG-1_V12D07-332_D1,0,1,0,1,0,2
AACGGACGTACGTATA-1_V12D07-332_D1,0,2,0,2,0,4
AACACACGCTCGCCGC-1_V12D07-332_D1,0,4,0,1,0,5
GCTACTATAGTAGAGT-1_V12D07-332_D1,0,3,0,1,0,4
AGCATATCAATATGCT-1_V12D07-332_D1,0,4,0,1,0,5
CGAACAGTATGGGCGT-1_V12D07-332_D1,0,3,0,2,0,5
ACAATTGTGTCTCTTT-1_V12D07-332_D1,0,3,0,0,0,3
GATCGCTACCCGATTT-1_V12D07-332_D1,0,1,0,1,0,2
ATTGCGATCAGTAACT-1_V12D07-332_D1,0,0,0,1,0,1
CAGCAGTCCAGACTAT-1_V12D07-332_D1,0,0,0,0,0,0
AGAGGCTTCGGAAACC-1_V12D07-332_D1,0,1,0,3,0,4
AAACAAGTATCTCCCA-1_V12D07-332_D1,2,0,0,1,2,5
GGCAGCAAACCTATGC-1_V12D07-332_D1,0,0,0,0,1,1
ACTAGTTGCGATCGTC-1_V12D07-332_D1,7,0,0,0,0,7
TTGGACCATCTGGCAA-1_V12D07-332_D1,15,0,0,1,0,16
CCCTCCTCGCTCGTAT-1_V12D07-332_D1,9,0,0,0,1,10
GAGCGCAAATACTCCG-1_V12D07-332_D1,1,1,0,0,0,2
ATTACATGTCAGTCTT-1_V12D07-332_D1,0,0,0,0,0,0
TTGGGACGTAAGAGTT-1_V12D07-332_D1,1,0,0,1,1,3
CTTCGGCCAATTGTTT-1_V12D07-332_D1,1,2,1,4,0,8
AGACCGCTCCGCGGTT-1_V12D07-332_D1,0,0,0,2,0,2
GACCGCGTCTGACGTG-1_V12D07-332_D1,0,1,0,1,0,2
CCAAATAACAAGATTC-1_V12D07-332_D1,0,3,0,1,0,4
TCTTTAGAGTCTAACA-1_V12D07-332_D1,0,3,0,2,0,5
CTCCCAATGAGTCGCG-1_V12D07-332_D1,0,0,0,1,0,1
TAGTCTTTCCGAATTG-1_V12D07-332_D1,0,0,0,2,0,2
GAGTAAACCGGAAAGT-1_V12D07-332_D1,0,1,1,0,0,2
GATCTCGACGCTGTGG-1_V12D07-332_D1,0,0,0,3,0,3
CTGACATAGAAATAGA-1_V12D07-332_D1,0,2,0,2,0,4
TATACCGAGTGCCACA-1_V12D07-332_D1,0,0,0,3,0,3
TCCGAACGTTGCCGCT-1_V12D07-332_D1,2,3,0,3,0,8
GCAGAAGGTAATCTCC-1_V12D07-332_D1,0,3,0,3,0,6
GGTACTAAGTGCTTTG-1_V12D07-332_D1,0,2,0,3,0,5
CAGAATATTCGTTATC-1_V12D07-332_D1,1,2,0,2,0,5
TAATCAACCAAATGGG-1_V12D07-332_D1,0,2,0,3,0,5
TCTGCTTAGAACAAGC-1_V12D07-332_D1,0,1,0,1,0,2
AACTGAGTTATACTGA-1_V12D07-332_D1,1,3,1,0,0,5
CAGATGTTTGTCCCAA-1_V12D07-332_D1,1,4,1,0,0,6
GTTTGTTAGCCAAGTA-1_V12D07-332_D1,3,3,1,0,0,7
ACGTGACAAAGTAAGT-1_V12D07-332_D1,9,2,0,0,0,11
TTGTCACCGCGGTATC-1_V12D07-332_D1,4,1,0,1,0,6
GATCTAACCGTATTCA-1_V12D07-332_D1,4,4,1,0,0,9
ATGGAAATTTAAGGAG-1_V12D07-332_D1,0,3,0,1,0,4
ATTGATCACCACATTT-1_V12D07-332_D1,0,0,0,0,0,0
ACTGCTCGGAAGGATG-1_V12D07-332_D1,0,0,0,0,0,0
TCTAAAGAACAGTCTC-1_V12D07-332_D1,0,1,0,0,0,1
CTGGGTTGAGTTAAAG-1_V12D07-332_D1,0,1,0,1,0,2
CCCAGTAAACTTGGGA-1_V12D07-332_D1,0,1,1,0,0,2
AGATTCACAACCGATA-1_V12D07-332_D1,0,6,8,0,0,14
AGAAGGTACACTTCAC-1_V12D07-332_D1,2,1,10,0,0,13
GCAGGAACTTAGATCT-1_V12D07-332_D1,2,1,10,0,0,13
AATCTAGGTTTACTTG-1_V12D07-332_D1,2,2,5,0,0,9
CCCGGTGTATCGGAAT-1_V12D07-332_D1,5,0,6,0,0,11
TTATCCTCAAGGAATA-1_V12D07-332_D1,5,3,4,0,0,12
AGCATCATTTCGAAAG-1_V12D07-332_D1,1,4,8,0,0,13
CGCGAGTCTGCCGGGT-1_V12D07-332_D1,0,12,2,0,0,14
TGCGTCATGACTGAGC-1_V12D07-332_D1,0,6,0,0,0,6
GTATGAAATTTCACTC-1_V12D07-332_D1,0,6,3,0,0,9
TTGGTTGCGGTGCGCG-1_V12D07-332_D1,1,5,1,0,0,7
ACAGAACTGAGAACAA-1_V12D07-332_D1,0,2,2,0,0,4
CTACTATCATAGGTTT-1_V12D07-332_D1,0,3,0,0,0,3
CCTCTATCGATTAGCA-1_V12D07-332_D1,0,4,0,1,0,5
CCGTATCTCGTCGTAG-1_V12D07-332_D1,0,0,2,2,0,4
TCACGATGTCCGTGGA-1_V12D07-332_D1,0,2,0,0,0,2
TCAACAAAGATAATTC-1_V12D07-332_D1,0,4,0,0,0,4
ATGACGCGTTCTATCC-1_V12D07-332_D1,0,4,0,0,0,4
ATTTGCGCGAGTAGCT-1_V12D07-332_D1,0,2,0,0,0,2
TTCTTGGACGATCTGC-1_V12D07-332_D1,0,3,0,0,0,3
AGACGACGATGCCGCT-1_V12D07-332_D1,0,3,1,0,0,4
GGTCTCTGAATGGACT-1_V12D07-332_D1,0,3,3,1,0,7
GCTCAATCCGTTTATT-1_V12D07-332_D1,0,2,0,2,0,4
CCAGAAAGCAACTCAT-1_V12D07-332_D1,0,3,0,2,0,5
CACCGTTAGGGATCAC-1_V12D07-332_D1,0,4,0,0,0,4
AATAACACTAGAACAA-1_V12D07-332_D1,0,3,0,0,0,3
CACCCGGTTTGTGACT-1_V12D07-332_D1,0,1,1,2,0,4
CCACCAACTTTACTGT-1_V12D07-332_D1,0,4,0,1,0,5
AACTCTCAGTGTGCTC-1_V12D07-332_D1,0,4,0,0,0,4
AAACCGTTCGTCCAGG-1_V12D07-332_D1,0,1,0,0,0,1
CAGCGATTCCCTTCAA-1_V12D07-332_D1,0,0,0,0,0,0
GCTAGCTTGAATAGCT-1_V12D07-332_D1,0,2,0,1,0,3
TTGCGGCATCAGAAAG-1_V12D07-332_D1,0,0,0,4,0,4
AATAGAACAGAGTGGC-1_V12D07-332_D1,0,3,2,1,0,6
GCCATCGAGCTGCGTG-1_V12D07-332_D1,0,3,0,0,0,3
ACACTGATCAAGGTGT-1_V12D07-332_D1,0,3,0,1,0,4
ACCAACGCTTATTTAT-1_V12D07-332_D1,0,4,0,0,0,4
GACATCGATTTATAAC-1_V12D07-332_D1,0,0,0,0,0,0
CAGACACCGATCGCTG-1_V12D07-332_D1,0,0,0,1,0,1
CCAAGAAAGTGGGCGA-1_V12D07-332_D1,0,0,0,0,0,0
GGTAGACCGTTGGGCG-1_V12D07-332_D1,0,0,0,0,0,0
TCGTTAGGAGTCCCTA-1_V12D07-332_D1,0,0,0,1,2,3
ACGGCCAACATGGACT-1_V12D07-332_D1,1,0,0,1,0,2
GTGAGTGGTACAACGC-1_V12D07-332_D1,0,0,0,1,1,2
GAGACTTCGCGACCGA-1_V12D07-332_D1,0,0,0,2,0,2
GAAGTCAGTTGCACTA-1_V12D07-332_D1,0,0,0,2,0,2
GTTTGGTAGGGTCAAC-1_V12D07-332_D1,0,0,0,1,0,1
ACGGCACTTGCTTGGG-1_V12D07-332_D1,0,0,0,2,0,2
CCTCTGTACTATTCTA-1_V12D07-332_D1,0,0,0,1,0,1
CTATTCATGTGTCCCA-1_V12D07-332_D1,0,0,0,1,0,1
GCCCGATCTGTGGTCG-1_V12D07-332_D1,0,0,0,1,0,1
TTAGAAGAACATGACT-1_V12D07-332_D1,0,0,0,0,0,0
AGGATAAAGTCGGGAT-1_V12D07-332_D1,0,0,0,1,0,1
CGGCAAACATCGTGCG-1_V12D07-332_D1,0,0,0,0,0,0
CTAGTTACAACCCGGT-1_V12D07-332_D1,0,0,0,0,0,0
TTCGACAGAGCCCGTG-1_V12D07-332_D1,1,0,0,0,0,1
AAGCATACTCTCCTGA-1_V12D07-332_D1,0,0,0,0,0,0
GACGACGATCCGCGTT-1_V12D07-332_D1,0,1,0,0,0,1
GGTAGAAGACCGCCTG-1_V12D07-332_D1,0,0,0,0,0,0
GAGATGGGAGTCGACA-1_V12D07-332_D1,1,0,0,0,0,1
AACGATAATGCCGTAG-1_V12D07-332_D1,0,0,0,1,0,1
TGGTCCCACGCTACGG-1_V12D07-332_D1,0,0,0,3,0,3
CTGCTTGGCGATAGCT-1_V12D07-332_D1,0,0,0,0,0,0
ATCGGAGACAGACGGC-1_V12D07-332_D1,0,0,0,1,0,1
TAGCGTCCGGTGTGGT-1_V12D07-332_D1,0,0,0,0,0,0
GTTGAGTCCCGCCGGT-1_V12D07-332_D1,0,0,0,2,0,2
AAATAGGGTGCTATTG-1_V12D07-332_D1,0,0,0,0,0,0
AAGTGTTTGGAGACGG-1_V12D07-332_D1,1,0,0,3,0,4
AGCACTACCTCACCAG-1_V12D07-332_D1,0,0,0,2,0,2
TGCCTTGGCCAGGCAA-1_V12D07-332_D1,0,1,0,3,0,4
TCGTCTTAGGCGTTAA-1_V12D07-332_D1,0,0,0,0,0,0
TTCTGACCGGGCTCAA-1_V12D07-332_D1,0,0,0,0,1,1
CAGAACTTAGCCCTCT-1_V12D07-332_D1,0,1,0,1,0,2
AGCTCCTTCGCACATC-1_V12D07-332_D1,0,0,0,0,0,0
ACAGGCTTGCCCGACT-1_V12D07-332_D1,0,1,0,0,0,1
GCTATACGTCTCGGAC-1_V12D07-332_D1,0,2,0,0,1,3
GAGCCAGCTACCTGTG-1_V12D07-332_D1,0,0,0,0,2,2
TGCTAAGTGTCTATTT-1_V12D07-332_D1,1,2,0,0,0,3
GTCCTACGAATAGTCT-1_V12D07-332_D1,0,1,0,2,0,3
CAGTGTCGGCTGGCCC-1_V12D07-332_D1,0,4,0,4,0,8
CTATCGACGAAATACA-1_V12D07-332_D1,0,5,1,2,0,8
CATCATTACCCTGAGG-1_V12D07-332_D1,0,6,0,0,0,6
TAAGTTGCGACGTAGG-1_V12D07-332_D1,0,4,0,0,0,4
AGTGCACGCTTAAGAA-1_V12D07-332_D1,0,0,0,0,0,0
TGTGCCGGTGCCGGAA-1_V12D07-332_D1,0,0,0,1,0,1
AGGAGGCCTTCGCGCG-1_V12D07-332_D1,0,1,0,0,0,1
TCCGCGGCCCAATGAA-1_V12D07-332_D1,0,0,0,0,0,0
TCCGTTAAGCTAATAT-1_V12D07-332_D1,0,0,0,2,0,2
AAATCTAGCCCTGCTA-1_V12D07-332_D1,0,1,0,0,0,1
CGCAGGCGATCCAAAC-1_V12D07-332_D1,0,0,0,3,0,3
CCATATGGAAACTATA-1_V12D07-332_D1,0,0,0,0,0,0
CACCGTATCCCATCCG-1_V12D07-332_D1,4,1,0,3,0,8
GGTCAAGACTACTTCG-1_V12D07-332_D1,5,0,0,0,1,6
CCCGTTTCGCAGATGT-1_V12D07-332_D1,18,0,0,2,0,20
GTTATAATACGGTGAA-1_V12D07-332_D1,5,0,1,2,3,11
ACTTGTGGATGGAACG-1_V12D07-332_D1,0,0,0,1,0,1
GTTCGCTGAGACGTCT-1_V12D07-332_D1,1,0,0,1,0,2
GACACTGGAACCCGAT-1_V12D07-332_D1,0,1,0,2,0,3
CCCAGGTCTGAAGGCT-1_V12D07-332_D1,0,3,0,0,0,3
TCTCGAGGAGGTTCGC-1_V12D07-332_D1,0,1,0,1,1,3
ACTATCTGCCCGCGTA-1_V12D07-332_D1,0,0,0,2,0,2
CCTAAATTGTATCCTA-1_V12D07-332_D1,0,0,0,3,0,3
AGAAATTATGACTCGC-1_V12D07-332_D1,0,0,0,0,0,0
TCCAGCGCTATAAGCG-1_V12D07-332_D1,0,2,0,0,0,2
TCGTGTATTGGTCACG-1_V12D07-332_D1,0,2,0,1,0,3
CCACATACTGCACCCA-1_V12D07-332_D1,0,1,0,1,0,2
GTTGCGGACGGTCAGG-1_V12D07-332_D1,1,1,0,0,0,2
GTATTTAATGGCATAA-1_V12D07-332_D1,0,0,0,2,0,2
GTCGATAGGTGACTTT-1_V12D07-332_D1,0,0,0,3,0,3
AATAATCTTCGTATCG-1_V12D07-332_D1,0,0,1,2,0,3
ATTGTTCAACGATCCG-1_V12D07-332_D1,0,0,0,1,0,1
GTGCAGCGTAGAGTAG-1_V12D07-332_D1,0,1,0,3,0,4
TGTGGTAGGGTGCCTT-1_V12D07-332_D1,0,1,0,1,0,2
TGTGGACTATCTACGT-1_V12D07-332_D1,0,0,0,3,0,3
GGCGGGCTCTAAGAGT-1_V12D07-332_D1,0,0,0,2,0,2
GCAAGCTGGAAACCGC-1_V12D07-332_D1,2,0,0,0,0,2
GATATCAAGCAGGAGC-1_V12D07-332_D1,8,4,0,0,0,12
CACCAATCATCCGTCT-1_V12D07-332_D1,3,1,1,0,0,5
CCACATGGCTCTTTAT-1_V12D07-332_D1,3,0,0,0,0,3
GTCCTACTCTACGGGC-1_V12D07-332_D1,1,2,0,0,0,3
CTCGAGACATACGATA-1_V12D07-332_D1,3,1,4,0,0,8
TATCAGTGGCGTAGTC-1_V12D07-332_D1,2,3,1,1,0,7
TGACAGGACAAGTCCA-1_V12D07-332_D1,0,1,0,2,0,3
TATTAACACCAAAGCA-1_V12D07-332_D1,0,0,0,0,0,0
TAGGCGATGAGGTCTC-1_V12D07-332_D1,0,0,1,1,0,2
CCGCCGGAACTTCTCG-1_V12D07-332_D1,0,1,1,0,0,2
GCCATTAGCCTCAAAC-1_V12D07-332_D1,0,4,2,0,0,6
GTTAGGCTACCCGTTT-1_V12D07-332_D1,1,0,9,0,0,10
GGGTATTCTAGCAAAC-1_V12D07-332_D1,1,1,9,0,0,11
GCCCTAGCCGTCGCGA-1_V12D07-332_D1,2,0,6,0,0,8
CAGATCCTGGTTTGAA-1_V12D07-332_D1,6,3,3,0,0,12
CTTCAGTGGTCGCCTA-1_V12D07-332_D1,3,7,2,0,0,12
GGGCAACCGCACGTGC-1_V12D07-332_D1,10,1,1,0,0,12
GACCCAATTATGATAC-1_V12D07-332_D1,1,5,2,0,0,8
GAAGCTCGGACCCGTC-1_V12D07-332_D1,0,7,2,0,0,9
CGTCGGGTCTAAGCGC-1_V12D07-332_D1,0,6,0,1,0,7
GAGGCCCGACTCCGCA-1_V12D07-332_D1,0,2,0,1,0,3
TTGCCATAGCCCGCTC-1_V12D07-332_D1,0,7,0,1,0,8
TAACATACACGCGATC-1_V12D07-332_D1,0,4,0,0,0,4
CCGACGGGCATGAGGT-1_V12D07-332_D1,0,3,0,0,0,3
AATGTGCCCGAGGTGT-1_V12D07-332_D1,0,6,2,0,0,8
AGCTGTAACCTCAATC-1_V12D07-332_D1,0,1,0,0,0,1
CGAGTGAAGGTACCAG-1_V12D07-332_D1,0,2,0,0,0,2
AGTCTCACAAGACTAC-1_V12D07-332_D1,0,4,0,0,0,4
AAATTGATAGTCCTTT-1_V12D07-332_D1,0,0,0,1,0,1
TAAGTCGCCGAGTATC-1_V12D07-332_D1,0,4,0,0,0,4
GCGGAGAAACTTCGCA-1_V12D07-332_D1,0,0,0,3,0,3
GGCAAAGGCGCCAATA-1_V12D07-332_D1,0,3,0,2,0,5
ATTTCCGGGTTCTGCG-1_V12D07-332_D1,0,3,0,1,0,4
TAAACCCAGGAGGGCA-1_V12D07-332_D1,0,2,0,4,0,6
TTCGGGCGCTAGTCTT-1_V12D07-332_D1,0,2,0,1,0,3
GTGGAGTCGGCGGTTG-1_V12D07-332_D1,0,4,0,1,0,5
GCACGCCTACTTAGAT-1_V12D07-332_D1,0,7,0,2,0,9
CAATATTCTTGACCTA-1_V12D07-332_D1,0,2,0,0,0,2
CGTTTGTGTAGAGGGT-1_V12D07-332_D1,0,1,0,0,0,1
CATAGCGTTGCCCACC-1_V12D07-332_D1,0,2,0,0,0,2
TGATACATTTAGCCGT-1_V12D07-332_D1,0,5,0,1,0,6
TTCCGGCCTTGAGGCT-1_V12D07-332_D1,0,0,1,1,0,2
CCTATACCGTCCTGTC-1_V12D07-332_D1,0,5,0,1,0,6
TCGTTGCTATCCGGTC-1_V12D07-332_D1,0,2,0,1,0,3
TGGCGACTGCTCCAAA-1_V12D07-332_D1,0,5,0,0,0,5
CAGAGGCGATGCATGA-1_V12D07-332_D1,0,1,0,1,1,3
TCACAGGAGAATAAGA-1_V12D07-332_D1,1,1,0,0,2,4
GGGTTAACATTTGAGT-1_V12D07-332_D1,1,0,0,0,0,1
GCGGGCGAGCCTTACC-1_V12D07-332_D1,0,0,0,0,1,1
TGCCAATGGGTACTCT-1_V12D07-332_D1,1,0,0,0,0,1
AGGGACTCTACGCGAC-1_V12D07-332_D1,0,0,0,1,1,2
GACGCCGTAAAGGCTA-1_V12D07-332_D1,0,0,0,0,0,0
AAAGGCTCTCGCGCCG-1_V12D07-332_D1,0,0,0,0,0,0
CTGGCTGGTTGTCAGT-1_V12D07-332_D1,0,0,0,1,0,1
ACATCCCGGCCATACG-1_V12D07-332_D1,1,1,0,0,0,2
CTCTTGTCCCGCTTGG-1_V12D07-332_D1,0,0,0,3,0,3
TACGCCTCCATTCCGA-1_V12D07-332_D1,0,0,0,1,0,1
CGGAGCAATTTAATCG-1_V12D07-332_D1,0,0,0,1,0,1
AACTAGGCTTGGGTGT-1_V12D07-332_D1,0,0,0,3,0,3
GCGTCGCCAGGGTGAT-1_V12D07-332_D1,1,0,0,2,0,3
GTTGGTCATGCTATCC-1_V12D07-332_D1,0,0,0,0,0,0
GCTGGCGGCGCATGCT-1_V12D07-332_D1,0,0,0,2,0,2
TGAGCGGAAAGTGTTC-1_V12D07-332_D1,0,2,0,3,0,5
CTTTCTGTGCGGGCTT-1_V12D07-332_D1,0,0,0,0,0,0
ATCTAATATCCTACGG-1_V12D07-332_D1,1,3,0,2,0,6
AACCTTTAAATACGGT-1_V12D07-332_D1,0,2,0,1,0,3
TTCACTCGAGCACCTA-1_V12D07-332_D1,0,0,0,2,0,2
CTGCACTCCAGTACAG-1_V12D07-332_D1,0,0,0,2,0,2
CCATTTCTACCTATTA-1_V12D07-332_D1,1,0,0,0,0,1
CAAGCGGCACATAATT-1_V12D07-332_D1,0,1,0,4,0,5
GTTAACATCACTTAAA-1_V12D07-332_D1,0,0,0,0,0,0
ATATAAATGTAGCTGC-1_V12D07-332_D1,0,0,0,0,0,0
GCCTCTATACATAGCA-1_V12D07-332_D1,2,0,0,4,0,6
GTGTCGTATAGCGTTC-1_V12D07-332_D1,0,0,0,1,0,1
ATACGTACTTAGCCAC-1_V12D07-332_D1,1,0,0,0,0,1
GCTATCATACTCATGG-1_V12D07-332_D1,0,0,0,1,0,1
TATCCAATTGGTTATC-1_V12D07-332_D1,0,1,0,0,0,1
TCTCCCTGGGCAGCGT-1_V12D07-332_D1,0,0,0,0,0,0
CCTATAATGAGTGCCC-1_V12D07-332_D1,0,1,0,0,0,1
CAATGCGAGAAGTATC-1_V12D07-332_D1,0,0,0,0,0,0
TACCAATAAAGTACCA-1_V12D07-332_D1,1,3,0,0,0,4
GCTAGGCACCACGGAG-1_V12D07-332_D1,0,1,0,2,0,3
GGTGGACTGCTCTGGC-1_V12D07-332_D1,0,0,0,1,1,2
TATTCCGAGCTGTTAT-1_V12D07-332_D1,0,4,0,1,0,5
TTGAGAAGTTTAGCAT-1_V12D07-332_D1,0,0,0,1,3,4
GTCCGGACCTGAAATT-1_V12D07-332_D1,0,0,0,1,0,1
CTGTGGTCGGGAGATA-1_V12D07-332_D1,1,0,0,1,1,3
CATGTAAGAGACATTT-1_V12D07-332_D1,0,1,0,0,1,2
CACGTTTCGTACACAC-1_V12D07-332_D1,0,2,0,1,1,4
CATCCTCTCAAAGATC-1_V12D07-332_D1,0,8,0,1,0,9
GATTAACCGAAAGCCC-1_V12D07-332_D1,0,3,0,1,0,4
AACGCTGTTGCTGAAA-1_V12D07-332_D1,0,10,1,1,0,12
TTCAGCTGGCGTGCCC-1_V12D07-332_D1,0,3,0,1,0,4
TAGAGGTTCTACTTGT-1_V12D07-332_D1,0,0,0,0,0,0
GTATCAAACGTTAGCT-1_V12D07-332_D1,0,2,0,2,0,4
AATCATGTAAAGACTC-1_V12D07-332_D1,0,2,0,3,0,5
AGTCACTAGCTCTCGA-1_V12D07-332_D1,0,4,0,4,0,8
GCGAAACGATCGGGAG-1_V12D07-332_D1,0,1,0,5,0,6
CATGGATTGTCTTCCG-1_V12D07-332_D1,0,0,0,0,0,0
ATTGGATTACAGCGTA-1_V12D07-332_D1,0,0,0,0,0,0
CACACACGCTAACGAG-1_V12D07-332_D1,0,0,0,1,0,1
CTATGGGAAGCGGAAT-1_V12D07-332_D1,0,0,0,2,0,2
TGCCTAATTGAAGATT-1_V12D07-332_D1,2,0,0,1,0,3
TGGCAATGGGACGGCG-1_V12D07-332_D1,15,0,0,1,0,16
ACCTCCGCCCTCGCTG-1_V12D07-332_D1,22,0,0,1,0,23
CGGCAATAAGATCGCC-1_V12D07-332_D1,1,1,0,0,1,3
CCTTGACCACTTTATT-1_V12D07-332_D1,0,1,0,2,1,4
TCATTTAGAAGTGTGA-1_V12D07-332_D1,0,1,0,2,0,3
CAGAATAACACACGGA-1_V12D07-332_D1,0,1,0,1,0,2
TCTGAGCAATTGACTG-1_V12D07-332_D1,0,0,0,3,0,3
CAACGTGGTGGAGTCT-1_V12D07-332_D1,0,0,0,1,0,1
CACAGTTCGCTTCCCA-1_V12D07-332_D1,0,0,0,0,0,0
TCTCTCGCCGCACATA-1_V12D07-332_D1,0,0,0,1,0,1
TGGGCAGGCCACCGCA-1_V12D07-332_D1,0,1,0,2,0,3
CTCCTGTTCAAGGCAG-1_V12D07-332_D1,0,0,1,2,0,3
TATTTGATTTGCACAG-1_V12D07-332_D1,0,0,0,3,0,3
GCCACTCCTTACGGTA-1_V12D07-332_D1,0,0,0,0,0,0
ACCGATATTTAATCAT-1_V12D07-332_D1,0,0,0,1,0,1
TTATTATCTGGAAGGC-1_V12D07-332_D1,0,0,0,1,0,1
TACATGCCGGAATTGT-1_V12D07-332_D1,0,0,0,1,0,1
GGCACTCAGCCGACCC-1_V12D07-332_D1,0,1,0,1,0,2
AAACCGGAAATGTTAA-1_V12D07-332_D1,0,0,0,4,0,4
AGACAGGCATCTCAGC-1_V12D07-332_D1,0,1,0,2,1,4
GTGGTGATGGTTTGTG-1_V12D07-332_D1,0,0,1,1,0,2
CCGATATGACGTAAGG-1_V12D07-332_D1,1,0,0,2,0,3
ACTTCCAGTGGAAGCT-1_V12D07-332_D1,3,1,1,0,0,5
CAATTGGGCCGCACTC-1_V12D07-332_D1,4,2,1,0,0,7
AAATCGCGGAAGGAGT-1_V12D07-332_D1,6,1,0,0,0,7
ATATCAATTCCAGCCT-1_V12D07-332_D1,4,4,1,0,0,9
CTTTGTCGAATGCTCC-1_V12D07-332_D1,4,2,1,0,0,7
TGAGGCATGTACTGTG-1_V12D07-332_D1,1,1,0,2,0,4
TTCGCCGCTCGCGCTA-1_V12D07-332_D1,0,1,0,0,0,1
GACTCCTTCCAATTGA-1_V12D07-332_D1,0,1,0,1,0,2
ACCGAAGAGTCTGGTT-1_V12D07-332_D1,0,2,1,1,0,4
TGGCATGAAGTTTGGG-1_V12D07-332_D1,0,0,0,0,0,0
ACGAGGTTTACAACGT-1_V12D07-332_D1,0,4,0,1,0,5
AACCCATCCCATGATC-1_V12D07-332_D1,1,3,8,0,0,12
TCGACAACTGAACCCG-1_V12D07-332_D1,4,4,4,0,0,12
TATCTTGCAATACAAC-1_V12D07-332_D1,8,4,2,0,0,14
TATTATGTTTGCCTGC-1_V12D07-332_D1,1,2,2,0,0,5
GTCAAAGAAGTGGTGT-1_V12D07-332_D1,11,4,0,0,0,15
GGGACAGAGTTACTCC-1_V12D07-332_D1,11,2,0,0,0,13
AGCAACCGAAAGTAAT-1_V12D07-332_D1,9,3,2,0,0,14
CTCTCTAACTGCCTAG-1_V12D07-332_D1,0,5,2,0,0,7
ATACGGAACGTCGTTT-1_V12D07-332_D1,0,5,0,3,0,8
TCGGTCCCGACAATAG-1_V12D07-332_D1,0,4,1,0,0,5
CGCGCAAATGTCCAGA-1_V12D07-332_D1,0,3,1,1,0,5
TCTAATACTGCCTCAG-1_V12D07-332_D1,0,3,0,0,0,3
CTCGGTTGTCGGCCCT-1_V12D07-332_D1,0,2,0,1,0,3
GGTAACCGGGAGGATA-1_V12D07-332_D1,0,4,2,1,0,7
CAGGCGCACGGTGGTC-1_V12D07-332_D1,0,7,0,0,0,7
TCATCGATGGTCCCAA-1_V12D07-332_D1,0,2,0,1,0,3
CAAAGATTATTGGGCC-1_V12D07-332_D1,0,2,0,0,0,2
ACAATGAATACGGAGA-1_V12D07-332_D1,0,4,1,0,0,5
GCTCCTGACATACTGG-1_V12D07-332_D1,0,2,0,1,0,3
GATGACAAGTAGGGCA-1_V12D07-332_D1,0,0,0,1,0,1
TACGCCGAGGGTACCC-1_V12D07-332_D1,0,2,1,1,0,4
AAGCGTCCCTCATCGA-1_V12D07-332_D1,0,4,0,0,0,4
CACTCCTATGTAAGAT-1_V12D07-332_D1,0,3,0,2,0,5
TCGAGCCAGGCAGGCC-1_V12D07-332_D1,0,7,0,1,0,8
TCGTCAAGTACGCGCA-1_V12D07-332_D1,0,3,0,1,0,4
CCCGTAGCTGGGAAGA-1_V12D07-332_D1,0,4,0,0,0,4
ACCCTATGCCATATCG-1_V12D07-332_D1,0,3,0,3,0,6
GTGGTATAGTCTGCCG-1_V12D07-332_D1,0,7,0,2,0,9
CCGGTTTGTAATTGTG-1_V12D07-332_D1,0,1,0,0,0,1
GTCGCCGTTGTGTGTT-1_V12D07-332_D1,0,5,0,0,0,5
TACTGAACAGATTTAG-1_V12D07-332_D1,0,2,0,0,0,2
TATTAACCTGACCGCG-1_V12D07-332_D1,0,3,0,2,0,5
CTGTAGCCATCTCACT-1_V12D07-332_D1,0,0,0,2,0,2
TACTATGGTTCCTCAG-1_V12D07-332_D1,1,1,0,3,0,5
GAGTCAGACCAGAATC-1_V12D07-332_D1,0,0,0,1,0,1
TAAGGCATAACATCAA-1_V12D07-332_D1,0,0,0,4,1,5
CTTCCGCTCCGTGAAG-1_V12D07-332_D1,0,1,0,0,0,1
GGGCTATGATCGATGG-1_V12D07-332_D1,1,5,0,1,1,8
GGTCGGTCGTCCACAG-1_V12D07-332_D1,0,0,0,0,0,0
GGGACCCGTATATCTT-1_V12D07-332_D1,0,1,0,0,0,1
GAAAGCAGTGCACTTT-1_V12D07-332_D1,1,1,0,1,0,3
AGCGCATAATGAATCG-1_V12D07-332_D1,0,1,0,1,1,3
GCTGCTAAGTAGTCGA-1_V12D07-332_D1,0,0,0,0,0,0
AATAGTCCGTCCCGAC-1_V12D07-332_D1,0,1,0,2,0,3
AGCAGCCAGATGAATA-1_V12D07-332_D1,0,0,0,0,0,0
CCTCGCGCTGTGCGAT-1_V12D07-332_D1,0,0,0,0,0,0
TTGTGTATGCCACCAA-1_V12D07-332_D1,0,0,0,1,0,1
TGCTCGGCGAAACCCA-1_V12D07-332_D1,1,0,0,1,0,2
CGATTAAATATCTCCT-1_V12D07-332_D1,0,0,0,2,0,2
TGCCGTGGATCGTCCT-1_V12D07-332_D1,0,0,1,2,0,3
GTGGACGCATTTGTCC-1_V12D07-332_D1,0,0,0,0,0,0
ACCCGGAAACTCCCAG-1_V12D07-332_D1,0,0,0,1,0,1
CCGCATGTGGTACGAT-1_V12D07-332_D1,0,0,0,2,0,2
GCAAACCTTGGCCATA-1_V12D07-332_D1,0,1,0,1,0,2
ATTCACTGATGTTGGA-1_V12D07-332_D1,0,0,0,0,0,0
ACTCCCTAATGCTAAA-1_V12D07-332_D1,0,1,0,0,0,1
TCCTAAATTGGGAAGC-1_V12D07-332_D1,0,1,0,0,0,1
GAACAGATTACTAAAT-1_V12D07-332_D1,0,0,0,0,0,0
ATACAGGCCCTCCAAT-1_V12D07-332_D1,1,0,0,3,0,4
CGATTCGCCTGGCTGC-1_V12D07-332_D1,3,0,0,2,0,5
TCCGCCTGTCTACAAG-1_V12D07-332_D1,0,0,0,0,0,0
CACATCTCACCGACGA-1_V12D07-332_D1,0,0,0,0,0,0
CGTCGTCCTTCGCGAA-1_V12D07-332_D1,0,0,0,0,0,0
CGTTGAATACCGCGCT-1_V12D07-332_D1,0,0,0,0,0,0
ACCAATATGCAAGTTA-1_V12D07-332_D1,0,0,0,0,0,0
ACGGATGGTGCGGATA-1_V12D07-332_D1,0,0,0,0,0,0
CACCCTAACAAGATCT-1_V12D07-332_D1,0,0,0,0,0,0
AAGCTCTTTCATGGTG-1_V12D07-332_D1,0,0,0,0,0,0
CATGGGTATGCCTTAT-1_V12D07-332_D1,0,0,0,0,0,0
GCGCGTCATTGGTACA-1_V12D07-332_D1,0,0,0,0,0,0
TCTGAAGCACGTGGTC-1_V12D07-332_D1,0,0,0,0,0,0
AAGTTCACTCCAAGCT-1_V12D07-332_D1,0,2,0,0,0,2
TTGGACCTATAACAGT-1_V12D07-332_D1,1,0,0,0,1,2
ATCAGCCTCATGCTGC-1_V12D07-332_D1,1,1,0,4,2,8
AGTACTCTTATGCCCA-1_V12D07-332_D1,0,1,0,0,0,1
GCGCTTAAATAATTGG-1_V12D07-332_D1,0,5,0,0,2,7
TTGTGAACCTAATCCG-1_V12D07-332_D1,0,1,0,0,1,2
AGTCGTCGACCACCAA-1_V12D07-332_D1,0,0,0,1,0,1
TCCTTTAAATCCGCTT-1_V12D07-332_D1,0,4,0,3,0,7
ACTGAAACGCCGTTAG-1_V12D07-332_D1,0,5,0,1,0,6
GCACACACTGGTAGCC-1_V12D07-332_D1,0,4,0,2,0,6
TAAGGGCCTGTCCGAT-1_V12D07-332_D1,0,3,0,1,0,4
GCTAGAGTAGAGATGT-1_V12D07-332_D1,1,2,1,1,0,5
CACAGGGCCATATAGT-1_V12D07-332_D1,0,2,0,1,0,3
CCATGCCCTAGATTTC-1_V12D07-332_D1,0,0,0,0,0,0
TCGCGTAGCAGTGTCC-1_V12D07-332_D1,0,1,0,0,0,1
GACGAGGCTAATAAAC-1_V12D07-332_D1,0,0,0,0,0,0
CTACACTCGCAGATGG-1_V12D07-332_D1,0,0,0,3,0,3
ACGCATACGTTTACTA-1_V12D07-332_D1,0,0,0,2,0,2
GGAGCAACATTTCAAG-1_V12D07-332_D1,0,0,0,0,0,0
CGAGAGGGTAGCCGCG-1_V12D07-332_D1,0,0,0,0,0,0
TCGTGTTCGACCACAA-1_V12D07-332_D1,0,0,0,1,0,1
TCTACCCAATAGAGAG-1_V12D07-332_D1,3,0,0,0,1,4
ATAAACGTTGCACCAC-1_V12D07-332_D1,17,0,0,0,0,17
TCAACTGCAGAGTCAG-1_V12D07-332_D1,12,0,0,2,0,14
AGCTCCATATATGTTC-1_V12D07-332_D1,2,0,0,1,0,3
GTAACATCTAAGATAA-1_V12D07-332_D1,0,1,0,0,0,1
CCGACAATAGGCCGCC-1_V12D07-332_D1,0,0,0,1,0,1
ATGCTTAGGAGTTGAT-1_V12D07-332_D1,1,1,0,1,0,3
AACCCGAGCAGAATCG-1_V12D07-332_D1,0,2,0,1,0,3
CGGGTTTGTTAGGGCT-1_V12D07-332_D1,0,0,0,2,0,2
AGGCACGTGACTGTCC-1_V12D07-332_D1,0,3,0,2,0,5
GACAAGAGATGAGATT-1_V12D07-332_D1,0,1,0,1,0,2
AGCCCTTGGACATCCC-1_V12D07-332_D1,0,2,0,1,0,3
GCAGTTCGATCCGAGC-1_V12D07-332_D1,0,2,0,1,0,3
TCGAGGGCAACAGACG-1_V12D07-332_D1,0,1,0,0,0,1
ACTTTGTCGACGCACT-1_V12D07-332_D1,2,2,0,1,0,5
GAGTATCAAAGTTACA-1_V12D07-332_D1,1,3,0,1,0,5
CCAGGCTGGCGTCTGA-1_V12D07-332_D1,0,1,0,0,0,1
GGACTCTTCCGGTTGA-1_V12D07-332_D1,0,3,0,3,0,6
TCCCAGCACACGACAT-1_V12D07-332_D1,1,3,0,0,1,5
GCTCCATGAGTGCAGA-1_V12D07-332_D1,0,2,0,0,0,2
GCAGTGCGGGCGGATG-1_V12D07-332_D1,0,0,0,1,0,1
GCGTTCTGACTAAGCG-1_V12D07-332_D1,0,0,0,4,0,4
GAGTTCTGTGGGTGCT-1_V12D07-332_D1,3,3,0,0,0,6
AAACGAAGATGGAGTA-1_V12D07-332_D1,4,1,1,0,0,6
AATTACGAGACCCATC-1_V12D07-332_D1,8,2,2,0,0,12
CCTTTGAATTATGGCT-1_V12D07-332_D1,3,3,2,0,0,8
CATGGTATTAGTTTGT-1_V12D07-332_D1,2,3,0,0,0,5
AACGAAAGTCGTCCCA-1_V12D07-332_D1,4,2,1,2,0,9
ACATAAGTCGTGGTGA-1_V12D07-332_D1,0,2,0,0,0,2
GCACAACCTCGGGCGT-1_V12D07-332_D1,0,2,0,1,0,3
ATGCACGCGCTGTTCA-1_V12D07-332_D1,0,3,0,0,0,3
CGATGTTGTTATCTAC-1_V12D07-332_D1,0,2,0,1,0,3
GTCTCCTGCCAGTATG-1_V12D07-332_D1,0,2,2,0,0,4
GATGCCTTCTGCGGCA-1_V12D07-332_D1,1,7,7,1,0,16
ACCGGTCAGGTACACC-1_V12D07-332_D1,7,4,8,0,0,19
GTGGAGCGTTTACCGA-1_V12D07-332_D1,13,1,3,0,0,17
AGGCGGTTTGTCCCGC-1_V12D07-332_D1,6,4,2,0,0,12
TCCCTGGCGTATTAAC-1_V12D07-332_D1,7,2,5,0,0,14
AAACACCAATAACTGC-1_V12D07-332_D1,15,0,0,0,0,15
TGGACGCAATCCAGCC-1_V12D07-332_D1,11,5,1,0,0,17
GGAACCTTGACTCTGC-1_V12D07-332_D1,0,2,0,0,0,2
GTATCTCAGTCTTGAC-1_V12D07-332_D1,0,3,0,0,0,3
GCTGAATCTTCCAATC-1_V12D07-332_D1,0,5,1,0,0,6
AGATGCAAGACGTGCA-1_V12D07-332_D1,0,3,0,0,0,3
TTAAGGCCCGTACTTT-1_V12D07-332_D1,0,3,0,0,0,3
AGTATGCTGGAGACCA-1_V12D07-332_D1,0,4,0,0,0,4
GCGGCAAAGTATTGCC-1_V12D07-332_D1,0,3,0,1,0,4
GCGCAAATATATTCAA-1_V12D07-332_D1,0,6,0,0,0,6
GAAGAAACGATATTGT-1_V12D07-332_D1,0,7,0,0,0,7
GGACCTCTAGGCCGCC-1_V12D07-332_D1,0,2,2,0,0,4
AACAGCTGTGTGGCAA-1_V12D07-332_D1,0,2,0,0,0,2
TCGAATATCCCGCAGG-1_V12D07-332_D1,0,2,0,0,0,2
GCGACCCAACCATCTG-1_V12D07-332_D1,0,2,0,1,0,3
AGAGAAGGAGTACAAT-1_V12D07-332_D1,1,4,1,0,0,6
GGCTCCTCCACCTGTT-1_V12D07-332_D1,0,4,0,1,0,5
TCAGTGTATACGTCAT-1_V12D07-332_D1,0,5,1,2,0,8
ATTATTATGTCCGTCA-1_V12D07-332_D1,0,2,0,2,0,4
TTAGGTCATAACCGAC-1_V12D07-332_D1,0,1,0,1,0,2
AAGATGGCACCGGACC-1_V12D07-332_D1,0,5,1,0,0,6
CTACAAGAAATAACCC-1_V12D07-332_D1,0,3,0,0,0,3
ACTATTTCCGGGCCCA-1_V12D07-332_D1,0,5,0,0,0,5
TTGTTTCACATCCAGG-1_V12D07-332_D1,0,1,0,0,0,1
CGCTGTGTGGATGTTG-1_V12D07-332_D1,0,3,1,1,0,5
TCAACATAGCGCCCTA-1_V12D07-332_D1,0,2,0,0,0,2
GGCCGTTTGGGTTTCA-1_V12D07-332_D1,0,3,0,0,0,3
TACTCTTTCGTCTTCA-1_V12D07-332_D1,0,1,0,1,0,2
TTCGCGCGCCATACGA-1_V12D07-332_D1,0,2,0,1,0,3
CGGAAAGAATCAAACG-1_V12D07-332_D1,1,2,0,0,0,3
AGGCAGGGAGCGTACT-1_V12D07-332_D1,0,2,0,0,0,2
CCTTTAAGGGAGCACT-1_V12D07-332_D1,0,1,0,1,1,3
CGCCCAGCACGCCTAG-1_V12D07-332_D1,0,0,0,0,0,0
AGTATTTGGCACGACC-1_V12D07-332_D1,0,1,0,1,2,4
TATCCGCACCGTCGGG-1_V12D07-332_D1,0,1,0,3,0,4
ACCCGTGTCATCAGTA-1_V12D07-332_D1,0,0,0,1,0,1
CAACTGCTCATCCGAT-1_V12D07-332_D1,1,0,0,0,0,1
CCGGAGCGTACTTTCT-1_V12D07-332_D1,0,0,0,0,0,0
TACCGTAGGTTAACTA-1_V12D07-332_D1,0,0,0,2,0,2
TGAGGAGTGCCAGCTT-1_V12D07-332_D1,1,1,0,0,0,2
CCAGTCTTGTCATAGA-1_V12D07-332_D1,2,0,0,0,0,2
GGGCAGAGCAATCGTT-1_V12D07-332_D1,1,0,0,1,0,2
TACCAAATAGCCCAGA-1_V12D07-332_D1,0,2,0,1,0,3
TACCTACTCCCAGTAT-1_V12D07-332_D1,0,0,0,0,0,0
TGTGAGACTAGCCCAA-1_V12D07-332_D1,0,0,0,0,0,0
ATACCTAACCAAGAAA-1_V12D07-332_D1,0,0,0,0,0,0
GTCGGGAAGCAGAAAC-1_V12D07-332_D1,0,0,0,1,0,1
AATTAACGGATTTCCA-1_V12D07-332_D1,0,0,0,0,0,0
GAACCCTCTGTGTTCT-1_V12D07-332_D1,0,0,0,0,0,0
ATATAAAGCGCTCGTG-1_V12D07-332_D1,0,0,0,0,0,0
CCTGGTCGAATGTGGG-1_V12D07-332_D1,0,0,0,1,0,1
CTAGGTTCGGACGTGA-1_V12D07-332_D1,0,2,0,2,0,4
TCGGGAGACAGCGTAC-1_V12D07-332_D1,0,1,0,0,0,1
CATAAGAAGCTTGGCT-1_V12D07-332_D1,3,0,0,1,0,4
AAGCACCCTGCGTATC-1_V12D07-332_D1,0,0,0,0,0,0
AGTTTGCACCTGCCTC-1_V12D07-332_D1,1,1,0,1,0,3
GACTGCAAATCGAGCT-1_V12D07-332_D1,0,0,0,0,0,0
GTGTATATCAGCGGGC-1_V12D07-332_D1,0,0,0,0,0,0
CTTCAACTCCACTTGG-1_V12D07-332_D1,0,0,0,0,0,0
ACTTACGCATCCACGC-1_V12D07-332_D1,0,0,0,0,0,0
CATGAGATGCACTCTC-1_V12D07-332_D1,0,0,0,0,0,0
GAGCACCTGTGTCCAG-1_V12D07-332_D1,0,0,0,0,0,0
CGCGACCGCGACAGAT-1_V12D07-332_D1,1,0,0,0,0,1
GTCCCGCGACGTTATG-1_V12D07-332_D1,0,0,0,0,0,0
GCAGTGTGGCTATAGG-1_V12D07-332_D1,0,0,0,1,0,1
ATACTGCCTTACACCG-1_V12D07-332_D1,0,0,0,1,1,2
TACAGAAACGGTGGGC-1_V12D07-332_D1,0,0,0,1,0,1
GGCGCGGAGATCTTTC-1_V12D07-332_D1,0,1,0,0,0,1
CGTTAATGTCCCGACG-1_V12D07-332_D1,0,0,0,0,0,0
GCTAACTGAAGTCTGA-1_V12D07-332_D1,0,0,0,2,2,4
AGTGATAACCTGCGCG-1_V12D07-332_D1,0,1,0,1,1,3
TATGATCTTCTCTTTA-1_V12D07-332_D1,0,1,0,1,1,3
TGTACCTACACGAGGG-1_V12D07-332_D1,0,0,0,0,2,2
ATATCGTTCCTCGAAC-1_V12D07-332_D1,0,6,0,2,0,8
CGGCGCCATCAATCCC-1_V12D07-332_D1,0,6,1,0,0,7
CCTGTTTGAAGACACG-1_V12D07-332_D1,0,4,0,2,0,6
GCCACTCAGAGCGCGA-1_V12D07-332_D1,0,4,0,1,0,5
TCGGCTTGTATCGACG-1_V12D07-332_D1,1,1,0,1,1,4
TAGATGGTTCCTTACT-1_V12D07-332_D1,0,0,0,0,0,0
ATCGTTAGCTAGCGGA-1_V12D07-332_D1,0,1,0,0,0,1
ACAGCGACATTCTCAT-1_V12D07-332_D1,0,1,0,2,0,3
ATTCAACCATTTAAGG-1_V12D07-332_D1,0,0,0,0,0,0
CACTCTTCTGCTAGCC-1_V12D07-332_D1,0,1,0,4,0,5
CTAACTGATAATCGCC-1_V12D07-332_D1,0,0,0,0,0,0
TGATGTCAATTAAGTG-1_V12D07-332_D1,0,0,0,1,0,1
CGCCGTTCAGCATAGT-1_V12D07-332_D1,0,0,0,1,0,1
ATACTACCCGTACCAC-1_V12D07-332_D1,0,0,0,0,0,0
CCACTGTTTGGATTAA-1_V12D07-332_D1,2,0,0,1,0,3
CACTACGGGAGCTGCC-1_V12D07-332_D1,6,0,0,0,0,6
GACCAAACGTTGACTG-1_V12D07-332_D1,16,0,0,1,0,17
AAGAGGCCCTTTGGAA-1_V12D07-332_D1,13,0,0,2,0,15
ACACGTAGGCCACAAG-1_V12D07-332_D1,0,0,0,0,0,0
TACTCTTACTTTACTG-1_V12D07-332_D1,0,0,0,2,0,2
AGAGCCGCCGAGATTT-1_V12D07-332_D1,0,0,0,0,0,0
GGCCTGCTTCTCCCGA-1_V12D07-332_D1,0,1,0,2,0,3
TCAAGCGCGGACGGTA-1_V12D07-332_D1,1,1,1,1,0,4
ACACTGGGACAGTCGT-1_V12D07-332_D1,0,1,0,2,0,3
TGTGTAGTAGCACGTG-1_V12D07-332_D1,0,0,1,0,0,1
CTAGCCACAGGCGAGC-1_V12D07-332_D1,0,0,0,2,0,2
CTATCGCGTAGAGAAC-1_V12D07-332_D1,0,0,0,2,0,2
GTTCCCGTAAACATAT-1_V12D07-332_D1,0,1,0,2,0,3
TCTTTCCTTCGAGATA-1_V12D07-332_D1,0,0,0,2,0,2
ATATTGGAGAGGCCTT-1_V12D07-332_D1,0,0,0,3,0,3
AGGCGATAACTGGCGT-1_V12D07-332_D1,0,0,0,4,0,4
ACCCGGAGCACCACAA-1_V12D07-332_D1,0,2,0,3,0,5
TGAGCTCAACTGTATA-1_V12D07-332_D1,1,1,0,3,0,5
ACGACCCATGAGTTGC-1_V12D07-332_D1,0,2,0,1,0,3
CGGTCAGTCCATATTT-1_V12D07-332_D1,0,0,0,1,0,1
TCCGGCTGTCGGGTCG-1_V12D07-332_D1,0,1,0,3,0,4
GGGCACTATTGACCAT-1_V12D07-332_D1,0,0,0,0,0,0
CCATAGAGGCTGCCAG-1_V12D07-332_D1,1,3,0,0,0,4
CCGAAGCATTGACCAA-1_V12D07-332_D1,12,2,0,0,0,14
TACTGAGGGAAGAAAG-1_V12D07-332_D1,6,0,0,0,0,6
TATGTAGAAACCCGGC-1_V12D07-332_D1,3,1,0,1,0,5
TGGTTAACTTACATTT-1_V12D07-332_D1,4,1,3,0,0,8
AGAACCCTCAATTGGG-1_V12D07-332_D1,1,2,3,2,0,8
CCTATATCGTGTCACG-1_V12D07-332_D1,0,1,0,0,0,1
ACGGCTGGATGTAGAA-1_V12D07-332_D1,0,3,1,0,0,4
CTCGCATTGCATAGCC-1_V12D07-332_D1,0,3,0,0,0,3
ACTTTGGTCGTGCTCC-1_V12D07-332_D1,0,1,0,0,0,1
GCTGGTTTAGGCCATA-1_V12D07-332_D1,0,6,0,1,0,7
TGTCGTTATCACATAT-1_V12D07-332_D1,1,7,4,0,0,12
ACACATGATCAAATCT-1_V12D07-332_D1,7,6,1,0,0,14
TATCCATCTCGGTTAG-1_V12D07-332_D1,2,3,2,0,0,7
CTCGTCGAGGGCTCAT-1_V12D07-332_D1,8,2,0,0,0,10
ATCAATGCCGTGGCTG-1_V12D07-332_D1,11,2,0,0,0,13
GAAACATAGGAAACAG-1_V12D07-332_D1,10,5,0,0,0,15
TAATAGGTCACCAGAA-1_V12D07-332_D1,3,6,0,0,0,9
CACCAGTCAGCATGCA-1_V12D07-332_D1,0,1,0,1,0,2
GAGCGCTGTTAGGTAA-1_V12D07-332_D1,0,3,0,0,0,3
CCCTATGTAGAGCAGA-1_V12D07-332_D1,0,2,0,1,0,3
GATCGCTATATCTCAG-1_V12D07-332_D1,0,3,0,1,0,4
AAGGGACTATGCATTC-1_V12D07-332_D1,0,1,1,0,0,2
CTCGGGTTCTCTGGCC-1_V12D07-332_D1,0,4,0,1,0,5
TATATATCGAGAAATG-1_V12D07-332_D1,0,2,0,0,0,2
ACCCGAGCGAAATTAC-1_V12D07-332_D1,0,3,0,0,0,3
TTGTTTCATTAGTCTA-1_V12D07-332_D1,0,3,0,2,0,5
ATGGGACCTGCTGAAC-1_V12D07-332_D1,0,0,0,0,0,0
TGCGACGGCCGAACGT-1_V12D07-332_D1,0,7,2,0,0,9
AGCTAACAAGCAATGT-1_V12D07-332_D1,1,0,1,1,0,3
CGTGTCTCGTTACGAC-1_V12D07-332_D1,0,2,0,0,0,2
CTAAATCCGGTGTACA-1_V12D07-332_D1,0,5,0,0,0,5
GAATAGTGCTCGATTA-1_V12D07-332_D1,0,1,1,3,0,5
AACAATACATTGTCGA-1_V12D07-332_D1,0,2,1,1,0,4
CACATCGTGCACGCGC-1_V12D07-332_D1,0,3,0,1,0,4
ACCGTGACCACGTGGG-1_V12D07-332_D1,0,0,0,0,0,0
CCCAATGAGATTTGCA-1_V12D07-332_D1,0,5,0,1,0,6
TCAGCAGTAGGCCCTG-1_V12D07-332_D1,0,4,0,0,0,4
CTACTCAAGGTATAGT-1_V12D07-332_D1,0,4,0,1,0,5
TAGTAGCTTATACCAG-1_V12D07-332_D1,0,1,0,1,0,2
ACGTTCGTTCAGGAAA-1_V12D07-332_D1,1,5,0,2,0,8
TTAGAATAAGGGTCGG-1_V12D07-332_D1,0,5,0,0,0,5
TTCTAGAAAGTCTTAT-1_V12D07-332_D1,0,2,0,2,0,4
CCTTCAGTTAAAGTGA-1_V12D07-332_D1,0,3,0,0,2,5
TAGCTAGTGATGATGG-1_V12D07-332_D1,0,4,0,0,0,4
AGCCCGGTAGCCTGTA-1_V12D07-332_D1,0,0,0,1,0,1
TACCTCAGTTGTCTGT-1_V12D07-332_D1,1,6,2,1,1,11
GACGGGTTGGCCCGTA-1_V12D07-332_D1,0,3,0,0,1,4
GAAACCTATACAAATG-1_V12D07-332_D1,0,6,0,2,1,9
TCCACCTCTAGCCTTT-1_V12D07-332_D1,0,0,0,0,0,0
AAGACCCAACTGAACA-1_V12D07-332_D1,1,0,0,1,0,2
CATACACGGTTCCCAC-1_V12D07-332_D1,0,0,0,0,0,0
ACTACGCGTTAGAATT-1_V12D07-332_D1,0,0,0,1,0,1
CTTGGCCAAGCTGGGA-1_V12D07-332_D1,0,0,0,0,0,0
TTACCCTAGGGATTGG-1_V12D07-332_D1,0,1,0,4,0,5
TTCGCACTGTACGACA-1_V12D07-332_D1,0,1,0,1,0,2
TAGGTGTTCCACAGAT-1_V12D07-332_D1,0,0,0,1,0,1
GAAGCCTGCACATTCC-1_V12D07-332_D1,0,0,0,0,0,0
GGCTTTCAATAAGGGT-1_V12D07-332_D1,0,0,0,1,0,1
TCCAGGGTATATACGA-1_V12D07-332_D1,0,1,1,1,0,3
CTCGCCGAATGTAGGG-1_V12D07-332_D1,0,0,0,0,0,0
AGGAAGCTGTCCGCCG-1_V12D07-332_D1,1,0,0,0,0,1
GTCTCAAGGCCCGGCT-1_V12D07-332_D1,0,1,0,0,0,1
ACCGACACATCTCCCA-1_V12D07-332_D1,0,0,0,0,0,0
TATACGCGTCATCACT-1_V12D07-332_D1,1,0,0,1,0,2
ATCTGGGCTGTTCTTG-1_V12D07-332_D1,0,0,0,0,0,0
TCAAATTTGAGACTCA-1_V12D07-332_D1,0,1,0,1,0,2
GTTAAGGGTGCGATGT-1_V12D07-332_D1,0,0,0,0,0,0
AGCAAAGGCCGCTAGT-1_V12D07-332_D1,1,1,0,2,0,4
TTATAGGTAATTGTCT-1_V12D07-332_D1,0,0,0,1,0,1
TTGTGCAGCCACGTCA-1_V12D07-332_D1,0,0,0,1,0,1
ACGGACTCTCAAAGCG-1_V12D07-332_D1,0,0,0,1,0,1
ATGCTCTGGCGCGGTA-1_V12D07-332_D1,0,0,0,0,0,0
ATAATCTTGGAGAACC-1_V12D07-332_D1,0,0,0,0,0,0
CTCATTGCTCTAACAA-1_V12D07-332_D1,1,0,0,2,0,3
TAGGTGACGATAACCT-1_V12D07-332_D1,0,0,0,2,0,2
CGGATCCTCAAGGACT-1_V12D07-332_D1,0,0,0,0,0,0
GGGCGTGGTTTCCCAG-1_V12D07-332_D1,1,0,0,0,0,1
TGGCTATGTGACATAC-1_V12D07-332_D1,0,0,0,0,0,0
CTTAGTGTAGTAGCAT-1_V12D07-332_D1,0,0,0,0,0,0
GGATTGCTGTGACTCC-1_V12D07-332_D1,0,0,0,0,0,0
ACTTCCATGCGGGACA-1_V12D07-332_D1,0,0,0,1,0,1
ACTCAAGTGCAAGGCT-1_V12D07-332_D1,0,0,0,0,0,0
ACAAGGATGCTTTAGG-1_V12D07-332_D1,0,0,0,0,0,0
TTGAACGACGTGCTGA-1_V12D07-332_D1,0,0,0,1,2,3
ATTCATCGTTGAGGCA-1_V12D07-332_D1,0,2,0,0,2,4
TGCAACCCATCTGCGG-1_V12D07-332_D1,0,2,0,1,1,4
AGTGCTAAACACAGCA-1_V12D07-332_D1,0,3,0,0,1,4
AACTCCAGAGCGTGTT-1_V12D07-332_D1,0,2,0,1,1,4
TCTCCACAAGTTGAAT-1_V12D07-332_D1,0,3,0,1,0,4
CTTTGCATCGCTCTTG-1_V12D07-332_D1,0,3,0,0,0,3
TCACAAACCGAGGTAC-1_V12D07-332_D1,0,5,0,0,0,5
CCGTAGGAAATCCCTG-1_V12D07-332_D1,0,4,0,2,0,6
AAACATTTCCCGGATT-1_V12D07-332_D1,0,2,0,1,0,3
GCCTCCGACAATTCAC-1_V12D07-332_D1,0,0,0,1,0,1
TCTGCATACCTTGCTT-1_V12D07-332_D1,0,1,0,0,0,1
ACCCATTTGTCCCTCT-1_V12D07-332_D1,0,1,0,2,0,3
CTGCAGAGAATCAGAG-1_V12D07-332_D1,0,1,0,1,0,2
GGAAACTAAATGGGCC-1_V12D07-332_D1,0,0,0,1,0,1
CAACCTACCGAGCAGT-1_V12D07-332_D1,0,0,0,0,0,0
CCGTAGGGTTGTTTAC-1_V12D07-332_D1,0,1,0,1,0,2
GGTTTGTGACCTGAGG-1_V12D07-332_D1,0,0,0,0,0,0
TAACCTAGGGAGTCCA-1_V12D07-332_D1,0,0,0,2,0,2
TTCCATCGACAGCGTG-1_V12D07-332_D1,0,0,0,2,0,2
ATCTCCCACGGAATAT-1_V12D07-332_D1,17,0,0,0,1,18
GTTTCAAACGAGTTGT-1_V12D07-332_D1,15,0,0,1,0,16
GGAACTTTGGCGATTA-1_V12D07-332_D1,1,0,0,2,0,3
CTGCAAGCACGTTCCG-1_V12D07-332_D1,0,1,1,1,0,3
CACAGTCCCGCTTCGC-1_V12D07-332_D1,0,0,0,0,0,0
TACGCTCGGTATTGGA-1_V12D07-332_D1,0,1,0,1,0,2
CTGGTAAAGTGTGGGC-1_V12D07-332_D1,0,1,0,3,0,4
CAACCAGTGGCCTACC-1_V12D07-332_D1,0,1,0,3,0,4
TCTTCGCGGTGAGAGG-1_V12D07-332_D1,0,1,0,2,0,3
TTCGGGTTGCCACGGG-1_V12D07-332_D1,0,0,0,2,0,2
ACCGATAGGCATAACC-1_V12D07-332_D1,1,0,0,2,0,3
CTTATAGATGGCTGTT-1_V12D07-332_D1,0,2,1,1,0,4
AGACGCCCACTTCGCC-1_V12D07-332_D1,0,1,0,1,0,2
AGGTCGCCTCCCAACA-1_V12D07-332_D1,2,1,0,3,0,6
CCTCACGTCAGCTAAT-1_V12D07-332_D1,0,1,0,3,0,4
CCACCTGTATGGAATA-1_V12D07-332_D1,0,0,0,0,0,0
GGACTCGAAGCTTTCA-1_V12D07-332_D1,0,2,0,3,0,5
AAGCCGGAGAGCAGGA-1_V12D07-332_D1,0,0,0,0,0,0
GCCTATCAGGTAAGAT-1_V12D07-332_D1,0,0,0,3,0,3
TCAGAGTGTGAGCATG-1_V12D07-332_D1,0,0,0,3,0,3
CTATACTTAAAGCGAG-1_V12D07-332_D1,3,2,0,0,0,5
ACCGTCCACTGGGCCC-1_V12D07-332_D1,7,1,1,0,0,9
AAGACCAAATAACTCA-1_V12D07-332_D1,4,0,0,0,0,4
TGTTTCTGAAGCGTGC-1_V12D07-332_D1,4,1,1,0,0,6
TTCTCTTACAGGTGAT-1_V12D07-332_D1,7,1,0,0,0,8
AATTCATTGTCATGCA-1_V12D07-332_D1,1,0,2,0,0,3
GCCCGAGAGTCTAAAT-1_V12D07-332_D1,1,2,1,0,0,4
ATATAGAGTATTGGTC-1_V12D07-332_D1,0,0,0,0,0,0
TTGAAGGATGGGCGCC-1_V12D07-332_D1,0,1,0,1,0,2
TAGTACCACAACTTTC-1_V12D07-332_D1,0,4,0,0,0,4
ATCCCATCCACAGCGC-1_V12D07-332_D1,0,4,2,0,0,6
CTTAGGTATAGACCAG-1_V12D07-332_D1,0,4,2,1,0,7
TGACTCCGAATCATAC-1_V12D07-332_D1,10,4,1,0,0,15
ACTACATCCCGACAAG-1_V12D07-332_D1,10,4,1,0,0,15
TTGCCGCAGACCTACA-1_V12D07-332_D1,7,3,1,0,0,11
TAAGAGGGACAGGGAC-1_V12D07-332_D1,1,4,2,0,0,7
CGAATGAAGTCATTGC-1_V12D07-332_D1,4,6,1,0,0,11
AAGGGAACGACTGGCT-1_V12D07-332_D1,6,6,3,0,0,15
CGAATCTGCTCGACGC-1_V12D07-332_D1,0,2,3,0,0,5
ATCGTGGAAAGTCTGG-1_V12D07-332_D1,0,5,1,0,0,6
CCTATGGCTCCTAGTG-1_V12D07-332_D1,0,2,0,0,0,2
CGTCGCTTGGTTATAC-1_V12D07-332_D1,0,6,1,1,0,8
TGCTTAGAGAGAATGC-1_V12D07-332_D1,0,5,1,0,0,6
GATTGCTCCAGTTGCA-1_V12D07-332_D1,0,5,1,0,0,6
CGTGCTTCTACCTAAA-1_V12D07-332_D1,0,1,0,2,0,3
ACTCCAATATCATCAT-1_V12D07-332_D1,0,3,0,1,0,4
GCCGACCCACGACTGC-1_V12D07-332_D1,0,3,0,1,0,4
GAGGGTAGTAACAAAG-1_V12D07-332_D1,0,3,0,2,0,5
GGCCGAGACTCTGGTG-1_V12D07-332_D1,0,1,2,0,0,3
TATATAGGGCTTTACG-1_V12D07-332_D1,0,3,1,1,0,5
TGCCGGATGTACGAGC-1_V12D07-332_D1,0,3,0,2,0,5
AGGTAGATCGAGATAT-1_V12D07-332_D1,0,4,0,1,0,5
GATCAACATAAAGGGA-1_V12D07-332_D1,0,5,1,0,0,6
TAACAGCGTTTGTGCT-1_V12D07-332_D1,0,4,0,0,0,4
CTATAGGCGTTGATGT-1_V12D07-332_D1,0,3,0,3,0,6
GGTTTAATTACCATCG-1_V12D07-332_D1,0,4,0,2,0,6
CTCTTCTGGAAGTTAG-1_V12D07-332_D1,0,5,0,1,0,6
ATCTGACATGGAAGGA-1_V12D07-332_D1,0,4,0,1,0,5
TACGTACTAGTGCTGA-1_V12D07-332_D1,0,3,0,2,0,5
ATGACTATCAGCTGTG-1_V12D07-332_D1,0,4,2,0,0,6
CTTTGGGATTGTTGCA-1_V12D07-332_D1,0,2,0,0,0,2
AGACTGTTACCGGGTC-1_V12D07-332_D1,0,3,0,0,1,4
TCCTAACCGTCGGGCA-1_V12D07-332_D1,0,3,0,0,0,3
ACGCAAACTAATAGAT-1_V12D07-332_D1,1,4,0,0,1,6
AAGTGAGTCGGGTTTA-1_V12D07-332_D1,0,1,1,0,0,2
TAAAGCGGTATTTCCA-1_V12D07-332_D1,0,0,0,0,0,0
CTCCTCCAGCTCACAC-1_V12D07-332_D1,0,2,0,0,0,2
CGGTCCGTCGCAAGCC-1_V12D07-332_D1,0,1,0,0,1,2
CCTATATTTGTCCTGG-1_V12D07-332_D1,0,0,0,3,0,3
TCCAATAAAGGCTACC-1_V12D07-332_D1,0,0,0,0,0,0
AAAGGCTACGGACCAT-1_V12D07-332_D1,0,0,0,0,0,0
CGTGACCAGTCCTCTG-1_V12D07-332_D1,0,0,0,0,0,0
GATCTGCTATCTAAGG-1_V12D07-332_D1,0,0,0,0,0,0
CGAATGACGCATAATG-1_V12D07-332_D1,1,1,0,2,1,5
GCTCAATGTAATACCG-1_V12D07-332_D1,0,1,0,2,0,3
CTATGCCCGAATGCAA-1_V12D07-332_D1,0,1,0,0,0,1
CACAGGGCCGTTGTCA-1_V12D07-332_D1,0,0,0,0,0,0
TCAATACGCCGTCATG-1_V12D07-332_D1,0,1,0,3,0,4
AGCGGACACTTCGTAG-1_V12D07-332_D1,0,0,0,3,0,3
ATACGTTATGCACGGA-1_V12D07-332_D1,0,1,0,2,0,3
GAGTAGATACTAGTTG-1_V12D07-332_D1,0,0,0,2,0,2
CCAGCTCGAACGCATT-1_V12D07-332_D1,0,0,0,0,0,0
TGCTTCCCAAGCAGTA-1_V12D07-332_D1,0,1,0,0,0,1
GTAGACACGCCTGACT-1_V12D07-332_D1,0,0,0,0,0,0
CTCACATTTACTAAAT-1_V12D07-332_D1,0,0,0,0,0,0
GAATGCGAATCGGTTC-1_V12D07-332_D1,1,0,0,0,0,1
TAAGGCCCGTCACCCT-1_V12D07-332_D1,0,0,0,1,0,1
GAGTATGCGCGTGCAT-1_V12D07-332_D1,0,1,0,0,0,1
ATCCACATCGACAGAA-1_V12D07-332_D1,0,0,0,0,0,0
TAGACGAAACGCCAAT-1_V12D07-332_D1,0,0,0,0,0,0
CAGCAGTCTGTGCTGC-1_V12D07-332_D1,0,0,0,1,0,1
CTCACTGTGATACTTA-1_V12D07-332_D1,1,0,0,1,0,2
TTAATTGCTTTGGGTG-1_V12D07-332_D1,0,0,0,1,0,1
GTAGTCTACGATATTG-1_V12D07-332_D1,0,0,0,0,0,0
TTGCCGCTTTCTAGTA-1_V12D07-332_D1,0,0,0,0,0,0
GAACCTTTAACGATCC-1_V12D07-332_D1,1,0,0,0,0,1
TGGACCAATCTAAGAT-1_V12D07-332_D1,0,0,0,0,0,0
CTAGTAGAAAGGGATT-1_V12D07-332_D1,1,0,0,3,0,4
AACCTCGCTTTAGCCC-1_V12D07-332_D1,0,0,0,0,0,0
GAGTGTCAACCAGAAA-1_V12D07-332_D1,0,0,0,0,0,0
GTGATCCTTGTCATGA-1_V12D07-332_D1,0,0,0,1,0,1
CTCAACTAACCCGGAT-1_V12D07-332_D1,0,0,0,0,0,0
AGTGGCGTCTGAAGGT-1_V12D07-332_D1,0,1,0,2,0,3
GGGAAGGGCTTTCTCA-1_V12D07-332_D1,0,0,0,1,0,1
AGGCCTGAGAATCTCG-1_V12D07-332_D1,0,0,0,0,0,0
AGCCACAGGTTACCCG-1_V12D07-332_D1,0,0,1,0,0,1
TGCAATCTAACACGGT-1_V12D07-332_D1,0,1,0,0,0,1
GTTTGGGTTTCGCCCG-1_V12D07-332_D1,0,2,0,0,1,3
CCTATGTCCACTCCAC-1_V12D07-332_D1,0,0,0,1,2,3
CTGCCTTTCTAGTAAA-1_V12D07-332_D1,0,3,0,1,0,4
TTAGTAAACCTGCTCT-1_V12D07-332_D1,0,3,0,1,0,4
TTGTGGTGGTACTAAG-1_V12D07-332_D1,0,7,0,0,0,7
CCTCCTGTTGTGTCGT-1_V12D07-332_D1,0,3,0,0,0,3
ACAAAGCATGACCTAG-1_V12D07-332_D1,0,5,0,0,0,5
ATAGCAACTAGGGAAG-1_V12D07-332_D1,0,2,1,4,0,7
CCGCTCTTCCGAACTA-1_V12D07-332_D1,0,1,1,3,0,5
TAGAATAGCCGATGAA-1_V12D07-332_D1,0,2,0,1,0,3
GGTCTCCGTCCAGGTT-1_V12D07-332_D1,0,1,1,1,0,3
TAATTACGTCAGTAGA-1_V12D07-332_D1,0,2,0,2,0,4
TACGTAAAGCGGAGTG-1_V12D07-332_D1,0,0,0,2,0,2
GCTACAATCGAGGATA-1_V12D07-332_D1,0,2,0,1,0,3
TCAGCCAATCCGTAAA-1_V12D07-332_D1,0,1,0,1,0,2
ATCATAGCCCTATGTA-1_V12D07-332_D1,0,1,0,2,0,3
GAGGCCTGTTGATACA-1_V12D07-332_D1,0,1,0,2,0,3
ATATACGCTCGTGACG-1_V12D07-332_D1,11,0,1,1,0,13
CCCTTTAATGGAGTTC-1_V12D07-332_D1,23,0,0,1,0,24
TTACACGATCTGCGAC-1_V12D07-332_D1,10,1,0,4,0,15
TCGCATAAAGGGCGCA-1_V12D07-332_D1,4,0,0,0,2,6
TGTAGCCATCCCATTC-1_V12D07-332_D1,1,0,1,3,0,5
GGGTCTATCGCTTTCC-1_V12D07-332_D1,0,2,0,0,0,2
GGAGGGTCAAGTAAGA-1_V12D07-332_D1,1,0,0,1,0,2
TACGGCATGGACGCTA-1_V12D07-332_D1,0,1,0,5,0,6
CACGTCAATCAATGGA-1_V12D07-332_D1,0,1,0,2,0,3
CGCTTGGACGGATAGA-1_V12D07-332_D1,0,0,0,1,0,1
CGCGGTACGGTATACA-1_V12D07-332_D1,0,1,0,1,0,2
CCTACTCAACACGATT-1_V12D07-332_D1,0,0,0,3,0,3
CGTTTGGTGTTGTGGG-1_V12D07-332_D1,0,1,0,2,0,3
GTTGTTGCAAGATGGC-1_V12D07-332_D1,0,1,0,1,0,2
CATTCGTCGTAGCGGT-1_V12D07-332_D1,0,1,0,0,0,1
CAGCCTCGATAGCGGT-1_V12D07-332_D1,0,0,0,1,0,1
TCATAAGTCCAAGAAG-1_V12D07-332_D1,0,0,0,1,0,1
AAAGTGCCATCAATTA-1_V12D07-332_D1,0,0,1,0,0,1
GTTGCAGTCGACAACA-1_V12D07-332_D1,0,1,0,2,0,3
TAAATGGGCTACTGAG-1_V12D07-332_D1,0,0,0,3,0,3
CAGTAAGGGACGTCTC-1_V12D07-332_D1,0,3,0,0,0,3
GGGATGGACCCGCGTC-1_V12D07-332_D1,5,2,0,0,0,7
GACGCATACCCGTCGG-1_V12D07-332_D1,5,0,0,0,0,5
GGGCAGGATTTCTGTG-1_V12D07-332_D1,5,3,0,0,0,8
TATCTGAGCCGATATT-1_V12D07-332_D1,3,2,0,0,0,5
AATGTATGGCACTGTA-1_V12D07-332_D1,0,1,1,0,0,2
GCCTTTGTCAGTGGAC-1_V12D07-332_D1,1,2,0,1,0,4
AACCATAGGGTTGAAC-1_V12D07-332_D1,0,3,0,0,0,3
AAACTTAATTGCACGC-1_V12D07-332_D1,0,0,0,0,0,0
TAGGCGGCTGCAAAGA-1_V12D07-332_D1,0,1,1,1,0,3
TCCATCAATACTAATC-1_V12D07-332_D1,0,3,0,1,0,4
ACCTCGAACTTATGCT-1_V12D07-332_D1,0,4,3,0,0,7
ACAAACCATGCGTCCT-1_V12D07-332_D1,3,0,5,0,0,8
ACACCGGTCTGACCGC-1_V12D07-332_D1,13,4,0,0,0,17
ATGGCAGCATTACGAT-1_V12D07-332_D1,8,7,1,0,0,16
CTGGTGAATGGGCCTA-1_V12D07-332_D1,13,2,2,0,0,17
CACAGAGACGAGGACG-1_V12D07-332_D1,13,6,1,0,0,20
GCACAAACCCTAGATG-1_V12D07-332_D1,5,2,1,0,0,8
ACTATGTCCAGCTGCC-1_V12D07-332_D1,0,3,7,0,0,10
AAGCCGCCGTGAAATC-1_V12D07-332_D1,0,4,1,2,0,7
ATGGGTGTATACCTCC-1_V12D07-332_D1,0,2,0,2,0,4
TAAGCGCGAATCAAAT-1_V12D07-332_D1,0,1,0,0,0,1
AGCCCGGCATTAGAGG-1_V12D07-332_D1,0,1,0,0,0,1
GTGATCAAGCGTGCAC-1_V12D07-332_D1,0,4,0,0,0,4
CTGCCTTTAATACCTT-1_V12D07-332_D1,0,4,0,1,0,5
TACCTCCACACCAATG-1_V12D07-332_D1,0,2,0,0,0,2
GAGCATCAACAACTTG-1_V12D07-332_D1,0,5,2,0,0,7
CATACGAACTAGCTGG-1_V12D07-332_D1,0,3,2,0,0,5
GGGAACGGTTTCAGAT-1_V12D07-332_D1,0,5,0,1,0,6
AGGGTGCCGTTCTTTA-1_V12D07-332_D1,0,2,1,0,0,3
ACGACTGGTCATACTC-1_V12D07-332_D1,1,4,0,1,0,6
GGATCTTACTGCCCTT-1_V12D07-332_D1,0,4,0,2,0,6
TACTCCTCTAGTTGAC-1_V12D07-332_D1,0,8,0,1,0,9
GTAGCTCCGGGAGGCT-1_V12D07-332_D1,0,3,0,1,0,4
GGACTCGTGAGTGGTC-1_V12D07-332_D1,0,1,2,2,1,6
GTAGTTCGAAGGCGAA-1_V12D07-332_D1,0,5,0,0,0,5
CTCAAACCACTGCCCG-1_V12D07-332_D1,0,2,0,0,0,2
GAGGGAGTCAGATCGC-1_V12D07-332_D1,0,2,0,0,0,2
GCGTCCCTAAGACATA-1_V12D07-332_D1,0,1,1,1,0,3
TCTCTTACCGCGAACC-1_V12D07-332_D1,0,5,0,0,0,5
GGCTACTATACACTCC-1_V12D07-332_D1,0,2,1,0,0,3
CGTTGCCCGCGTGGGA-1_V12D07-332_D1,0,2,0,0,0,2
TATAGAGTCGCTTGAA-1_V12D07-332_D1,1,5,0,1,0,7
ATGTTGTAGTCTGTTT-1_V12D07-332_D1,0,5,0,0,1,6
AGTATACACAGCGACA-1_V12D07-332_D1,0,3,1,0,0,4
TGTGGTTGCTAAAGCT-1_V12D07-332_D1,0,0,1,0,0,1
TGATTCCCGGTTACCT-1_V12D07-332_D1,0,1,0,1,0,2
CACTGACGATTGTGGA-1_V12D07-332_D1,2,2,2,1,0,7
AACATTGTGACTCGAG-1_V12D07-332_D1,0,0,0,1,0,1
GTCCAATATTTAGCCT-1_V12D07-332_D1,0,0,0,0,1,1
GCTCTTTCCGCTAGTG-1_V12D07-332_D1,0,0,0,0,0,0
GGGTCAGGAGCTAGAT-1_V12D07-332_D1,0,2,0,2,0,4
AGGTGGTGACCTTCGC-1_V12D07-332_D1,0,0,0,3,1,4
CCCGGGTCGTTCAGGG-1_V12D07-332_D1,1,1,0,0,0,2
AGCCAAGCTTTGTGTC-1_V12D07-332_D1,0,0,0,2,0,2
TGTGGCGGGCTTCTGG-1_V12D07-332_D1,0,0,0,1,0,1
CGAGGGTATCCAGGTG-1_V12D07-332_D1,0,1,0,0,0,1
CGTTCAGACCCGCGAA-1_V12D07-332_D1,0,0,0,0,0,0
TCATATGAGCTTTGTT-1_V12D07-332_D1,0,0,0,2,0,2
AGTTGACGGTCCTTGC-1_V12D07-332_D1,0,0,0,0,0,0
ATAATTAGCTAAGTAG-1_V12D07-332_D1,0,0,0,0,0,0
GGTCTTGAGCGCTCTT-1_V12D07-332_D1,0,0,0,0,0,0
CGTTGTCGGCAATTGA-1_V12D07-332_D1,1,1,0,1,0,3
TCTTGCTCCCGATACT-1_V12D07-332_D1,0,0,0,1,0,1
AGCAGAAGGAGAAAGA-1_V12D07-332_D1,0,1,0,1,0,2
GAAGCCACTGATTATG-1_V12D07-332_D1,0,2,0,4,0,6
TGCTCTTGAGAGTTTG-1_V12D07-332_D1,0,0,0,1,0,1
GACATCCGTCGAACTG-1_V12D07-332_D1,0,0,0,0,0,0
AGATATAATACGACTA-1_V12D07-332_D1,0,0,0,1,0,1
TCGCTACTGGCTTTGA-1_V12D07-332_D1,0,0,0,2,0,2
GTGACAGCTTCCCACT-1_V12D07-332_D1,0,0,0,2,0,2
GTGACGCAGGTTTCAT-1_V12D07-332_D1,0,0,0,2,0,2
GGGAAGACGGTCTGTC-1_V12D07-332_D1,0,0,0,0,0,0
CGTCGCATGTGAGCCA-1_V12D07-332_D1,1,0,0,0,0,1
AGAAGGTTGTAGGTCG-1_V12D07-332_D1,0,0,0,0,0,0
GGCCGGCGTCTGCTAT-1_V12D07-332_D1,0,0,0,1,0,1
TTGACCAGGAACAACT-1_V12D07-332_D1,2,0,0,0,0,2
AGTCGTATAAAGCAGA-1_V12D07-332_D1,0,1,0,4,0,5
GGCGTAGGGAAAGCTG-1_V12D07-332_D1,0,0,0,0,0,0
AAACCTAAGCAGCCGG-1_V12D07-332_D1,0,0,0,1,0,1
ATTGCCTTTATGTTTG-1_V12D07-332_D1,0,0,0,4,0,4
CAGGCAGTCTTACCAG-1_V12D07-332_D1,0,0,0,0,0,0
AGCTAAGTACGCAGGC-1_V12D07-332_D1,0,0,0,1,0,1
AAATCCGATACACGCC-1_V12D07-332_D1,0,0,0,1,0,1
CGAGAGCTTTCACTAC-1_V12D07-332_D1,0,0,0,0,0,0
CGCCCAGCGTTTCACG-1_V12D07-332_D1,0,1,0,0,0,1
TTAAGTATTGTTATCC-1_V12D07-332_D1,0,0,0,3,0,3
AAACGGGCGTACGGGT-1_V12D07-332_D1,0,1,0,0,0,1
GTATCCTTTGGTAACC-1_V12D07-332_D1,0,0,0,1,0,1
CATAGTCAAATACATA-1_V12D07-332_D1,0,2,0,1,0,3
TCTATGCTATAACGAC-1_V12D07-332_D1,0,6,0,0,0,6
ACGTTCTGTACAAGTC-1_V12D07-332_D1,0,4,0,1,0,5
CGCGAAGTGGCATACT-1_V12D07-332_D1,0,2,0,0,0,2
ACCAACCGCACTCCAC-1_V12D07-332_D1,0,3,0,0,0,3
GTCATGCGCGAGGGCT-1_V12D07-332_D1,1,3,0,0,0,4
TAGGCTAAAGTGGCAC-1_V12D07-332_D1,0,1,0,2,0,3
TGGCTACACTCTACCT-1_V12D07-332_D1,0,0,0,0,0,0
TGTCCACGGCTCAACT-1_V12D07-332_D1,0,1,0,1,0,2
AATTGCAGCAATCGAC-1_V12D07-332_D1,0,2,0,0,1,3
GTCAACCAGGCCTATA-1_V12D07-332_D1,0,1,0,0,0,1
ATCTTATCGCACACCC-1_V12D07-332_D1,0,0,0,1,0,1
GTCTATTGCATGCTCG-1_V12D07-332_D1,0,0,0,0,0,0
GCACGTGGTTTACTTA-1_V12D07-332_D1,0,0,0,1,0,1
ATTCGCGCCTTGAGAG-1_V12D07-332_D1,0,0,0,2,0,2
AGCGATGCGCCTAATA-1_V12D07-332_D1,7,1,0,2,0,10
TCTATAGGTGGGTAAT-1_V12D07-332_D1,18,1,0,2,0,21
AGATACCAATAGAACC-1_V12D07-332_D1,1,0,0,0,0,1
CGTGTATGGGAGCTGA-1_V12D07-332_D1,7,0,0,0,0,7
ATGTACATGCGGTGAG-1_V12D07-332_D1,1,1,1,3,0,6
TTGGCTCAATATGTGT-1_V12D07-332_D1,1,1,0,3,0,5
GTTCGGAGCACTCAAC-1_V12D07-332_D1,1,0,0,1,0,2
TCCCTCTTCTCAAGGG-1_V12D07-332_D1,1,0,0,1,0,2
TTACGTATCTATGACA-1_V12D07-332_D1,0,2,0,1,0,3
CCCATATAGGTCGATT-1_V12D07-332_D1,0,0,0,1,0,1
GTCCACGTCGCATTCG-1_V12D07-332_D1,0,2,1,2,0,5
AATTGTGGTTGCCAAA-1_V12D07-332_D1,0,1,0,0,0,1
AGGAACGAACGACTTC-1_V12D07-332_D1,0,0,0,0,0,0
TAATTCCAATGCTTCA-1_V12D07-332_D1,0,0,0,0,0,0
AGGGCCCTAATGTTCT-1_V12D07-332_D1,0,1,0,2,0,3
AGGTGTTGCCGACCAC-1_V12D07-332_D1,1,0,0,2,0,3
CTGAGAGTAGAAATAC-1_V12D07-332_D1,0,0,0,2,0,2
TAGAAGAAGGGTTACA-1_V12D07-332_D1,0,1,0,2,0,3
GGTGACTGATAGAGAG-1_V12D07-332_D1,1,1,0,1,0,3
TACCCTCGGTAACCCT-1_V12D07-332_D1,0,1,0,0,0,1
TCTTTCATCCGTCCTT-1_V12D07-332_D1,2,1,0,0,0,3
TCGGATCTGGATGACC-1_V12D07-332_D1,3,1,2,0,0,6
GTCCTAGGATACCTTA-1_V12D07-332_D1,4,1,3,0,0,8
TGTACCCGACCCTAAT-1_V12D07-332_D1,4,0,0,0,0,4
AGGTTCTCCTTTCCGG-1_V12D07-332_D1,4,2,0,0,0,6
AATTGCGTGGATTACA-1_V12D07-332_D1,4,6,0,1,0,11
CGATAGCGATACAGTG-1_V12D07-332_D1,0,3,0,0,0,3
CGCCCTAATTGTTCAA-1_V12D07-332_D1,0,3,0,0,0,3
ATTATGAGACCCAATT-1_V12D07-332_D1,0,3,1,1,0,5
CCTCCTAGCTAGAGTC-1_V12D07-332_D1,0,5,4,0,0,9
CGAAGGGTTTCAGATT-1_V12D07-332_D1,0,2,0,0,0,2
CACAAGCTAAGAAAGG-1_V12D07-332_D1,0,3,2,0,0,5
CACCGGTAGAGACATT-1_V12D07-332_D1,5,5,6,0,0,16
ACTCATGGCAGCCTTC-1_V12D07-332_D1,12,2,1,0,0,15
CATCCAATATAGTTTG-1_V12D07-332_D1,6,5,1,0,0,12
CAGATATGAAGATGAC-1_V12D07-332_D1,5,5,4,0,0,14
GCAAAGGGCGTTAGCC-1_V12D07-332_D1,11,2,1,0,0,14
CTGTTGTTCAGTCGTA-1_V12D07-332_D1,5,3,3,0,0,11
AAAGGCCCTATAATAC-1_V12D07-332_D1,1,5,0,0,0,6
AACATTGAAGTTGATC-1_V12D07-332_D1,1,2,4,0,0,7
GCTAGCGATAGGTCTT-1_V12D07-332_D1,0,7,0,0,0,7
ATTGCCTATTAGACCG-1_V12D07-332_D1,0,2,0,0,0,2
GGGCGTTTACATTCAT-1_V12D07-332_D1,0,8,0,0,0,8
CCTCTACAAGGATTGG-1_V12D07-332_D1,0,0,3,0,0,3
AGTGACTGTGACACAA-1_V12D07-332_D1,0,2,1,1,0,4
AGCCCTCCCTGGTGGC-1_V12D07-332_D1,0,2,0,0,0,2
CGGTTGAGTATCCTTC-1_V12D07-332_D1,0,2,0,4,0,6
CATTATCCCATTAACG-1_V12D07-332_D1,0,5,0,1,0,6
AATGTGCTAATCTGAG-1_V12D07-332_D1,0,2,0,1,0,3
CTTAGTTGAGGAATCG-1_V12D07-332_D1,0,5,0,2,0,7
CTTCTGGGCGTACCTA-1_V12D07-332_D1,0,5,1,0,0,6
AGTCAAATGATGTGAT-1_V12D07-332_D1,0,4,1,0,0,5
TGAACAAGCAGGGACT-1_V12D07-332_D1,0,5,0,0,0,5
AATACCGGAGGGCTGT-1_V12D07-332_D1,0,5,1,2,0,8
GTTTGGTGATCGGTGC-1_V12D07-332_D1,0,2,1,4,0,7
GACTGCTGGTGAGAAA-1_V12D07-332_D1,0,4,0,0,0,4
CGATCCTCGCAACATA-1_V12D07-332_D1,0,6,0,0,0,6
CCAACCTTATGTAACT-1_V12D07-332_D1,0,3,0,0,0,3
CGTGGTACCCAAAGGC-1_V12D07-332_D1,0,2,1,2,0,5
AACCCGACAACCCGTG-1_V12D07-332_D1,0,2,0,1,0,3
TATGTAAAGTGCTTAA-1_V12D07-332_D1,0,1,0,2,0,3
GCAAGTGTAAAGCATG-1_V12D07-332_D1,0,3,0,0,0,3
GTAACTGCCCAAGGAG-1_V12D07-332_D1,0,1,1,1,0,3
GGTGCATAAATGATTA-1_V12D07-332_D1,0,3,0,0,0,3
TAGTCCCGGAGACCAC-1_V12D07-332_D1,0,1,0,0,1,2
CGGCCAGAGCGACCAT-1_V12D07-332_D1,0,0,1,0,0,1
TGAATGAGTGTTTCCC-1_V12D07-332_D1,2,1,0,0,0,3
TTCACTTCCTAGAACG-1_V12D07-332_D1,0,1,0,0,0,1
CGCTTAGTATTGATAC-1_V12D07-332_D1,1,0,0,0,0,1
AACGCGACCTTGGGCG-1_V12D07-332_D1,1,0,0,1,0,2
GTGCACCAGCTTCAAC-1_V12D07-332_D1,0,0,0,1,0,1
TTCTATTAAACGCAGC-1_V12D07-332_D1,1,0,0,0,0,1
TGGCAAGCACAAGTCG-1_V12D07-332_D1,0,0,0,2,0,2
ATCTGCTGTTATCGCC-1_V12D07-332_D1,0,0,0,1,0,1
AATTCCAAGCATGTAC-1_V12D07-332_D1,0,1,0,1,0,2
AAACGGTTGCGAACTG-1_V12D07-332_D1,0,0,1,1,0,2
GAAGGAGTCGAGTGCG-1_V12D07-332_D1,0,0,0,0,0,0
GGCAAGCCCATAGTGG-1_V12D07-332_D1,0,2,0,3,0,5
TGACCAAATCTTAAAC-1_V12D07-332_D1,0,0,0,2,0,2
TTCGGTACTGTAGAGG-1_V12D07-332_D1,0,0,0,0,0,0
ATGTACGATGACGTCG-1_V12D07-332_D1,0,0,0,1,0,1
ATCTAGCTTGTGAGGG-1_V12D07-332_D1,0,0,1,2,0,3
AGCGGGTCTGACACTC-1_V12D07-332_D1,0,0,0,1,0,1
GAGGTACGCGTGTCCC-1_V12D07-332_D1,0,0,0,2,0,2
GCACTGCCTACCTTTA-1_V12D07-332_D1,0,1,0,3,0,4
GGAGCGAGGCCTACTT-1_V12D07-332_D1,1,0,1,0,0,2
AAACTCGGTTCGCAAT-1_V12D07-332_D1,0,0,0,1,0,1
GGCGCTTCATTCCCTG-1_V12D07-332_D1,0,1,0,0,0,1
TGCTCGGTGGGTCACC-1_V12D07-332_D1,0,0,0,1,0,1
AAGCGCAGGGCTTTGA-1_V12D07-332_D1,0,0,0,0,0,0
GACCTTCCACGTCTAC-1_V12D07-332_D1,0,0,0,1,0,1
GTTAGCCCATGACATC-1_V12D07-332_D1,1,0,0,0,0,1
AATTCGATTCGAGGAT-1_V12D07-332_D1,1,2,0,1,0,4
AGTCTTTAAAGTGTCC-1_V12D07-332_D1,0,0,0,0,0,0
GACTAGGCCGTTAGGT-1_V12D07-332_D1,0,0,0,0,0,0
TCCAAGCCTAGACACA-1_V12D07-332_D1,1,2,0,0,0,3
GATTGGGAAAGGTTGT-1_V12D07-332_D1,0,0,0,0,0,0
GATGAGGAACCTTCGG-1_V12D07-332_D1,0,0,0,0,0,0
TGAATACCGACGCGTA-1_V12D07-332_D1,0,0,0,0,0,0
AATCGTGAGCCGAGCA-1_V12D07-332_D1,0,0,0,0,0,0
GCGAAGAATCTGACGG-1_V12D07-332_D1,0,0,0,0,0,0
GAACAACTGGGATGAA-1_V12D07-332_D1,0,0,0,1,0,1
TCGCCGACATATTCGC-1_V12D07-332_D1,0,0,0,1,0,1
CGTAGAGAGTAATTAT-1_V12D07-332_D1,0,0,0,0,0,0
CGATAGTCGTACTGCA-1_V12D07-332_D1,1,0,0,1,0,2
CGCATGCCGAATGCGT-1_V12D07-332_D1,0,0,0,2,0,2
CTCTAGCCCTCGGAAA-1_V12D07-332_D1,0,0,0,0,1,1
TCCAACTCAGCTATCT-1_V12D07-332_D1,0,2,0,0,0,2
GTCTAGTGAGCCGCTT-1_V12D07-332_D1,0,1,0,0,1,2
TACCGAATAATTGTAA-1_V12D07-332_D1,1,1,0,1,1,4
ATATAACACGGGCGCA-1_V12D07-332_D1,2,5,0,3,0,10
GCATGCTAATAACGAT-1_V12D07-332_D1,0,2,0,1,0,3
TCCGGGCTTGACGGGA-1_V12D07-332_D1,0,7,1,1,0,9
ATTATTCAGAGTCACT-1_V12D07-332_D1,0,4,1,1,0,6
TAGCAGTATGACTAAA-1_V12D07-332_D1,0,3,0,1,0,4
TATGAAGAATTAAGGT-1_V12D07-332_D1,0,5,1,1,0,7
CAAGGCCAGTGGTGCA-1_V12D07-332_D1,0,2,0,3,0,5
TGCGTACGGCTAATTG-1_V12D07-332_D1,0,4,0,2,1,7
CAGATAATGGGCGGGT-1_V12D07-332_D1,0,2,0,0,1,3
GAGAACGGTTCTGACT-1_V12D07-332_D1,0,1,0,0,0,1
CGCTTCGGTCTAAGAC-1_V12D07-332_D1,0,0,0,0,0,0
AGCATTACGAGGCAAG-1_V12D07-332_D1,0,0,0,1,0,1
AAGTTGTGATGTTATA-1_V12D07-332_D1,0,2,0,0,0,2
TTGCTCATAGTACGTG-1_V12D07-332_D1,0,0,0,1,0,1
TACTTAAACATGTACA-1_V12D07-332_D1,0,0,0,0,0,0
AGTGAGTCGAATTAAC-1_V12D07-332_D1,0,0,0,0,0,0
TAGGCCTATATAGTCT-1_V12D07-332_D1,14,0,0,2,0,16
ACTCGCCGTTCGATAA-1_V12D07-332_D1,20,0,0,0,0,20
GGTACGTTGCGGCCGG-1_V12D07-332_D1,14,0,0,3,0,17
TATTGCCGGGCTTGTA-1_V12D07-332_D1,3,0,0,0,0,3
GGTAAACTCTGCGCTG-1_V12D07-332_D1,0,1,0,1,0,2
TCCCTTGTCTGAAACT-1_V12D07-332_D1,3,1,0,5,0,9
CATGATCGCTTTGAGA-1_V12D07-332_D1,0,0,0,1,0,1
GGACGGGCGACCAACC-1_V12D07-332_D1,1,0,0,1,0,2
GAGAGGCCTATGTGTA-1_V12D07-332_D1,0,0,0,1,0,1
TCGTAACTCCCAAGAC-1_V12D07-332_D1,0,1,0,2,0,3
CGTATCTAGAACTAAG-1_V12D07-332_D1,0,1,0,2,0,3
GCACCTTCCCGAAGGT-1_V12D07-332_D1,0,0,0,0,0,0
TACCTCTTTACCATCC-1_V12D07-332_D1,0,0,0,0,0,0
TGACTCTAACTGGTAA-1_V12D07-332_D1,0,0,0,3,0,3
GAGAAACTGGATCCCA-1_V12D07-332_D1,0,1,0,1,0,2
ATCCGGACCAGCCTGA-1_V12D07-332_D1,1,0,0,3,0,4
TTATTTAGGTTCCTTA-1_V12D07-332_D1,0,0,0,0,0,0
CGAATTCCCGGTTCAA-1_V12D07-332_D1,0,0,0,0,0,0
ATTACGGGCTACGGTT-1_V12D07-332_D1,0,0,0,1,0,1
GCAAACGTAAGCGACC-1_V12D07-332_D1,1,3,3,0,0,7
TTCGGACTGGGCATGG-1_V12D07-332_D1,12,2,0,0,0,14
GGGCCATTCGTGCTGG-1_V12D07-332_D1,1,1,0,0,0,2
GAGTTGTCACCAGTCT-1_V12D07-332_D1,6,1,0,0,0,7
AGTAATTTGCAAGCGT-1_V12D07-332_D1,1,4,0,1,0,6
GTGGCCGGTTTCTCGG-1_V12D07-332_D1,0,4,4,0,0,8
ATCTTAGGGCATTAAT-1_V12D07-332_D1,0,1,1,0,0,2
CTACATATCGCGGGAC-1_V12D07-332_D1,0,4,1,0,2,7
ATGGTATTTACTGATT-1_V12D07-332_D1,0,0,3,1,1,5
CCGTCAACCTCTGGCG-1_V12D07-332_D1,0,2,2,0,0,4
GCTTCGACGTTCAATC-1_V12D07-332_D1,0,4,0,0,0,4
GACCGATTAAATATGT-1_V12D07-332_D1,1,6,1,0,0,8
GTCGAATTTGGGCGCT-1_V12D07-332_D1,6,2,0,0,0,8
TCACGGCCCAAGAGAG-1_V12D07-332_D1,2,9,4,0,0,15
CTACGATCCTATCCTA-1_V12D07-332_D1,9,2,2,0,0,13
TGCAGTGGTAGGGAAC-1_V12D07-332_D1,5,3,3,0,0,11
TTGCCTAATCCAAAGT-1_V12D07-332_D1,1,0,6,0,0,7
AGCGAGACGTGAAGGC-1_V12D07-332_D1,0,10,6,0,0,16
TTCTACCTCAATCGGT-1_V12D07-332_D1,6,1,3,0,0,10
TACGCTGCTGTGTTAA-1_V12D07-332_D1,0,3,0,0,0,3
TAGTCCTGCACTAAGC-1_V12D07-332_D1,0,1,1,0,0,2
AGCACACGTTTAGACT-1_V12D07-332_D1,0,3,0,0,0,3
GTTCGACAATTGTATA-1_V12D07-332_D1,0,3,0,0,0,3
CCATGTTCATCTATAT-1_V12D07-332_D1,0,2,0,0,0,2
CCCTCGATAATACACA-1_V12D07-332_D1,0,9,0,4,0,13
ACTGCCCGCCATTCTC-1_V12D07-332_D1,0,2,0,4,0,6
CTATATCCAGCCTGGC-1_V12D07-332_D1,1,4,2,1,0,8
CGCACGTCTGTTTATG-1_V12D07-332_D1,0,6,2,0,0,8
AATCAGGTTTCATTTA-1_V12D07-332_D1,0,5,0,0,0,5
AGAGAAACACCAGAAA-1_V12D07-332_D1,0,2,0,1,0,3
ACCCGATTGGTTCCGA-1_V12D07-332_D1,0,2,0,3,0,5
TACCAGGAATCCCGTC-1_V12D07-332_D1,0,3,0,1,0,4
AAGTGCTTCTCTATTG-1_V12D07-332_D1,0,1,0,0,0,1
TGCATGTGACCCATAG-1_V12D07-332_D1,0,3,1,1,0,5
TAGATTCAAAGTGCGG-1_V12D07-332_D1,0,4,0,2,0,6
AGGGTCAGAGCACTCG-1_V12D07-332_D1,0,3,0,1,0,4
GTGAGATAACCTTATA-1_V12D07-332_D1,0,4,0,0,0,4
GTGTCAGTGTACGTGG-1_V12D07-332_D1,0,2,0,1,0,3
CTGTAGTGAGGATCGA-1_V12D07-332_D1,0,2,2,0,0,4
GATAGTGCGAGTAAGT-1_V12D07-332_D1,0,2,0,1,0,3
AGGGTTCAGACGGTCC-1_V12D07-332_D1,0,2,0,0,0,2
GGACTCGACAGCGCAT-1_V12D07-332_D1,0,2,0,0,1,3
CACTCTCAAGCATCGA-1_V12D07-332_D1,0,2,0,0,0,2
GAGCGGAATGCGGTGT-1_V12D07-332_D1,0,1,0,0,0,1
CAGTTCGAGGACCCGA-1_V12D07-332_D1,0,0,0,4,3,7
CGTAACTTCGACACTT-1_V12D07-332_D1,0,0,0,1,0,1
TGATCACCACACTGAC-1_V12D07-332_D1,0,5,0,0,0,5
CATACTTCTTTCTCCG-1_V12D07-332_D1,0,0,0,0,0,0
CAAGTAAGTGATAGAC-1_V12D07-332_D1,0,0,0,1,4,5
AGCCCGCAACAAGCAG-1_V12D07-332_D1,0,1,0,0,1,2
GCTCCATGCAAAGCAA-1_V12D07-332_D1,0,3,0,2,0,5
TCGTACCGACGTCAAG-1_V12D07-332_D1,0,0,0,1,0,1
ATTATCGGAATGTACG-1_V12D07-332_D1,0,1,0,0,0,1
ACCTACTATAAATCTA-1_V12D07-332_D1,0,1,0,0,0,1
TATCCTATCAACTGGT-1_V12D07-332_D1,1,1,0,1,0,3
GCGCGGTCTAGTAACT-1_V12D07-332_D1,0,0,0,0,0,0
CCTTCGTATAGAATCC-1_V12D07-332_D1,1,0,0,2,0,3
TGGGCGATACAATAAG-1_V12D07-332_D1,0,1,0,1,0,2
TGACATGTAACGTGAC-1_V12D07-332_D1,0,0,0,2,0,2
TTGGGAAGACGAGCCG-1_V12D07-332_D1,1,1,0,2,0,4
GGTGTAAATCGATTGT-1_V12D07-332_D1,0,1,0,0,0,1
GAACTGTGGAGAGACA-1_V12D07-332_D1,0,1,0,3,0,4
TCCACATCGTATATTG-1_V12D07-332_D1,1,1,0,0,0,2
CCTATGGTCAAAGCTG-1_V12D07-332_D1,0,1,0,2,0,3
TCCTTGTCCTTTAATT-1_V12D07-332_D1,0,0,0,0,0,0
AAGTTTATGGGCCCAA-1_V12D07-332_D1,0,0,0,0,0,0
GTCCGGGTTCACATTA-1_V12D07-332_D1,1,2,1,0,0,4
ATGTAGCGCGCGTAGG-1_V12D07-332_D1,1,1,0,0,0,2
TACGGAAGCCAAACCA-1_V12D07-332_D1,0,0,0,0,0,0
GCCCTGAGGATGGGCT-1_V12D07-332_D1,0,1,0,1,0,2
CGGGCGATGGATCACG-1_V12D07-332_D1,0,0,0,0,0,0
TGCGGACTTGACTCCG-1_V12D07-332_D1,1,0,0,3,0,4
TAATACTAGAACAGAC-1_V12D07-332_D1,1,0,0,0,0,1
TCAAATTGTTGTGCCG-1_V12D07-332_D1,2,0,0,0,0,2
GGGCAGTCAACGCCAA-1_V12D07-332_D1,1,0,0,0,0,1
TCGCTGCCAATGCTGT-1_V12D07-332_D1,1,0,1,5,0,7
TACGTGGGCCCAGGGC-1_V12D07-332_D1,1,0,0,0,0,1
GCCTACGTTCTGTGCA-1_V12D07-332_D1,0,0,0,1,0,1
TTGCGTGTGTAGGCAT-1_V12D07-332_D1,0,0,0,1,0,1
TCCTAAAGATTCAGAC-1_V12D07-332_D1,0,0,0,0,0,0
TGGGTGCACAAGCCAT-1_V12D07-332_D1,0,0,0,0,0,0
GGGAGCGACCGTAGTG-1_V12D07-332_D1,0,0,0,0,0,0
CATAGAGGAGATACTA-1_V12D07-332_D1,0,1,0,0,0,1
CTTCGATTGCGCAAGC-1_V12D07-332_D1,0,0,0,3,1,4
GTGCCTGAGACCAAAC-1_V12D07-332_D1,0,1,0,0,0,1
TCATCCTCAGCTGCTT-1_V12D07-332_D1,0,2,0,1,0,3
TGCAACTACTGGTTGA-1_V12D07-332_D1,0,0,0,0,0,0
ATGTTGATTAGAGACT-1_V12D07-332_D1,1,0,1,1,1,4
GTTTCTAGAGGCGCGG-1_V12D07-332_D1,0,1,0,0,0,1
TACAAGGGCTTCTTTA-1_V12D07-332_D1,0,0,0,0,0,0
ACAGGCACGGATCCTT-1_V12D07-332_D1,0,2,0,0,1,3
CCCAAGTCATTACACT-1_V12D07-332_D1,0,3,0,1,0,4
ACTCTGACCTAATAGA-1_V12D07-332_D1,0,3,0,2,0,5
GGATGGCTTGAAGTAT-1_V12D07-332_D1,0,7,0,2,0,9
ACCCTCCCGTCAGGGC-1_V12D07-332_D1,0,3,1,1,0,5
AGCTTCTTCTCGAGCA-1_V12D07-332_D1,0,6,2,0,0,8
TTGCGCTTGATCAATA-1_V12D07-332_D1,0,2,0,1,1,4
TGGGTGTAATAGATTT-1_V12D07-332_D1,0,1,0,0,1,2
CATGGTTTATTAATCA-1_V12D07-332_D1,0,2,0,0,0,2
TTGCCTTCTCGCCGGG-1_V12D07-332_D1,0,1,0,0,0,1
TTAAAGTAAGTCGCCA-1_V12D07-332_D1,0,1,0,2,0,3
AGTTGGCAAGGCTAGA-1_V12D07-332_D1,0,0,0,0,0,0
CCGCACTTGCAATGAC-1_V12D07-332_D1,0,1,0,0,0,1
AATGTTGTCGTGAGAC-1_V12D07-332_D1,0,0,0,1,0,1
CCAAGGTTGCCCTTTC-1_V12D07-332_D1,0,1,0,0,1,2
TGTGACTAGAGTTTGC-1_V12D07-332_D1,0,0,0,0,0,0
TTGTGATCTGTTCAGT-1_V12D07-332_D1,1,0,0,1,0,2
GGAGTTGATTCTGTGT-1_V12D07-332_D1,16,0,0,2,0,18
GTAGTGAGCAACCTCA-1_V12D07-332_D1,21,0,0,0,0,21
AAGACATACGTGGTTT-1_V12D07-332_D1,16,0,0,0,0,16
CATCCCGAGATTCATA-1_V12D07-332_D1,11,0,0,1,0,12
GGCCGCAGGAACCGCA-1_V12D07-332_D1,6,1,0,2,0,9
CCAGAAACTGATGCGA-1_V12D07-332_D1,22,0,0,0,0,22
ACCCGTAGTCTAGTTG-1_V12D07-332_D1,4,0,0,2,0,6
AGGGTCTGGACGCAGT-1_V12D07-332_D1,12,0,0,1,0,13
TTGAAACCCTCATTCC-1_V12D07-332_D1,1,0,0,2,0,3
TCAATCCCGCGCCAAA-1_V12D07-332_D1,2,1,0,4,0,7
AGGACATCGGCACACT-1_V12D07-332_D1,0,0,0,1,0,1
GACAAGACGCCCGTGC-1_V12D07-332_D1,0,0,0,1,0,1
GAGTAAATTAAGAACC-1_V12D07-332_D1,0,3,0,0,0,3
TAAGTCGGTGAGCTAG-1_V12D07-332_D1,0,1,0,3,0,4
CTTACTGACTCCTCTG-1_V12D07-332_D1,0,1,0,1,0,2
TTAACTGATCGTTTGG-1_V12D07-332_D1,0,1,0,4,0,5
GCTGAAGGGTTCTTGG-1_V12D07-332_D1,0,1,0,0,0,1
TAATTGCGCTGATTAC-1_V12D07-332_D1,0,2,3,1,0,6
TCGCGCGTTTACATGA-1_V12D07-332_D1,5,0,6,0,0,11
TAACTGAAATACGCCT-1_V12D07-332_D1,5,3,1,0,0,9
CCTGTCGTGTATGAAG-1_V12D07-332_D1,7,2,1,0,0,10
CGGGAACGCCCTGCAT-1_V12D07-332_D1,7,1,1,0,0,9
AGTTGCGGTCCTCAAC-1_V12D07-332_D1,0,0,2,1,0,3
GGGTCCTTGGAAGAAG-1_V12D07-332_D1,0,4,0,2,0,6
CGGGAAGTACCGTGGC-1_V12D07-332_D1,0,3,1,0,0,4
ACGGTCACCGAGAACA-1_V12D07-332_D1,0,4,1,1,2,8
TAGACTCAGTTGGCCT-1_V12D07-332_D1,0,4,0,0,0,4
CCTTCCGCAACGCTGC-1_V12D07-332_D1,0,3,0,0,0,3
CAGTGTTAATCTCTCA-1_V12D07-332_D1,0,7,2,0,0,9
CAGGCCAGTACCACCT-1_V12D07-332_D1,8,3,0,1,0,12
GATCGCTGTGGTGCGT-1_V12D07-332_D1,12,3,2,0,0,17
GTATCTCGGGCGCTTT-1_V12D07-332_D1,7,3,1,0,0,11
CCGGGCTAAGAATTTC-1_V12D07-332_D1,1,4,1,0,0,6
CTTCACGCCCTGGTAC-1_V12D07-332_D1,6,3,1,0,0,10
CGGATGAATGCTGTGA-1_V12D07-332_D1,13,0,2,0,0,15
CTCTGCAGGCATTCTT-1_V12D07-332_D1,5,3,4,0,0,12
TCAAAGTCACGGCGTC-1_V12D07-332_D1,0,3,1,1,0,5
TGGGTTTCGGGCGTAC-1_V12D07-332_D1,0,5,1,0,0,6
TGCTATGGCAAAGGGA-1_V12D07-332_D1,0,6,1,0,0,7
TTCACGGTCGTCACGT-1_V12D07-332_D1,0,2,0,0,0,2
CGTAAAGCAAGAAATC-1_V12D07-332_D1,0,3,1,2,0,6
CTGATCCCTTTATGCA-1_V12D07-332_D1,0,5,0,2,0,7
GAGTATACCCTAATCA-1_V12D07-332_D1,0,2,3,1,0,6
CCACGGCAGGTGTAGG-1_V12D07-332_D1,0,4,0,0,0,4
ACGTACTTTGGCACGG-1_V12D07-332_D1,0,1,0,0,0,1
CCTGAGAATAAATGCA-1_V12D07-332_D1,0,5,1,0,0,6
TTGATGCCGCTCGTCG-1_V12D07-332_D1,0,0,0,0,0,0
GCCAGGAAAGAACACT-1_V12D07-332_D1,0,3,0,2,0,5
TCCGACCGCTAATCAA-1_V12D07-332_D1,0,7,1,0,0,8
TATATCAAAGTGATCT-1_V12D07-332_D1,0,5,0,0,0,5
CCTCGGTTTCCTTGCC-1_V12D07-332_D1,0,2,1,1,0,4
TAAATTTAGTAACACC-1_V12D07-332_D1,0,2,0,0,0,2
CTCGTTACGGCTACCA-1_V12D07-332_D1,0,5,0,0,0,5
GCCGTCGGTTTCGGGC-1_V12D07-332_D1,0,1,0,3,0,4
GTTCCGTCCGCCTGCA-1_V12D07-332_D1,0,2,0,1,0,3
CTAGGGATAGGGACAA-1_V12D07-332_D1,0,2,0,1,0,3
GTCCAGGCACGTGTGC-1_V12D07-332_D1,0,3,0,0,0,3
GAGGAATATCTCTTTG-1_V12D07-332_D1,0,2,0,0,0,2
CGTTCAAGGAAACGGA-1_V12D07-332_D1,0,3,0,0,0,3
GTGGGAACAAACCGGG-1_V12D07-332_D1,0,2,0,0,2,4
GGGCACGTAGTACTGT-1_V12D07-332_D1,0,2,1,1,1,5
ACTACAAAGAGAGGTG-1_V12D07-332_D1,0,0,0,1,1,2
GGTGTAGGTAAGTAAA-1_V12D07-332_D1,0,1,0,0,1,2
CCTGTTCAACCTCGGG-1_V12D07-332_D1,0,0,0,3,1,4
TGAGGTGTGTGGCGGA-1_V12D07-332_D1,0,1,0,2,1,4
ATTGTCTGTTTCATGT-1_V12D07-332_D1,0,0,0,1,0,1
GCCGGTCGTATCTCTC-1_V12D07-332_D1,0,0,0,0,0,0
ATATGGGATAGCAACT-1_V12D07-332_D1,0,0,0,1,0,1
GATAGAACCCGCTAGG-1_V12D07-332_D1,0,0,1,0,0,1
ATCCCATTTCCGTGGG-1_V12D07-332_D1,1,1,0,0,0,2
GATGCTACCTTCGATG-1_V12D07-332_D1,0,4,0,2,0,6
TGCAAAGTTCGTCTGT-1_V12D07-332_D1,0,0,0,1,0,1
GTTCAGTCGCCAAATG-1_V12D07-332_D1,0,0,0,0,0,0
GTCTCCGCCTCAATAC-1_V12D07-332_D1,0,0,1,0,0,1
AGTAGAAGGCGCCTCA-1_V12D07-332_D1,0,0,0,0,0,0
GTTGTAGATTTATGAG-1_V12D07-332_D1,1,0,0,1,0,2
CTATTTGCTTGGAGGA-1_V12D07-332_D1,0,1,0,0,0,1
AGCCATATAGTATGTG-1_V12D07-332_D1,0,0,0,1,0,1
TGTTCCGGCCTGAGCT-1_V12D07-332_D1,0,0,0,1,0,1
TGCCGTGGGACCCAAT-1_V12D07-332_D1,1,1,1,4,0,7
TTGCAAGAAGACTCCT-1_V12D07-332_D1,1,0,0,1,0,2
CCGCTCCAGGGCGATC-1_V12D07-332_D1,0,0,0,1,0,1
CAAACCCTCCGGCGGG-1_V12D07-332_D1,1,0,0,1,0,2
CGGACCTTTACGTCCC-1_V12D07-332_D1,0,0,0,1,0,1
ACGTAGGAGAGTCGCT-1_V12D07-332_D1,0,0,0,1,0,1
CTGCGACCTCGCCGAA-1_V12D07-332_D1,1,0,0,1,0,2
GGCCCAGCTGGTTTGC-1_V12D07-332_D1,0,2,0,0,0,2
GGATTAATCATGGACC-1_V12D07-332_D1,0,0,0,0,0,0
GAGATGGCTTTAATCA-1_V12D07-332_D1,0,1,0,2,0,3
AGTACAGAAGCTTATA-1_V12D07-332_D1,1,0,1,0,0,2
GCGGCTTTAGCAAGTT-1_V12D07-332_D1,0,0,0,0,0,0
ACCGAGTCTCCTTATT-1_V12D07-332_D1,0,0,0,1,0,1
GACCACACTTCCCTTT-1_V12D07-332_D1,0,0,0,0,0,0
TGTAGCCAATTCCGTT-1_V12D07-332_D1,0,0,0,1,0,1
CTCGTCTGTGCCTTCG-1_V12D07-332_D1,0,0,0,0,0,0
GGACTCTTTGACTAAG-1_V12D07-332_D1,0,0,0,0,0,0
TCATCGACGACCGTCG-1_V12D07-332_D1,0,0,0,1,0,1
TACTACGTGCAATGCG-1_V12D07-332_D1,0,0,1,11,2,14
CCCTACTTGAACAATG-1_V12D07-332_D1,1,0,0,0,0,1
GCAGCTGTCAACGCAT-1_V12D07-332_D1,0,0,0,0,0,0
ATCTACCATCTGCTCC-1_V12D07-332_D1,0,0,0,0,0,0
TCTCAAATCAATCGGG-1_V12D07-332_D1,0,1,0,0,0,1
ACTCCGGCCGACCACT-1_V12D07-332_D1,0,0,0,2,0,2
TACACCTCTTCGAATC-1_V12D07-332_D1,0,0,0,1,0,1
GTGGCTGTTTCTGTTC-1_V12D07-332_D1,1,1,0,1,0,3
ACGACTCTAGGGCCGA-1_V12D07-332_D1,0,2,0,0,0,2
TCGTTTACGCGACCCT-1_V12D07-332_D1,0,0,0,0,1,1
AGGATATCCGACTGCA-1_V12D07-332_D1,0,0,0,0,4,4
GACACTTCCAATTACC-1_V12D07-332_D1,0,3,0,0,0,3
ACGGTACAGTTCAATG-1_V12D07-332_D1,0,3,0,2,0,5
CTTGATGACCATCCAG-1_V12D07-332_D1,0,3,0,2,0,5
CTGGTAAAGACTTACA-1_V12D07-332_D1,0,4,0,2,0,6
CTTGCCCACCCACGCA-1_V12D07-332_D1,0,2,0,2,0,4
CATTACGCAGGAAGGG-1_V12D07-332_D1,0,4,0,1,0,5
GGACAACCATGAAGCC-1_V12D07-332_D1,0,2,0,0,1,3
GTTATCAAGCTATCGA-1_V12D07-332_D1,0,2,0,1,2,5
AGGTGCACGTCCACAT-1_V12D07-332_D1,0,0,0,0,0,0
AAAGAATGTGGACTAA-1_V12D07-332_D1,0,0,1,5,0,6
ACCAAGTCATCGGCAG-1_V12D07-332_D1,0,1,0,0,0,1
AGTAACTATAGCAGCC-1_V12D07-332_D1,0,1,0,0,0,1
GGGAAAGAATGCCAAC-1_V12D07-332_D1,0,0,0,2,0,2
AATCGGTATAGCCCTC-1_V12D07-332_D1,0,0,0,3,0,3
GGCACTGCGGTGGTTT-1_V12D07-332_D1,0,0,0,1,0,1
CGTCCTCATCGCGTGC-1_V12D07-332_D1,0,0,0,1,0,1
CTTAACTTACAGTATA-1_V12D07-332_D1,0,1,0,1,0,2
GTGAGTCGACTAATAG-1_V12D07-332_D1,0,0,0,0,0,0
TGTACTTCCGGGCATG-1_V12D07-332_D1,17,1,0,1,0,19
CACAAACCGCAGAACT-1_V12D07-332_D1,2,0,0,4,0,6
GCTTTACACAACTGGG-1_V12D07-332_D1,14,0,0,2,0,16
CACCGATGATGGGTAC-1_V12D07-332_D1,6,1,0,2,0,9
TCAATATACAGGAGGC-1_V12D07-332_D1,23,0,0,1,0,24
AACGACCTCCTAGCCG-1_V12D07-332_D1,11,0,0,1,0,12
GTTACCAAGGCGTACG-1_V12D07-332_D1,18,0,0,0,0,18
TAGCTCACTGTGTTTG-1_V12D07-332_D1,13,0,0,0,0,13
TCGGCAGGGTTAAGGG-1_V12D07-332_D1,16,1,0,1,0,18
TGTTAACAAAGTGACT-1_V12D07-332_D1,20,0,0,1,0,21
CAGAGCGATGGATGCT-1_V12D07-332_D1,0,0,0,1,0,1
CATAGTGGGCACGCCT-1_V12D07-332_D1,12,0,0,1,0,13
AAACGCTGGGCACGAC-1_V12D07-332_D1,0,0,0,3,0,3
TGTTCTCATACTATAG-1_V12D07-332_D1,0,3,0,2,0,5
ACGGGTTGTGACCTGT-1_V12D07-332_D1,0,2,2,0,0,4
TGACAGAAATCTTGCT-1_V12D07-332_D1,6,2,0,0,0,8
TAGCCATGATTGCCTA-1_V12D07-332_D1,6,1,2,0,0,9
CGAAGCCACAGCATGG-1_V12D07-332_D1,12,1,1,0,0,14
ACCCGTAGCAGAGAAT-1_V12D07-332_D1,4,4,1,0,0,9
AGCTTGATCAGGGTAG-1_V12D07-332_D1,0,6,0,1,0,7
CTATAAGTAGGGTTTG-1_V12D07-332_D1,0,6,0,0,0,6
TATAGTTAGGTGTACT-1_V12D07-332_D1,0,2,1,1,0,4
TACGCTGATAGTTGTA-1_V12D07-332_D1,0,2,3,1,0,6
TTCTCAATTGCTACAA-1_V12D07-332_D1,0,3,2,0,0,5
GTTGCCCTAACGGGTG-1_V12D07-332_D1,0,2,1,0,0,3
GACATTTCGCCCAGCC-1_V12D07-332_D1,0,8,1,0,0,9
GTAACTACGTAGACCT-1_V12D07-332_D1,3,2,2,0,0,7
CCAGTGTACAGACCGA-1_V12D07-332_D1,5,2,4,0,0,11
GCCCGATGCCCAGTTC-1_V12D07-332_D1,5,4,3,0,0,12
CGAACCTCTTTCCTAG-1_V12D07-332_D1,9,2,3,0,0,14
CATGCACATGAGAGGC-1_V12D07-332_D1,16,0,0,0,0,16
CCAAATCAAAGGGCAA-1_V12D07-332_D1,8,3,2,0,0,13
GTAGTTTAAGCACACG-1_V12D07-332_D1,8,4,2,0,0,14
TAAGTGAATAGTCTAC-1_V12D07-332_D1,0,5,4,0,0,9
GGTCCACGTCTATTTG-1_V12D07-332_D1,0,6,0,1,0,7
CCCTCAGATCGAGAAC-1_V12D07-332_D1,0,10,0,1,0,11
ACATTCGCGCGGAATA-1_V12D07-332_D1,0,5,0,2,0,7
CTATGAACACCTTGCC-1_V12D07-332_D1,0,4,0,1,0,5
CGAATGGTAGGTCGTC-1_V12D07-332_D1,0,2,1,0,0,3
TCGACATAGCGTAGCG-1_V12D07-332_D1,0,3,1,1,0,5
GACGTTGCTCGGCGGC-1_V12D07-332_D1,0,0,2,0,0,2
CTCGAGGCAAGTTTCA-1_V12D07-332_D1,0,0,0,2,0,2
GCTGGGAGCGCGTCAA-1_V12D07-332_D1,0,4,1,0,0,5
GACGATATCACTGGGT-1_V12D07-332_D1,0,5,0,1,0,6
CAGCTCTGGGCTCACT-1_V12D07-332_D1,0,3,0,2,0,5
TAGTCTGCGGCACATT-1_V12D07-332_D1,0,6,2,0,0,8
TGGTCGATATACCTCT-1_V12D07-332_D1,0,3,0,0,0,3
TTCAGTTCAAGAGGAG-1_V12D07-332_D1,0,5,2,1,0,8
GTCTGTAGGTTGAACA-1_V12D07-332_D1,0,3,1,1,0,5
GAGAGTCTCGGGAGAG-1_V12D07-332_D1,0,5,0,0,0,5
TTGTTTGTATTACACG-1_V12D07-332_D1,0,4,0,0,0,4
GCACAGCACGGGCCGA-1_V12D07-332_D1,0,1,0,0,0,1
AAACAGTGTTCCTGGG-1_V12D07-332_D1,0,3,1,1,0,5
TGGAGAATAATCGTCC-1_V12D07-332_D1,0,0,0,0,0,0
CGCCGCGTTCTGAACG-1_V12D07-332_D1,0,1,0,0,0,1
CATGCGTTGAGAGGAG-1_V12D07-332_D1,0,3,1,0,0,4
TACGCTCCTAGAACTG-1_V12D07-332_D1,0,1,0,0,0,1
CCTTGTGAACGTGGTT-1_V12D07-332_D1,0,4,0,0,0,4
TTAAAGGCGATGCTCG-1_V12D07-332_D1,0,3,0,0,1,4
TAAAGTGCACGTCTCG-1_V12D07-332_D1,0,0,0,1,0,1
TGTCCGCAAACAATTC-1_V12D07-332_D1,0,3,1,0,0,4
AGGCCTATCATACCAA-1_V12D07-332_D1,0,0,0,0,0,0
ACTGGGATGCCAGTGC-1_V12D07-332_D1,0,2,2,0,0,4
CGATCCACCATTGTTG-1_V12D07-332_D1,0,0,1,0,0,1
GGGCATGCATGTCGAG-1_V12D07-332_D1,0,0,0,1,0,1
TCCAGGCAGGACGATC-1_V12D07-332_D1,0,0,0,1,0,1
CAATGACCCTTAATTT-1_V12D07-332_D1,0,0,0,0,0,0
ATCAAGATCCCAGGAC-1_V12D07-332_D1,0,0,0,0,0,0
CTCAGAGCTAATGTCG-1_V12D07-332_D1,0,0,0,0,0,0
CTGCGATTTCGAGATT-1_V12D07-332_D1,0,0,0,2,0,2
ATGGTATTGGGAACCG-1_V12D07-332_D1,0,2,0,1,0,3
TAGGTTCTGCTGAGAA-1_V12D07-332_D1,0,3,0,2,0,5
GCCTGTCCCGGTGCAT-1_V12D07-332_D1,0,0,0,0,0,0
GGCCTGCTCTGATGTT-1_V12D07-332_D1,0,1,0,1,0,2
TAGAGGGAGTTTATCT-1_V12D07-332_D1,0,0,0,3,0,3
CTCTACATCCTGCGTG-1_V12D07-332_D1,1,0,1,1,0,3
ACACATTTCCGTAGAC-1_V12D07-332_D1,0,1,0,2,0,3
TGGGTGTTAAGTAGAA-1_V12D07-332_D1,0,0,0,0,0,0
GAGCTCAACATGAGCG-1_V12D07-332_D1,0,0,0,1,0,1
GCACACAGCTATTACC-1_V12D07-332_D1,0,0,0,0,0,0
GCGACGGTAGTCTCCT-1_V12D07-332_D1,0,0,0,0,0,0
GTATCAAGGTACTTCC-1_V12D07-332_D1,1,1,0,0,0,2
GGAAAGGGAATTGAGC-1_V12D07-332_D1,0,0,0,1,0,1
TACACAGCCGTGGTGC-1_V12D07-332_D1,0,0,0,1,0,1
CGGTTGGGCAGGGTCC-1_V12D07-332_D1,0,0,0,0,0,0
GCACGCCGATTCCCGC-1_V12D07-332_D1,0,0,0,0,0,0
CGCTTTCCGCCAAGGT-1_V12D07-332_D1,0,0,0,2,0,2
TGCCCGATAGTTAGAA-1_V12D07-332_D1,0,0,0,0,0,0
TCAGAACGGCGGTAAT-1_V12D07-332_D1,0,0,0,0,0,0
CCACTCAGATCCGCAA-1_V12D07-332_D1,0,0,0,0,0,0
GAAGGGTCATTAAGAC-1_V12D07-332_D1,1,0,0,0,0,1
GCGGTCTTGCTTTCAC-1_V12D07-332_D1,0,0,0,1,0,1
GGAAGGACACCGTATA-1_V12D07-332_D1,0,0,0,0,0,0
CGCGGGAATTCCTTTC-1_V12D07-332_D1,0,0,0,1,0,1
TCTATCCGATTGCACA-1_V12D07-332_D1,0,0,0,0,0,0
TACTCGTTTGAATCAA-1_V12D07-332_D1,0,1,0,0,0,1
GTCTGCCGACTCGACG-1_V12D07-332_D1,0,0,0,0,0,0
TACGGGTAATAACATA-1_V12D07-332_D1,0,0,0,0,0,0
CCAGTTCGGTAACTCA-1_V12D07-332_D1,0,0,0,0,0,0
CGTGCACACCACTGTA-1_V12D07-332_D1,0,0,0,0,0,0
CTTCAGTTGGACAACG-1_V12D07-332_D1,0,1,0,1,0,2
TGATCTATCACACTCT-1_V12D07-332_D1,0,1,0,1,0,2
TAGCAGATACTTAGGG-1_V12D07-332_D1,0,1,0,1,0,2
CACCGGGCATCACAAG-1_V12D07-332_D1,0,0,0,2,1,3
AGTGGCCCGCAAATGG-1_V12D07-332_D1,0,0,0,1,2,3
CTCGCTAGGTAAGCGA-1_V12D07-332_D1,0,0,0,1,0,1
GATAGATAGTACAGTC-1_V12D07-332_D1,0,2,0,0,0,2
CGAGACTACTGCTGCT-1_V12D07-332_D1,1,9,0,2,0,12
ACATTTGAAACCTAAC-1_V12D07-332_D1,0,4,0,2,0,6
GACACAGCCGGGACTG-1_V12D07-332_D1,1,7,0,0,0,8
ACGGAACACGAGTGCC-1_V12D07-332_D1,0,7,0,2,0,9
ACGCCAGTGCGTTTGC-1_V12D07-332_D1,0,4,0,0,0,4
GCACCTAGGCGAGTCC-1_V12D07-332_D1,0,3,1,1,0,5
TCACTATCCCTTCGGT-1_V12D07-332_D1,0,1,0,1,0,2
TGAGTGTAACAACGGG-1_V12D07-332_D1,0,1,0,0,0,1
ATTGGTTGTGCATTAC-1_V12D07-332_D1,0,4,1,0,0,5
CTGGCGATTTACATGT-1_V12D07-332_D1,0,5,0,1,0,6
TCCACCAAGACATAGG-1_V12D07-332_D1,0,2,0,2,0,4
AACGTCGCTGCACTTC-1_V12D07-332_D1,0,1,1,0,0,2
GTCTCCCGAGTCCCGT-1_V12D07-332_D1,0,1,0,1,0,2
AGCCCGCACTACAATG-1_V12D07-332_D1,0,0,0,0,0,0
GGCACGCTGCTACAGT-1_V12D07-332_D1,0,0,0,1,0,1
GCTTGAGTGACCTCTG-1_V12D07-332_D1,0,0,0,0,0,0
ATAGCCATAACAGTCA-1_V12D07-332_D1,1,0,0,0,0,1
TAGGAGGCTCGAGAAC-1_V12D07-332_D1,1,0,0,1,0,2
GTCGGGTGAAGTACCG-1_V12D07-332_D1,0,0,0,1,0,1
CACCCGCGTTTGACAC-1_V12D07-332_D1,0,0,0,0,0,0
TCTCAGGCTACTCGCT-1_V12D07-332_D1,5,0,0,2,0,7
TAGATTCTCTAGCAAA-1_V12D07-332_D1,1,1,0,0,0,2
CCCATTATTGTATCCT-1_V12D07-332_D1,4,0,0,0,0,4
GTTAATAGCGTCATTA-1_V12D07-332_D1,0,0,0,0,0,0
TACTCATTGACGCATC-1_V12D07-332_D1,2,1,0,2,0,5
TAGTGACAAGCTCTAC-1_V12D07-332_D1,0,0,0,1,0,1
ATCGCCGTGGTTCATG-1_V12D07-332_D1,17,0,0,0,0,17
CTGCTCTCAACACACC-1_V12D07-332_D1,2,0,0,0,0,2
GCATGACACAAAGGAA-1_V12D07-332_D1,21,0,0,0,0,21
CAACGATCGATCCAAT-1_V12D07-332_D1,20,0,0,2,0,22
TCTGTTTAGATTGTTC-1_V12D07-332_D1,0,2,1,0,0,3
GCTACTCGGACGCAGA-1_V12D07-332_D1,8,0,2,0,0,10
AAGAAAGTTTGATGGG-1_V12D07-332_D1,12,1,1,0,0,14
CGCCAGTAGTACCTTG-1_V12D07-332_D1,8,3,2,0,0,13
CTCCCTTGTATCAAGG-1_V12D07-332_D1,3,3,1,0,0,7
ACTTTATACACCACTT-1_V12D07-332_D1,2,6,3,0,0,11
AGATCTGGAGAGGATA-1_V12D07-332_D1,0,3,2,0,0,5
TCATCCATCTGATCAC-1_V12D07-332_D1,0,1,1,1,0,3
AGAACACGGCGATGGT-1_V12D07-332_D1,0,6,0,0,0,6
CCGCTCCGGATAAGCT-1_V12D07-332_D1,0,6,0,0,0,6
TGGTCGGGTACAGGGC-1_V12D07-332_D1,0,6,0,0,0,6
ACGGACGCAGCGACAA-1_V12D07-332_D1,0,4,3,0,0,7
ACATGCTTACGGCAGC-1_V12D07-332_D1,1,2,10,0,0,13
CAGGGAGATAGGCCAG-1_V12D07-332_D1,8,5,0,0,0,13
TCGCCACCCGGATTAC-1_V12D07-332_D1,11,2,1,0,0,14
TCTTGGTCAATGATAC-1_V12D07-332_D1,13,1,3,0,0,17
CATAGGGACACTTGTG-1_V12D07-332_D1,6,3,3,0,0,12
CACGAGCAAACCAGAC-1_V12D07-332_D1,5,4,3,0,0,12
GGGATATTGATCGCCA-1_V12D07-332_D1,2,3,1,0,0,6
TAATGTCGGTTCATGG-1_V12D07-332_D1,2,5,1,0,0,8
CGATTTGTCATTAATG-1_V12D07-332_D1,0,2,1,7,0,10
TTAAGATACCCAGAGA-1_V12D07-332_D1,0,4,0,5,0,9
CGACCGTTGGTATTCG-1_V12D07-332_D1,0,6,0,0,0,6
ACTACCATCCGAGGGC-1_V12D07-332_D1,0,3,0,0,0,3
TCTACGCACGATCTCC-1_V12D07-332_D1,1,8,0,0,0,9
AAGCCACTTGCAGGTA-1_V12D07-332_D1,0,4,1,0,0,5
ACGTTGTCGTTGAAAG-1_V12D07-332_D1,0,2,0,1,0,3
ACCGCTAGTCATTGGT-1_V12D07-332_D1,1,1,1,2,0,5
CATGAGTCCATCACGG-1_V12D07-332_D1,0,7,1,0,0,8
ATGTCTTGTTTGACTC-1_V12D07-332_D1,0,2,0,1,0,3
TCCCAAACATCCTCTA-1_V12D07-332_D1,1,5,0,0,0,6
CAACGCGATGAGCCAA-1_V12D07-332_D1,0,4,1,1,0,6
GACACCCAAAGACGCG-1_V12D07-332_D1,0,2,0,1,0,3
ACGTTCACTATGCCGC-1_V12D07-332_D1,0,3,0,0,0,3
ATGGACTGCTTAGTTG-1_V12D07-332_D1,0,1,0,3,0,4
CCATGGCAAACGCTCA-1_V12D07-332_D1,0,5,0,0,0,5
TTGTCTCGGCAAGATG-1_V12D07-332_D1,0,4,2,0,0,6
TTCGAACGAAACATGC-1_V12D07-332_D1,0,4,0,0,0,4
GGAAAGTCTTGATTGT-1_V12D07-332_D1,0,3,0,0,0,3
ATCATAGATCGACGAG-1_V12D07-332_D1,0,3,1,0,0,4
GATTAGAAACAAGCGT-1_V12D07-332_D1,0,2,0,0,0,2
GCTGCGAAGAATTATT-1_V12D07-332_D1,0,2,0,1,0,3
TTCCAGTGGGTTTCGT-1_V12D07-332_D1,0,1,0,1,0,2
GCTCATTGATCATATC-1_V12D07-332_D1,0,3,0,1,0,4
ATACGAGGTTTGTAAG-1_V12D07-332_D1,0,2,0,0,0,2
GTCTATACACGCATGG-1_V12D07-332_D1,0,1,0,0,2,3
GATTTGCGCTAACACC-1_V12D07-332_D1,0,1,1,0,0,2
TGGTGCCCTGCCTTAC-1_V12D07-332_D1,0,0,0,0,0,0
TCGAATCGCAGGGTAG-1_V12D07-332_D1,0,3,0,0,0,3
GGTAGGCCAATATCAC-1_V12D07-332_D1,0,1,0,1,1,3
CGTAAATAACAAAGGG-1_V12D07-332_D1,0,1,0,0,0,1
GACTCTAGAGTTCCAA-1_V12D07-332_D1,0,3,0,0,0,3
ACTTGTTACCGGATCA-1_V12D07-332_D1,0,0,0,3,0,3
GGCATTGAACATCTCA-1_V12D07-332_D1,0,1,0,0,0,1
AACCCGCTGTATTCCA-1_V12D07-332_D1,1,1,0,1,0,3
TAACAGGTTCCCTTAG-1_V12D07-332_D1,0,2,0,1,0,3
GTTCTTGTAACTCAAT-1_V12D07-332_D1,0,0,0,0,0,0
GATTCTGTTAATGAGT-1_V12D07-332_D1,0,0,0,0,0,0
GGACACCTCGGTGTTG-1_V12D07-332_D1,0,0,1,1,0,2
CGATCGAGAAGCACCA-1_V12D07-332_D1,1,0,0,0,0,1
CTGCTCTGACGGCAAA-1_V12D07-332_D1,0,0,0,1,0,1
CCCAGGAAGAATTCGA-1_V12D07-332_D1,0,0,0,0,0,0
TGTCGTGGGTATAGGC-1_V12D07-332_D1,0,1,0,1,0,2
ATATGTCTAGAGCGTG-1_V12D07-332_D1,0,1,0,4,0,5
GCGGGCAGACGGGTGA-1_V12D07-332_D1,0,0,0,0,0,0
CGAAGATCAGTTTCAT-1_V12D07-332_D1,0,0,0,1,0,1
ACGCCACTCGAAACAG-1_V12D07-332_D1,0,0,0,0,0,0
CTTAGATGTTTCATCC-1_V12D07-332_D1,0,0,0,0,0,0
GCGAATGGACTAGCGA-1_V12D07-332_D1,0,0,0,1,0,1
TAAATTGTGGGTAAAG-1_V12D07-332_D1,0,1,0,1,0,2
ATTTATACTGGTAAAG-1_V12D07-332_D1,0,1,0,0,0,1
GCGTCGTAACATGGTC-1_V12D07-332_D1,0,0,0,0,0,0
CGGTATGGGCACTCTG-1_V12D07-332_D1,1,0,0,0,0,1
CTATCACAACGCTGGA-1_V12D07-332_D1,0,0,0,1,0,1
ACCACACGGTTGATGG-1_V12D07-332_D1,0,0,0,1,0,1
TCAGCGCACGCCGTTT-1_V12D07-332_D1,0,0,0,2,0,2
AATGTTAAGACCCTGA-1_V12D07-332_D1,0,0,0,1,0,1
CTTACATAGATTTCTT-1_V12D07-332_D1,1,0,0,4,0,5
AACATAGCGTGTATCG-1_V12D07-332_D1,0,0,0,0,0,0
AGCAGTCGAAGCATGC-1_V12D07-332_D1,0,0,0,1,0,1
GTACTACGGCCTCGTT-1_V12D07-332_D1,0,0,0,1,0,1
TTGGCCAAATTGTATC-1_V12D07-332_D1,0,1,0,1,0,2
TCAGAGGACGCGTTAG-1_V12D07-332_D1,0,1,0,1,0,2
AGTAATCTAAGGGTGG-1_V12D07-332_D1,0,0,0,0,0,0
AATTATACCCAGCAAG-1_V12D07-332_D1,0,0,0,1,0,1
CCCTACCCACACCCAG-1_V12D07-332_D1,0,0,0,0,2,2
CTCTGTCCATGCACCA-1_V12D07-332_D1,0,1,0,0,0,1
TCGCCTCCTTCGGCTC-1_V12D07-332_D1,1,1,0,0,1,3
CCTGATTCGCGAAGAA-1_V12D07-332_D1,0,0,0,0,0,0
GACTTCAACGCATCAA-1_V12D07-332_D1,0,1,0,0,0,1
GCTTCCCGTAAGCTCC-1_V12D07-332_D1,0,0,0,1,0,1
AGAACTGTACTTTGTA-1_V12D07-332_D1,0,2,0,0,0,2
CCTTAAGTACGCAATT-1_V12D07-332_D1,0,3,0,0,0,3
GGCCAATTGTATAGAC-1_V12D07-332_D1,1,1,1,0,0,3
AGAATACAGGCTATCC-1_V12D07-332_D1,0,1,1,2,0,4
AATACCTGATGTGAAC-1_V12D07-332_D1,0,1,1,1,0,3
TAGAGTGTTCCGGGTA-1_V12D07-332_D1,0,3,1,1,0,5
GCTTCCATGTAACCGC-1_V12D07-332_D1,0,1,0,3,0,4
GGTTCGCATTTGCCGT-1_V12D07-332_D1,0,3,1,1,0,5
TCAATCCGGGAAGTTT-1_V12D07-332_D1,0,2,0,1,0,3
CCGGAAGTGCAATATG-1_V12D07-332_D1,0,1,0,0,0,1
CTCATAAATGTGTATA-1_V12D07-332_D1,0,2,0,2,0,4
GACGGGCATCGAATTT-1_V12D07-332_D1,0,2,0,2,0,4
GCTAAGCCCAGTATGC-1_V12D07-332_D1,0,3,0,1,0,4
GCTATAAGGGCCAGGA-1_V12D07-332_D1,0,4,0,0,0,4
GCGGATTACTTGTTCT-1_V12D07-332_D1,0,0,0,0,0,0
TACAACAGCGCATACA-1_V12D07-332_D1,0,0,0,2,2,4
TCTAACCTAGCCTGCG-1_V12D07-332_D1,0,0,0,0,0,0
TCTACCCGCATCATTT-1_V12D07-332_D1,0,0,0,0,0,0
GTCTTACCACGCCAAG-1_V12D07-332_D1,0,0,0,0,0,0
AATAACGTCGCGCCCA-1_V12D07-332_D1,0,0,0,3,0,3
CGTTTCGGTTATATGC-1_V12D07-332_D1,0,0,0,1,1,2
TACGCTGCACGGTCGT-1_V12D07-332_D1,0,0,0,0,0,0
CGTTAAATACGACCAG-1_V12D07-332_D1,0,0,0,0,0,0
TCGACTGACGATGGCT-1_V12D07-332_D1,0,0,0,2,0,2
ACGCTACTGAATGGGC-1_V12D07-332_D1,0,0,1,2,0,3
AAGGGTTAGCCATGCG-1_V12D07-332_D1,1,0,0,1,0,2
ACGTTTCGGTGCACTT-1_V12D07-332_D1,1,0,0,0,0,1
TTAACCCGAGGCGTGT-1_V12D07-332_D1,0,0,0,1,0,1
GCCCGTCAAGCCCAAT-1_V12D07-332_D1,0,0,0,0,0,0
ATTCGTCCCGAGGTTA-1_V12D07-332_D1,0,1,0,1,1,3
TCAAATTATGTTCGAC-1_V12D07-332_D1,0,0,0,1,0,1
AACGTTCTACCATTGT-1_V12D07-332_D1,1,0,0,0,0,1
ATCAGAAGCTGGTTGC-1_V12D07-332_D1,2,5,0,0,0,7
TGAACCTGAATGTGAG-1_V12D07-332_D1,3,5,1,0,0,9
TCAGAGCATGTCAACG-1_V12D07-332_D1,7,1,1,0,0,9
ATACCCTCCCGGCCAA-1_V12D07-332_D1,6,1,2,0,0,9
GCCACCTTATTCGCGA-1_V12D07-332_D1,6,2,2,0,0,10
CAACGAGCTTATTATG-1_V12D07-332_D1,1,5,2,0,0,8
GATCCAACCTTTAAAC-1_V12D07-332_D1,0,3,0,1,0,4
TTGTGGAGACAGCCGG-1_V12D07-332_D1,0,1,0,0,0,1
AGATAATCACACCTAT-1_V12D07-332_D1,0,5,0,1,0,6
GGTTAGGGATGCTAAT-1_V12D07-332_D1,0,2,2,1,0,5
TCATGAAGCGCTGCAT-1_V12D07-332_D1,0,3,2,0,0,5
CCAGGCGAGATGGTCT-1_V12D07-332_D1,0,4,2,0,0,6
CGACTTGCCGGGAAAT-1_V12D07-332_D1,4,5,1,0,0,10
GTGCCAAACGTTTCGA-1_V12D07-332_D1,8,0,0,0,0,8
TGCTCAAAGGATGCAC-1_V12D07-332_D1,8,2,3,0,0,13
GCCTCAGGTACCGGTC-1_V12D07-332_D1,8,5,1,0,0,14
ACAAGTAATTGTAAGG-1_V12D07-332_D1,10,1,2,0,0,13
TTAGAGTATTGTCGAG-1_V12D07-332_D1,9,4,0,0,0,13
GTCATCCCAAACTCAC-1_V12D07-332_D1,3,8,1,0,0,12
CTCCTAGTAATCGTGA-1_V12D07-332_D1,3,7,3,0,0,13
CCCTCATCACAGAGTA-1_V12D07-332_D1,1,5,0,0,0,6
GGAAACAGAGCTTGGG-1_V12D07-332_D1,1,5,2,0,0,8
ACATCGCAATATTCGG-1_V12D07-332_D1,0,4,0,0,0,4
TTAGCCATAGGGCTCG-1_V12D07-332_D1,0,4,0,0,0,4
CGGATTCTGCCTTATG-1_V12D07-332_D1,0,2,2,0,0,4
TTGTTGGCAATGACTG-1_V12D07-332_D1,0,4,1,0,0,5
GGATCTACCGTTCGTC-1_V12D07-332_D1,0,2,0,2,0,4
GGTGGGATTAGGTCCC-1_V12D07-332_D1,0,3,3,0,0,6
AATAGGCACGACCCTT-1_V12D07-332_D1,0,1,0,0,0,1
GAGGTCCGTTCGCTGT-1_V12D07-332_D1,0,6,0,0,0,6
TGACAACTTAAAGGTG-1_V12D07-332_D1,0,2,0,1,0,3
AGCTAAGCTCCGTCCG-1_V12D07-332_D1,0,4,0,0,0,4
CTAGCCCGGGAGACGA-1_V12D07-332_D1,0,3,0,0,0,3
CCCAGATTCCCGTGAC-1_V12D07-332_D1,0,5,0,1,0,6
GCCCGTTCACACAATT-1_V12D07-332_D1,0,3,1,2,0,6
ACAAACTCCATCAGAG-1_V12D07-332_D1,0,3,0,0,0,3
GGTTCCGTACGACTAA-1_V12D07-332_D1,0,1,1,1,0,3
TTGCGGAAAGCTGCCC-1_V12D07-332_D1,0,4,0,0,0,4
GGAACTCGTGAATACG-1_V12D07-332_D1,0,5,0,0,0,5
GGTTACCGCTCCCTAC-1_V12D07-332_D1,0,3,1,0,0,4
AGCGACTTTGAAGACA-1_V12D07-332_D1,0,4,1,0,0,5
CCGTTTCCTTTCCGTG-1_V12D07-332_D1,0,2,0,0,0,2
TGGATGGCATCTTGGA-1_V12D07-332_D1,0,5,1,0,0,6
CAAGTCGTTGAAATCT-1_V12D07-332_D1,0,2,1,0,0,3
TGCAAACGTACTAGTT-1_V12D07-332_D1,0,1,0,0,1,2
GGCTGTCCTACTGCGG-1_V12D07-332_D1,0,3,0,0,0,3
TACTGCATGATTAAAT-1_V12D07-332_D1,0,2,0,0,2,4
CGGACCTCTGTAGTTA-1_V12D07-332_D1,0,2,0,1,0,3
CCCTAGCTCTAAGGTC-1_V12D07-332_D1,0,2,1,0,0,3
GTAACAGGTTAACGGC-1_V12D07-332_D1,0,1,0,2,0,3
CCCGCAAATAATCATC-1_V12D07-332_D1,0,4,0,0,0,4
AATCCCGCTCAGAGCC-1_V12D07-332_D1,0,1,0,1,1,3
AACGTCATCCGGCTTG-1_V12D07-332_D1,0,4,0,1,0,5
CTCGTGGCACTGAAAG-1_V12D07-332_D1,1,0,0,1,1,3
CTTTATCCGACGCATG-1_V12D07-332_D1,0,0,0,0,0,0
AAATGACTGATCAAAC-1_V12D07-332_D1,0,0,0,0,0,0
TTCGTGCATGTTATAG-1_V12D07-332_D1,0,1,0,0,0,1
ATCAAAGAGCCGTGGT-1_V12D07-332_D1,0,0,0,0,0,0
ATGTCATAATAAACGA-1_V12D07-332_D1,0,1,0,0,0,1
CTTAATCGACTTAGTA-1_V12D07-332_D1,1,1,1,0,0,3
CTAAAGGATGAGATAC-1_V12D07-332_D1,0,0,0,0,0,0
GTGCTATCCAGCTGGA-1_V12D07-332_D1,0,2,0,2,0,4
GACAGAGGTCTTCAGT-1_V12D07-332_D1,0,0,0,2,0,2
TCGATTTACGAAACGA-1_V12D07-332_D1,0,0,0,0,0,0
AGGCTTAAGTTGCACA-1_V12D07-332_D1,0,0,0,0,0,0
TAGGATCTTAACCGCA-1_V12D07-332_D1,0,1,0,2,0,3
GACTTTCGAGCGGTTC-1_V12D07-332_D1,1,0,0,1,0,2
CCCTGGGAGGGATCCT-1_V12D07-332_D1,0,0,0,2,0,2
TAGTAGTTGCCGGACA-1_V12D07-332_D1,1,0,0,2,0,3
GCCCTAAGTGCAGGAT-1_V12D07-332_D1,0,0,0,2,0,2
ACTTGGGCTTTCGCCA-1_V12D07-332_D1,0,0,0,0,0,0
CATGATACGGTGAAAC-1_V12D07-332_D1,0,0,1,1,0,2
TCCTGCAGCCGCCAAT-1_V12D07-332_D1,0,0,0,0,0,0
GTCCGTTAGAGGGCCT-1_V12D07-332_D1,0,0,0,3,0,3
GCTTTATTAAGTTACC-1_V12D07-332_D1,0,0,0,1,0,1
AATCGAGGTCTCAAGG-1_V12D07-332_D1,0,0,0,2,0,2
GTGCTGTTAGAACATA-1_V12D07-332_D1,1,0,0,1,0,2
GGCTTCTCGTGGGTGG-1_V12D07-332_D1,0,0,0,1,0,1
CCTACAGTTGAGGGAG-1_V12D07-332_D1,0,0,0,0,1,1
TATCCCTCGATCTGCA-1_V12D07-332_D1,0,0,0,2,0,2
CCGGTATCTGGCGACT-1_V12D07-332_D1,0,0,0,0,1,1
CTCTAACACCGGCAGC-1_V12D07-332_D1,0,0,0,0,0,0
CTTCATCACCAGGGCT-1_V12D07-332_D1,0,0,0,0,0,0
GGCTGGCAATCCCACG-1_V12D07-332_D1,0,0,0,0,0,0
CAAACCATAAGCGTAT-1_V12D07-332_D1,0,0,0,2,0,2
CATGTGGGCTCATCAC-1_V12D07-332_D1,0,0,0,1,0,1
CCCGTGACAGTGCCTT-1_V12D07-332_D1,1,0,0,1,0,2
GATTATCTTGCATTAT-1_V12D07-332_D1,0,0,0,0,0,0
GAGTCCACCAGGTTTA-1_V12D07-332_D1,0,0,0,0,0,0
TGTACTATCGCTCGTT-1_V12D07-332_D1,0,0,0,0,0,0
TTAGCGAATAGATAGG-1_V12D07-332_D1,0,2,0,4,0,6
ACATACAATCAAGCGG-1_V12D07-332_D1,0,2,0,2,0,4
ATTCGTGTACCCATTC-1_V12D07-332_D1,0,0,0,1,0,1
GCTAGCAACGCACCTA-1_V12D07-332_D1,0,0,1,0,0,1
ACCTCAGCGAGGCGCA-1_V12D07-332_D1,1,3,2,1,0,7
TCCGGGCCACTAACGG-1_V12D07-332_D1,0,5,0,0,0,5
TCCCAATATCGACGAC-1_V12D07-332_D1,0,2,0,0,0,2
GGATTGAAGTAGCCTC-1_V12D07-332_D1,0,5,0,3,0,8
GGCGCACAGTTTACCT-1_V12D07-332_D1,0,10,0,0,0,10
CCCGGCACGTGTCAGG-1_V12D07-332_D1,0,9,3,2,0,14
AGTAAGGGACAGAATC-1_V12D07-332_D1,1,10,0,0,0,11
TTGCGCACAACCACGT-1_V12D07-332_D1,0,2,0,1,0,3
CCTGCTACAACCATAC-1_V12D07-332_D1,0,2,0,1,0,3
CTGGGCTACTGGAGAG-1_V12D07-332_D1,0,5,2,0,0,7
AGCTACGAATGGTGGT-1_V12D07-332_D1,0,5,0,0,0,5
ATTCGTTTATCGTATT-1_V12D07-332_D1,0,1,0,1,0,2
GGCATTCCCTCCCTCG-1_V12D07-332_D1,0,0,0,0,0,0
AGTTATTCAGACTGTG-1_V12D07-332_D1,0,2,0,0,0,2
CCACTTTCCTTCTAGG-1_V12D07-332_D1,0,1,0,1,0,2
CGCAGTTCTATCTTTC-1_V12D07-332_D1,0,1,0,3,0,4
AGGAGCGTTTATTATC-1_V12D07-332_D1,0,1,0,0,0,1
GACAGGTAATCCGTGT-1_V12D07-332_D1,0,0,0,0,0,0
TTCCCAAAGTACTGAT-1_V12D07-332_D1,0,0,0,2,0,2
CTGCAGGGTGACGCTC-1_V12D07-332_D1,0,0,1,1,0,2
TCATGGAGGCCTTTGT-1_V12D07-332_D1,0,1,0,0,0,1
ATGGCCCGAAAGGTTA-1_V12D07-332_D1,0,0,0,2,0,2
CGTAATATGGCCCTTG-1_V12D07-332_D1,0,0,0,0,0,0
AGAGTCTTAATGAAAG-1_V12D07-332_D1,0,0,0,1,0,1
GAACGTTTGTATCCAC-1_V12D07-332_D1,0,3,0,1,0,4
ATTGAATTCCCTGTAG-1_V12D07-332_D1,0,0,0,1,0,1
TACCTCACCAATTGTA-1_V12D07-332_D1,0,0,0,0,0,0
AGTCGAATTAGCGTAA-1_V12D07-332_D1,0,0,0,4,0,4
TTGAAGTGCATCTACA-1_V12D07-332_D1,0,0,0,0,0,0
