key,other,oligo,microglia,neuron,astrocyte,n_cells
TACCGATCCAACACTT-1_V12D07-332_C1,1,3,0,0,0,4
GATAAGGGACGATTAG-1_V12D07-332_C1,1,3,0,0,0,4
TGTTGGCTGGCGGAAG-1_V12D07-332_C1,3,3,1,0,0,7
GCGAGGGACTGCTAGA-1_V12D07-332_C1,1,3,0,0,0,4
GCGCGTTTAAATCGTA-1_V12D07-332_C1,2,0,0,1,0,3
GACGACTTTCCAAGAA-1_V12D07-332_C1,2,1,0,0,0,3
ATACCCTGGCTCAAAT-1_V12D07-332_C1,0,2,1,0,0,3
TAACCGTCCAGTTCAT-1_V12D07-332_C1,1,1,0,1,0,3
CAAGGGAGTGTATTTG-1_V12D07-332_C1,1,3,1,1,0,6
TTATTTCATCCCAAAC-1_V12D07-332_C1,0,3,0,1,0,4
TATGGCAGACTTTCGA-1_V12D07-332_C1,1,4,0,0,1,6
ACAGGAGGCGCAGCCG-1_V12D07-332_C1,0,2,1,1,0,4
AGGCAATACGGAGGAC-1_V12D07-332_C1,2,0,0,1,0,3
TGGTGTGACAGACGAT-1_V12D07-332_C1,0,1,0,0,0,1
ATCTATCGATGATCAA-1_V12D07-332_C1,1,1,0,0,0,2
CGGTAACAAGATACAT-1_V12D07-332_C1,1,4,3,0,0,8
TCGCCGGAGAGTCTTA-1_V12D07-332_C1,0,0,0,1,0,1
GGAGGAGTGTGTTTAT-1_V12D07-332_C1,2,0,0,0,0,2
TTAGGTGTGACTGGTC-1_V12D07-332_C1,1,1,0,0,0,2
CAGGGCTAACGAAACC-1_V12D07-332_C1,1,1,0,0,0,2
CCCGTGGGTTAATTGA-1_V12D07-332_C1,1,6,1,0,0,8
GACCGACCGCTAATAT-1_V12D07-332_C1,0,3,1,1,0,5
GGTATCAAGCATAGAA-1_V12D07-332_C1,0,2,1,0,0,3
TGCATGAGTAGATTCG-1_V12D07-332_C1,0,1,0,0,0,1
AATTCCAACTTGGTGA-1_V12D07-332_C1,1,1,0,0,0,2
TGCCGATGTCATCAAT-1_V12D07-332_C1,0,2,0,0,0,2
GCTGGGTCCGCTGTTA-1_V12D07-332_C1,0,2,0,0,0,2
TGAACACCCGAAGCAG-1_V12D07-332_C1,3,3,1,1,0,8
AACATTGGTCAGCCGT-1_V12D07-332_C1,2,0,0,0,0,2
GTGGGTCTTCTTTGCG-1_V12D07-332_C1,0,0,0,0,0,0
CATCGAATGGATCTCT-1_V12D07-332_C1,0,1,0,0,0,1
GCTACACTGTCCGAAC-1_V12D07-332_C1,1,1,0,0,0,2
CGGGTTGTAGCTTTGG-1_V12D07-332_C1,0,1,0,1,0,2
CCTAAGTGTCTAACCG-1_V12D07-332_C1,0,0,0,0,0,0
TCTGTGACTGACCGTT-1_V12D07-332_C1,0,0,0,1,0,1
TTATCATACTCGCAAA-1_V12D07-332_C1,0,4,0,0,0,4
AGCGTAGCGCTAGACC-1_V12D07-332_C1,0,2,0,0,0,2
TCCCTCCGAAATCGTT-1_V12D07-332_C1,0,2,0,0,0,2
AGGTCGCCACTTCGGT-1_V12D07-332_C1,1,1,0,0,0,2
CTAGCAACTAATTTAC-1_V12D07-332_C1,1,2,1,0,0,4
TTGCTAGCTACCAATC-1_V12D07-332_C1,2,0,1,0,0,3
GCCGGTTTGGGCGGAT-1_V12D07-332_C1,0,0,0,0,0,0
TGTAACTTGTCAACCT-1_V12D07-332_C1,0,0,0,0,0,0
CGAGATGTTGCCTATA-1_V12D07-332_C1,1,2,0,0,0,3
GTTACGAAATCCACGC-1_V12D07-332_C1,1,7,0,0,0,8
CTTGTCGTACGTGTCA-1_V12D07-332_C1,0,3,0,0,0,3
GCGTCCAGCTCGTGGC-1_V12D07-332_C1,2,0,0,1,1,4
CCCTTCTCGTACGCGA-1_V12D07-332_C1,0,0,0,0,0,0
CCAAAGTCCCGCTAAC-1_V12D07-332_C1,0,2,0,1,0,3
CCGCTTCGCGGTTAAC-1_V12D07-332_C1,0,1,0,0,0,1
GTTACGGCCCGACTGC-1_V12D07-332_C1,0,1,1,0,1,3
CCCGCTTGCCCTCGTC-1_V12D07-332_C1,1,1,1,1,0,4
TAGTGAGAAGTGGTTG-1_V12D07-332_C1,1,1,0,0,0,2
CGCTACCGCCCTATGA-1_V12D07-332_C1,0,4,0,2,0,6
AAACAATCTACTAGCA-1_V12D07-332_C1,0,2,0,0,0,2
GCGCGATGGGTCAAGT-1_V12D07-332_C1,0,1,0,2,1,4
ATAAACCATTGGACGG-1_V12D07-332_C1,1,2,0,0,0,3
TCGGGCACTTCTGGAT-1_V12D07-332_C1,0,1,0,0,0,1
TCTGTGGCTACATTTC-1_V12D07-332_C1,2,0,0,0,0,2
CTCTGTGCCTGCTATG-1_V12D07-332_C1,0,6,0,0,0,6
CACGACTAAAGTTCTG-1_V12D07-332_C1,1,1,0,0,0,2
GAGGAGTAATTCCTAC-1_V12D07-332_C1,0,1,0,0,0,1
AGAGGTATCTCGGTCC-1_V12D07-332_C1,0,1,0,0,0,1
GGCGTACCCTATATAA-1_V12D07-332_C1,0,1,0,0,0,1
GCCGGAAACACATCTT-1_V12D07-332_C1,1,2,1,1,1,6
AAATGTGGGTGCTCCT-1_V12D07-332_C1,1,1,0,0,0,2
ACCAGGAGTGTGATCT-1_V12D07-332_C1,0,0,0,0,0,0
AAGGAGAACTTATAAG-1_V12D07-332_C1,0,2,0,2,0,4
ACTGTTTAGTGTAGGC-1_V12D07-332_C1,0,2,0,1,0,3
GCGTGTATGTCGTATT-1_V12D07-332_C1,0,1,0,0,0,1
CAGCCCTCACAGGCAG-1_V12D07-332_C1,0,2,1,0,0,3
GAAGACTTCAATGCCG-1_V12D07-332_C1,0,0,0,1,1,2
ACCAAACTAGAAATCC-1_V12D07-332_C1,2,1,1,0,0,4
GACCAGGTCATTCATA-1_V12D07-332_C1,2,0,0,0,1,3
ACGCCCAGCTGTCGAT-1_V12D07-332_C1,1,0,1,1,0,3
CCTCGACCCACTGCCT-1_V12D07-332_C1,2,1,1,0,0,4
TCAGTTACGGAATGAT-1_V12D07-332_C1,0,0,0,1,0,1
TCGGCTAACTTCCCTT-1_V12D07-332_C1,2,0,0,0,0,2
ATATCGTGCCAGACCC-1_V12D07-332_C1,0,0,0,0,0,0
ACGCTTAGTGTCTCTC-1_V12D07-332_C1,0,0,0,0,1,1
TAGTGGAACTCATACA-1_V12D07-332_C1,0,0,0,1,0,1
GTTATTAAATACGACC-1_V12D07-332_C1,2,1,0,0,0,3
CCTGACGCAACCTTTA-1_V12D07-332_C1,0,0,0,0,0,0
AACTGGGTTCGAGCCG-1_V12D07-332_C1,0,0,0,1,0,1
GATCTTAGTGAACGTG-1_V12D07-332_C1,0,0,0,0,0,0
CTAATGCGCCCAACAA-1_V12D07-332_C1,0,3,0,0,0,3
GCCACCCATTCCACTT-1_V12D07-332_C1,0,0,0,0,0,0
TACTCACAACGTAGTA-1_V12D07-332_C1,1,2,0,0,0,3
GTTCGGTGTGGATTTA-1_V12D07-332_C1,0,3,0,0,0,3
TCTTTCGGCGGGACAC-1_V12D07-332_C1,0,1,1,0,0,2
GGAGACATTCACGGGC-1_V12D07-332_C1,3,2,0,0,0,5
GGGATTATCTCACAAC-1_V12D07-332_C1,0,2,0,1,0,3
TAGAACGCCAGTAACG-1_V12D07-332_C1,2,2,1,1,0,6
ACGAGTCGCCGGCGTT-1_V12D07-332_C1,1,1,0,1,0,3
TGATGGGACTAAGTCA-1_V12D07-332_C1,0,1,0,0,0,1
TGCGAGAAACGTTACG-1_V12D07-332_C1,1,4,1,0,0,6
TCGCCTCGACCTGTTG-1_V12D07-332_C1,1,0,1,0,0,2
AACTCGATAAACACGT-1_V12D07-332_C1,3,2,1,1,0,7
AGGAAAGCCTCTGATG-1_V12D07-332_C1,1,3,0,0,0,4
GAAGGACTAAATTGAA-1_V12D07-332_C1,0,2,0,0,0,2
GTATCGGGACGAGCTG-1_V12D07-332_C1,1,2,0,0,0,3
CCTGTGCATAGGAGAC-1_V12D07-332_C1,1,1,1,0,0,3
CATACGGGTGCATGAT-1_V12D07-332_C1,1,1,0,0,0,2
CCACTAAACTGAATCG-1_V12D07-332_C1,0,2,0,0,0,2
AAATTGCGGCGGTTCT-1_V12D07-332_C1,0,2,0,0,1,3
AGTCCAGCGGGTACGT-1_V12D07-332_C1,0,1,1,0,0,2
CATTCAGGTCAGTGCG-1_V12D07-332_C1,2,1,1,0,1,5
CTAAAGTCCGAAGCTA-1_V12D07-332_C1,0,1,0,0,0,1
AATCAGACTGCAGGAC-1_V12D07-332_C1,0,4,0,0,0,4
AGTATCCATAATAACG-1_V12D07-332_C1,2,2,0,0,0,4
CTGGCTGCTAACGTAA-1_V12D07-332_C1,2,0,0,0,0,2
GTTCCAAGACAGCGAC-1_V12D07-332_C1,1,2,0,0,0,3
AAGACTAACCCGTTGT-1_V12D07-332_C1,0,3,1,0,0,4
GATTAATCCTGGCTCA-1_V12D07-332_C1,1,1,1,0,0,3
CGCGCAAGGAACTACA-1_V12D07-332_C1,2,1,0,1,2,6
CAGTAGCGAGGTAGTA-1_V12D07-332_C1,0,0,0,0,0,0
ACGGCGGGTTGCCCTG-1_V12D07-332_C1,0,1,0,0,0,1
CTAGGCGGCAGAGAAT-1_V12D07-332_C1,0,5,1,0,0,6
GTGCGCAGCTTGCTCC-1_V12D07-332_C1,2,0,0,0,0,2
TCACTATCGTGCAATC-1_V12D07-332_C1,0,0,0,0,0,0
TATGATTCTGCTTGGT-1_V12D07-332_C1,2,3,0,1,0,6
TAAGATTTAGCGGGAG-1_V12D07-332_C1,2,1,1,0,0,4
TTACGGTGTCACCGAG-1_V12D07-332_C1,0,1,0,0,0,1
CTACACTAGCTTGTTC-1_V12D07-332_C1,3,1,0,1,0,5
TGAGCAGTCGTGAAGT-1_V12D07-332_C1,0,4,0,0,0,4
CGCTGAGGACGTCCAA-1_V12D07-332_C1,1,4,0,0,1,6
GTGTATGACTTTAAAG-1_V12D07-332_C1,1,0,0,0,0,1
CTAAACGGGTGTAATC-1_V12D07-332_C1,1,2,0,0,0,3
TGTACTGTGCCAAAGT-1_V12D07-332_C1,1,1,0,0,0,2
GGCCACAAGCGATGGC-1_V12D07-332_C1,2,1,0,1,0,4
GTCAATTGTACTGAAG-1_V12D07-332_C1,0,2,0,0,2,4
AGGGACAGCACGGCGG-1_V12D07-332_C1,1,0,2,0,0,3
AGCTTATAGAGACCTG-1_V12D07-332_C1,1,2,0,0,0,3
AACTAGCGTATCGCAC-1_V12D07-332_C1,2,2,0,0,0,4
AACTTTAGCTGCTGAG-1_V12D07-332_C1,0,1,0,0,0,1
CCCAAGACAGAGTATG-1_V12D07-332_C1,0,2,0,0,0,2
GGCATCAACGAGCACG-1_V12D07-332_C1,1,0,0,0,0,1
ATGCATTCCGTGATGG-1_V12D07-332_C1,0,0,0,0,0,0
TTATAGATGCACATTA-1_V12D07-332_C1,1,1,0,0,0,2
GAACCATCTGGGAGAC-1_V12D07-332_C1,0,1,0,0,0,1
TGCTATACAAACGGAC-1_V12D07-332_C1,0,1,1,0,0,2
ACTTGCCATATTGTAC-1_V12D07-332_C1,0,3,0,1,1,5
TATTCCGGCAGTCCTA-1_V12D07-332_C1,3,0,0,0,0,3
GACGGACCGCGTTCCT-1_V12D07-332_C1,1,0,0,0,0,1
ATGTGTAGTTTAGTCA-1_V12D07-332_C1,2,1,0,0,0,3
ATACCAGCAAATTGCT-1_V12D07-332_C1,1,0,0,2,0,3
AAGTTTACTAATGGCA-1_V12D07-332_C1,1,3,0,0,0,4
CTCTCGATGTGCGCCT-1_V12D07-332_C1,0,3,0,1,0,4
GATTGACACTCTGCTC-1_V12D07-332_C1,0,2,0,0,0,2
TATCACAGCACGGGCA-1_V12D07-332_C1,0,3,0,1,0,4
ACCGTTCCCGCTCTGA-1_V12D07-332_C1,0,0,0,0,0,0
CCGCCACCACAATCCA-1_V12D07-332_C1,0,0,1,1,0,2
CATTCACTGACAGCTA-1_V12D07-332_C1,0,3,0,0,0,3
CGGCTGCAAGATTAAG-1_V12D07-332_C1,1,0,0,0,0,1
CATGAACCTCTTATCA-1_V12D07-332_C1,0,2,0,1,0,3
TTAATGCGAGGTAACT-1_V12D07-332_C1,3,1,0,0,0,4
AATAAGTCCTCGAGAC-1_V12D07-332_C1,0,1,0,0,0,1
ACCAGCCCGGTCTTTG-1_V12D07-332_C1,1,0,0,0,0,1
CTACGAACTAGGTCGA-1_V12D07-332_C1,1,1,0,1,1,4
ACATCTCAACGCGTAA-1_V12D07-332_C1,3,2,0,0,0,5
CACTACTCAGTTCTGT-1_V12D07-332_C1,1,0,0,0,0,1
CCGACTCGCATAGTCT-1_V12D07-332_C1,0,2,1,0,0,3
CATTTATCGTTCAAGA-1_V12D07-332_C1,1,0,0,0,0,1
CAAACGTGGTCTTGCG-1_V12D07-332_C1,1,2,0,0,0,3
TAGAAACCACTAAGTA-1_V12D07-332_C1,0,4,0,0,0,4
ACTGATTTAGTGATTC-1_V12D07-332_C1,1,1,0,0,0,2
TCGTATTTCGTCCGGA-1_V12D07-332_C1,0,5,0,0,0,5
CGGAAATTTCACATCC-1_V12D07-332_C1,1,0,0,0,0,1
ATCCACGCTAAATGTT-1_V12D07-332_C1,0,0,1,0,0,1
GTTCAATCTATGTCAA-1_V12D07-332_C1,1,1,0,1,0,3
ATAAAGGTCAAGTACG-1_V12D07-332_C1,0,1,0,0,0,1
CAACTCCAACGTTTAG-1_V12D07-332_C1,0,1,0,0,0,1
TAGGAACAGCCTCCAG-1_V12D07-332_C1,0,1,0,0,0,1
ATGGGAACGGAAGCGG-1_V12D07-332_C1,0,4,0,0,0,4
CACACGTTTCAATGGG-1_V12D07-332_C1,0,1,0,0,0,1
GGTGTTCTGTTTCTAC-1_V12D07-332_C1,0,4,0,0,0,4
AGTAACGTTCATCCTG-1_V12D07-332_C1,0,0,1,0,0,1
GTATAGTGGCCCATGT-1_V12D07-332_C1,0,1,0,0,0,1
TCTACACGTTCATGCA-1_V12D07-332_C1,1,0,0,0,0,1
AATCTGGGTAGACCCT-1_V12D07-332_C1,2,2,0,1,0,5
TCGGTTAGCCATGTAG-1_V12D07-332_C1,2,0,0,0,0,2
TGCCATGGCTTATAAG-1_V12D07-332_C1,1,1,0,0,0,2
TAAGTAAATGTGCCGC-1_V12D07-332_C1,0,3,0,0,0,3
GTGTCCGATAAGGCAT-1_V12D07-332_C1,2,2,0,0,0,4
TGGCACGAGCTCGAGT-1_V12D07-332_C1,1,1,0,1,0,3
ACCGGTCTGAGTACGG-1_V12D07-332_C1,0,0,0,0,0,0
GAACTTAGCGCCCGGT-1_V12D07-332_C1,2,0,0,0,0,2
AGTAGCTAGACGCCGA-1_V12D07-332_C1,1,0,0,0,0,1
ATAGGAATCTAAGCTT-1_V12D07-332_C1,2,0,1,0,0,3
CTTCCTGCATATTTAC-1_V12D07-332_C1,1,2,0,0,0,3
CAATATGTAGATTTAC-1_V12D07-332_C1,1,0,0,1,0,2
TTATAGTCCAAGGTGC-1_V12D07-332_C1,0,2,0,0,0,2
CCTCGTTACGCCTGTT-1_V12D07-332_C1,0,0,0,0,1,1
ACGCATAAATGACATG-1_V12D07-332_C1,0,1,0,0,4,5
CTTTGGCAGACAGAGT-1_V12D07-332_C1,0,1,0,0,0,1
CAAAGGTTAAATTCAG-1_V12D07-332_C1,0,0,0,0,0,0
GCTTTCTATCTCAACT-1_V12D07-332_C1,0,2,0,0,0,2
CTGAAACGGCCCTCAG-1_V12D07-332_C1,0,1,0,0,0,1
AACCCGATAGGGCTTC-1_V12D07-332_C1,0,0,0,0,0,0
CGTCTCTCGCCGAGGC-1_V12D07-332_C1,0,0,0,0,0,0
AGTGGGAGTATACACG-1_V12D07-332_C1,1,1,0,0,0,2
GGTCTTGGTGTTAACT-1_V12D07-332_C1,1,3,0,0,0,4
GGCTGGCAGCTTTATG-1_V12D07-332_C1,2,1,0,0,0,3
CGCCAATTATTGCGTT-1_V12D07-332_C1,1,1,0,0,0,2
GGTAACCGGCAAAGGT-1_V12D07-332_C1,0,0,0,0,0,0
TGGGACCATTGGGAGT-1_V12D07-332_C1,1,3,0,0,0,4
CTGCAGGTGCTCGGCC-1_V12D07-332_C1,1,1,0,0,0,2
CCGGTGCGAGTGATAG-1_V12D07-332_C1,0,1,0,0,0,1
GGGTACACTCTGGAGG-1_V12D07-332_C1,1,1,1,0,0,3
TAGCCAGAGGGTCCGG-1_V12D07-332_C1,1,3,0,0,1,5
CTTGTGAGGACAGCGG-1_V12D07-332_C1,4,0,0,0,0,4
GAAGGGCATAACCATG-1_V12D07-332_C1,1,1,0,0,0,2
CAACATGGCCTGATAA-1_V12D07-332_C1,1,3,0,0,0,4
CAATTTGACCGGGAAG-1_V12D07-332_C1,0,0,0,0,0,0
TCTGACTGTAATGGTT-1_V12D07-332_C1,0,3,0,0,0,3
TTCATAGCCTTGTAAC-1_V12D07-332_C1,0,5,1,0,0,6
TGGAAACGGAGTGAAC-1_V12D07-332_C1,0,1,0,0,0,1
ATCGCACGATTGTTCA-1_V12D07-332_C1,0,2,0,0,0,2
CGCCACCCGCATTAAC-1_V12D07-332_C1,0,2,1,0,0,3
TGGACCACGGCGTTGA-1_V12D07-332_C1,0,3,0,0,0,3
GTATATGTTACGGCGG-1_V12D07-332_C1,0,2,0,1,0,3
GTATTCTTACCGTGCT-1_V12D07-332_C1,0,0,0,0,0,0
TTCAGAGTAACCTGAC-1_V12D07-332_C1,3,0,0,0,1,4
GCGGTAACCCAAATGA-1_V12D07-332_C1,0,4,0,0,0,4
CTACGTGTTGCCACCA-1_V12D07-332_C1,1,2,0,2,0,5
CTAGATAAACTCCTCG-1_V12D07-332_C1,0,3,0,0,0,3
TCCATTAGTTGGATAG-1_V12D07-332_C1,0,1,0,0,0,1
CTGGCTCCTGCGGGAT-1_V12D07-332_C1,0,2,0,0,0,2
CAGTCTCTCGGCTAAT-1_V12D07-332_C1,0,1,0,0,0,1
GTATGACGTGGGAAAC-1_V12D07-332_C1,1,1,0,1,0,3
AGTCACTCCGCCTCAT-1_V12D07-332_C1,2,1,0,0,0,3
GCAGCGGTGGGCATTA-1_V12D07-332_C1,0,0,0,0,0,0
TATGGAGTTTCTCGTT-1_V12D07-332_C1,1,3,1,0,0,5
ACTCAACGAATGTATT-1_V12D07-332_C1,0,2,0,0,1,3
AACACGCGGCCGCGAA-1_V12D07-332_C1,1,3,0,0,0,4
CGATATTAGCCGCAGG-1_V12D07-332_C1,1,2,0,0,0,3
AGCGTCTGAACCCGCA-1_V12D07-332_C1,2,5,1,0,1,9
GATGTCCGGATCACAT-1_V12D07-332_C1,1,1,1,0,0,3
GGTCACGTTAGATTCA-1_V12D07-332_C1,0,2,0,0,0,2
TTAAGGATACGGAGGT-1_V12D07-332_C1,0,2,0,0,0,2
GTGCGGGACCATCGGC-1_V12D07-332_C1,0,1,0,1,0,2
CCATCTTGTTCACAAT-1_V12D07-332_C1,1,1,0,0,0,2
TCCGAGAAGGCTAAGC-1_V12D07-332_C1,1,2,0,0,0,3
TGGCGGTGTGCGATTG-1_V12D07-332_C1,1,1,0,0,0,2
ATCCTGCTGCAGATAG-1_V12D07-332_C1,0,2,0,0,0,2
TTATGCGTCCCGGTCC-1_V12D07-332_C1,2,2,0,0,0,4
CATAATGAGCGGGCGA-1_V12D07-332_C1,1,1,0,0,0,2
AGACATAGATCCTTCC-1_V12D07-332_C1,0,2,0,1,0,3
GGTGAAACCGGGAATG-1_V12D07-332_C1,0,1,1,1,0,3
AACTGGTGTGGGCCTT-1_V12D07-332_C1,1,1,0,1,1,4
GTAGCGCTGTTGTAGT-1_V12D07-332_C1,0,1,0,0,0,1
TTGTTTGTGTAAATTC-1_V12D07-332_C1,0,3,0,1,0,4
GGATCAAAGGACGAGG-1_V12D07-332_C1,0,0,0,1,0,1
CGTAGCGCCGACGTTG-1_V12D07-332_C1,2,2,0,0,0,4
CAAGTGAACTTTGGTT-1_V12D07-332_C1,1,2,0,1,0,4
GTAGACAACCGATGAA-1_V12D07-332_C1,1,2,0,1,0,4
CAATGGTCGGCCTGGG-1_V12D07-332_C1,0,0,1,0,0,1
ACAGATTAGGTTAGTG-1_V12D07-332_C1,0,1,0,1,0,2
GTTATCACCTTCTGAA-1_V12D07-332_C1,0,0,0,0,0,0
TGGTATCGGTCTGTAT-1_V12D07-332_C1,1,3,0,0,0,4
GGAATAACCTCAAGAA-1_V12D07-332_C1,0,2,1,1,0,4
ATTATCTCGACAGATC-1_V12D07-332_C1,0,0,0,0,0,0
CCGAGGGATGTTAGGC-1_V12D07-332_C1,1,2,1,0,0,4
TGAGATCAAATACTCA-1_V12D07-332_C1,0,2,0,4,0,6
AAACGAAGAACATACC-1_V12D07-332_C1,0,4,0,0,0,4
CTGGTCCTAACTTGGC-1_V12D07-332_C1,1,2,0,1,0,4
TGCACGAGTCGGCAGC-1_V12D07-332_C1,1,3,0,1,0,5
ATAGTCTTTGACGTGC-1_V12D07-332_C1,0,0,0,0,0,0
TGGAGCTAAAGTTCCC-1_V12D07-332_C1,1,0,0,0,0,1
GGGTGGTCCAGCCTGT-1_V12D07-332_C1,0,0,0,0,0,0
CATGCATGGAGACCCT-1_V12D07-332_C1,1,0,0,0,0,1
ACACGGCACTATGCAT-1_V12D07-332_C1,0,2,0,1,0,3
CCCTGGTATGGGCGGC-1_V12D07-332_C1,1,0,1,0,0,2
GGAGGATTGAAAGGAG-1_V12D07-332_C1,1,2,0,0,0,3
CCGCTGGTGCCATTCA-1_V12D07-332_C1,0,1,0,0,0,1
GTTAGAGTGTGCCGCT-1_V12D07-332_C1,0,6,0,0,0,6
TCGGAATGACCATCAA-1_V12D07-332_C1,1,0,0,1,0,2
TTCAATTAGCCATAAT-1_V12D07-332_C1,1,1,0,0,0,2
GATGTGTTGTCACAAG-1_V12D07-332_C1,0,1,0,0,0,1
TCTTTCTCTTAAGGAG-1_V12D07-332_C1,1,1,0,2,0,4
ACCCTTTAGTTCTCCA-1_V12D07-332_C1,0,0,0,0,1,1
ACCACAACTCAGAACA-1_V12D07-332_C1,3,1,0,1,0,5
TATGATAAATCTAACG-1_V12D07-332_C1,2,0,1,1,0,4
GATCCTCTTGCGCTTA-1_V12D07-332_C1,0,3,0,0,1,4
TTCTACCTTTATGTTG-1_V12D07-332_C1,1,0,1,0,0,2
GAAATACCTGCTGGCT-1_V12D07-332_C1,0,0,1,1,0,2
ATTCTGAGTATGAACT-1_V12D07-332_C1,2,0,0,0,0,2
GGATTAAGCTAAGGTC-1_V12D07-332_C1,0,1,0,0,0,1
AGTACGTGGCCTGTCT-1_V12D07-332_C1,3,1,0,0,0,4
TCAGGGTGCACGAAAC-1_V12D07-332_C1,0,0,0,0,0,0
AAATTTACCGAAATCC-1_V12D07-332_C1,0,2,1,0,0,3
TTGAGGCATTTAACTC-1_V12D07-332_C1,0,1,0,0,0,1
AACCAGTATCACTCTT-1_V12D07-332_C1,1,1,0,0,0,2
CACCGGAGATATCTCC-1_V12D07-332_C1,1,0,0,0,0,1
GACTGGGCGCCGCAAC-1_V12D07-332_C1,0,1,0,0,0,1
CACGTCTATGATGTGG-1_V12D07-332_C1,1,3,0,0,0,4
TTAAGACGAACGAACC-1_V12D07-332_C1,0,0,1,0,0,1
TGACCAGCTTCAAAGT-1_V12D07-332_C1,2,0,1,0,1,4
AGAGTTAGAGACCGAT-1_V12D07-332_C1,0,0,0,1,0,1
TTCGGACTGATGCCTT-1_V12D07-332_C1,1,0,0,0,0,1
CTCGAATGGAACGTAT-1_V12D07-332_C1,1,0,0,0,0,1
GGACGGCTTGCGCAAC-1_V12D07-332_C1,0,0,0,1,0,1
CTAAGTACAGGGCTAC-1_V12D07-332_C1,0,1,0,0,0,1
ACAAATTCAGATCTGA-1_V12D07-332_C1,2,0,0,1,0,3
CATGGAAATGGGACCA-1_V12D07-332_C1,1,0,0,2,0,3
GGTGGACCACGTGTTA-1_V12D07-332_C1,0,0,0,0,0,0
CACGACGTAATAGTAA-1_V12D07-332_C1,3,0,0,1,0,4
CGGGTTCGGCACGTAT-1_V12D07-332_C1,1,0,0,0,0,1
CTGGGCTATCCTTTGG-1_V12D07-332_C1,0,0,0,0,0,0
GTATTAGGGTTCGCGT-1_V12D07-332_C1,0,0,0,0,0,0
TCATTCGTATAATTTG-1_V12D07-332_C1,0,1,0,0,1,2
AATAGCAAGCCTCCTG-1_V12D07-332_C1,3,0,0,1,3,7
CATCTACCCGAGAACG-1_V12D07-332_C1,0,1,1,0,0,2
GCTTCAGTGGGATTAC-1_V12D07-332_C1,0,0,0,0,2,2
TCTGTGATGGAGGTTG-1_V12D07-332_C1,0,1,0,0,2,3
ATCCACTTTCAGACTA-1_V12D07-332_C1,0,0,1,0,2,3
ATGGTTACGAAACATG-1_V12D07-332_C1,0,0,0,0,1,1
GGCCCAATCTAGAGGG-1_V12D07-332_C1,0,2,0,0,1,3
GATGGTGAAATAACCC-1_V12D07-332_C1,0,1,0,0,0,1
AGAGGGACAATTGTCC-1_V12D07-332_C1,0,2,0,0,2,4
CGCGTACATTCTGGAA-1_V12D07-332_C1,0,1,0,0,4,5
CAAGAAACCCTAAACT-1_V12D07-332_C1,0,1,0,0,1,2
TTGGTGCGGTGTTGAA-1_V12D07-332_C1,0,0,0,1,1,2
GGTTCCCTAGTGTCTC-1_V12D07-332_C1,0,0,0,0,0,0
CGATAACCAATTTGAG-1_V12D07-332_C1,0,5,0,0,0,5
GCCCACTGGTCCACAA-1_V12D07-332_C1,0,3,0,0,0,3
GAGGGCCGGCAGAGTC-1_V12D07-332_C1,0,3,0,0,0,3
CGACACGGATGCCCAC-1_V12D07-332_C1,1,2,0,0,0,3
CTGTCTGTGGCTGGCT-1_V12D07-332_C1,0,2,0,1,0,3
ATATTATCCCGTATTT-1_V12D07-332_C1,2,3,0,0,0,5
GCGCTGGCGGAAAGTC-1_V12D07-332_C1,0,4,0,0,0,4
ATCTAACGTCCCTATG-1_V12D07-332_C1,0,2,1,0,0,3
GTCAGACAGCGTTGGA-1_V12D07-332_C1,0,3,1,0,1,5
GCCAGGCTTAGTGGTA-1_V12D07-332_C1,0,4,2,0,0,6
ATTCAAAGTACCTGTT-1_V12D07-332_C1,0,1,0,0,0,1
TGGACGTAGGCGAATC-1_V12D07-332_C1,0,2,0,0,0,2
ACACATTGACGCAACA-1_V12D07-332_C1,1,1,0,0,0,2
GATATCAGTATGTATC-1_V12D07-332_C1,0,4,0,0,0,4
TGGGCCTTGCCTGCAT-1_V12D07-332_C1,0,1,0,0,0,1
CAAAGTCAGGTTAGCT-1_V12D07-332_C1,0,2,0,0,0,2
GGATCCCTACCAGCTA-1_V12D07-332_C1,3,2,0,0,0,5
ATCGTCCAATCGAGTC-1_V12D07-332_C1,0,2,0,1,0,3
ACATGGCTCAATTTAG-1_V12D07-332_C1,0,1,0,0,0,1
AGGCCCAGTGACTGGT-1_V12D07-332_C1,2,0,0,0,0,2
GCTTCCAGCTTAGATT-1_V12D07-332_C1,2,1,0,0,0,3
TGCTTGAAACCATGCA-1_V12D07-332_C1,1,3,0,5,0,9
CAATATTGGACTAGTG-1_V12D07-332_C1,1,2,0,0,0,3
CGTGCTGGCCTAGTCG-1_V12D07-332_C1,0,2,0,1,0,3
CCTGCGATAGAACTGT-1_V12D07-332_C1,0,2,0,0,0,2
GGGTAATGCTGTGTTT-1_V12D07-332_C1,0,1,0,0,0,1
AACGCGAACGGCAACA-1_V12D07-332_C1,1,2,1,0,0,4
TGTCGGCATGGTGGAA-1_V12D07-332_C1,1,2,0,0,1,4
AGCGTACGAGAGCTAG-1_V12D07-332_C1,0,1,0,0,1,2
ATACTCTCGCCACTCT-1_V12D07-332_C1,0,2,0,0,1,3
AATCCATGCAAGGGTG-1_V12D07-332_C1,0,1,1,1,0,3
TTAAACAGAGTCCCGC-1_V12D07-332_C1,1,1,0,0,0,2
CCACAGCTGAAATCAT-1_V12D07-332_C1,1,0,0,1,1,3
CGGTTCCGGCTTCTTG-1_V12D07-332_C1,2,3,0,0,0,5
GACGTGAGACTCCATG-1_V12D07-332_C1,0,2,0,0,0,2
TCGTTGGCTCGTCAAT-1_V12D07-332_C1,0,1,0,0,0,1
GGTGAACGGGCTAGCC-1_V12D07-332_C1,1,4,0,2,0,7
GCACTGTGCAAATGTA-1_V12D07-332_C1,1,2,0,0,0,3
ACGAGAACCCATCACG-1_V12D07-332_C1,0,4,0,0,0,4
CCAGCTACGCCTCATA-1_V12D07-332_C1,1,1,0,0,0,2
TCCCGGTCAGGAATTT-1_V12D07-332_C1,0,0,0,0,0,0
TCGCATTCAATGACTT-1_V12D07-332_C1,0,1,1,0,0,2
CTGGTTCAACGCATCA-1_V12D07-332_C1,0,1,0,0,0,1
GGTGATTTCATCTTGT-1_V12D07-332_C1,0,0,0,0,0,0
CACCCTTTCCTCGCTC-1_V12D07-332_C1,1,4,0,0,0,5
CAACTTGTAGTGGGCA-1_V12D07-332_C1,1,2,0,0,0,3
AATATCAAGGTCGGAT-1_V12D07-332_C1,0,1,0,0,0,1
ACTCAGACCTGCTTCT-1_V12D07-332_C1,0,3,0,0,2,5
TTGGAGTCTCCCTTCT-1_V12D07-332_C1,1,4,0,0,0,5
GGATACTCATGAATTG-1_V12D07-332_C1,1,3,0,1,2,7
TGGGCACAAACAGAAC-1_V12D07-332_C1,1,1,0,2,0,4
GAGCCACGGTAGTAGG-1_V12D07-332_C1,0,1,1,0,0,2
TCGATAGGCTAGTCGC-1_V12D07-332_C1,1,3,0,0,0,4
TAACCGCCCGCAGTGC-1_V12D07-332_C1,0,2,0,1,0,3
GCCTATTTGCTACACA-1_V12D07-332_C1,0,0,0,0,0,0
TTGACGATTCAGCACG-1_V12D07-332_C1,0,3,0,2,0,5
TTAAACCGGTAGCGAC-1_V12D07-332_C1,1,0,0,1,0,2
ACCGAAAGGGCCCTGC-1_V12D07-332_C1,1,0,0,0,0,1
ACGTTCCGCGCTCCGT-1_V12D07-332_C1,0,2,0,1,0,3
ATACCAGGCTAATAGA-1_V12D07-332_C1,1,3,0,0,0,4
CGGCTTTGTATGATAA-1_V12D07-332_C1,0,2,0,1,0,3
CTTGACCCGAAAGATA-1_V12D07-332_C1,0,0,0,3,0,3
CGCAGAAACATTTGCG-1_V12D07-332_C1,1,2,1,0,0,4
GACCCGTCGCCGGCTA-1_V12D07-332_C1,2,3,0,0,0,5
AATCGGGACACTACGA-1_V12D07-332_C1,1,0,0,0,0,1
GTCACAAAGTTTCCAA-1_V12D07-332_C1,4,1,0,0,0,5
TATATTCGCGTCGATA-1_V12D07-332_C1,0,7,1,1,0,9
CCTCCCGACAATCCCT-1_V12D07-332_C1,0,0,1,0,0,1
CGACATGCGATCTTCT-1_V12D07-332_C1,0,0,0,0,0,0
AACACGACTGTACTGA-1_V12D07-332_C1,0,0,0,0,0,0
CCCAACCACACTAACA-1_V12D07-332_C1,0,0,0,0,0,0
CACCGCCGACCAGCGA-1_V12D07-332_C1,0,2,0,0,0,2
TGGTATCGCATCCCAA-1_V12D07-332_C1,0,1,0,0,0,1
CAGAGTGATTTAACGT-1_V12D07-332_C1,0,2,0,1,0,3
AACCCTGGTGGAACCA-1_V12D07-332_C1,2,1,0,0,0,3
GTCAGTTGTGCTCGTT-1_V12D07-332_C1,2,0,0,0,0,2
ATTGACGTAACTCGGT-1_V12D07-332_C1,0,0,0,0,0,0
GATGTCGGTCAACTGC-1_V12D07-332_C1,0,0,0,1,0,1
AGGGCAGCGGCGTGGT-1_V12D07-332_C1,1,1,0,0,0,2
ACATCGTTAACCTAGT-1_V12D07-332_C1,0,0,0,0,0,0
TCCATTGTGACCTCGT-1_V12D07-332_C1,1,3,0,1,0,5
TGTTTAATACTTCATC-1_V12D07-332_C1,0,1,0,0,0,1
TTGCTGGCCGGGCTTC-1_V12D07-332_C1,0,1,0,0,0,1
CATATTATTTGCCCTA-1_V12D07-332_C1,0,4,0,0,0,4
CTGCCTAGCCACCAAG-1_V12D07-332_C1,0,2,0,0,1,3
ACGAGATATTTGCTTA-1_V12D07-332_C1,3,1,0,0,0,4
GACTACAATTGCTCGT-1_V12D07-332_C1,0,0,0,0,0,0
AACGTGATGAAGGACA-1_V12D07-332_C1,1,0,0,0,0,1
ACTCTCTTATACACGA-1_V12D07-332_C1,0,0,0,0,0,0
CGCATCATGGCTTCAG-1_V12D07-332_C1,0,2,0,1,0,3
CGGCTCTTCGTCGAAC-1_V12D07-332_C1,0,1,0,0,0,1
ATTCTTCGTACTTATG-1_V12D07-332_C1,0,0,0,0,0,0
AGTGAGGGTTTCTGAC-1_V12D07-332_C1,0,0,0,0,7,7
GCCAGGCGTTCGCATG-1_V12D07-332_C1,0,1,0,1,2,4
GACTAACACAGCACCT-1_V12D07-332_C1,0,2,0,0,0,2
CAATGGAATCTACATA-1_V12D07-332_C1,0,0,0,0,1,1
GTGGTCAGCGAAGTAT-1_V12D07-332_C1,1,4,0,1,0,6
ATGGCTGGAAATGGCC-1_V12D07-332_C1,0,0,0,0,0,0
ATCAGGTCGCCATTGC-1_V12D07-332_C1,1,3,1,0,0,5
TATCACCATGTAAAGT-1_V12D07-332_C1,0,1,0,0,0,1
AGCGCTTATGGGCAAG-1_V12D07-332_C1,0,1,0,0,0,1
AAGCGGCGTCATGGGT-1_V12D07-332_C1,2,0,0,0,0,2
ACTAATACGTCAGGCG-1_V12D07-332_C1,1,1,0,0,0,2
GGCTGAGCATCGTAAG-1_V12D07-332_C1,0,1,1,0,0,2
CGGTTGGGTTCAAGTT-1_V12D07-332_C1,4,2,0,0,0,6
GACTGATTGGTCACAA-1_V12D07-332_C1,0,1,0,0,0,1
AGACGGGCCGATTTAA-1_V12D07-332_C1,1,0,0,0,0,1
ACCAGTGCCCGGTCAA-1_V12D07-332_C1,1,2,0,0,0,3
GTCCTTTAATGACTTC-1_V12D07-332_C1,2,2,0,1,0,5
CCTACAAGTCCGGAAT-1_V12D07-332_C1,0,0,0,1,0,1
GCCTGCTACACTGAGA-1_V12D07-332_C1,1,0,0,1,0,2
GACTCGGTCGGCGGAT-1_V12D07-332_C1,1,0,0,0,0,1
CTAGACATATATGTAG-1_V12D07-332_C1,1,2,0,0,1,4
TCGCCCAACTGACTCC-1_V12D07-332_C1,0,0,0,0,0,0
AAACTAACGTGGCGAC-1_V12D07-332_C1,0,0,0,0,1,1
AACTGAGGTCAGCGTC-1_V12D07-332_C1,0,0,0,0,1,1
ACAATGATTCTTCTAC-1_V12D07-332_C1,0,1,0,1,0,2
ATAAGTACCCGATTGT-1_V12D07-332_C1,1,0,0,0,0,1
ATTGGGAGTTCTGTAA-1_V12D07-332_C1,0,1,0,1,0,2
CGAACATAGTCAGAAA-1_V12D07-332_C1,0,0,0,0,2,2
TAGCTCAGATCCTAGT-1_V12D07-332_C1,0,0,0,0,1,1
GTGTCGTATTCACCTT-1_V12D07-332_C1,0,0,0,0,1,1
CTCACCGATCCAAACT-1_V12D07-332_C1,0,1,0,0,0,1
ATATGTGCACAAACCA-1_V12D07-332_C1,0,0,0,0,1,1
CAGTCCAACGCCTTCT-1_V12D07-332_C1,0,1,0,0,0,1
TCGTCCGGGTACACTC-1_V12D07-332_C1,0,4,0,0,2,6
GCAGAAACGTAATCCA-1_V12D07-332_C1,0,3,0,0,0,3
TTCGAGCCGGCGCTAC-1_V12D07-332_C1,0,1,0,0,0,1
GGAAGATAAGACTGTA-1_V12D07-332_C1,1,0,0,0,0,1
ATAAGCAAACACCGAG-1_V12D07-332_C1,0,3,0,0,1,4
GCATAAATTGAACGCC-1_V12D07-332_C1,1,2,0,0,0,3
CGCCGGTGTCGCAGTA-1_V12D07-332_C1,1,0,0,0,0,1
GACCTGGTCTGGGCGT-1_V12D07-332_C1,0,2,0,0,0,2
AGCCGCTTGATTAGCG-1_V12D07-332_C1,0,1,0,0,0,1
CCCGGCTAGGTGAGAA-1_V12D07-332_C1,0,1,0,0,0,1
CGAGCCGAGCACTCGA-1_V12D07-332_C1,2,2,0,0,0,4
TAGTGCTTGAATCCTT-1_V12D07-332_C1,0,1,2,0,0,3
CAACCGCACCTAGACA-1_V12D07-332_C1,1,2,0,0,0,3
ACCACTGTTCAAGAAG-1_V12D07-332_C1,1,3,0,0,1,5
AGATGCTATAACGAGC-1_V12D07-332_C1,1,2,0,0,2,5
AATTACTCGTACGCTC-1_V12D07-332_C1,0,3,0,0,0,3
CGTCAATCTTTAACAT-1_V12D07-332_C1,1,3,0,0,0,4
CCAAAGCAGTTGGTTG-1_V12D07-332_C1,1,3,0,0,0,4
CCATATTGGATCATGA-1_V12D07-332_C1,2,3,0,0,0,5
CGTACCGAAAGTCTAG-1_V12D07-332_C1,1,2,0,0,0,3
CTCGAGATCCAAAGCA-1_V12D07-332_C1,0,4,0,0,0,4
TGGATAGAGTAACAGA-1_V12D07-332_C1,1,2,1,1,0,5
TCACAGATCCTCAAAC-1_V12D07-332_C1,1,4,0,0,0,5
AGAGCTACGAAAGCAT-1_V12D07-332_C1,0,0,0,0,1,1
TGCGTGATTGGGTGTC-1_V12D07-332_C1,0,2,0,0,0,2
CACATGTTTGGACATG-1_V12D07-332_C1,0,2,0,2,0,4
TTCGCATCCGGAAGCA-1_V12D07-332_C1,0,0,0,0,0,0
CCCTAGTGTCAGGTGT-1_V12D07-332_C1,0,1,0,0,0,1
TTACCGCCTTAGGGAA-1_V12D07-332_C1,0,1,1,0,0,2
CCAGTCCATTATTCGA-1_V12D07-332_C1,0,1,0,0,0,1
CGTAAACGCTTGAGTG-1_V12D07-332_C1,0,0,0,1,0,1
ATTCCTTCCAGGCGGT-1_V12D07-332_C1,0,1,1,0,0,2
TTCCTTTCTGTGTTGC-1_V12D07-332_C1,0,1,0,1,1,3
AGTTGACATCGGCTGG-1_V12D07-332_C1,0,5,0,1,0,6
AACTCGATGGCGCAGT-1_V12D07-332_C1,0,0,0,0,0,0
GATAAGGCAGATGCAA-1_V12D07-332_C1,0,2,0,0,0,2
GGCTGGCTAGCTTAAA-1_V12D07-332_C1,0,2,0,1,0,3
CCTCATGCAGCTACGA-1_V12D07-332_C1,0,1,0,0,0,1
GACGCCTGTTGCAGGG-1_V12D07-332_C1,1,0,0,0,1,2
TAATTAGATGGATATG-1_V12D07-332_C1,0,2,1,0,0,3
GAGGGCATCGCGTATC-1_V12D07-332_C1,1,2,0,0,0,3
CTTGTGAGTCTTTGAC-1_V12D07-332_C1,0,2,0,0,0,2
TCAACACATTGGGTAA-1_V12D07-332_C1,1,5,0,2,0,8
ACTGTATACGCGAGCA-1_V12D07-332_C1,1,4,1,0,0,6
GTGAAACGTGCTCCAC-1_V12D07-332_C1,1,4,0,0,0,5
CGAGTGCTATAGTTCG-1_V12D07-332_C1,2,6,0,0,0,8
GTACTGCATGAAGCGT-1_V12D07-332_C1,1,2,0,0,0,3
GTAACTTGCGGCAGTC-1_V12D07-332_C1,0,0,0,0,0,0
GAATCGCCGGACACGG-1_V12D07-332_C1,1,0,0,0,0,1
GGGAGTAATGGCTGGC-1_V12D07-332_C1,0,4,0,0,0,4
CATGAACCGACATTTG-1_V12D07-332_C1,0,0,0,0,0,0
TCTGTCATACAAGAGC-1_V12D07-332_C1,1,6,0,0,0,7
GTCGTCAATTATAAGG-1_V12D07-332_C1,0,0,0,0,0,0
TAAAGAGCCCGAAACC-1_V12D07-332_C1,0,1,0,2,0,3
GTACTGAGGTCGTAAC-1_V12D07-332_C1,1,3,0,0,0,4
AAAGACCCAAGTCGCG-1_V12D07-332_C1,0,1,0,0,0,1
CGTCAGTGCGCACAAG-1_V12D07-332_C1,0,1,0,1,0,2
TGTATCCTTATTCCAT-1_V12D07-332_C1,0,3,1,0,0,4
ATTCTCGTCTCTTTAG-1_V12D07-332_C1,0,0,0,0,0,0
AAAGTCACTGATGTAA-1_V12D07-332_C1,1,2,0,2,0,5
TGTCTACAGTTTCTGT-1_V12D07-332_C1,0,1,0,0,0,1
TTAACGTCGCAAGACC-1_V12D07-332_C1,0,1,0,0,0,1
CTATGTCTATTGAAAC-1_V12D07-332_C1,0,3,0,0,0,3
TCGGGTGAAACTGCTA-1_V12D07-332_C1,1,4,0,0,0,5
TGTCCCGACATAGCAC-1_V12D07-332_C1,1,0,0,2,0,3
ACAGCATAGAGCCAGT-1_V12D07-332_C1,2,0,0,1,0,3
ATATTCCCACAGGTCA-1_V12D07-332_C1,1,1,0,2,0,4
TTGGATCGACTTCTGG-1_V12D07-332_C1,0,1,0,0,0,1
CACCATCGGAGGAGAC-1_V12D07-332_C1,1,0,0,0,0,1
TCGTTCGTTATTATGT-1_V12D07-332_C1,0,2,0,2,0,4
CTTAACTTCGAAGTAC-1_V12D07-332_C1,2,3,0,0,0,5
GCACAAGTGTCGGAAG-1_V12D07-332_C1,2,1,0,1,0,4
TACCAGCTAGGTTTAA-1_V12D07-332_C1,1,1,1,1,0,4
ACGTACAGATTTCTCT-1_V12D07-332_C1,1,2,0,0,0,3
AATTTGGTTCCAAAGA-1_V12D07-332_C1,0,1,0,1,0,2
GTAAGGATTTGTCGGA-1_V12D07-332_C1,1,1,1,0,0,3
CATCATCTACCCGGAC-1_V12D07-332_C1,1,1,0,0,0,2
ACGATGGATCCGATGC-1_V12D07-332_C1,0,1,0,0,0,1
CACTCAGCTCTTGAGG-1_V12D07-332_C1,0,0,0,0,0,0
TAGATCCGAAGTCGCA-1_V12D07-332_C1,0,1,0,1,0,2
TGAAACTTATGCAAGC-1_V12D07-332_C1,2,0,0,0,0,2
GCGATTCTGGAAGCAG-1_V12D07-332_C1,3,1,0,0,0,4
CAAACTATTGAGCTTC-1_V12D07-332_C1,1,2,0,1,0,4
TAGAATTAAGGGCAAC-1_V12D07-332_C1,0,1,0,1,0,2
CGAAACATAGATGGCA-1_V12D07-332_C1,1,1,0,0,0,2
GATGGTGCCCTAGGCA-1_V12D07-332_C1,1,2,0,0,0,3
CCCGCAGGGCCCAAAG-1_V12D07-332_C1,0,0,0,0,0,0
ACAGCGCACCCGCAGC-1_V12D07-332_C1,0,2,1,0,0,3
GGTAAATGTGCGTTAC-1_V12D07-332_C1,1,0,1,0,0,2
GTCCTTCTAGTGGGTT-1_V12D07-332_C1,0,1,0,0,0,1
GGAAGCTCGCTTACAG-1_V12D07-332_C1,2,1,0,0,0,3
CACCGATACACCGAGC-1_V12D07-332_C1,0,0,0,1,0,1
CAGCCGGGCCCTCTAT-1_V12D07-332_C1,0,3,0,0,0,3
CGGAGCTTATAACACC-1_V12D07-332_C1,1,0,0,0,0,1
ATTACAACTACCGGCC-1_V12D07-332_C1,1,0,0,0,1,2
TCCTCTGGCCCATTAG-1_V12D07-332_C1,0,1,0,0,0,1
CGGCACCGTTAGCGCC-1_V12D07-332_C1,1,0,0,0,1,2
TCGGTCCCTGACTCCA-1_V12D07-332_C1,0,0,0,1,0,1
TGGTTGGAGGATCCTG-1_V12D07-332_C1,0,1,0,2,0,3
CTGCGGTAGTCACGTG-1_V12D07-332_C1,4,0,0,2,0,6
GTGCCTCAGTGTACGG-1_V12D07-332_C1,0,4,0,0,1,5
ATCGTTCACTTTCGCC-1_V12D07-332_C1,0,3,0,0,0,3
ACTTACCGGGCGCGCA-1_V12D07-332_C1,0,0,0,0,0,0
CTAGACTGCATTTCGT-1_V12D07-332_C1,0,3,0,0,0,3
TTGCCGGTGATCCCTC-1_V12D07-332_C1,1,1,0,0,0,2
CTGTCACGCCAGGCGC-1_V12D07-332_C1,0,0,0,0,0,0
CGGTATAGGTATTAGC-1_V12D07-332_C1,0,0,0,0,0,0
CCAACGCTTGCCAGGG-1_V12D07-332_C1,1,0,0,0,0,1
CGTTGAGTAATTGCGT-1_V12D07-332_C1,3,0,0,0,0,3
TGTATTTACCTAATGC-1_V12D07-332_C1,0,0,0,0,0,0
TAAATGCCGTCTCATG-1_V12D07-332_C1,0,1,0,0,0,1
CGGTTTATGAAGGAAC-1_V12D07-332_C1,4,1,0,2,0,7
GCAAGATGTGTTCGCG-1_V12D07-332_C1,1,1,0,0,0,2
AAAGGTAAGCTGTACC-1_V12D07-332_C1,1,1,0,1,0,3
GTACGTCACGTATTAA-1_V12D07-332_C1,0,2,0,0,1,3
AGTACCTTCGAGTGCT-1_V12D07-332_C1,0,0,0,0,0,0
ATTGTGACTTCGCTGC-1_V12D07-332_C1,1,0,0,0,1,2
TGTATCAGACTGAAGC-1_V12D07-332_C1,1,2,0,0,0,3
GAGACCCTGCAACGCC-1_V12D07-332_C1,0,0,0,0,0,0
TGGGTGGGATGTCATT-1_V12D07-332_C1,1,0,0,0,1,2
GGCTAATGATTGAAAT-1_V12D07-332_C1,0,0,0,0,0,0
ATAACGTTACCTCCAC-1_V12D07-332_C1,0,0,0,0,0,0
TGCGAGATGGCGGCCA-1_V12D07-332_C1,0,1,0,0,2,3
CACACTTGTATTGCGA-1_V12D07-332_C1,0,0,0,0,0,0
GCTGGTGACTCGTAGT-1_V12D07-332_C1,1,0,0,0,0,1
CGACACCGCTTAAGGA-1_V12D07-332_C1,0,0,0,0,0,0
GTAACAACTGACCTTG-1_V12D07-332_C1,1,2,0,0,0,3
CAACTGAGGGTATGAC-1_V12D07-332_C1,0,0,0,0,1,1
CTAATTATGAAGCGTA-1_V12D07-332_C1,0,4,0,0,1,5
CCGATCTTAAGAGGCT-1_V12D07-332_C1,1,0,0,0,0,1
CGACTCGGTACACGGT-1_V12D07-332_C1,0,1,0,0,1,2
TGCTGCGTCAGAGTTA-1_V12D07-332_C1,0,0,1,0,1,2
AGAGTTGCAGGCCTCC-1_V12D07-332_C1,2,3,0,0,1,6
ACTGGCGAACCTGCGT-1_V12D07-332_C1,1,0,0,0,0,1
ACTAAGGACGCACACC-1_V12D07-332_C1,0,1,0,0,1,2
CGTCCAGATGGCTCCA-1_V12D07-332_C1,0,4,1,0,0,5
ACTATCGCCGGCTAAA-1_V12D07-332_C1,0,3,0,1,0,4
GATAGCGTACCACGCG-1_V12D07-332_C1,0,4,0,0,0,4
AGGACTTATAGGAGAA-1_V12D07-332_C1,0,2,0,0,0,2
TAGTCGGGATTCTTCG-1_V12D07-332_C1,1,0,0,0,1,2
ACCATTAAGGGTGTCA-1_V12D07-332_C1,1,1,0,0,0,2
TTAATGTGTTTGCAGG-1_V12D07-332_C1,0,1,0,0,0,1
TCCGCAGCCACCTAGC-1_V12D07-332_C1,0,1,0,0,0,1
GAGGAGATCCTCATGC-1_V12D07-332_C1,0,0,0,0,0,0
GGTCCTTCATACGACT-1_V12D07-332_C1,0,4,0,0,0,4
CCCTGTTGGCAAAGAC-1_V12D07-332_C1,3,2,0,0,0,5
GTGCCTAGCTATGCTT-1_V12D07-332_C1,0,3,0,0,1,4
GTCATCTCCTACAGCT-1_V12D07-332_C1,1,2,0,0,0,3
GCGAGAAACGGGAGTT-1_V12D07-332_C1,0,1,0,0,0,1
CGTCGCGGCGGGATTT-1_V12D07-332_C1,0,2,1,0,0,3
CATTGTGTGCTAGATC-1_V12D07-332_C1,0,5,1,0,0,6
CGCGGCAGTATTACGG-1_V12D07-332_C1,0,1,1,0,0,2
GAAATGGGATGTAAAC-1_V12D07-332_C1,0,3,0,0,0,3
CATTCCCTAAGTACAA-1_V12D07-332_C1,0,1,0,0,0,1
AGTTCTGCGTTGTATC-1_V12D07-332_C1,0,1,0,0,0,1
ACCCTATAGGACTGAG-1_V12D07-332_C1,1,3,0,0,0,4
TTAGATAGGTCGATAC-1_V12D07-332_C1,1,1,1,1,0,4
ATTGATAGCAACGAGA-1_V12D07-332_C1,1,0,0,0,0,1
TCTCGGCTCCAGGACT-1_V12D07-332_C1,2,5,0,0,1,8
CTTGAGGTTATCCCGA-1_V12D07-332_C1,0,2,0,0,0,2
AAGAAGGATCAGTTAG-1_V12D07-332_C1,0,3,1,0,0,4
GTACGACGGCGCTGCG-1_V12D07-332_C1,2,6,0,0,0,8
CTTATGTTGACTACCA-1_V12D07-332_C1,1,0,0,0,0,1
CGGCACTCAAGAAAGT-1_V12D07-332_C1,1,2,0,0,0,3
GTCAAAGTTTACATAG-1_V12D07-332_C1,0,3,0,2,0,5
CTCCTAAGTTATGTCT-1_V12D07-332_C1,0,3,0,0,0,3
ACTGTGCTAGTAGATC-1_V12D07-332_C1,0,3,1,0,1,5
GTTTGGCCGCTCAGCG-1_V12D07-332_C1,0,1,0,0,0,1
TTATCCAATCGAACTC-1_V12D07-332_C1,1,3,1,0,0,5
CCGTACCCAAGCGCCA-1_V12D07-332_C1,0,3,0,0,0,3
CATACAAAGCCGAACC-1_V12D07-332_C1,1,4,0,0,0,5
GGTCGGTAATTAGACA-1_V12D07-332_C1,0,6,1,0,0,7
AGCGGGAAGGGTCCAT-1_V12D07-332_C1,1,0,0,0,0,1
GCCCACCAAGGCTGTC-1_V12D07-332_C1,1,2,0,0,0,3
GTAGACGTCGTTACAT-1_V12D07-332_C1,0,0,0,0,0,0
GAGCATCATCCCTGGG-1_V12D07-332_C1,1,0,0,1,0,2
AGGTAACCTCCTATTC-1_V12D07-332_C1,0,0,0,0,0,0
GGTTTGAGTGCTGGAA-1_V12D07-332_C1,0,0,0,0,0,0
GCACTAGTCGCGCTAT-1_V12D07-332_C1,0,0,0,0,0,0
GGTAACTATGTATCTG-1_V12D07-332_C1,0,0,0,0,0,0
GCGGTCCCTAGACGCA-1_V12D07-332_C1,0,1,0,1,0,2
CGAGCGTTGATCAGCC-1_V12D07-332_C1,2,1,0,0,0,3
AATCCAAGGGCCTGAG-1_V12D07-332_C1,0,1,0,0,0,1
CCGTGCCCATGACGGC-1_V12D07-332_C1,0,2,0,1,0,3
GAAATTCACATCGCTG-1_V12D07-332_C1,2,4,0,0,0,6
CTCTGCGAAGCAAGCA-1_V12D07-332_C1,0,1,0,0,0,1
AGTAGGTAACATACAT-1_V12D07-332_C1,0,2,0,0,0,2
ATTGGGAATATCTTGG-1_V12D07-332_C1,0,2,0,0,0,2
TAGAGCTACGAAGAAC-1_V12D07-332_C1,1,0,0,1,0,2
TGCGGCATAGTTCAAC-1_V12D07-332_C1,1,1,0,0,0,2
CCGCCGGTCAACACAC-1_V12D07-332_C1,0,2,0,2,0,4
TCGTATAGTGCAATTA-1_V12D07-332_C1,0,3,0,0,0,3
TAGTTTATTCTTGCTT-1_V12D07-332_C1,0,1,0,1,0,2
GATATCTCATGCAATA-1_V12D07-332_C1,2,1,0,0,0,3
CGTTTAAGCGGAGCAC-1_V12D07-332_C1,0,1,1,0,0,2
CATGCTGGCTCCAATT-1_V12D07-332_C1,1,3,0,0,0,4
GAAACAGCCATGCAGT-1_V12D07-332_C1,1,1,1,0,0,3
AGTTTCGCAGGTCGGA-1_V12D07-332_C1,3,8,0,2,0,13
CTCATGGCTCACAATC-1_V12D07-332_C1,1,1,0,1,0,3
AACCGTTGTGTTTGCT-1_V12D07-332_C1,1,4,1,0,0,6
ACCCTTCATCTGCGAA-1_V12D07-332_C1,2,2,0,1,0,5
TGCGGTGAAATTTCAT-1_V12D07-332_C1,0,1,0,2,0,3
CAAATTGTCAGCAAGC-1_V12D07-332_C1,0,1,0,1,0,2
GAGGTACATCCATCTT-1_V12D07-332_C1,0,4,1,0,0,5
AAATGGCATGTCTTGT-1_V12D07-332_C1,1,4,0,1,0,6
TCATCCCAGAGGGTGG-1_V12D07-332_C1,0,0,0,0,0,0
CGTAGCGAATTGTCAG-1_V12D07-332_C1,0,2,0,1,0,3
CCTAGTTAGTCGCATG-1_V12D07-332_C1,2,3,0,2,0,7
GAAACTCTAATGAAGG-1_V12D07-332_C1,1,1,1,0,0,3
TTGTATCACACAGAAT-1_V12D07-332_C1,2,0,0,0,0,2
TTCAAGCCGAGCTGAG-1_V12D07-332_C1,0,0,0,0,0,0
AGGTACGATATTGCCA-1_V12D07-332_C1,0,0,0,0,0,0
TTAAGCCGACAACTTC-1_V12D07-332_C1,0,0,0,1,0,1
GTCTTAGTACAGCCGG-1_V12D07-332_C1,0,2,0,0,0,2
TGGGTAAGGTTCCCGC-1_V12D07-332_C1,0,0,0,0,0,0
CTACGCCATTTCCGAT-1_V12D07-332_C1,2,0,0,0,0,2
GACCGTCAGGTCGTGA-1_V12D07-332_C1,0,0,0,0,0,0
TAGTTAAGATAGGATA-1_V12D07-332_C1,1,2,0,0,0,3
GAATATTCGGAGTCCC-1_V12D07-332_C1,0,0,0,0,0,0
CAAACTACGATAGAGA-1_V12D07-332_C1,0,1,0,0,0,1
CAGGAAGACTTTATAT-1_V12D07-332_C1,0,1,0,0,0,1
TTCGTAATCCCAGCGG-1_V12D07-332_C1,1,1,0,2,0,4
GTGAGGAGCGGTTGAG-1_V12D07-332_C1,2,1,0,1,0,4
CAATCCCTATACCAGC-1_V12D07-332_C1,0,0,0,1,0,1
AGGGAAACGAGGTACT-1_V12D07-332_C1,1,0,0,0,0,1
TCCTGCCAACTGGAGA-1_V12D07-332_C1,0,0,0,1,0,1
AATTTGGGACATAGTA-1_V12D07-332_C1,1,0,0,1,0,2
AACTCCTAATCCCATG-1_V12D07-332_C1,0,0,0,0,0,0
GCTCATTACTGCATGT-1_V12D07-332_C1,2,0,0,0,0,2
TCTCGAACGAGGTCAC-1_V12D07-332_C1,2,1,0,0,0,3
TCACTACGACCAATGC-1_V12D07-332_C1,3,0,0,0,0,3
GTGATGCACAACATCT-1_V12D07-332_C1,1,1,0,0,0,2
CCGACGTAAACACAAC-1_V12D07-332_C1,0,0,0,0,1,1
TGGGATGCACTCATTC-1_V12D07-332_C1,2,0,0,0,0,2
TTCCATCATGCGGTGA-1_V12D07-332_C1,1,0,0,1,0,2
TGCACAGTGAAGTTAT-1_V12D07-332_C1,1,1,0,1,0,3
CTATTGTGTTTGGTCA-1_V12D07-332_C1,2,0,0,0,0,2
TGCGAGCCCTTCCGCG-1_V12D07-332_C1,2,0,0,1,0,3
TTGAAAGGTGTAAAGG-1_V12D07-332_C1,1,0,0,0,0,1
GGTGCAGAGCCTATCG-1_V12D07-332_C1,0,1,0,0,0,1
ACTATATGCTGTGTTC-1_V12D07-332_C1,3,0,0,0,1,4
TCCTGGCGCTGCCTGG-1_V12D07-332_C1,1,0,0,0,0,1
GAGCCGAGCGTTTATT-1_V12D07-332_C1,0,2,1,1,0,4
AGAATGCGGGTTCGGA-1_V12D07-332_C1,2,1,0,0,0,3
ATGCGACAATTGGTCC-1_V12D07-332_C1,0,0,0,0,0,0
TTCCGGCTCGACTTCT-1_V12D07-332_C1,1,0,0,0,0,1
TGATTATGGCACGCAG-1_V12D07-332_C1,0,1,0,0,2,3
GGTTTGACAAGAAGCT-1_V12D07-332_C1,0,0,0,1,2,3
GCAGCTATGGACAGGT-1_V12D07-332_C1,0,0,0,0,3,3
CACCATGATCGCAAAG-1_V12D07-332_C1,0,3,0,0,0,3
GTCGGAAGGATACCAG-1_V12D07-332_C1,0,2,0,0,2,4
GGCCCAGTTATCAGCA-1_V12D07-332_C1,0,1,0,1,0,2
GGGCCTATTTAAGTAT-1_V12D07-332_C1,0,3,0,0,0,3
GTTGTTACATTGCGCT-1_V12D07-332_C1,0,1,0,0,2,3
CAACTCCGTAACTTGC-1_V12D07-332_C1,0,2,0,0,0,2
GATCTTTGCTCAAAGA-1_V12D07-332_C1,0,2,0,0,0,2
TCGCTTAATTACGAAG-1_V12D07-332_C1,0,1,0,0,0,1
CGATCATTAGAGGCAC-1_V12D07-332_C1,0,1,0,0,1,2
TGTTCTCTACTCCCTA-1_V12D07-332_C1,0,1,0,0,1,2
GCTTAGGGAAGCGGTA-1_V12D07-332_C1,1,3,0,0,0,4
CAGGTTTAGTACTACA-1_V12D07-332_C1,2,1,0,0,1,4
AAGCGGAGTGCGCGCA-1_V12D07-332_C1,0,2,0,0,0,2
TCAGATGGAGACGTAG-1_V12D07-332_C1,0,3,0,0,0,3
TCGCACTAACGTTTGT-1_V12D07-332_C1,0,1,1,0,0,2
CACGTCGGGTTCTAGA-1_V12D07-332_C1,0,3,1,0,0,4
GGAGTACACATGAGCT-1_V12D07-332_C1,0,3,0,0,0,3
GTGTGTCGACGTCGCT-1_V12D07-332_C1,1,1,0,1,0,3
GAAGCTCTTTGCTTAG-1_V12D07-332_C1,0,0,1,0,0,1
ACACCGAGCGCTCTTT-1_V12D07-332_C1,0,3,0,0,0,3
CGTAATAATTACGAGT-1_V12D07-332_C1,1,5,0,1,0,7
CATCAACACCTACTAA-1_V12D07-332_C1,0,3,0,0,0,3
CCAAGTTTCTACAGAT-1_V12D07-332_C1,0,2,0,0,0,2
ACGGGTCATGTGACTT-1_V12D07-332_C1,0,2,0,0,0,2
AGTGTGCTAAGATCGC-1_V12D07-332_C1,0,4,0,1,0,5
GGCGGTTTGCCGGTGC-1_V12D07-332_C1,1,4,0,0,0,5
GTATAATCTCCCGGAT-1_V12D07-332_C1,0,3,0,0,0,3
TAGTCCGTATGCATAA-1_V12D07-332_C1,0,3,0,0,0,3
CACTTCGTCTTATCTC-1_V12D07-332_C1,1,3,0,0,1,5
CATCCGCAGGCCCGAA-1_V12D07-332_C1,1,2,0,0,0,3
CCCTGATGTAACTCGT-1_V12D07-332_C1,0,0,0,1,0,1
CCATAGTCAGTAACCC-1_V12D07-332_C1,0,1,0,1,0,2
CGGGCCATAGCCGCAC-1_V12D07-332_C1,0,3,0,2,0,5
CTCCGGCTTGTAGACA-1_V12D07-332_C1,0,2,0,0,0,2
AACTTGCGTTCTCGCG-1_V12D07-332_C1,2,0,0,1,0,3
AATGAGTTCGCATATG-1_V12D07-332_C1,0,2,0,0,0,2
CGAGGCCAGGCATTGG-1_V12D07-332_C1,0,1,0,0,0,1
TCTGCGTCCGGTTTCT-1_V12D07-332_C1,2,3,0,1,0,6
CAATCCTGCCGTGGAG-1_V12D07-332_C1,1,2,0,0,0,3
CTGAGCAAGTAACAAG-1_V12D07-332_C1,1,4,0,0,0,5
GGGTACCCACGGTCCT-1_V12D07-332_C1,0,4,0,2,0,6
ACGGAATTTAGCAAAT-1_V12D07-332_C1,0,2,3,1,0,6
GGGCGGTCCTATTGTC-1_V12D07-332_C1,0,2,0,1,0,3
ATGTTACGAGCAATAC-1_V12D07-332_C1,0,2,0,0,0,2
AACCATGGGATCGCTA-1_V12D07-332_C1,1,2,0,0,0,3
TCGCATCCCTAAGTGT-1_V12D07-332_C1,1,1,0,0,0,2
ACTTAGTACGACAAGA-1_V12D07-332_C1,1,5,0,1,0,7
GAGCTCTCGGACCTAA-1_V12D07-332_C1,0,2,0,1,0,3
TCTATTACGCTGGCGA-1_V12D07-332_C1,0,4,1,1,0,6
AGATACGACTTCATAT-1_V12D07-332_C1,0,0,0,0,0,0
CGCTATACCGCCCACT-1_V12D07-332_C1,0,0,0,0,0,0
CAGTGTCCGCAGAATG-1_V12D07-332_C1,0,0,0,0,0,0
CCATCCATACCAAGTC-1_V12D07-332_C1,0,0,0,0,0,0
AACCCAGAGACGGAGA-1_V12D07-332_C1,0,0,0,0,0,0
GAAGAACGGTGCAGGT-1_V12D07-332_C1,0,0,0,0,0,0
GATAAATCGGTGGATG-1_V12D07-332_C1,0,0,0,0,0,0
CAGCTCGTGCTTGTGT-1_V12D07-332_C1,0,0,0,0,0,0
GAGTACGGGTATACAA-1_V12D07-332_C1,0,0,0,0,0,0
CATCGCCCGCGGCCAA-1_V12D07-332_C1,0,0,0,0,0,0
TCTTACAGAGGTACCG-1_V12D07-332_C1,0,0,0,0,0,0
TGGAAGACGAACACCA-1_V12D07-332_C1,0,1,0,0,0,1
GTTGTCGTGTTAGTTG-1_V12D07-332_C1,0,0,0,0,0,0
CCAAGGAACAGAGAGG-1_V12D07-332_C1,0,0,0,0,0,0
CTGCACCTGGAACCGC-1_V12D07-332_C1,1,2,0,0,0,3
CGCTTTCATACCGGTG-1_V12D07-332_C1,0,1,0,1,0,2
GTTCTTCCCTCGATGT-1_V12D07-332_C1,0,3,0,1,0,4
ATTTAACTCGTATTAC-1_V12D07-332_C1,0,1,0,0,0,1
AACGATAGAAGGGCCG-1_V12D07-332_C1,1,2,0,0,0,3
TATCCTGCATGGGAAT-1_V12D07-332_C1,0,0,0,2,0,2
AGGCCCATTGTACAGG-1_V12D07-332_C1,1,0,0,0,0,1
CCGGCGCATATTGGAT-1_V12D07-332_C1,1,3,0,0,0,4
ATCTGTAATTGTACCC-1_V12D07-332_C1,1,1,0,0,0,2
GAGCGAGGGAGTACCG-1_V12D07-332_C1,3,0,0,0,1,4
TTATTAGGGAAGCATC-1_V12D07-332_C1,1,2,0,0,0,3
CTTCTTACGTCGTATA-1_V12D07-332_C1,1,0,0,0,0,1
GAAGTGCTGGATAGCT-1_V12D07-332_C1,1,2,0,0,0,3
GTGCAACAAATGTGGC-1_V12D07-332_C1,0,2,0,1,0,3
CATGCGTTAGACAGAA-1_V12D07-332_C1,0,3,1,0,0,4
ACACACTTTCTACACG-1_V12D07-332_C1,0,0,0,1,0,1
AGCCCTAAGCGAAGTT-1_V12D07-332_C1,1,1,0,1,0,3
ATTAATTCGGTCACTC-1_V12D07-332_C1,0,2,1,1,0,4
AACAGGAAATCGAATA-1_V12D07-332_C1,0,4,0,1,0,5
ACGTTTAGTTGTGATC-1_V12D07-332_C1,0,5,0,1,1,7
TCCTTCAGTGGTCGAA-1_V12D07-332_C1,2,1,0,0,1,4
CGAACGCCCAGTGCCG-1_V12D07-332_C1,5,2,0,0,0,7
CCTCGAAGTGGACGGG-1_V12D07-332_C1,1,2,0,1,0,4
CTCTGTTTGAGGATTC-1_V12D07-332_C1,0,4,1,2,0,7
TGGGCACGTTCTATGG-1_V12D07-332_C1,2,2,0,2,0,6
ACTATTCGTCCGTGGT-1_V12D07-332_C1,0,0,0,1,0,1
CCTCTGGCCTAGACGG-1_V12D07-332_C1,0,0,0,0,0,0
CCATAAACAACCCGAC-1_V12D07-332_C1,0,0,0,0,0,0
CATAGTACATTGAGAG-1_V12D07-332_C1,0,1,0,0,0,1
ATTTCATTATTTCGCG-1_V12D07-332_C1,0,0,0,0,0,0
CAACTATATCGAATGC-1_V12D07-332_C1,1,0,0,0,0,1
CTAGTATTCGGAATTA-1_V12D07-332_C1,0,1,0,0,0,1
GTGGAACCTACATGCG-1_V12D07-332_C1,0,0,1,0,0,1
CCTAAAGGCTGACGCT-1_V12D07-332_C1,0,0,0,1,0,1
CGTGACATTGGGTCGT-1_V12D07-332_C1,0,0,0,0,0,0
CCAATCGGTAGATCGA-1_V12D07-332_C1,1,0,0,0,0,1
ATTGTCGCAATACCTT-1_V12D07-332_C1,0,0,0,0,0,0
AAATTACACGACTCTG-1_V12D07-332_C1,0,0,0,0,0,0
CACTCCTCTCGGTCGG-1_V12D07-332_C1,1,1,0,0,0,2
AAATAACCATACGGGA-1_V12D07-332_C1,0,0,0,1,0,1
AGTTACTCTATCGTGG-1_V12D07-332_C1,1,1,0,0,0,2
CGTTAGCTCACAACTG-1_V12D07-332_C1,2,1,0,1,0,4
GAATGTATGGCAGGTC-1_V12D07-332_C1,0,0,0,0,0,0
GCAACCACCAGACCGG-1_V12D07-332_C1,0,2,0,0,1,3
TCACTCGTGCAACGGC-1_V12D07-332_C1,0,0,0,0,0,0
AAACAGAGCGACTCCT-1_V12D07-332_C1,2,2,0,0,1,5
CAGCCTCTCCTCAAGA-1_V12D07-332_C1,1,0,0,0,0,1
TTGCGTGAACGCTTAG-1_V12D07-332_C1,0,0,0,0,0,0
CCGCCTGCGAATTGGT-1_V12D07-332_C1,0,0,0,0,0,0
AGATGAGGGTTGCGAT-1_V12D07-332_C1,2,1,0,0,0,3
CGGTGGGCTCCAGCCT-1_V12D07-332_C1,1,0,0,0,0,1
GGCAGCGGTAATCCTA-1_V12D07-332_C1,1,1,0,0,0,2
GCTAGCAGGGAGTGGG-1_V12D07-332_C1,2,0,0,0,0,2
CTCAAGACATTAGCGC-1_V12D07-332_C1,2,1,0,0,0,3
CACGGCGCGCCAAAGG-1_V12D07-332_C1,2,0,0,0,0,2
TGCAATTTGGGCACGG-1_V12D07-332_C1,1,0,0,0,0,1
ATGCCAATCGCTCTGC-1_V12D07-332_C1,3,0,0,0,1,4
GCTGGACCCAAAGTGG-1_V12D07-332_C1,0,1,0,0,2,3
ATTCCTAAGACGTGGA-1_V12D07-332_C1,1,1,0,0,0,2
TCCGGAGGAAGGGCTG-1_V12D07-332_C1,1,1,0,0,0,2
TCGGTGACCGCTCCGG-1_V12D07-332_C1,0,2,0,1,0,3
TCCGAAGTAGTCACCA-1_V12D07-332_C1,0,0,0,1,2,3
CATGTAGGAGCGCCAA-1_V12D07-332_C1,0,1,0,0,0,1
CACAAGAAAGATATTA-1_V12D07-332_C1,0,0,0,0,1,1
AGGGTCAGTAACCCTA-1_V12D07-332_C1,0,1,0,0,0,1
TAAGCCCTTACGACCA-1_V12D07-332_C1,0,1,0,0,0,1
ATACCGTCATCCATAA-1_V12D07-332_C1,0,1,0,0,2,3
GGACGTCCATAGTTGG-1_V12D07-332_C1,0,0,1,0,0,1
CATCAAACTGGCGCCC-1_V12D07-332_C1,0,3,0,0,5,8
AAACGTGTTCGCCCTA-1_V12D07-332_C1,0,0,0,0,2,2
AAATTGGTGAGAAGCA-1_V12D07-332_C1,0,1,1,0,1,3
GGTCATTGTAGTCATA-1_V12D07-332_C1,0,0,0,0,2,2
TGCAGTGAGGCTCGGG-1_V12D07-332_C1,0,3,0,0,1,4
GAACATTAGTATGTTA-1_V12D07-332_C1,1,1,0,0,0,2
GGTTTGCGAACACGTA-1_V12D07-332_C1,0,3,0,0,0,3
ACACAAATATTCCTAG-1_V12D07-332_C1,0,3,0,0,0,3
TTGGGTTTATTCAGCG-1_V12D07-332_C1,0,1,1,0,0,2
ATTCGCAGAGGACACT-1_V12D07-332_C1,0,2,0,0,0,2
GATTTAGTGCGTACTG-1_V12D07-332_C1,2,2,0,0,0,4
TAGAAACACAATAGTG-1_V12D07-332_C1,0,1,0,0,0,1
CAGTAGATGATGTCCG-1_V12D07-332_C1,0,2,1,1,1,5
TCTTAACTCGGATGTA-1_V12D07-332_C1,1,2,0,0,0,3
TACATCTTGTTTCTTG-1_V12D07-332_C1,0,1,0,1,0,2
TTCATAGGGTGTCCAT-1_V12D07-332_C1,0,3,0,2,0,5
TGAAGTAGCTTACGGA-1_V12D07-332_C1,0,1,1,0,0,2
GCACAAGTGGATCATA-1_V12D07-332_C1,0,2,0,0,0,2
GGGCGAATTTCTCCAC-1_V12D07-332_C1,0,2,0,0,1,3
ATGTTCCTGCCCACCT-1_V12D07-332_C1,0,4,1,0,0,5
GCTCAACCTCTTAGAG-1_V12D07-332_C1,1,0,2,0,0,3
ATAGCTGCTCTTGTTA-1_V12D07-332_C1,0,2,0,0,0,2
CGTCAGCTATTTACTC-1_V12D07-332_C1,1,1,0,0,0,2
ATCTGATAGTGTCTTA-1_V12D07-332_C1,0,2,2,0,0,4
TGCACTATGTGAGTGC-1_V12D07-332_C1,2,4,0,0,0,6
CCGACAAACACATGAG-1_V12D07-332_C1,0,3,0,0,1,4
GCCTTGTATATGCAGT-1_V12D07-332_C1,0,2,0,1,0,3
ATAATACCGTTAGCCG-1_V12D07-332_C1,1,1,0,0,0,2
ACACTCCAATGTCACT-1_V12D07-332_C1,0,0,0,0,0,0
AGTTGCTGACTGATAT-1_V12D07-332_C1,3,1,1,0,2,7
GGCGCTCCTCATCAAT-1_V12D07-332_C1,0,2,0,0,0,2
TGCCTGACATCGGTCA-1_V12D07-332_C1,0,4,0,0,0,4
TTGGCCATCTTGCGCT-1_V12D07-332_C1,0,4,0,0,0,4
CAGTGGTTGCACATGA-1_V12D07-332_C1,0,1,0,0,1,2
AGAATTGTTTGACATA-1_V12D07-332_C1,1,0,1,0,1,3
AAATGCTCGTTACGTT-1_V12D07-332_C1,0,1,0,0,0,1
CACCTAATAGAGTCGT-1_V12D07-332_C1,0,5,0,2,0,7
CATTTCTAGCAGACTA-1_V12D07-332_C1,0,3,0,1,0,4
CCGAAAGTGGTGAGCA-1_V12D07-332_C1,1,2,0,0,0,3
AGTCAGCCACCGCCTG-1_V12D07-332_C1,0,0,0,0,0,0
TCATCACTCGAGCTCG-1_V12D07-332_C1,1,1,0,0,0,2
CTCAGGACTCACCTGT-1_V12D07-332_C1,0,2,0,0,0,2
CGGTGTACTTGATCCC-1_V12D07-332_C1,1,4,1,2,0,8
CCTACGGCTCAGTCGA-1_V12D07-332_C1,0,1,0,0,0,1
GTACTTGGGCACTTCT-1_V12D07-332_C1,1,0,0,0,0,1
TGATTTCCTCCTGACG-1_V12D07-332_C1,1,1,0,0,0,2
CCTCACCAATCTTGAC-1_V12D07-332_C1,1,2,0,0,0,3
GGTGAGATGCAGATAA-1_V12D07-332_C1,0,0,0,0,0,0
GCTAGTTTCATTGAGG-1_V12D07-332_C1,0,1,0,0,0,1
AGGACATCGCACGTCG-1_V12D07-332_C1,0,0,0,0,0,0
GTGGACGTGCTGAGAC-1_V12D07-332_C1,1,0,0,0,0,1
TAAGGAACTTGTGGGA-1_V12D07-332_C1,0,0,0,0,0,0
TCGCTGTGCGTAAATC-1_V12D07-332_C1,0,0,0,0,0,0
GCATCCCTAACTTTGA-1_V12D07-332_C1,0,0,0,0,0,0
CACCCACACGTCACCC-1_V12D07-332_C1,1,2,0,0,0,3
CCCTCATTCTGGAATT-1_V12D07-332_C1,0,0,0,1,0,1
AGGGCGTGATCGGCTA-1_V12D07-332_C1,1,1,0,0,0,2
GGTGCGGATAAGTGGC-1_V12D07-332_C1,0,1,0,0,0,1
TAATATTGAAATTCGC-1_V12D07-332_C1,0,1,0,0,0,1
CTTACACTGGGAAATA-1_V12D07-332_C1,0,5,0,0,0,5
ACCAAGAACGCGTGTC-1_V12D07-332_C1,2,0,0,0,0,2
GCCTTCAGCCCTACCG-1_V12D07-332_C1,1,4,1,0,0,6
GATGCTACAAGCGCCT-1_V12D07-332_C1,2,2,0,1,0,5
CCGGGACCCGCAGAGA-1_V12D07-332_C1,1,3,0,0,0,4
GTTCCAGTCTGACCAT-1_V12D07-332_C1,1,1,0,0,0,2
ATGATCGGGAATAGAC-1_V12D07-332_C1,3,3,0,0,0,6
TTGGATTGGGTACCAC-1_V12D07-332_C1,0,1,0,0,0,1
TACCTCACGCTTGTAC-1_V12D07-332_C1,0,1,0,1,0,2
CATGGCAGGAAGATCG-1_V12D07-332_C1,1,0,0,0,0,1
ATGACGCCGGCTCTAA-1_V12D07-332_C1,0,0,0,0,0,0
AGCGACATCCCATTCA-1_V12D07-332_C1,0,1,1,0,0,2
AGTAATGTCTTGCCGC-1_V12D07-332_C1,0,6,1,0,0,7
TTCTTAGTGGCTCAGA-1_V12D07-332_C1,0,0,0,0,0,0
CGTCTGGAAGGGCCCG-1_V12D07-332_C1,1,1,0,1,0,3
ACGTGCGCCTCGTGCA-1_V12D07-332_C1,0,0,0,0,0,0
AGAGCGGGCTAATCAT-1_V12D07-332_C1,1,1,0,0,1,3
GCGTCGAAATGTCGGT-1_V12D07-332_C1,0,1,1,1,0,3
AACTGATATTAGGCCT-1_V12D07-332_C1,0,1,1,4,0,6
CGAGCTGGGCTTTAGG-1_V12D07-332_C1,0,0,1,0,0,1
GGGTGTTTCAGCTATG-1_V12D07-332_C1,0,3,1,2,0,6
TTAATTTCAGACGCGG-1_V12D07-332_C1,0,1,0,0,0,1
ACTGCCGTCGTAACTC-1_V12D07-332_C1,1,2,0,0,0,3
GTGCACGAAAGTGACT-1_V12D07-332_C1,1,2,0,0,0,3
ATCTCCCTGCAATCTA-1_V12D07-332_C1,3,1,0,0,0,4
ACGCCAGATGATTTCT-1_V12D07-332_C1,2,1,0,0,0,3
AGCTATTTAATCCAAC-1_V12D07-332_C1,2,4,0,2,0,8
CCACGAGAAGAGAATC-1_V12D07-332_C1,1,0,0,1,0,2
GATTCCGCGTTTCCGT-1_V12D07-332_C1,1,0,0,0,0,1
GTCGGATGTAGCGCGC-1_V12D07-332_C1,0,0,0,0,0,0
TATTTATACCGAGTAG-1_V12D07-332_C1,1,0,0,0,0,1
GTAGGTGATCCGTGTA-1_V12D07-332_C1,0,1,0,0,0,1
AGTTAAGCGGTCCCGG-1_V12D07-332_C1,0,2,1,0,0,3
CTGGCGACATAAGTCC-1_V12D07-332_C1,0,1,0,0,0,1
TTGGCCTAGAATTTCG-1_V12D07-332_C1,0,1,0,0,0,1
GGCATATCGGTTCTGC-1_V12D07-332_C1,0,0,0,0,0,0
GGGCGTCCACTGGCTC-1_V12D07-332_C1,1,0,0,0,0,1
TTACCCATTGCCGGGT-1_V12D07-332_C1,0,0,0,0,0,0
TTAGACACGATCGTTG-1_V12D07-332_C1,1,1,0,0,0,2
GCGCTGATCCAGACTC-1_V12D07-332_C1,1,0,0,1,0,2
TTCGGCAACCCGCTGA-1_V12D07-332_C1,0,1,0,1,0,2
GATATTTCCTACATGG-1_V12D07-332_C1,0,1,0,1,0,2
CTGCGTTACGATATAA-1_V12D07-332_C1,2,0,1,0,0,3
TAATAAACAAGGAGAT-1_V12D07-332_C1,1,1,1,0,0,3
AACCTTTACGACGTCT-1_V12D07-332_C1,1,1,0,1,0,3
AGTCCCGCCTTTAATT-1_V12D07-332_C1,2,1,0,0,0,3
TGAGATTAGGCCCTAA-1_V12D07-332_C1,1,1,0,0,0,2
AGTGTATTGCGCATTG-1_V12D07-332_C1,0,0,0,0,0,0
GTTGGATTCAGTGGCT-1_V12D07-332_C1,0,0,0,0,0,0
TAAAGCTGCAATAGGG-1_V12D07-332_C1,0,0,0,0,0,0
AGTAGGAAGGAAGTTG-1_V12D07-332_C1,1,0,0,0,0,1
TATCACTTCGAGTAAC-1_V12D07-332_C1,2,1,1,1,0,5
TGATCTACGCTGATCT-1_V12D07-332_C1,0,2,0,0,0,2
GGATCATCCCGTACGC-1_V12D07-332_C1,3,0,0,0,0,3
TGACACTTCTCTTTGC-1_V12D07-332_C1,3,1,0,0,0,4
AGCCCTTCTAATCCGA-1_V12D07-332_C1,0,0,0,0,0,0
CACCGCGTCCACTCTA-1_V12D07-332_C1,0,1,0,0,0,1
TAATTGGAATCGGGAA-1_V12D07-332_C1,0,0,1,1,0,2
TCGTAAGCTCCGAGGA-1_V12D07-332_C1,0,1,0,0,1,2
TATATTACAAATGTCG-1_V12D07-332_C1,2,2,0,0,1,5
CGCGAGAGGGACTTGT-1_V12D07-332_C1,1,1,0,0,1,3
GGACCTACGGTAACGT-1_V12D07-332_C1,0,0,0,0,1,1
GAAATATGCTTGAATG-1_V12D07-332_C1,0,0,0,0,0,0
CCGTATTAGCGCAGTT-1_V12D07-332_C1,0,3,0,0,0,3
AGGCGTCTATGGACGG-1_V12D07-332_C1,0,2,0,0,0,2
AACATCGATACGTCTA-1_V12D07-332_C1,0,3,0,1,0,4
TGAATATGCTATAAAC-1_V12D07-332_C1,0,0,0,0,0,0
ACCAAACACCCAGCGA-1_V12D07-332_C1,0,1,0,0,3,4
TGGCTTGTACAAGCTT-1_V12D07-332_C1,0,2,0,0,0,2
GAATGAAGGTCTTCAG-1_V12D07-332_C1,0,1,0,0,1,2
AGATACCAGCACTTCA-1_V12D07-332_C1,0,1,0,0,0,1
GCGGTCCCGGTGAAGG-1_V12D07-332_C1,0,0,0,0,2,2
GAGGCATTTGCAGCAG-1_V12D07-332_C1,0,1,0,0,1,2
GGCAAGCCAGGGATAG-1_V12D07-332_C1,0,5,0,0,0,5
TCTACGGGCTCAGTTG-1_V12D07-332_C1,0,0,1,0,1,2
TCTGCGAATCGTTCGC-1_V12D07-332_C1,1,2,0,1,1,5
AGCTCGTTGATGGAAA-1_V12D07-332_C1,1,2,0,0,0,3
TGAATGAGATACAGCA-1_V12D07-332_C1,1,1,0,0,0,2
ACCCTTGCCTGGGTCG-1_V12D07-332_C1,0,3,0,0,0,3
GGCGAACCGTTCTGAT-1_V12D07-332_C1,1,3,1,0,0,5
GCGATGTCTGTGCTTG-1_V12D07-332_C1,0,3,0,0,0,3
ATTAACACCTGAGATA-1_V12D07-332_C1,0,0,0,0,1,1
GAAATCTGACCAAGTT-1_V12D07-332_C1,0,3,0,0,0,3
CCTGACAAACTCGCGC-1_V12D07-332_C1,0,2,0,0,0,2
ATGTCATTTCCCATTG-1_V12D07-332_C1,0,5,0,0,0,5
GCGGTGCGGAGCATCG-1_V12D07-332_C1,1,1,0,0,0,2
CGGAAAGCAAATGTGC-1_V12D07-332_C1,0,3,1,0,0,4
GCTGAGCAACGGTTCT-1_V12D07-332_C1,1,3,0,0,1,5
TCACTCTTCGTCTGTC-1_V12D07-332_C1,2,2,0,0,0,4
GATCTTCATTGTCCTC-1_V12D07-332_C1,2,1,0,0,0,3
ACTCGATGTATTTCAT-1_V12D07-332_C1,2,3,1,0,0,6
TGAAGAGCGGTCCTAG-1_V12D07-332_C1,1,4,0,0,0,5
TAAACGTCGTCAATGA-1_V12D07-332_C1,0,1,0,0,0,1
ACGTTATTGGTCACTC-1_V12D07-332_C1,0,2,0,0,0,2
ATAGCCTCAGTACCCA-1_V12D07-332_C1,2,5,0,0,0,7
CGGGAGTATACCGCCG-1_V12D07-332_C1,0,1,1,0,0,2
GTCCTACAGGCGGCTC-1_V12D07-332_C1,0,2,0,0,1,3
CGGATAAGCGGACATG-1_V12D07-332_C1,1,3,1,0,1,6
AACTTCTGCGTCTATC-1_V12D07-332_C1,0,3,1,0,0,4
GGGTTCAGACGAACAA-1_V12D07-332_C1,0,1,1,0,0,2
AGTCTGGACATCCTTG-1_V12D07-332_C1,1,2,0,0,1,4
TTGAACGAATCCTTTG-1_V12D07-332_C1,0,3,0,0,0,3
GAAATACTAAACGTTT-1_V12D07-332_C1,1,3,0,0,0,4
CCCGCGCAATGCACCC-1_V12D07-332_C1,1,3,0,0,0,4
TTCGGCTAGAGATGGT-1_V12D07-332_C1,1,3,0,0,0,4
GACACGAGTTAGAGGA-1_V12D07-332_C1,0,1,1,0,1,3
GAGGTCCCAAAGATCT-1_V12D07-332_C1,1,1,0,0,0,2
TAACTCCATGGAGGCT-1_V12D07-332_C1,1,1,0,0,0,2
CTTGTTTATGTAGCCA-1_V12D07-332_C1,2,1,0,0,0,3
GATGGCGCACACATTA-1_V12D07-332_C1,1,1,0,1,0,3
ATAATAGTGTAGGGAC-1_V12D07-332_C1,1,2,0,0,0,3
CGCTATTCAATGTATG-1_V12D07-332_C1,1,4,1,0,0,6
ATATTGCTGTCAAAGT-1_V12D07-332_C1,1,2,0,0,0,3
GGATTCAGTACGGTGG-1_V12D07-332_C1,0,0,0,0,0,0
TTCTTAGTGAACGGTG-1_V12D07-332_C1,0,0,0,0,0,0
AATGGTTCTCACAAGC-1_V12D07-332_C1,0,2,0,0,0,2
TATACACGCAAAGTAT-1_V12D07-332_C1,1,0,0,0,0,1
CTTCATAGCTCAAGAA-1_V12D07-332_C1,0,4,0,1,0,5
CAACGGTTCTTGATAC-1_V12D07-332_C1,0,2,0,0,0,2
ACACCCGAGAAATCCG-1_V12D07-332_C1,0,0,0,1,0,1
TCTATCATGCAGTTAC-1_V12D07-332_C1,1,1,0,0,0,2
CCCGCCATGCTCCCGT-1_V12D07-332_C1,1,1,0,2,0,4
CGCTTCCACTGAAATC-1_V12D07-332_C1,2,1,1,0,0,4
CACTGTCCAAGTGAGA-1_V12D07-332_C1,1,2,0,1,0,4
ATTACTAGCCTCTTGC-1_V12D07-332_C1,1,0,0,0,0,1
CATAGTAGCATAGTAG-1_V12D07-332_C1,0,2,0,0,0,2
CAACTCCTTGATCCCG-1_V12D07-332_C1,1,2,0,0,0,3
AAGTAGAAGACCGGGT-1_V12D07-332_C1,1,0,0,0,0,1
GCGGGAACCAGGCCCT-1_V12D07-332_C1,1,2,0,2,0,5
ATTAGATTGATAGCGG-1_V12D07-332_C1,0,0,0,0,0,0
CTCGGTCCGTAGCCTG-1_V12D07-332_C1,1,0,0,0,0,1
TGGCTTTGGGTAGACA-1_V12D07-332_C1,0,0,0,0,0,0
TATCCATATCATGCGA-1_V12D07-332_C1,1,1,0,0,0,2
GGAGTGCCGCCCTGGA-1_V12D07-332_C1,0,1,0,0,0,1
TGAGAATGCTTTACCG-1_V12D07-332_C1,0,0,0,0,0,0
TTAACCAACCCTCCCT-1_V12D07-332_C1,1,2,0,1,0,4
TGTTTCGGTACTTCTC-1_V12D07-332_C1,0,1,1,1,0,3
TTGCTGAAGGAACCAC-1_V12D07-332_C1,1,1,0,2,0,4
TATTTAGTCTAGATCG-1_V12D07-332_C1,0,1,1,0,0,2
CTCCGGCCTAATATGC-1_V12D07-332_C1,0,3,0,0,1,4
TTGTGGCCCTGACAGT-1_V12D07-332_C1,2,0,0,0,0,2
TCGCCGGTCGATCCGT-1_V12D07-332_C1,0,3,0,0,0,3
CCATAGGTTGGCGTGG-1_V12D07-332_C1,2,1,0,0,0,3
GAACGACCGAATGATA-1_V12D07-332_C1,0,1,0,0,0,1
TCCGATAATTGCCATA-1_V12D07-332_C1,1,0,0,0,0,1
CATTACGTCGGCCCGT-1_V12D07-332_C1,0,1,0,0,0,1
CAAGCACCAAATGCCT-1_V12D07-332_C1,0,6,0,2,0,8
TGCATGGATCGGATCT-1_V12D07-332_C1,0,0,0,1,0,1
GAAATCGCGCGCAACT-1_V12D07-332_C1,2,2,0,0,0,4
CTGAAAGAGATCCGAC-1_V12D07-332_C1,3,3,0,2,0,8
CACCTCGATGGTGGAC-1_V12D07-332_C1,2,2,0,2,0,6
ATTTGTTCCAGGGCTC-1_V12D07-332_C1,1,4,0,0,0,5
TGGGCCACAAGAGCGC-1_V12D07-332_C1,1,3,0,1,0,5
CCTTCTTGATCCAGTG-1_V12D07-332_C1,0,0,0,0,0,0
CCTCGCCAGCAAATTA-1_V12D07-332_C1,1,1,0,1,0,3
TTCATGGCGCAACAGG-1_V12D07-332_C1,0,0,0,0,0,0
TTAATCAGTACGTCAG-1_V12D07-332_C1,1,2,0,0,0,3
CCTATCTATATCGGAA-1_V12D07-332_C1,2,2,0,0,1,5
ATTATACTTTGCTCGT-1_V12D07-332_C1,3,0,0,0,0,3
ATGGATCCGGCGTCCG-1_V12D07-332_C1,0,1,0,1,0,2
CGCCCGCTTCCGTACA-1_V12D07-332_C1,2,1,0,1,0,4
GGATTCCGCTATACCC-1_V12D07-332_C1,0,4,0,1,0,5
CGGTCTATCAACCCGT-1_V12D07-332_C1,1,1,0,0,0,2
ATGCCGGTTGATGGGA-1_V12D07-332_C1,0,1,0,1,0,2
TCATGCAGGTTCTCAT-1_V12D07-332_C1,2,2,0,0,0,4
TGAGCTTTAATGACGC-1_V12D07-332_C1,0,0,1,0,0,1
TCCCTTAGATTACTCG-1_V12D07-332_C1,0,2,0,0,0,2
ATATCTCCCTCGTTAA-1_V12D07-332_C1,3,3,0,0,0,6
AGCTCTTCCCAGTGCA-1_V12D07-332_C1,4,2,0,0,0,6
TCGCTAAACCGCTATC-1_V12D07-332_C1,0,1,0,0,1,2
CACATTCTTTCGATGG-1_V12D07-332_C1,0,1,0,0,0,1
GATATGCGGTAGCCAA-1_V12D07-332_C1,4,1,0,0,0,5
CGTTTCACTTCGGGCG-1_V12D07-332_C1,0,0,0,0,0,0
CCAATTACGGGTCGAG-1_V12D07-332_C1,3,1,0,1,0,5
GCAGGTAGAGTATGGT-1_V12D07-332_C1,0,1,0,0,0,1
GTCGTATTGGCGTACA-1_V12D07-332_C1,0,0,0,0,0,0
GAAATTAGCACGGATA-1_V12D07-332_C1,0,1,0,0,0,1
AATGCACCAAGCAATG-1_V12D07-332_C1,0,1,0,0,0,1
AGGACGCTCGATGTTG-1_V12D07-332_C1,1,1,0,1,0,3
GGCTAAAGGGCGGGTC-1_V12D07-332_C1,0,0,0,0,0,0
CATCTATCCCGTGTCT-1_V12D07-332_C1,3,0,1,0,1,5
CAGTAACTATTTATTG-1_V12D07-332_C1,0,0,0,1,0,1
CATATACTACTGATAA-1_V12D07-332_C1,0,0,0,0,0,0
GCGTTCGGAGACCGGG-1_V12D07-332_C1,1,3,0,0,0,4
AAGTTCAGTCTGCGTA-1_V12D07-332_C1,0,1,0,0,1,2
CGAAGCTATAAATTCA-1_V12D07-332_C1,4,0,0,0,0,4
CGCGGTCACAAACCAA-1_V12D07-332_C1,0,1,0,0,1,2
GGGAATGAGCCCTCAC-1_V12D07-332_C1,2,0,0,0,0,2
ACGGAGCGCAAATTAC-1_V12D07-332_C1,1,0,0,0,0,1
CGTTCTTCGCACACCT-1_V12D07-332_C1,0,0,0,0,0,0
GAATAGCCCTGCGGTC-1_V12D07-332_C1,0,2,0,0,1,3
AATAGCTACCGCGTGC-1_V12D07-332_C1,0,0,0,0,0,0
CCGAGCTGTGCTTGTC-1_V12D07-332_C1,0,1,0,0,0,1
GATGACGATGATCGCG-1_V12D07-332_C1,0,0,0,0,2,2
GCCTATGCTGGGCCTT-1_V12D07-332_C1,0,3,0,0,0,3
TTACTGTCTAGAGCTC-1_V12D07-332_C1,0,0,0,0,0,0
AGCGGTTGCCGCTCTG-1_V12D07-332_C1,0,2,0,1,0,3
GCTTGCAGCACAATTG-1_V12D07-332_C1,0,0,0,0,0,0
CCGGAGGTCTTATGGT-1_V12D07-332_C1,0,2,0,0,0,2
ACAGTATACCGTGGGA-1_V12D07-332_C1,0,2,0,0,0,2
GGGATCCCAATACAAA-1_V12D07-332_C1,0,2,0,0,1,3
ATTACGACTCCACAGT-1_V12D07-332_C1,0,1,0,0,1,2
CTCACACGCAAGCCTA-1_V12D07-332_C1,1,1,0,0,1,3
CCAGATGTAAATGGGT-1_V12D07-332_C1,0,2,0,0,1,3
GAACTTGTGCACGGGA-1_V12D07-332_C1,1,3,0,0,0,4
AAGCCGCTTTACCTTG-1_V12D07-332_C1,0,4,0,0,0,4
TCCATTCCCACTAGAG-1_V12D07-332_C1,1,0,0,0,0,1
AGAGCGCTTGTAACGG-1_V12D07-332_C1,2,3,1,0,0,6
TGGGTTCCCGGACGGA-1_V12D07-332_C1,0,1,0,0,0,1
GCTGCGCCTCCCACGT-1_V12D07-332_C1,0,4,0,0,0,4
CTGTTGGCTCTTCTGA-1_V12D07-332_C1,0,3,0,0,0,3
TTGTTCTAGATACGCT-1_V12D07-332_C1,1,4,0,0,0,5
CCCTCAAGCTCTTAGT-1_V12D07-332_C1,0,5,0,0,0,5
TGGTCTAGCTTACATG-1_V12D07-332_C1,0,6,0,0,0,6
ATGCACCTTCCTTAAT-1_V12D07-332_C1,1,0,0,0,0,1
GGGATACGGTAATAAT-1_V12D07-332_C1,0,2,0,1,0,3
AGTTCACCGGTTGGAC-1_V12D07-332_C1,0,4,1,0,0,5
GACATACTGTCGCAGA-1_V12D07-332_C1,1,3,0,0,0,4
TGGACACCGTTGCTTG-1_V12D07-332_C1,2,1,0,0,0,3
TGCGATGCTAATGGCT-1_V12D07-332_C1,0,5,0,0,0,5
TTCTGTTTCCTGTCGC-1_V12D07-332_C1,1,0,0,0,0,1
CGTTGTAAACGTCAGG-1_V12D07-332_C1,0,5,1,0,1,7
GATCGGCGATAAGTCG-1_V12D07-332_C1,0,2,0,0,0,2
AGCCTTAAAGCGGAAG-1_V12D07-332_C1,1,0,0,0,0,1
TCCGTAACCACAATCC-1_V12D07-332_C1,0,3,0,0,0,3
GAATGCCGAAATGACC-1_V12D07-332_C1,1,3,1,0,0,5
TATACTCATGCGGCAA-1_V12D07-332_C1,3,3,0,0,1,7
TAGTGTCAGAAACGGC-1_V12D07-332_C1,0,1,0,0,0,1
CGTCATACCATATCCA-1_V12D07-332_C1,0,5,0,0,0,5
TAGTACCTTAGTGGTC-1_V12D07-332_C1,0,2,0,0,0,2
CTGGCGGGAATAAGTA-1_V12D07-332_C1,0,2,0,1,0,3
AGTGTGGTCTATTGTG-1_V12D07-332_C1,0,1,1,0,1,3
GCTATCGCGGCGCAAC-1_V12D07-332_C1,1,1,0,0,0,2
CAGTAATCCCTCCCAG-1_V12D07-332_C1,0,1,1,0,0,2
GTATTAAGGCGTCTAA-1_V12D07-332_C1,0,1,0,0,0,1
CTAATTTCAACAACAC-1_V12D07-332_C1,3,1,0,0,0,4
TTAGCAACATGGATGT-1_V12D07-332_C1,0,2,0,0,0,2
ATGCTCAGTGTTGCAT-1_V12D07-332_C1,0,2,2,0,0,4
GATGTTTGTGCGAGAT-1_V12D07-332_C1,1,1,0,0,0,2
CACTTCGCCACAGGCT-1_V12D07-332_C1,0,2,0,0,0,2
CTGTATGGTGTAGAAA-1_V12D07-332_C1,0,4,0,0,0,4
TACGTGCACTATGCTG-1_V12D07-332_C1,0,6,3,0,0,9
GTATCAGCTTGGGTTC-1_V12D07-332_C1,1,2,0,1,0,4
TAACAAAGGGAGAAGC-1_V12D07-332_C1,0,0,0,1,0,1
TTACATCGTGGCCTGG-1_V12D07-332_C1,0,3,0,1,0,4
TCTGAACCGGTCGGCT-1_V12D07-332_C1,1,2,0,0,0,3
GGCTCGTGCCACCAGC-1_V12D07-332_C1,1,1,0,0,0,2
TATAAGTGAGGATAGC-1_V12D07-332_C1,3,5,1,1,0,10
GCCCGCGCGTTTGACA-1_V12D07-332_C1,0,3,0,0,0,3
TGCTGGTTGGACAATT-1_V12D07-332_C1,0,1,0,0,1,2
GCCTAGCGATCTGACC-1_V12D07-332_C1,1,6,0,0,0,7
CCATGCTCTGCAGGAA-1_V12D07-332_C1,0,2,0,0,0,2
TATAAATCCACAAGCT-1_V12D07-332_C1,3,1,0,1,0,5
CGCTCGACATAATGAT-1_V12D07-332_C1,0,0,1,0,0,1
CCAATTGAATGTTAAT-1_V12D07-332_C1,0,1,0,0,0,1
GCTAATACCGAATGCC-1_V12D07-332_C1,0,5,0,0,0,5
TTCAACGACCCGACCG-1_V12D07-332_C1,0,0,0,0,0,0
TTCCTCGAGGGTGTCT-1_V12D07-332_C1,0,1,1,0,0,2
CAACGACCCGTTTACA-1_V12D07-332_C1,0,5,1,0,0,6
CTTGTACTTGTTGACT-1_V12D07-332_C1,0,2,0,0,0,2
TCTCTAATAGCTGGTA-1_V12D07-332_C1,2,1,0,0,0,3
ATTATGCCATAGGGAG-1_V12D07-332_C1,3,2,0,0,0,5
GACAACGCAGCTTACG-1_V12D07-332_C1,2,1,0,0,0,3
AGATGACTCGCCCACG-1_V12D07-332_C1,1,0,0,0,0,1
GTGCGGGTCTCCAAAT-1_V12D07-332_C1,1,3,0,1,1,6
GTACGAGATTGCGACA-1_V12D07-332_C1,0,3,0,0,2,5
GTATAGGACTCAGTAG-1_V12D07-332_C1,1,0,1,0,0,2
TTGCACGGAGCAGCAC-1_V12D07-332_C1,0,3,0,0,0,3
CACAGCTAGGGAGTGA-1_V12D07-332_C1,0,1,0,0,0,1
ATACTAGCATGACCCT-1_V12D07-332_C1,0,1,0,0,0,1
CCAAGACTTCTGCGAA-1_V12D07-332_C1,0,1,0,0,0,1
ACATAATAAGGCGGTG-1_V12D07-332_C1,0,0,0,0,1,1
TAATACACAGTAGTAT-1_V12D07-332_C1,1,2,0,0,1,4
TCTTGGTAACACCAAA-1_V12D07-332_C1,0,2,1,1,0,4
AACTGGGTCCCGACGT-1_V12D07-332_C1,2,6,0,0,0,8
ATCACTTCATCCTCGC-1_V12D07-332_C1,1,1,0,0,0,2
TGGAAGGATAAAGATG-1_V12D07-332_C1,0,0,0,0,0,0
CATGATGCACAATTCT-1_V12D07-332_C1,0,2,0,4,0,6
TGCCTGATCAAACGAT-1_V12D07-332_C1,2,2,0,1,0,5
ATAGGGATATCCTTGA-1_V12D07-332_C1,0,2,0,0,0,2
CACCTAATCAGTTTAC-1_V12D07-332_C1,1,2,0,0,0,3
TGTGACTACGCCAGTC-1_V12D07-332_C1,2,3,0,1,0,6
CCCGACCATAGTCCGC-1_V12D07-332_C1,2,0,0,0,0,2
CGCGCCCGACTTAATA-1_V12D07-332_C1,0,0,0,0,1,1
TGCCACCTGGCGAAAC-1_V12D07-332_C1,0,3,0,0,0,3
CTGCCAAGGTTGGAAG-1_V12D07-332_C1,1,3,0,1,0,5
TCTCCAACGTAGGTTA-1_V12D07-332_C1,0,1,0,1,0,2
TTCTTGGAGTAATGAG-1_V12D07-332_C1,1,1,0,1,0,3
GTCTCGATCTGCTTTC-1_V12D07-332_C1,0,0,0,1,0,1
TACTCTCCGAACAAAT-1_V12D07-332_C1,1,1,0,0,0,2
ATCACATTAGAATATC-1_V12D07-332_C1,0,0,0,1,0,1
TACGGGATGCTAGCAG-1_V12D07-332_C1,0,0,0,0,0,0
AGCTGAAGTAAACCAA-1_V12D07-332_C1,0,3,0,0,0,3
CATGGGTCGGGTGTGG-1_V12D07-332_C1,0,0,0,0,0,0
CACCCACGAGGCAATT-1_V12D07-332_C1,1,2,0,1,0,4
TGCCATTACTAAAGAA-1_V12D07-332_C1,0,4,0,0,0,4
CCGTTACGTTAGAACA-1_V12D07-332_C1,0,0,0,0,0,0
GCCAGGAGTAACCGAT-1_V12D07-332_C1,0,0,0,0,0,0
GGAAAGTGCCCATGCC-1_V12D07-332_C1,0,0,0,0,0,0
TCTTACCGGAACTCGT-1_V12D07-332_C1,1,2,0,0,1,4
TATGTCAAGACCGACT-1_V12D07-332_C1,0,2,2,0,0,4
CCTAACTAAGGCTCTA-1_V12D07-332_C1,0,1,0,1,0,2
GCGGTGAACTGCGCTC-1_V12D07-332_C1,1,0,0,0,0,1
CCTCGCGCGATATAGG-1_V12D07-332_C1,3,0,0,0,0,3
ATCGGCAAGCAGTCCA-1_V12D07-332_C1,2,1,0,0,0,3
AGATCGTGCATAAGAT-1_V12D07-332_C1,1,3,1,1,0,6
ATTCAGGACCTATTTC-1_V12D07-332_C1,1,0,0,0,0,1
AGCTAGAAGCAGAAGT-1_V12D07-332_C1,1,0,0,0,0,1
TTCGCTATCTGACGTG-1_V12D07-332_C1,2,1,0,0,0,3
TTCCGCAGAGAAATAT-1_V12D07-332_C1,0,0,0,0,0,0
CAGTACATTCTCTAAA-1_V12D07-332_C1,2,0,0,0,0,2
GTGAAGATTTCAAGTG-1_V12D07-332_C1,3,0,0,0,0,3
AACGCATGATCTGGGT-1_V12D07-332_C1,0,1,0,0,0,1
CCCAGAGGAGGGCGTA-1_V12D07-332_C1,1,0,0,1,0,2
GGAAACCTTGTTGAAT-1_V12D07-332_C1,1,3,0,0,0,4
GTGAAGCCGTATAGTC-1_V12D07-332_C1,0,3,1,0,0,4
GAGCTGTCGTCTCGGA-1_V12D07-332_C1,2,0,0,0,0,2
TGTCATTTGTTGGGAA-1_V12D07-332_C1,0,2,0,1,0,3
ACCAACACCACACACT-1_V12D07-332_C1,1,1,0,0,0,2
AAATGATTCGATCAGC-1_V12D07-332_C1,0,0,0,0,0,0
CTGCTTTATGTCCGCG-1_V12D07-332_C1,1,0,0,0,0,1
GCGAGAGGCCATGTAA-1_V12D07-332_C1,1,1,0,0,1,3
ATTGACCGGCGATGAC-1_V12D07-332_C1,0,1,0,0,1,2
ACCCTGGTAACGCCCT-1_V12D07-332_C1,0,3,0,0,1,4
GTTGGACCGCATCAGG-1_V12D07-332_C1,0,0,0,0,0,0
CGTTTACAAGGCAGCT-1_V12D07-332_C1,0,0,0,0,0,0
CGGTCCATGAGACTCC-1_V12D07-332_C1,0,2,0,0,1,3
GTTCGTCTGGGTCCCT-1_V12D07-332_C1,0,1,0,0,0,1
TGTACTACTCTCACGG-1_V12D07-332_C1,0,2,0,0,0,2
AGTGAAGATGGTGTCC-1_V12D07-332_C1,0,0,0,0,1,1
GAGGGCCATAATATTA-1_V12D07-332_C1,0,2,0,0,1,3
ACTCCCGTAGACTAGG-1_V12D07-332_C1,0,3,1,0,0,4
CGTCAAATGGTCGCAG-1_V12D07-332_C1,1,1,0,0,0,2
AAGTCTAGTAGCTGCC-1_V12D07-332_C1,1,8,0,0,0,9
AAGAAATCACCAGATT-1_V12D07-332_C1,0,2,0,0,0,2
GAGTGCACGGACAACA-1_V12D07-332_C1,1,1,0,0,0,2
GTTCAAATCAGATGTC-1_V12D07-332_C1,0,0,0,0,0,0
CATGGCTCCCTATGTC-1_V12D07-332_C1,0,4,0,0,1,5
GGCCACACGAAAGCCT-1_V12D07-332_C1,0,4,0,0,0,4
GAAGCCGGGTAAGCTC-1_V12D07-332_C1,1,0,0,0,0,1
TTGCGCTCTCTCGCTT-1_V12D07-332_C1,1,4,0,0,1,6
TACATGACCTTATCCG-1_V12D07-332_C1,1,4,0,0,0,5
GTCCTTCTACAACCCA-1_V12D07-332_C1,1,1,0,0,0,2
TATATGCTGGGTTGCC-1_V12D07-332_C1,0,2,2,0,1,5
GTTTATGGGATTTAGA-1_V12D07-332_C1,0,4,0,0,0,4
GGAACCCGAACAAGAA-1_V12D07-332_C1,0,1,1,0,0,2
AACGTTATCAGCACCT-1_V12D07-332_C1,0,1,1,0,1,3
CATCGTCCGGTTACTA-1_V12D07-332_C1,0,4,0,0,0,4
AGACAGCTCAGAATCC-1_V12D07-332_C1,0,2,0,0,1,3
GCAGATCCTCGCAAAT-1_V12D07-332_C1,1,2,0,0,0,3
GGGTCATGCGTACCAT-1_V12D07-332_C1,0,3,2,0,2,7
CTGGTCATTCCAATCC-1_V12D07-332_C1,0,0,1,0,0,1
TCAGGGCGCAAACTCG-1_V12D07-332_C1,0,3,0,0,0,3
GATGCCAGCAGAAGGC-1_V12D07-332_C1,2,1,0,0,0,3
GTTATTAACGTGGGAG-1_V12D07-332_C1,1,1,1,0,0,3
AATACAATGTTTCAGG-1_V12D07-332_C1,0,4,0,0,0,4
TTGCTGCACCTATCCA-1_V12D07-332_C1,0,3,1,1,0,5
TAGCAACCTGTCACAA-1_V12D07-332_C1,1,2,0,0,0,3
TGGGAAATGCCTTTCC-1_V12D07-332_C1,3,0,0,1,0,4
AGACCATGGGATACAA-1_V12D07-332_C1,4,4,0,0,1,9
TAAATGAATCCGTTTC-1_V12D07-332_C1,2,0,1,1,0,4
ACAACGGTCCCTGCGA-1_V12D07-332_C1,0,1,1,0,0,2
GTCACTCTCCAAATCT-1_V12D07-332_C1,2,1,0,0,0,3
TTCTACTTGCGAGGGC-1_V12D07-332_C1,0,0,0,0,0,0
CGCAATTACTTTCGGT-1_V12D07-332_C1,1,0,1,0,0,2
CTGTTCATCTCACGGG-1_V12D07-332_C1,1,2,0,1,0,4
TTCTTGTAACCTAATG-1_V12D07-332_C1,1,2,1,0,0,4
GCTTGATGATAATCAG-1_V12D07-332_C1,0,2,0,0,0,2
TTGGCTCGCATGAGAC-1_V12D07-332_C1,0,1,1,0,0,2
GCCCAGTTGGTATGCC-1_V12D07-332_C1,2,0,0,0,0,2
ATTCCTCCGCCAGTGC-1_V12D07-332_C1,1,2,1,0,0,4
TCGTCCGCTGGCGTCT-1_V12D07-332_C1,1,1,0,0,0,2
GGAGAAGTCATTGGCA-1_V12D07-332_C1,1,1,0,0,0,2
TTGTTAGCAAATTCGA-1_V12D07-332_C1,1,1,0,0,0,2
TCTAGCATCTTCGATG-1_V12D07-332_C1,0,1,0,0,0,1
TTCTAGGCCAATTGTG-1_V12D07-332_C1,0,0,0,0,0,0
TCACGGTCATCGCACA-1_V12D07-332_C1,1,3,0,0,0,4
ATGAAGCCAAGGAGCC-1_V12D07-332_C1,0,3,0,1,0,4
AATGACTGTCAGCCGG-1_V12D07-332_C1,0,0,0,0,0,0
CCAAACAGAACCCTCG-1_V12D07-332_C1,0,2,0,0,1,3
TATCGATGATTAAACG-1_V12D07-332_C1,0,2,0,0,1,3
GAACACACATCAACCA-1_V12D07-332_C1,0,4,0,0,1,5
CCCGTCAGCGTCTGAC-1_V12D07-332_C1,0,2,0,0,1,3
AGCATCGTCGATAATT-1_V12D07-332_C1,0,2,1,0,0,3
GACTAAGATCATGCAC-1_V12D07-332_C1,0,2,0,0,0,2
TAGGGTGTTTCAAGAG-1_V12D07-332_C1,0,2,0,0,0,2
TGGTTCGTAGCAAAGG-1_V12D07-332_C1,0,2,0,0,2,4
CTGTTCACTGCCTGTG-1_V12D07-332_C1,0,1,0,1,1,3
ATGTGCATCCGACGCA-1_V12D07-332_C1,0,2,0,0,1,3
TTGTCGTTCAGTTACC-1_V12D07-332_C1,0,1,0,1,0,2
CGGGATCAATGTAAGA-1_V12D07-332_C1,0,1,0,1,1,3
TTATCTGTATCATAAC-1_V12D07-332_C1,0,1,0,0,0,1
ATCGACTCTTTCCGTT-1_V12D07-332_C1,0,4,0,0,2,6
CTCATTTGATGGGCGG-1_V12D07-332_C1,0,1,0,0,0,1
GTAAGCGGGCAGTCAG-1_V12D07-332_C1,1,3,0,1,0,5
TCTATCGGTCGCAACA-1_V12D07-332_C1,0,1,0,0,0,1
AACGCGGTCTCCAGCC-1_V12D07-332_C1,0,2,0,0,0,2
ATTAATACTACGCGGG-1_V12D07-332_C1,1,1,0,0,1,3
CTTTAACTTTCAAAGG-1_V12D07-332_C1,0,5,0,1,0,6
CGTACCTGATAGGCCT-1_V12D07-332_C1,0,1,0,1,0,2
GAATGTTGGGTAATCT-1_V12D07-332_C1,0,4,0,1,0,5
TGCGGAGTAAAGGTGC-1_V12D07-332_C1,0,1,0,0,0,1
CCTGAATATTTACATA-1_V12D07-332_C1,0,0,0,0,1,1
TTGCTCCCATACCGGA-1_V12D07-332_C1,0,0,1,0,0,1
CCTCTAATCTGCCAAG-1_V12D07-332_C1,0,2,0,3,0,5
AGGTTGAGGCACGCTT-1_V12D07-332_C1,1,2,0,0,0,3
TCCCGTCAGTCCCGCA-1_V12D07-332_C1,0,3,0,0,0,3
TCCGATGACTGAGCTC-1_V12D07-332_C1,1,2,0,1,0,4
CAGCCTCCTGCAGAGG-1_V12D07-332_C1,0,0,0,0,0,0
CTTAGCCTTCCACATG-1_V12D07-332_C1,1,1,0,0,1,3
ATTAATGAACCAGTCG-1_V12D07-332_C1,1,0,0,0,0,1
ACGATACATAGAACTA-1_V12D07-332_C1,0,2,0,0,0,2
AGCCACTCCCGTGCTT-1_V12D07-332_C1,1,0,0,0,0,1
ATACGGGTTTCGATTG-1_V12D07-332_C1,0,1,0,0,0,1
CTGTCAAATGGCTCGG-1_V12D07-332_C1,1,1,0,0,0,2
GCTCGGAATTTAAAGC-1_V12D07-332_C1,1,0,0,1,0,2
TAGGCATGTTACGCCA-1_V12D07-332_C1,0,0,0,0,0,0
TGGCAACTCGCGCGCC-1_V12D07-332_C1,0,2,0,0,0,2
ATCAGTAGGCAGGGAT-1_V12D07-332_C1,0,0,0,0,0,0
TATCGATCTATGCATA-1_V12D07-332_C1,2,0,0,0,0,2
CGACTCAGGATGTTAT-1_V12D07-332_C1,1,1,0,0,0,2
GCCATATTGCACACAG-1_V12D07-332_C1,0,0,0,1,0,1
AATTCATAAGGGATCT-1_V12D07-332_C1,1,0,0,0,1,2
CGGTAGAGGTGCAGGT-1_V12D07-332_C1,0,3,0,1,0,4
AATGATGATACGCTAT-1_V12D07-332_C1,1,0,0,0,0,1
CTTGTGCTCACCGATT-1_V12D07-332_C1,1,0,0,0,0,1
TTCCAATCAGAGCTAG-1_V12D07-332_C1,0,0,0,0,0,0
CGATGGACCCTACGCC-1_V12D07-332_C1,0,0,0,0,0,0
GGTCGGATAAACGGCG-1_V12D07-332_C1,0,1,0,1,0,2
TTAGCTAATACGATCT-1_V12D07-332_C1,2,1,0,0,0,3
CTCGATATTTGCGAGC-1_V12D07-332_C1,0,1,0,1,0,2
ATTACTTACTGGGCAT-1_V12D07-332_C1,0,0,0,1,0,1
CTAGCCGATGTTATGA-1_V12D07-332_C1,1,0,0,0,0,1
TACTGCAATCAATTAC-1_V12D07-332_C1,0,1,0,0,0,1
TAGTCTGTGACGTTGC-1_V12D07-332_C1,0,0,0,0,0,0
CTCGTTTCTAATGTTT-1_V12D07-332_C1,0,0,0,0,0,0
TTCGTTCAACGAAGTT-1_V12D07-332_C1,0,0,0,0,0,0
CTGAATTTATTGCCAG-1_V12D07-332_C1,0,1,0,0,0,1
TGGAATATCCTTGACC-1_V12D07-332_C1,0,0,0,0,0,0
CAGATCATTTAAAGTC-1_V12D07-332_C1,0,1,0,0,0,1
CTCCTTTACGCAAGTC-1_V12D07-332_C1,0,0,0,0,1,1
TCCCAAACAGACAACG-1_V12D07-332_C1,0,0,0,1,0,1
ATCGCTGCGTGCAGCA-1_V12D07-332_C1,1,1,0,0,0,2
TTAGTTCAAGTGTTCG-1_V12D07-332_C1,0,1,0,0,0,1
AAACTCGTGATATAAG-1_V12D07-332_C1,0,2,0,0,0,2
TTAACGAACAAGCAGT-1_V12D07-332_C1,0,2,0,0,1,3
GTTATATCAGGAGCCA-1_V12D07-332_C1,0,2,1,0,1,4
CAAATTGGATTATGCC-1_V12D07-332_C1,0,3,0,0,1,4
CGAGGAGCTTCCATAT-1_V12D07-332_C1,0,1,0,0,2,3
GGAGACCAATGTGCTT-1_V12D07-332_C1,0,3,0,0,0,3
CATTGATGAACACGCC-1_V12D07-332_C1,0,0,0,0,1,1
GTCAATGCTATAATTT-1_V12D07-332_C1,0,2,0,0,2,4
ACCACCCTCTCTTCTA-1_V12D07-332_C1,0,0,0,0,1,1
TGGAGGGAAACACCTC-1_V12D07-332_C1,0,2,0,0,0,2
CACGGACGTGGATGGC-1_V12D07-332_C1,1,0,0,0,0,1
AACTTTCTCGATCATG-1_V12D07-332_C1,1,1,0,0,0,2
CGTATTGTTTCCTAAT-1_V12D07-332_C1,1,6,1,0,0,8
CCTACTGCGGCGGCCA-1_V12D07-332_C1,1,3,0,1,0,5
CTTAGGTCCCAATCGT-1_V12D07-332_C1,0,0,0,0,0,0
CGCAATCGATCATTAG-1_V12D07-332_C1,0,2,0,0,1,3
TGGTTATGCTTGCGGT-1_V12D07-332_C1,0,4,1,0,0,5
GGCTTGGCTCTCACCT-1_V12D07-332_C1,0,0,0,0,0,0
ATTGGTAGGATCCGCT-1_V12D07-332_C1,0,2,1,0,0,3
TCAGGGCGACTTCCTT-1_V12D07-332_C1,0,1,0,0,0,1
TCTGCAGATTCGAGTC-1_V12D07-332_C1,0,1,0,0,0,1
CTCTCGCTGTACTATG-1_V12D07-332_C1,1,0,0,0,1,2
AATAGTCGCGAGTCGG-1_V12D07-332_C1,0,1,0,0,0,1
AGTTACCCTTAAGACT-1_V12D07-332_C1,0,5,0,0,0,5
CTTAAATAAGACCCAT-1_V12D07-332_C1,0,2,0,0,0,2
GGTTGTGCTCTTGTCC-1_V12D07-332_C1,0,2,0,0,0,2
GTGAGTCTAAGACGGA-1_V12D07-332_C1,0,2,0,0,0,2
CGCGACACTGCGCAGC-1_V12D07-332_C1,0,1,0,0,0,1
GCTCGCGGTTCCGCTC-1_V12D07-332_C1,1,2,0,0,0,3
TTAACTCACGCGTGGA-1_V12D07-332_C1,1,1,0,0,0,2
GGAACGGCCTGCAGCC-1_V12D07-332_C1,0,5,0,0,0,5
GTAGAAACGGGTGGAG-1_V12D07-332_C1,0,2,1,0,0,3
TAATGAAAGACCCTTG-1_V12D07-332_C1,0,0,0,0,0,0
AGGCTTGCTAGACACC-1_V12D07-332_C1,0,1,0,0,0,1
CACACAGGGATAGATT-1_V12D07-332_C1,2,3,1,0,0,6
AGAGCGTACAAGCTCG-1_V12D07-332_C1,0,4,0,1,0,5
TCTTACGGCATCCGAC-1_V12D07-332_C1,0,2,0,0,0,2
GCCTATTCCGATATAG-1_V12D07-332_C1,1,2,0,0,0,3
GAAAGTGACTAACTGC-1_V12D07-332_C1,2,2,0,0,0,4
CCGGAATGGTTTCAGT-1_V12D07-332_C1,1,0,0,0,0,1
AGTATAATACTAGGCA-1_V12D07-332_C1,1,0,0,0,0,1
TAACTATCGAAGGTCC-1_V12D07-332_C1,1,1,0,0,0,2
ATGAGGAGTGTTAATC-1_V12D07-332_C1,1,0,1,0,1,3
TGTGTCGCGAGTTGCA-1_V12D07-332_C1,1,3,0,1,0,5
ATCCAACGCAGTCATA-1_V12D07-332_C1,1,1,2,0,0,4
AAGGCGCGTAAAGCTT-1_V12D07-332_C1,1,1,0,0,0,2
AGTCGGCCCAAACGAC-1_V12D07-332_C1,1,0,0,0,0,1
AACGTCAGACTAGTGG-1_V12D07-332_C1,1,1,0,0,1,3
ACTACCAGCTCTCTGG-1_V12D07-332_C1,0,0,0,0,0,0
GCAAGTGCACAGAGAA-1_V12D07-332_C1,0,2,1,1,0,4
ACACCTTAAGTAGGGC-1_V12D07-332_C1,0,2,0,0,0,2
TTCGACGGGAAGGGCG-1_V12D07-332_C1,1,2,0,0,0,3
TTCGCACTCGCGTGCT-1_V12D07-332_C1,1,4,2,0,0,7
TATTTGTTACCCTTTA-1_V12D07-332_C1,0,1,0,0,0,1
CGCTGTGACGCCGCAC-1_V12D07-332_C1,2,3,0,0,0,5
GTTGCACGGAGTTTCG-1_V12D07-332_C1,1,1,0,0,0,2
GTTTCCTGGAGGGTGA-1_V12D07-332_C1,0,0,0,0,2,2
ACACCCAGCATGCAGC-1_V12D07-332_C1,0,0,0,0,0,0
TCAACCATGTTCGGGC-1_V12D07-332_C1,1,1,0,1,0,3
TTACAACTACGCATCC-1_V12D07-332_C1,0,2,0,0,0,2
TCCGATGGTGCGACAT-1_V12D07-332_C1,0,4,1,0,0,5
GGGCGTACATTTATAT-1_V12D07-332_C1,0,0,0,0,1,1
AGCGACCAACGATATT-1_V12D07-332_C1,2,3,0,0,0,5
ACACAAAGACGGGTGG-1_V12D07-332_C1,0,3,0,1,0,4
ATCGCACGCCGGGAGA-1_V12D07-332_C1,0,1,0,0,0,1
GCTCTAAACCCTGACG-1_V12D07-332_C1,0,0,0,0,0,0
AATGCAACCGGGTACC-1_V12D07-332_C1,0,1,1,0,0,2
TCAAACAACCGCGTCG-1_V12D07-332_C1,0,2,0,0,3,5
TATGCTCCCTACTTAC-1_V12D07-332_C1,1,3,0,0,0,4
AAAGGGATGTAGCAAG-1_V12D07-332_C1,2,2,0,0,0,4
ACGATCATACATAGAG-1_V12D07-332_C1,1,0,0,0,0,1
TTGTTCAGTGTGCTAC-1_V12D07-332_C1,0,2,0,0,0,2
ATGCATGATCCAGGAT-1_V12D07-332_C1,1,3,0,0,0,4
AGTCTTCTCCTCAAAT-1_V12D07-332_C1,1,3,0,1,0,5
GATTCCCTTGTCGCAG-1_V12D07-332_C1,0,2,0,0,1,3
CTCGCACCTATATAGT-1_V12D07-332_C1,1,0,0,0,1,2
ACTCAATAAAGGCACG-1_V12D07-332_C1,0,0,0,0,0,0
AACCGAGCTTGGTCAT-1_V12D07-332_C1,1,3,1,0,0,5
TAAGGCAACATAAGAT-1_V12D07-332_C1,1,1,0,0,0,2
CACGCACAGCGCAGCT-1_V12D07-332_C1,1,1,1,0,0,3
GGTTTACAATCTCAAT-1_V12D07-332_C1,2,1,0,0,0,3
TGCAGGATCGGCAAAG-1_V12D07-332_C1,0,2,0,1,0,3
ATAACGGAGTCCAACG-1_V12D07-332_C1,0,1,0,1,0,2
AACGATATGTCAACTG-1_V12D07-332_C1,0,1,0,0,0,1
GACAACGACCATTGAA-1_V12D07-332_C1,0,0,0,0,0,0
TTGACCATGTTCTCCG-1_V12D07-332_C1,0,1,0,0,0,1
AGTACGGGCACCTGGC-1_V12D07-332_C1,1,4,0,0,0,5
CGCCATCCGATTATGA-1_V12D07-332_C1,0,1,0,0,1,2
AAGGTATCCTAATATA-1_V12D07-332_C1,0,0,0,0,0,0
TGTTGTCAAGAAGTCT-1_V12D07-332_C1,0,3,1,1,0,5
CAGTGAATAAATGACT-1_V12D07-332_C1,0,0,0,0,0,0
CACCTTGCGAAACTCG-1_V12D07-332_C1,1,1,0,0,0,2
CATTTAGCGGACCATG-1_V12D07-332_C1,1,0,0,0,0,1
CCAGTCTAGACGGCGC-1_V12D07-332_C1,0,0,0,0,0,0
TCGCTTTAAACGTTTG-1_V12D07-332_C1,0,0,0,0,0,0
GTGAAACGGCGCCACC-1_V12D07-332_C1,0,0,0,0,0,0
GGGCTCATCGAACCCA-1_V12D07-332_C1,0,1,0,0,0,1
TTGATGTGTAGTCCCG-1_V12D07-332_C1,0,1,0,0,0,1
CAGTAGCCCACGCGGT-1_V12D07-332_C1,1,1,0,1,1,4
AGCGCGGGTGCCAATG-1_V12D07-332_C1,1,3,0,0,0,4
TAATCGATCCGTACGT-1_V12D07-332_C1,0,0,0,0,0,0
AGTGGCGGCAATTTGA-1_V12D07-332_C1,1,2,0,0,0,3
CCTTTCAATGAAGAAA-1_V12D07-332_C1,3,0,0,0,0,3
CTCAGTCACGACAAAT-1_V12D07-332_C1,1,1,0,1,0,3
ATAGGCTAGCTTCGCA-1_V12D07-332_C1,2,1,0,1,0,4
CGGTTCAAGTAGGTGT-1_V12D07-332_C1,2,1,0,0,0,3
CAGTCGAGGATGCAAT-1_V12D07-332_C1,0,1,0,0,0,1
TATCACCCAACCGACC-1_V12D07-332_C1,3,0,0,0,0,3
AATGATGCGACTCCTG-1_V12D07-332_C1,1,1,0,0,0,2
TGGAACCACTGACACA-1_V12D07-332_C1,0,0,0,1,0,1
GCCAATAGGGCATCTC-1_V12D07-332_C1,0,1,0,0,0,1
TTCTTTGGTCGCGACG-1_V12D07-332_C1,0,0,1,0,0,1
ATTAGATTCCTCAGCA-1_V12D07-332_C1,0,0,0,0,0,0
CCGTGGAACGATCCAA-1_V12D07-332_C1,1,0,0,0,0,1
GGGTCGTGGCAAGTGT-1_V12D07-332_C1,2,2,0,1,0,5
TCGCTCGGCACCAGCG-1_V12D07-332_C1,0,0,0,0,0,0
ACGCAATCACTACAGC-1_V12D07-332_C1,0,0,0,0,0,0
CTCTAATGCATTGATC-1_V12D07-332_C1,0,1,0,0,0,1
GTCTCGACTAAGTTTG-1_V12D07-332_C1,0,1,1,0,0,2
TGGTTTAAACGTGGGT-1_V12D07-332_C1,0,2,0,0,0,2
CGCAGATCTTCACCCG-1_V12D07-332_C1,1,2,0,0,1,4
TCCAGATGTACGCCAA-1_V12D07-332_C1,0,1,0,0,0,1
CATTGCGGGTCAATTC-1_V12D07-332_C1,0,2,0,1,1,4
GACGTTCGTAAATACA-1_V12D07-332_C1,0,1,2,0,1,4
TACACCGTCGTTAGTC-1_V12D07-332_C1,0,2,0,1,1,4
ACGGGCGTATGCGACA-1_V12D07-332_C1,0,1,1,0,0,2
GAAGGCTACCATTGTT-1_V12D07-332_C1,0,1,0,0,2,3
TAAATCTTTACACCTC-1_V12D07-332_C1,0,2,0,0,2,4
AGTTTATGTAAAGACA-1_V12D07-332_C1,1,4,0,1,0,6
AGGAGACATCCACAGT-1_V12D07-332_C1,0,4,0,0,0,4
CAACCTGAACCTGCCA-1_V12D07-332_C1,1,2,1,1,0,5
AGTCCCTCGCAGAAAG-1_V12D07-332_C1,0,5,0,0,0,5
TGTATACGGATGATGA-1_V12D07-332_C1,1,4,0,0,0,5
TTGTGGTATAGGTATG-1_V12D07-332_C1,1,2,0,0,0,3
TCTGCACCATTAGTAA-1_V12D07-332_C1,0,0,0,0,0,0
AAATGTATCTTATCCC-1_V12D07-332_C1,0,1,0,0,4,5
ACTCTAAACCTGGGAT-1_V12D07-332_C1,0,0,1,0,1,2
GCTGGCAGGTGCCGTG-1_V12D07-332_C1,0,3,1,0,0,4
CTCATTCGTGAACATC-1_V12D07-332_C1,0,2,0,0,1,3
TCGCCGGATGGGCAAG-1_V12D07-332_C1,0,2,0,0,1,3
GGACTAAGTCAGGAGT-1_V12D07-332_C1,0,4,0,1,0,5
TATCAAAGGTCTGTAA-1_V12D07-332_C1,0,0,0,0,0,0
TTCAGTTTGTGGCAGC-1_V12D07-332_C1,0,1,0,0,0,1
TGTTCATAAATGTGCT-1_V12D07-332_C1,0,3,0,0,1,4
CTTAGCCCGGATAGTG-1_V12D07-332_C1,0,3,0,0,0,3
GATGCGAATGGTATTA-1_V12D07-332_C1,0,1,0,0,0,1
TCTAACTGTATGTAAA-1_V12D07-332_C1,1,4,1,0,0,6
TTAAACCTGGTTCCTT-1_V12D07-332_C1,1,2,0,0,1,4
GCTAAGTAAAGGCGAT-1_V12D07-332_C1,0,0,0,0,0,0
AGTTACCGCACATGGT-1_V12D07-332_C1,0,1,0,0,0,1
GACTGCGGCACGTGTA-1_V12D07-332_C1,1,3,0,0,1,5
ATTCAGTAGCAGGGTC-1_V12D07-332_C1,2,0,1,0,0,3
CAGTTCCGCGGGTCGA-1_V12D07-332_C1,3,3,0,1,0,7
AAGAGATGAATCGGTA-1_V12D07-332_C1,2,2,0,0,0,4
CGCAATTCTACAATAA-1_V12D07-332_C1,1,1,2,0,0,4
TAACGCTTTGAGAGCG-1_V12D07-332_C1,3,1,1,0,0,5
AGGCTATGGTTAGCTT-1_V12D07-332_C1,3,2,0,0,0,5
GAGGAATGGAGAGGTT-1_V12D07-332_C1,1,2,1,0,0,4
TCCTCTACGAGATGGC-1_V12D07-332_C1,1,0,0,0,0,1
TTGATTATGCAGATGA-1_V12D07-332_C1,2,4,0,0,0,6
TCAGTACTGACCCGCG-1_V12D07-332_C1,3,0,0,0,1,4
TTATGACAAACTGGAT-1_V12D07-332_C1,0,1,0,0,0,1
GTAAGTAGGGTATACC-1_V12D07-332_C1,0,0,1,0,0,1
CGCAAACACGAGTTAC-1_V12D07-332_C1,0,1,2,0,0,3
TGGCCGTATATTGACC-1_V12D07-332_C1,2,2,1,0,0,5
ACTGTAGCACTTTGGA-1_V12D07-332_C1,4,1,0,0,0,5
GCTCTATGTTACGTGC-1_V12D07-332_C1,1,1,0,1,1,4
TGCGCGATTAACGGAG-1_V12D07-332_C1,0,3,1,0,0,4
GAATCGACATGGTCAC-1_V12D07-332_C1,0,1,0,0,0,1
GACTAAGTAGGCTCAC-1_V12D07-332_C1,0,1,0,2,0,3
ATCTTGACCTGCAACG-1_V12D07-332_C1,1,3,0,1,0,5
ATGCACTACCGCATTG-1_V12D07-332_C1,1,1,1,0,0,3
CAGATACTAACATAGT-1_V12D07-332_C1,0,1,0,0,0,1
GATCGACACTATCTGA-1_V12D07-332_C1,0,0,1,0,0,1
ATAGAGTACTGGGACA-1_V12D07-332_C1,0,5,0,0,0,5
CCTACTGCTTACACTT-1_V12D07-332_C1,1,5,0,0,0,6
CCTGCTATTTGAGAAG-1_V12D07-332_C1,0,5,1,0,0,6
CGCGTTCATGAAATAC-1_V12D07-332_C1,0,1,0,0,0,1
CATTATGCTTGTTGTG-1_V12D07-332_C1,1,2,0,1,0,4
CCAGGGACGTGGCCTC-1_V12D07-332_C1,0,1,0,0,0,1
TATGGATGTGCTACGC-1_V12D07-332_C1,0,1,0,1,0,2
GTACTAAGATTTGGAG-1_V12D07-332_C1,0,2,0,1,0,3
AGACCCGCCCTCCTCG-1_V12D07-332_C1,0,1,0,1,0,2
CGCATTAGCTAATAGG-1_V12D07-332_C1,0,0,0,0,2,2
GCTCTCGGGTACCGAA-1_V12D07-332_C1,0,5,0,0,1,6
CACCGCCAGAAGGTTT-1_V12D07-332_C1,1,0,0,0,0,1
TCCCAAAGACGAAGGA-1_V12D07-332_C1,0,1,0,0,0,1
ATGGATTGACCAAACG-1_V12D07-332_C1,1,2,0,0,0,3
GTCATGGACATGACTA-1_V12D07-332_C1,0,2,0,0,0,2
CTACTGCCACCTGACC-1_V12D07-332_C1,0,5,1,0,0,6
TTATATTTGGCAATCC-1_V12D07-332_C1,1,1,0,0,1,3
AGCACCAGTACTCACG-1_V12D07-332_C1,0,0,0,0,0,0
CATGGTCTAGATACCG-1_V12D07-332_C1,0,2,0,0,0,2
TCTACCGTCCACAAGC-1_V12D07-332_C1,0,1,0,0,4,5
CTAGTTGGGCCCGGTA-1_V12D07-332_C1,0,3,0,1,0,4
TCCCGCGTACTCCTGG-1_V12D07-332_C1,0,0,0,0,0,0
CAGAGCATGAGCTTGC-1_V12D07-332_C1,1,0,0,1,0,2
ACACGGGAACTTAGGG-1_V12D07-332_C1,0,0,0,0,0,0
GGCTCTGCTCCAACGC-1_V12D07-332_C1,0,2,0,1,0,3
AGAACGTGGTACATTC-1_V12D07-332_C1,1,1,0,0,0,2
CAATAAACCTTGGCCC-1_V12D07-332_C1,1,2,0,0,0,3
ACTTCGCCATACGCAC-1_V12D07-332_C1,0,0,0,0,2,2
ATCTGGTTAAGACTGT-1_V12D07-332_C1,2,2,0,0,0,4
TCGTAAGACGACATTG-1_V12D07-332_C1,1,3,0,0,0,4
GTGTACCTTGGCTACG-1_V12D07-332_C1,1,1,0,0,0,2
GCCCGTAATACCTTCT-1_V12D07-332_C1,0,0,0,1,0,1
CGGTCAAGTGGGAACC-1_V12D07-332_C1,1,1,0,0,0,2
TTGTAAGGCCAGTTGG-1_V12D07-332_C1,1,3,0,0,0,4
GGAGCACCAAGAACTA-1_V12D07-332_C1,0,1,0,0,0,1
TAATAGTGACGACCAG-1_V12D07-332_C1,0,0,0,1,0,1
CTAAATCCTATTCCGG-1_V12D07-332_C1,1,1,1,0,0,3
CGAGTTCTGTCCCACC-1_V12D07-332_C1,0,1,0,0,0,1
AGGCAGATGCGTAAAC-1_V12D07-332_C1,0,2,0,0,0,2
AAGGATGAGGGACCTC-1_V12D07-332_C1,1,0,0,0,0,1
AGAGAACCGTCTAGGA-1_V12D07-332_C1,0,0,0,0,0,0
GAGGGCGCAGCTCTGC-1_V12D07-332_C1,1,2,0,0,0,3
AAGATTGGCGGAACGT-1_V12D07-332_C1,1,3,0,0,0,4
CCAGTAGTCTGATCCA-1_V12D07-332_C1,0,0,0,0,0,0
AAGGGACAGATTCTGT-1_V12D07-332_C1,2,0,0,0,0,2
ATAGAGTTATCAACTT-1_V12D07-332_C1,1,0,0,0,0,1
AAATTACCTATCGATG-1_V12D07-332_C1,0,1,0,0,0,1
GATCCTAAATCGGGAC-1_V12D07-332_C1,1,1,0,0,0,2
TTACAGACCTAAATGA-1_V12D07-332_C1,0,0,0,0,0,0
CCTCACCTTAGCATCG-1_V12D07-332_C1,1,3,0,0,0,4
CATGCGACCAGTTTAA-1_V12D07-332_C1,0,1,1,1,0,3
AACATATCAACTGGTG-1_V12D07-332_C1,0,0,0,1,0,1
CTATAAGAGCCAATCG-1_V12D07-332_C1,1,0,0,0,0,1
AATATCGAGGGTTCTC-1_V12D07-332_C1,5,0,0,0,0,5
GTACTCCTGGGTATGC-1_V12D07-332_C1,0,1,0,0,0,1
ATAAGTAGGATTCAGA-1_V12D07-332_C1,1,1,0,0,0,2
AGGTCGCGGAGTTACT-1_V12D07-332_C1,0,0,0,0,0,0
CTAATTCTCAGATATT-1_V12D07-332_C1,1,1,0,2,0,4
GCCAACCATTTCCGGA-1_V12D07-332_C1,1,0,0,0,0,1
TGATCCCAGCATTAGT-1_V12D07-332_C1,1,1,0,0,0,2
CGTTGTAAGATTGATT-1_V12D07-332_C1,0,0,0,0,0,0
GAAACCATGGTGCGCT-1_V12D07-332_C1,0,0,0,1,0,1
AATCTATGCCGGAGCC-1_V12D07-332_C1,0,0,0,0,0,0
GACTCCCAGAATAAGG-1_V12D07-332_C1,0,2,0,0,0,2
TATGATCCGGCACGCC-1_V12D07-332_C1,0,2,0,0,0,2
CCGCTTGCTGACATGG-1_V12D07-332_C1,0,1,0,0,0,1
TGGTTAAGGGCGCTGG-1_V12D07-332_C1,0,2,1,0,0,3
TTGATAGTCAATACAT-1_V12D07-332_C1,0,0,0,0,0,0
GGTTTAATTGAGCAGG-1_V12D07-332_C1,0,6,0,0,0,6
CATTACATAGATTGTG-1_V12D07-332_C1,0,1,0,0,1,2
GGTACACCAGATTTAT-1_V12D07-332_C1,0,1,0,0,1,2
GGCCCGTATACCATGC-1_V12D07-332_C1,0,1,0,0,0,1
ATCTTTCGTATAACCA-1_V12D07-332_C1,0,2,1,0,1,4
GAGATGACAATCCTTA-1_V12D07-332_C1,1,2,0,0,0,3
AAAGCTTGCCTACATA-1_V12D07-332_C1,2,5,0,0,0,7
GAACGATAAGTTAAAG-1_V12D07-332_C1,0,1,1,0,0,2
TAATAGCTAAATGATG-1_V12D07-332_C1,2,1,0,0,0,3
TATGGCTAGGCTAATT-1_V12D07-332_C1,3,1,0,0,0,4
AGGAGAGTCTGGCTAC-1_V12D07-332_C1,1,0,0,0,0,1
TGCTCTGCCGGTTCAC-1_V12D07-332_C1,0,0,0,0,0,0
CCAATAGATTTCATCT-1_V12D07-332_C1,0,0,0,0,1,1
GGGCACGAATTGGCCG-1_V12D07-332_C1,0,2,0,0,0,2
TCGTTGACAGGGTCCC-1_V12D07-332_C1,1,2,1,0,0,4
ATCGTATTCCGAGAAC-1_V12D07-332_C1,1,5,0,0,0,6
GGGAATTCTGTCCAGT-1_V12D07-332_C1,0,2,0,0,0,2
ACGCGTTTCTTAAGAG-1_V12D07-332_C1,0,2,0,0,0,2
GAGAGCGCAGTCCCTG-1_V12D07-332_C1,0,2,2,1,0,5
GTCCTATTGTTGTGGT-1_V12D07-332_C1,1,1,0,0,0,2
CATCTGCAGGATCATT-1_V12D07-332_C1,0,4,0,0,1,5
GAGTCGACAGACCCTC-1_V12D07-332_C1,1,2,2,0,0,5
AAGTGCAAAGGTAGAC-1_V12D07-332_C1,0,2,0,0,0,2
AGGGTGGATAGTGCAT-1_V12D07-332_C1,0,0,1,0,0,1
TGATAGCGGGATTCTA-1_V12D07-332_C1,1,2,0,0,0,3
GTCAGTTTGGTAGTCG-1_V12D07-332_C1,0,6,1,0,0,7
GCATTCGAAATGAACA-1_V12D07-332_C1,2,4,0,0,0,6
AAAGACTGGGCGCTTT-1_V12D07-332_C1,1,2,0,0,0,3
CCAGCTTCCGCCCGCA-1_V12D07-332_C1,0,5,0,0,0,5
AGAGCAGTTATGAGAC-1_V12D07-332_C1,0,3,0,0,0,3
TATGAAGACAGGTGCG-1_V12D07-332_C1,0,3,1,0,0,4
TAGGTCCAAGTAAGGA-1_V12D07-332_C1,1,2,0,0,0,3
GAAACTCGTGCGATGC-1_V12D07-332_C1,2,1,0,0,0,3
AACAATTACTCTACGC-1_V12D07-332_C1,1,1,0,0,0,2
CCGCACGTGACCTCGG-1_V12D07-332_C1,2,1,0,0,0,3
AACTTGCCCGTATGCA-1_V12D07-332_C1,5,1,0,0,2,8
GGGTATGTATGCACTT-1_V12D07-332_C1,0,2,0,0,0,2
TTCGTACTCCAGAACG-1_V12D07-332_C1,1,1,0,0,0,2
GAATTTCTCGCTGCAG-1_V12D07-332_C1,3,2,0,1,0,6
AACAGGATGGGCCGCG-1_V12D07-332_C1,0,0,1,0,0,1
GACGTGTAGGGATTAT-1_V12D07-332_C1,0,1,2,1,0,4
TAGGTGAGCCCTACTC-1_V12D07-332_C1,0,0,1,0,0,1
CTAATTCGCACGCGCT-1_V12D07-332_C1,0,1,0,1,0,2
GAAGCTTGCTGACCGC-1_V12D07-332_C1,0,0,1,0,0,1
GGTTAGGCTTGGAGAA-1_V12D07-332_C1,0,4,3,0,0,7
ACAAGGACAAGAGGTT-1_V12D07-332_C1,0,2,0,0,0,2
AGGCCACCCGTTATGA-1_V12D07-332_C1,1,0,0,1,0,2
GTGGGCTTAGACACAC-1_V12D07-332_C1,0,2,0,0,1,3
CGTGTCCCATTCGCGA-1_V12D07-332_C1,1,1,0,0,0,2
TGGAGTGATGCGATGA-1_V12D07-332_C1,2,0,0,0,1,3
AACAACTGGTAGTTGC-1_V12D07-332_C1,0,2,3,1,0,6
CCTGGCTAGACCCGCC-1_V12D07-332_C1,0,1,0,0,0,1
CGCAATTAGGGTAATA-1_V12D07-332_C1,2,6,0,0,0,8
TCGAAATTTAGGACCA-1_V12D07-332_C1,0,3,0,0,0,3
AGACTAGCCTTCCAGA-1_V12D07-332_C1,0,0,1,0,0,1
TTGATCTAACTTTGTC-1_V12D07-332_C1,3,4,0,0,0,7
AAGGAGCGGTTGGTGC-1_V12D07-332_C1,0,0,0,0,0,0
ACTTGGGACCCGGTGG-1_V12D07-332_C1,0,4,0,1,0,5
TGATCTCCGGCGCCAG-1_V12D07-332_C1,2,1,0,0,0,3
CAGTTCAAATTGACAC-1_V12D07-332_C1,2,5,0,0,0,7
GTCCGGCTGAATTGCG-1_V12D07-332_C1,0,3,0,0,0,3
CTGGAAATGGATGCTT-1_V12D07-332_C1,1,6,0,1,0,8
TGATCGGTTTGACCCT-1_V12D07-332_C1,0,2,0,0,2,4
TAGAGTCTAAGCGAAC-1_V12D07-332_C1,1,1,0,0,0,2
GAGACTGATGGGTAGA-1_V12D07-332_C1,0,1,0,0,0,1
TAGCTAAGTCCGGGAG-1_V12D07-332_C1,0,2,0,0,0,2
GGGCGATATGTGTGAA-1_V12D07-332_C1,0,2,0,0,0,2
CTCGAGGTCGAACAGT-1_V12D07-332_C1,1,1,0,0,1,3
GATCCCTTTATACTGC-1_V12D07-332_C1,2,0,0,0,0,2
GTCATGCACCTCCGTT-1_V12D07-332_C1,0,0,0,0,0,0
ACTTTCCTATAGCTTC-1_V12D07-332_C1,0,2,0,1,0,3
TCGCTCGATATATTCC-1_V12D07-332_C1,1,0,0,0,0,1
ATAGGTTGGGCAGATG-1_V12D07-332_C1,0,1,0,0,0,1
CAATTAAGGGTGATGA-1_V12D07-332_C1,0,2,1,0,0,3
ACCGACTGAGTCCCAC-1_V12D07-332_C1,0,1,0,0,0,1
CCTGTCACCCGGGCTC-1_V12D07-332_C1,0,0,0,0,0,0
GATCGGTGGCCATAAC-1_V12D07-332_C1,0,1,1,0,0,2
CCTATGGGTTACCGTC-1_V12D07-332_C1,2,1,0,0,0,3
TTGGGACACTGCCCGC-1_V12D07-332_C1,2,2,0,0,0,4
CGAGGCTAAATATGGC-1_V12D07-332_C1,1,1,0,0,0,2
TCAGGGTGTAACGTAA-1_V12D07-332_C1,1,1,0,0,0,2
CGAGAGATGTGAACCT-1_V12D07-332_C1,2,2,1,0,0,5
TCGCTGGGCGGATTGT-1_V12D07-332_C1,1,0,0,0,0,1
AGATCTCAGGTGTGAT-1_V12D07-332_C1,0,1,0,1,0,2
TGGCCAAACTGAAGTA-1_V12D07-332_C1,0,2,0,0,0,2
GCTTCCGTCCCTAGAC-1_V12D07-332_C1,0,1,0,1,0,2
CAGCAGCCCGTTCCTT-1_V12D07-332_C1,0,3,0,0,0,3
TGTATAACAGATCCTG-1_V12D07-332_C1,2,0,0,1,0,3
CGCGGGAATTAGGCAG-1_V12D07-332_C1,0,1,0,1,0,2
TGCATGTGGTAATCTA-1_V12D07-332_C1,0,2,0,2,0,4
ACAATTTGAGCAGTGG-1_V12D07-332_C1,0,2,0,0,0,2
GAGCTAAGGGCATATC-1_V12D07-332_C1,0,3,0,0,1,4
CCAGATAGTTGAGTGA-1_V12D07-332_C1,0,1,0,0,0,1
CCACAATGTACGTCTT-1_V12D07-332_C1,2,0,0,0,0,2
CAATGGATCTCTACCA-1_V12D07-332_C1,3,0,0,1,0,4
TGTGGCAAAGCGTATG-1_V12D07-332_C1,0,0,0,0,0,0
TAAAGCGTTAGGAGAA-1_V12D07-332_C1,0,2,0,1,0,3
TCCGTTTAGCCTTGAA-1_V12D07-332_C1,2,0,0,0,0,2
CAGCTCGACAAGTTAA-1_V12D07-332_C1,1,0,0,0,0,1
GCCTATAGTGTCAGGG-1_V12D07-332_C1,0,4,0,1,0,5
ATAGACAACGGGACCT-1_V12D07-332_C1,1,1,0,0,0,2
CTACTATCTTTCAGAG-1_V12D07-332_C1,1,1,0,0,0,2
GCGCTGCTTTGCATTT-1_V12D07-332_C1,3,0,0,0,0,3
GCGCATCCAGTCAGCA-1_V12D07-332_C1,1,0,0,0,0,1
GACTCGCGGGAATGAC-1_V12D07-332_C1,0,1,0,0,0,1
CTGGTAACGAGCTCTT-1_V12D07-332_C1,2,1,0,1,0,4
TCCGGCCTAGCGTACA-1_V12D07-332_C1,0,0,0,0,0,0
TCTAGGTGGCGACGCT-1_V12D07-332_C1,0,0,0,0,0,0
ACGCTAGTGATACACT-1_V12D07-332_C1,1,1,0,1,0,3
ATCTGCACCTCTGCGA-1_V12D07-332_C1,1,0,0,0,0,1
CCTCACCTGAGGGAGC-1_V12D07-332_C1,1,0,0,0,1,2
AGTGAGCCTCGCCGCC-1_V12D07-332_C1,1,1,0,0,0,2
ACGAGTACGGATGCCC-1_V12D07-332_C1,0,0,0,0,0,0
GGTACCATTAAGACGG-1_V12D07-332_C1,0,0,0,1,0,1
TTCTGCTAGACTCCAA-1_V12D07-332_C1,1,1,0,0,0,2
TAACTATTACGCCAAA-1_V12D07-332_C1,1,0,0,0,0,1
GCATTCAAGGCAACGC-1_V12D07-332_C1,1,1,0,0,0,2
AGTACATCATTTATCA-1_V12D07-332_C1,0,2,1,1,0,4
GTCGTGTCTGGTCATC-1_V12D07-332_C1,1,0,0,1,0,2
AGTCTAAAGTATACTC-1_V12D07-332_C1,0,2,0,0,2,4
CGGCCCAACCTGTAGT-1_V12D07-332_C1,0,0,0,0,3,3
AGGGAGACATACTTCG-1_V12D07-332_C1,0,1,0,0,0,1
TCCCTAGATCAATAGG-1_V12D07-332_C1,1,1,0,0,1,3
TCCCGTCGCGTCATAG-1_V12D07-332_C1,0,2,0,0,0,2
CGCATCCATCAGCCAG-1_V12D07-332_C1,0,2,0,0,0,2
CTGCACCTAGTCCACA-1_V12D07-332_C1,0,2,0,0,1,3
CGAGGATCGGGAACGA-1_V12D07-332_C1,1,0,0,0,0,1
CAATGAGGTTCGACTA-1_V12D07-332_C1,0,2,0,0,0,2
TCTGACGGGCTAACCC-1_V12D07-332_C1,0,1,0,0,1,2
TTCTATGCCTTTCGCA-1_V12D07-332_C1,0,3,1,0,0,4
AGAGTATAGTGTTACG-1_V12D07-332_C1,0,4,0,0,0,4
CCATTGTTTCCTCCAT-1_V12D07-332_C1,2,1,0,0,0,3
CTCATCACTTAGTGAT-1_V12D07-332_C1,2,3,0,0,0,5
CCGAAGGGCGTACCGC-1_V12D07-332_C1,0,2,1,0,0,3
TCAAGCTGCCTTGAAA-1_V12D07-332_C1,0,0,0,0,0,0
CTCATTAACGTTGCCC-1_V12D07-332_C1,0,0,1,0,0,1
GTCTTCCTCACCTAAG-1_V12D07-332_C1,0,0,0,0,0,0
GGTGATGAAGGAAGTG-1_V12D07-332_C1,1,1,0,0,0,2
TCAATACAATTGCTGC-1_V12D07-332_C1,2,5,1,0,0,8
GCAACCCAAGTTGTTT-1_V12D07-332_C1,1,4,0,0,0,5
ATGAAGTGGACCCAGC-1_V12D07-332_C1,1,3,0,0,0,4
GAGAATCTCACGATCA-1_V12D07-332_C1,0,0,1,0,0,1
TATATCATTGATCAGT-1_V12D07-332_C1,0,3,0,0,0,3
AACTTTACGGGAGCTT-1_V12D07-332_C1,0,1,0,0,0,1
TTCTTGTGTCCATCAG-1_V12D07-332_C1,0,2,0,0,0,2
ACAATTTAGGAGGCTC-1_V12D07-332_C1,0,3,1,0,0,4
ATACTTGTTCTCGAGC-1_V12D07-332_C1,1,0,1,0,0,2
CACGGGATTGAGGGTT-1_V12D07-332_C1,0,4,0,0,0,4
GTTAATGTCTATCTTA-1_V12D07-332_C1,1,2,0,0,0,3
GCGTTATATTTGGAAC-1_V12D07-332_C1,4,8,0,0,0,12
CGTCAAGGCTATAAAT-1_V12D07-332_C1,0,2,0,0,0,2
TTAGCTCTGTAATCCG-1_V12D07-332_C1,1,4,0,0,0,5
AATGGTCCACCGTTCA-1_V12D07-332_C1,0,2,1,0,0,3
GTCATTGCATTGACCC-1_V12D07-332_C1,1,1,2,0,0,4
TGTCCGTGGCGCCTTT-1_V12D07-332_C1,0,3,1,0,0,4
TCAACTAACGTATAAC-1_V12D07-332_C1,1,5,1,0,0,7
TCCTCTCCAGTTGTCC-1_V12D07-332_C1,1,2,0,0,0,3
TGTGTTCGTATCCAAG-1_V12D07-332_C1,1,4,2,0,0,7
CCGCGTAGGTAAGGGC-1_V12D07-332_C1,0,2,0,0,0,2
CTGCGGGTGAAATGTT-1_V12D07-332_C1,0,2,2,0,0,4
TATCTACAGAGGTAAT-1_V12D07-332_C1,3,3,1,0,0,7
CTACTCTAGGCCCGGC-1_V12D07-332_C1,2,0,1,0,0,3
ACAAGCAGTGCCTAGC-1_V12D07-332_C1,3,1,1,0,0,5
TACAAGTCTCGTGCAT-1_V12D07-332_C1,0,2,2,0,0,4
TCGGAATGCGCTCTGA-1_V12D07-332_C1,1,3,0,0,0,4
TCGCGTCCAGAAGGTC-1_V12D07-332_C1,0,0,0,0,0,0
TATGGCCCGGCCTCGC-1_V12D07-332_C1,1,0,0,0,0,1
GCTGGCATATTCACCT-1_V12D07-332_C1,2,1,2,0,0,5
GTCAGAATAGTCTATG-1_V12D07-332_C1,0,0,0,0,0,0
GGCGTCCTATCCGCTG-1_V12D07-332_C1,2,1,0,0,0,3
CGGAGTTTGAGAGACA-1_V12D07-332_C1,2,4,0,0,0,6
AGCACTTAAGGACGCC-1_V12D07-332_C1,0,2,0,0,1,3
TCCACAATGGTTTACG-1_V12D07-332_C1,1,2,1,0,0,4
CCAACGATGCACTGAT-1_V12D07-332_C1,0,2,0,0,1,3
ATTTACAGTTTACTGG-1_V12D07-332_C1,0,0,0,0,0,0
CCCTGAAATGAGTTGA-1_V12D07-332_C1,0,3,0,0,0,3
CAAACGGTCGCACTTT-1_V12D07-332_C1,0,1,0,0,1,2
TGATTCGTCTATCACT-1_V12D07-332_C1,2,2,1,0,0,5
TCAGGTTCTTTGAGAA-1_V12D07-332_C1,1,2,1,0,0,4
CACGCAGCGAGGCTTT-1_V12D07-332_C1,0,2,0,0,0,2
TTAAGCGCCTGACCCA-1_V12D07-332_C1,0,1,1,0,0,2
CTTACACGGTATTCCA-1_V12D07-332_C1,1,1,0,0,0,2
AAGGCTGTGCTCATCG-1_V12D07-332_C1,1,0,0,0,0,1
GACCAGAGCCCTGTAG-1_V12D07-332_C1,0,1,1,0,0,2
TCCCAGGCTTAGCTAA-1_V12D07-332_C1,2,3,0,0,1,6
ATTGAAGATCTTAGTG-1_V12D07-332_C1,0,2,0,0,0,2
AGTTCCTACAGAATTA-1_V12D07-332_C1,2,7,0,0,1,10
GGGCTGGTTAGTCGCG-1_V12D07-332_C1,1,2,0,0,0,3
GAAATGGCGGTGTTAG-1_V12D07-332_C1,0,2,1,0,0,3
TACGAACACGACTTCA-1_V12D07-332_C1,0,1,0,0,1,2
ACCACAAGTTTCTATC-1_V12D07-332_C1,0,3,0,1,0,4
ATATTTAACCCTCAAG-1_V12D07-332_C1,0,2,0,0,0,2
GATCATTCCAAACATT-1_V12D07-332_C1,0,2,0,0,0,2
TCCAGGCGAGTACGGT-1_V12D07-332_C1,4,0,0,1,1,6
GTTTGACCAAATCCTA-1_V12D07-332_C1,0,1,0,0,0,1
CACAGCACCCACGGCA-1_V12D07-332_C1,0,1,0,1,0,2
TGCAAGAATGACGTAA-1_V12D07-332_C1,1,4,1,1,0,7
GCGAAGCCATACCCGT-1_V12D07-332_C1,0,3,0,0,1,4
TCCTTTCTTACGCTTA-1_V12D07-332_C1,0,1,0,1,1,3
GCTGCTCTCCGGACAC-1_V12D07-332_C1,0,3,0,1,0,4
ACTGTCTTCTTTAGAA-1_V12D07-332_C1,0,3,1,0,0,4
TCAAACTTAGATTGTT-1_V12D07-332_C1,1,0,0,0,4,5
CTATGTCACTAGCCCA-1_V12D07-332_C1,1,2,0,0,0,3
TGCGCAAAGCATTTGG-1_V12D07-332_C1,0,1,0,0,0,1
TTAATGTAGACCAGGT-1_V12D07-332_C1,1,1,0,0,0,2
GGCGGTAGGATCATTG-1_V12D07-332_C1,1,0,0,0,0,1
GGCAATAGTCAATGAG-1_V12D07-332_C1,0,3,0,1,0,4
ACACGAGACTCCTTCT-1_V12D07-332_C1,2,1,0,0,0,3
GACACAAGGGAAGAAA-1_V12D07-332_C1,3,5,0,0,1,9
TCAGCAAATGCATCTC-1_V12D07-332_C1,0,0,0,0,1,1
GAGATCTGTCACTCCG-1_V12D07-332_C1,1,2,0,0,0,3
ATGCCGGTCTTGCATA-1_V12D07-332_C1,0,3,1,0,1,5
TTGGGCGGCGGTTGCC-1_V12D07-332_C1,1,1,0,0,2,4
TTGTTGTGTGTCAAGA-1_V12D07-332_C1,0,3,0,2,1,6
ACTGTACGATACACAT-1_V12D07-332_C1,0,4,0,0,0,4
TCCACTTTATCTAGGT-1_V12D07-332_C1,1,2,0,1,0,4
GGTCTGAGAATCTGGA-1_V12D07-332_C1,1,2,0,2,0,5
TAGAAAGGTGGCGCTA-1_V12D07-332_C1,0,0,0,0,0,0
TATGTCTCATTGTGCC-1_V12D07-332_C1,0,2,1,0,0,3
GGATTTCACTTCTATA-1_V12D07-332_C1,2,2,1,0,0,5
TGAGTGGTCCGTGACG-1_V12D07-332_C1,2,3,0,0,0,5
CGCTTTCTTGCATTCG-1_V12D07-332_C1,2,1,0,0,1,4
ACCCAACGCCCGTGGC-1_V12D07-332_C1,2,2,0,2,0,6
GAACGTCTCATGGTCG-1_V12D07-332_C1,1,2,0,0,0,3
AGGGTTCCCTTTGGTT-1_V12D07-332_C1,2,0,0,0,0,2
GTAGCTTCCTCTTGTT-1_V12D07-332_C1,0,1,0,0,0,1
GCATGAGGGACGCGGC-1_V12D07-332_C1,1,0,0,1,0,2
CTACCCTAAGGTCATA-1_V12D07-332_C1,1,1,0,0,0,2
TCACCGCTCGGCACTC-1_V12D07-332_C1,0,0,0,0,0,0
GGCTCGCGTTGAGGTA-1_V12D07-332_C1,0,0,0,0,0,0
CTAACGAAACTTGCTG-1_V12D07-332_C1,2,0,0,0,0,2
TTAAACTCGAATTCAT-1_V12D07-332_C1,1,0,0,0,0,1
TACTTTACTGAGCCGG-1_V12D07-332_C1,0,0,0,0,0,0
GCTTGGATCGATTAGG-1_V12D07-332_C1,2,0,0,0,0,2
CGGTTATCCAACAGTG-1_V12D07-332_C1,0,1,0,0,0,1
CAGACCTGTAAGTGTT-1_V12D07-332_C1,1,2,0,0,0,3
GACGGTCAATAGAAGC-1_V12D07-332_C1,1,0,0,0,0,1
CTGACTGCGCAGCTCG-1_V12D07-332_C1,0,0,0,0,0,0
CCATACCTTTACTTGT-1_V12D07-332_C1,1,1,1,1,0,4
GTAATAAAGGGCTCCC-1_V12D07-332_C1,2,0,0,0,0,2
GTGAACTCCCATTCGA-1_V12D07-332_C1,1,1,0,0,0,2
GTGGTTACTTCTTTCG-1_V12D07-332_C1,4,1,0,0,0,5
TCAGAACCTCCACAGG-1_V12D07-332_C1,1,1,0,1,0,3
TCCCACTCTCTTCCGG-1_V12D07-332_C1,0,0,0,0,0,0
ATCTTGACTTGTCCAA-1_V12D07-332_C1,0,0,0,0,0,0
TCGGGAACGTGCCTAG-1_V12D07-332_C1,0,2,0,1,1,4
GTTAGCCGTAAATCAA-1_V12D07-332_C1,0,0,0,0,0,0
ATTTACTAAGTCCATT-1_V12D07-332_C1,0,2,0,0,2,4
GGGTGCATATGAAAGC-1_V12D07-332_C1,0,1,0,0,1,2
TCCGAATGGTCCTGAG-1_V12D07-332_C1,0,0,0,0,2,2
TGATGGCTGTTTCTGA-1_V12D07-332_C1,0,2,0,0,0,2
AAATAAGGTAGTGCCC-1_V12D07-332_C1,0,0,0,0,1,1
CCACTATCCGGGTCAC-1_V12D07-332_C1,0,7,0,0,0,7
ACACCACATAATTAGC-1_V12D07-332_C1,0,1,0,0,1,2
CGCGGTAAGTCTAGCT-1_V12D07-332_C1,1,2,0,0,1,4
GCGGGCATTACGATGC-1_V12D07-332_C1,0,4,0,1,0,5
AGGATTGCTTACGACA-1_V12D07-332_C1,0,0,0,0,0,0
CTCGGGATAACACCTA-1_V12D07-332_C1,0,3,0,0,1,4
GTCGTCTGGTTGGCTA-1_V12D07-332_C1,0,4,0,0,1,5
GCAATTAGTCGCACCG-1_V12D07-332_C1,1,2,0,0,0,3
GTGACCTAAAGAATAA-1_V12D07-332_C1,0,3,0,1,0,4
CTGAGCGAGACTTATT-1_V12D07-332_C1,0,3,1,0,0,4
CAAGACTCAGAAGCGC-1_V12D07-332_C1,0,1,0,0,0,1
ACTTCGCTAGCGAGTG-1_V12D07-332_C1,5,3,0,0,0,8
CCATACTCGCCTCTCC-1_V12D07-332_C1,0,0,0,0,0,0
ACGATACCTATCCTGA-1_V12D07-332_C1,0,2,0,0,0,2
CTCACCAGTACAAGTG-1_V12D07-332_C1,0,1,0,0,0,1
CGAAGACGGTGAGTGC-1_V12D07-332_C1,0,1,0,0,0,1
AAATTAATAAGCGCGA-1_V12D07-332_C1,1,9,1,0,0,11
GGGCCCTTATCTATAC-1_V12D07-332_C1,2,4,4,0,0,10
CTGCCCACGAAGCGTT-1_V12D07-332_C1,0,2,0,0,0,2
GGACAAGTTGCAGTGA-1_V12D07-332_C1,0,1,0,0,0,1
GTCCGAGAGCAATCAT-1_V12D07-332_C1,1,3,1,0,0,5
ATGGCAGCCGAGAAAC-1_V12D07-332_C1,0,1,0,0,2,3
CCTCGGATGCTACCTG-1_V12D07-332_C1,0,2,2,0,0,4
ATACGGTGAAGATGCA-1_V12D07-332_C1,0,1,0,0,0,1
ACATCAGCTGGGACGC-1_V12D07-332_C1,0,2,0,0,0,2
GGTTGTGTAGCCTGGC-1_V12D07-332_C1,0,3,1,0,0,4
CCTGCGTTCTACGCTT-1_V12D07-332_C1,0,0,0,0,0,0
GAACGTTAGGAAGACG-1_V12D07-332_C1,0,3,1,0,0,4
CTGATAGTGTATCTCA-1_V12D07-332_C1,0,1,0,0,0,1
TTCTGCGAGCGCCCTT-1_V12D07-332_C1,0,2,2,0,0,4
CTTTGGCGCTTTATAC-1_V12D07-332_C1,1,2,2,0,0,5
TCCGAACTTGGCTTAC-1_V12D07-332_C1,0,3,1,0,0,4
TAGATTCCTGGTTATT-1_V12D07-332_C1,0,3,1,0,0,4
CCGACAAAGGGAGTGC-1_V12D07-332_C1,0,3,0,0,0,3
CCATGGCCCTTGTACC-1_V12D07-332_C1,0,0,1,0,0,1
GAAATATCACCATCAG-1_V12D07-332_C1,0,1,0,0,0,1
ACGAAATGGGCGGCAC-1_V12D07-332_C1,2,2,0,0,0,4
GTGAGCGTGCTGCACT-1_V12D07-332_C1,0,0,0,0,0,0
CCGCGGGTACGAAGAA-1_V12D07-332_C1,0,4,1,0,0,5
TCCCTGGCTCGCTGGA-1_V12D07-332_C1,2,3,1,0,0,6
CAGCTTAGTAGGTAGC-1_V12D07-332_C1,0,0,0,0,0,0
CACGAAAGTTAGTCCC-1_V12D07-332_C1,0,5,0,0,0,5
ACCTAATCGACTTCCT-1_V12D07-332_C1,2,3,0,0,0,5
AAGTAGTGACGCGAGG-1_V12D07-332_C1,0,0,2,0,0,2
TCCGATTACATTGCCG-1_V12D07-332_C1,1,2,1,0,0,4
CCTCCGACAATTCAAG-1_V12D07-332_C1,1,3,2,0,0,6
GTTCACAGGAGTCTAG-1_V12D07-332_C1,2,1,0,1,0,4
CGAAGTTGCTCTGTGT-1_V12D07-332_C1,2,4,0,1,2,9
GTCGGATATCTCAGAC-1_V12D07-332_C1,1,2,1,0,0,4
CGCTCTCCGTAGATTA-1_V12D07-332_C1,4,2,1,0,0,7
CAAGCAACGTCGGAGT-1_V12D07-332_C1,1,1,0,0,0,2
CCATTCCCTGCCCACA-1_V12D07-332_C1,5,0,1,0,0,6
CTTTGGCTTTAGTAAA-1_V12D07-332_C1,2,1,0,0,0,3
GGCTATTAAGTTGTAT-1_V12D07-332_C1,0,1,1,0,0,2
CCATTAGCGATAATCC-1_V12D07-332_C1,1,1,1,0,0,3
TGTTCTTCCATTGACT-1_V12D07-332_C1,2,4,0,0,0,6
AGATAACTTCAGGGCC-1_V12D07-332_C1,1,0,0,0,0,1
ATAGACGAAGAGAAAG-1_V12D07-332_C1,0,4,0,0,1,5
GGCGGAGTAATATTAG-1_V12D07-332_C1,0,4,1,0,0,5
TGACCCACGTTAGACA-1_V12D07-332_C1,0,2,1,0,0,3
TCACAGGTTATTGGGC-1_V12D07-332_C1,0,3,0,0,1,4
TCACGCATTGTAGATC-1_V12D07-332_C1,0,0,2,0,1,3
TTGAAGAATTCCCAGG-1_V12D07-332_C1,0,3,1,0,0,4
AAATGGTCAATGTGCC-1_V12D07-332_C1,0,3,0,0,0,3
TAGTGCCCTCCAGAGT-1_V12D07-332_C1,0,4,0,0,0,4
GGTATTGCCGAGTTTA-1_V12D07-332_C1,16,0,0,0,5,21
CGTATTAAGAGATCTA-1_V12D07-332_C1,0,3,0,0,0,3
ACTGTCCAGGATTATA-1_V12D07-332_C1,1,0,0,0,0,1
CGGGCAGCTAAACCGC-1_V12D07-332_C1,0,0,0,0,0,0
TTGCTGATCATGTTCG-1_V12D07-332_C1,0,3,0,0,0,3
TATGGGTACGTATCGT-1_V12D07-332_C1,0,3,0,0,1,4
CAGCTCACTGAGACAT-1_V12D07-332_C1,0,0,2,0,0,2
GGGACTGCATAGATAG-1_V12D07-332_C1,0,1,1,0,0,2
ACGCATTCGTGAGTAC-1_V12D07-332_C1,3,1,1,0,1,6
CTCTGGACGCCTGGTG-1_V12D07-332_C1,1,2,0,0,0,3
AGGGTTTAGTTCGGGA-1_V12D07-332_C1,0,1,1,0,1,3
GGGAGAACTCACAGTA-1_V12D07-332_C1,0,3,1,0,3,7
ATCAATCTGGGCTGCA-1_V12D07-332_C1,1,1,1,1,0,4
TCTTCGATACCAATAA-1_V12D07-332_C1,0,0,1,0,0,1
ACGTAGATTGCTGATG-1_V12D07-332_C1,0,2,1,0,0,3
TCTTGATGCGTAGCGA-1_V12D07-332_C1,0,5,0,0,1,6
GGGCTGCCTAGGGCGA-1_V12D07-332_C1,0,2,0,0,0,2
CTCTCACAATCGATGA-1_V12D07-332_C1,0,5,0,1,0,6
CCAAGCGTAACTCGTA-1_V12D07-332_C1,0,0,0,0,1,1
ACAACAGCATGAGCTA-1_V12D07-332_C1,1,6,0,1,0,8
GTCCCAACGTAAAGTA-1_V12D07-332_C1,0,3,0,0,0,3
TCGGAGTACATGAGTA-1_V12D07-332_C1,0,1,0,0,0,1
GGGAGTTAATGAGGCG-1_V12D07-332_C1,0,1,0,0,3,4
CCGGGCGGTCTCGTCA-1_V12D07-332_C1,1,1,0,1,0,3
CCGTAAGTTGGTCCCA-1_V12D07-332_C1,1,2,0,2,1,6
GGAGGGCTTGGTTGGC-1_V12D07-332_C1,0,1,0,0,0,1
TCGGACGCCCAGCCCA-1_V12D07-332_C1,0,1,0,0,0,1
TCTGTGCCATCATAGT-1_V12D07-332_C1,2,2,0,0,0,4
GTACTGGAGTTAGACC-1_V12D07-332_C1,0,2,0,0,0,2
GGAATGCGCTAGCGTG-1_V12D07-332_C1,1,2,0,1,0,4
GTGTGAATAACTTAGG-1_V12D07-332_C1,2,2,0,1,0,5
GGTCGGCCAGGAGCTT-1_V12D07-332_C1,1,0,0,0,0,1
TAGCCGGCGGTCAGCG-1_V12D07-332_C1,2,0,1,1,0,4
CGGGTGTACCCATTTA-1_V12D07-332_C1,1,0,0,0,0,1
AGTGATTCAAGCAGGA-1_V12D07-332_C1,2,1,0,1,0,4
GTTGGATTGAGAACAC-1_V12D07-332_C1,0,0,1,0,0,1
CACACGCGCTGTCTTA-1_V12D07-332_C1,0,0,0,0,0,0
TAGACGCCCGTACCGG-1_V12D07-332_C1,0,0,0,0,0,0
GGTTTCAATCGGTCAG-1_V12D07-332_C1,0,1,0,0,0,1
AATCTGCGTTGGGACG-1_V12D07-332_C1,0,2,0,0,0,2
TTACGGATGGTTCGAG-1_V12D07-332_C1,1,1,0,0,0,2
CGGCAGGGTCGGGTTG-1_V12D07-332_C1,2,2,0,0,0,4
GCTTTCAGAGGAGGTG-1_V12D07-332_C1,0,0,0,0,0,0
TCTTCCCATGGGCACA-1_V12D07-332_C1,1,1,0,0,0,2
TACCGCGGACTTGCAG-1_V12D07-332_C1,0,0,0,0,0,0
AGAATTATGGATTCGA-1_V12D07-332_C1,2,1,0,0,0,3
ATTGATGAGTCCTAAC-1_V12D07-332_C1,1,1,1,1,0,4
TAGGTCGCCGGAACTG-1_V12D07-332_C1,1,2,0,0,0,3
TAACCTACCGTCCGAG-1_V12D07-332_C1,2,1,0,1,0,4
CTTAGTAGGCCTACAG-1_V12D07-332_C1,2,1,0,0,0,3
CTAGATGTGAGTGTAA-1_V12D07-332_C1,0,1,0,0,0,1
ACTCCCGAATTCGTTT-1_V12D07-332_C1,0,1,0,0,0,1
GTTCATCGTTTGGCTG-1_V12D07-332_C1,0,0,0,0,0,0
ACTTTACCCTCATGAA-1_V12D07-332_C1,0,0,0,1,0,1
GCGAGAGTTGCGTCCA-1_V12D07-332_C1,0,3,0,0,0,3
GTTCGGGCGTACCATT-1_V12D07-332_C1,0,0,0,1,0,1
CGACTTTGTATAGCCT-1_V12D07-332_C1,0,1,0,0,1,2
GCCATCGATGCTGCAT-1_V12D07-332_C1,0,0,0,0,0,0
GCATTTCCAAGGCTCC-1_V12D07-332_C1,0,0,0,0,1,1
ATGTAAGGCTGCTCTT-1_V12D07-332_C1,0,1,0,0,0,1
ACGTTCGCAATCAATT-1_V12D07-332_C1,0,1,0,0,0,1
GTGACGAGGGTGACCC-1_V12D07-332_C1,0,1,0,0,0,1
ATTATAGCTACTTTAC-1_V12D07-332_C1,0,1,0,1,0,2
CGTGTGTTAAACCCTG-1_V12D07-332_C1,0,4,0,0,1,5
TTGGTATGGCTTGTGT-1_V12D07-332_C1,0,2,1,0,0,3
CATTCCCATTCCGTCG-1_V12D07-332_C1,0,0,0,0,1,1
TGCCGAAAGCGTATTC-1_V12D07-332_C1,0,2,0,0,0,2
CAACACATCTCCTGCC-1_V12D07-332_C1,0,3,0,0,1,4
CTGCCTCATATGCAAC-1_V12D07-332_C1,1,1,1,0,0,3
TCCCGCCTATGTGCGT-1_V12D07-332_C1,0,2,0,0,0,2
GGTTACCCGACACTTT-1_V12D07-332_C1,1,1,1,0,0,3
CCAGCGGGATCACCAG-1_V12D07-332_C1,4,2,0,0,1,7
ATGTTTCGGCCCGGAG-1_V12D07-332_C1,1,1,0,0,0,2
GCGTCTAACCTCCTAA-1_V12D07-332_C1,1,1,0,1,0,3
ATCAGGTAGCTGACAG-1_V12D07-332_C1,1,1,1,0,0,3
GGTATGAAAGAACTGA-1_V12D07-332_C1,1,0,0,0,0,1
GTGGCCTAATATCATT-1_V12D07-332_C1,0,6,0,0,0,6
CCTGTGAAACCGTAAC-1_V12D07-332_C1,1,1,1,0,0,3
GGCAGAGAGATCGGGA-1_V12D07-332_C1,0,2,1,0,0,3
TAGCGTCGAATATTGA-1_V12D07-332_C1,1,2,1,0,0,4
CGCCGACTATTCGCTA-1_V12D07-332_C1,2,2,2,0,0,6
TCTGGCGCAAGCCGGG-1_V12D07-332_C1,1,2,1,0,0,4
AGTGGTTGCGTATAGG-1_V12D07-332_C1,0,1,0,0,0,1
ATCGGTTACCTAGTAA-1_V12D07-332_C1,1,3,0,0,0,4
CCTGCCCGTTGTCTAG-1_V12D07-332_C1,0,2,2,0,0,4
GCACACGCCCATGGTC-1_V12D07-332_C1,0,2,1,0,0,3
AGTACGGCCCGTATCG-1_V12D07-332_C1,1,1,0,0,0,2
TATCTAGCCTAAAGGA-1_V12D07-332_C1,0,2,1,0,0,3
CACTCGGTTAGGAGGA-1_V12D07-332_C1,0,2,0,0,0,2
ATGTTCGTCGACCCAC-1_V12D07-332_C1,0,3,0,0,0,3
TTCCTCTGCCCGAATA-1_V12D07-332_C1,1,4,1,0,0,6
TTACTATCGGCTTCTC-1_V12D07-332_C1,0,1,0,0,0,1
GCCGCATTAGTCCGGC-1_V12D07-332_C1,0,0,1,0,0,1
TAAGGGCTGGGAGAGG-1_V12D07-332_C1,1,2,1,0,0,4
TAAGCAGGCGACACGC-1_V12D07-332_C1,1,2,0,0,0,3
AGCACTACCGGCCTGT-1_V12D07-332_C1,0,2,0,0,0,2
GAAAGCCCTTTGGACC-1_V12D07-332_C1,0,2,0,0,0,2
GACCGACTGAAGCGTC-1_V12D07-332_C1,1,3,0,0,0,4
CGGTGAAGACTAAAGT-1_V12D07-332_C1,2,3,0,0,0,5
CCCTGCGCTACGCATA-1_V12D07-332_C1,2,0,3,0,1,6
TACTGGACAGCTCGGC-1_V12D07-332_C1,2,0,2,0,0,4
TTAGTAGGGCGGCGGG-1_V12D07-332_C1,2,2,1,0,0,5
GAGGCTATCAAAGTCG-1_V12D07-332_C1,0,1,1,0,0,2
TTACCATTGATTACCC-1_V12D07-332_C1,1,2,0,0,0,3
ATACCACGGGCAACTT-1_V12D07-332_C1,1,1,0,0,0,2
TGTCCTAAGTCACCGC-1_V12D07-332_C1,0,0,0,0,0,0
AGGTAGGTACAAAGCT-1_V12D07-332_C1,4,1,0,0,0,5
GGCATACAGGTAGCGG-1_V12D07-332_C1,2,1,0,1,0,4
TGTAGTGATCTATAAT-1_V12D07-332_C1,0,1,0,0,1,2
TCCCGGGTGTGCTGCT-1_V12D07-332_C1,3,1,0,0,0,4
TACGATGTTGATCATC-1_V12D07-332_C1,0,0,0,0,0,0
CCTCTCTCCCATCTAG-1_V12D07-332_C1,2,0,1,0,0,3
GCAGGACTATAGAATA-1_V12D07-332_C1,0,1,0,0,0,1
CTAGTGAAGGACAGGA-1_V12D07-332_C1,2,1,0,0,0,3
TACGAGAACTTCACGT-1_V12D07-332_C1,2,1,0,0,1,4
CGTTGTTTCAATTCCC-1_V12D07-332_C1,0,2,1,0,1,4
GCAAATATTACGCTTT-1_V12D07-332_C1,1,3,0,0,1,5
CCAATAGTGCCGTCGA-1_V12D07-332_C1,1,1,1,0,0,3
ATTGCTGCTCCTCCAT-1_V12D07-332_C1,2,0,0,0,0,2
GAGATCTGCTTGGCAT-1_V12D07-332_C1,4,1,0,0,0,5
GCCGAAATTCCTACGT-1_V12D07-332_C1,2,2,0,1,0,5
GGCACTCCACTGGGCA-1_V12D07-332_C1,0,3,0,0,0,3
GGGTCACCGTGACGGT-1_V12D07-332_C1,1,0,1,0,0,2
CACTTAATCAGACGGA-1_V12D07-332_C1,0,3,0,0,0,3
CGTTTCGCTCATTACA-1_V12D07-332_C1,0,2,0,0,0,2
ATAAAGGCTCGGTCGT-1_V12D07-332_C1,0,2,0,0,0,2
CACTAAAGTTGCCTAT-1_V12D07-332_C1,1,1,1,0,0,3
GTGCTCAAGTACTGTC-1_V12D07-332_C1,0,2,0,0,0,2
CCATGCCTGTTTAGTA-1_V12D07-332_C1,0,2,1,0,0,3
TCTAGTTATCAGAAGA-1_V12D07-332_C1,0,3,0,0,0,3
TTGTAATCCGTACTCG-1_V12D07-332_C1,1,0,0,0,1,2
TCCCAGCTTTAGTCTG-1_V12D07-332_C1,0,2,0,0,1,3
CTACGCACGGAGTACC-1_V12D07-332_C1,0,2,1,0,1,4
AAATTAACGGGTAGCT-1_V12D07-332_C1,0,2,0,0,1,3
CGGCCACGCACAAAGT-1_V12D07-332_C1,0,4,1,0,3,8
GAAGCGTGAGGAATTT-1_V12D07-332_C1,0,0,0,0,2,2
ATATCTTAGGGCCTTC-1_V12D07-332_C1,1,0,0,0,0,1
ACGCGGGCCAAGGACA-1_V12D07-332_C1,0,4,0,0,1,5
GCGAGTTCTGCAAAGA-1_V12D07-332_C1,0,0,1,0,1,2
TATTCGTGCCAGAATA-1_V12D07-332_C1,1,2,0,0,0,3
AGGGCTGCAGTTACAG-1_V12D07-332_C1,0,3,0,0,0,3
CTAGCATAGTATAATG-1_V12D07-332_C1,0,3,0,1,0,4
TAGGTTCGAGTTCGTC-1_V12D07-332_C1,0,0,1,0,1,2
GAATTATAGTGAAAGG-1_V12D07-332_C1,0,0,0,0,1,1
CTATCGGGTCTCAACA-1_V12D07-332_C1,1,3,0,0,0,4
GCGCTAATTGAATAGA-1_V12D07-332_C1,0,0,0,0,0,0
ATGCGACAGTCCCATT-1_V12D07-332_C1,0,2,0,0,0,2
GGTAGTGCTCGCACCA-1_V12D07-332_C1,0,0,0,0,0,0
AAGCTCGTGCCAAGTC-1_V12D07-332_C1,0,4,0,1,0,5
TATTCAATTCTAATCC-1_V12D07-332_C1,0,3,0,1,0,4
TTCAAAGTCTCTAGCC-1_V12D07-332_C1,0,0,0,1,0,1
TTGAATATGGACTTTC-1_V12D07-332_C1,1,3,0,0,0,4
AAGAGCTCTTTATCGG-1_V12D07-332_C1,1,1,0,0,0,2
TTACTCCGGCCGGGAA-1_V12D07-332_C1,0,2,0,2,0,4
AAACGAGACGGTTGAT-1_V12D07-332_C1,0,1,1,0,0,2
GCTAAGTAGTTTCTCT-1_V12D07-332_C1,2,2,1,0,0,5
ATAACGCCGGAGGGTC-1_V12D07-332_C1,0,1,0,0,0,1
GGATCCGGAATATACT-1_V12D07-332_C1,0,1,0,0,0,1
TGAAAGGACCTGACTC-1_V12D07-332_C1,1,2,2,1,2,8
TCCGCGGCAGCATCTG-1_V12D07-332_C1,1,2,0,0,0,3
TGCATATGTCTGTCAC-1_V12D07-332_C1,1,1,0,0,0,2
TGTAGGAGAAATTTCC-1_V12D07-332_C1,0,1,0,0,0,1
AGTGAGACTTCCAGTA-1_V12D07-332_C1,0,0,0,0,0,0
CCCAAACATGCTGCTC-1_V12D07-332_C1,0,0,0,0,0,0
GCTTATGAAGCAGGAA-1_V12D07-332_C1,1,0,0,1,0,2
TTCTAACCGAAGCTTA-1_V12D07-332_C1,0,1,0,1,1,3
GGATGTCCTTACCGCA-1_V12D07-332_C1,1,0,0,0,0,1
AGGGTGCTCTCGAGGG-1_V12D07-332_C1,1,1,0,0,0,2
AACTCTCAATAGAGCG-1_V12D07-332_C1,0,0,1,0,0,1
TCTGAATTCCGTACAA-1_V12D07-332_C1,0,0,1,0,0,1
GCGTGGTACTGGGTTA-1_V12D07-332_C1,1,0,0,1,0,2
CGTCGGATAGTGTTGA-1_V12D07-332_C1,1,5,0,1,0,7
ATATGTCTCCCTAGCC-1_V12D07-332_C1,0,1,0,1,0,2
TCTTTAAGACTATGAA-1_V12D07-332_C1,0,1,0,1,0,2
TCATTTAAGTCTCCGA-1_V12D07-332_C1,0,0,0,0,0,0
GATATTGAGATTGGCG-1_V12D07-332_C1,0,1,0,0,0,1
TGACATCGAGCGGACC-1_V12D07-332_C1,0,1,0,0,0,1
GCGTAAATGGCCATAA-1_V12D07-332_C1,0,1,0,0,1,2
ATTGTACAACTCGGCT-1_V12D07-332_C1,4,1,0,1,0,6
TACGCTATAGAAACCT-1_V12D07-332_C1,2,2,0,1,0,5
CACCCAAATCTTATGT-1_V12D07-332_C1,2,0,0,0,0,2
AGATGATGGAGTCTGG-1_V12D07-332_C1,1,1,0,0,0,2
CCACGGTGCCCGGTAG-1_V12D07-332_C1,1,1,0,0,0,2
TCAAGAAATACTAGCT-1_V12D07-332_C1,1,0,0,1,0,2
AGGTATAATTGATAGT-1_V12D07-332_C1,0,0,0,0,1,1
CAAGGTCCTATAGGCT-1_V12D07-332_C1,0,0,0,0,1,1
CCGGCACGACCGTTTC-1_V12D07-332_C1,0,0,0,0,1,1
ACCTCCGTTATTCACC-1_V12D07-332_C1,1,0,0,0,0,1
GCAGCCTATATCACAT-1_V12D07-332_C1,0,0,0,0,0,0
GGTATAGTGACACATA-1_V12D07-332_C1,0,2,0,0,0,2
AAATTCCAGGTCCAAA-1_V12D07-332_C1,0,1,0,0,0,1
TCTTTAGCAGGCGAAC-1_V12D07-332_C1,1,2,0,0,0,3
TATTGACATTTCTGCC-1_V12D07-332_C1,1,2,0,0,0,3
TCTGATCGGGTGCTAG-1_V12D07-332_C1,0,2,0,0,2,4
GGCCCGGAGCATGTCT-1_V12D07-332_C1,0,1,1,0,0,2
GGGCGCAGCGTTACTC-1_V12D07-332_C1,1,2,0,0,0,3
TTGGCGATCCGAATAT-1_V12D07-332_C1,0,2,0,0,1,3
CCACGTAAATTAGACT-1_V12D07-332_C1,0,1,0,0,0,1
TCTGATTGGAAATGGA-1_V12D07-332_C1,0,0,0,0,0,0
ATGGCGGAATAGTCGC-1_V12D07-332_C1,1,4,0,0,0,5
ATCGCTTTACGTCTCA-1_V12D07-332_C1,2,5,0,1,0,8
TACGTGCAAGGTTCCT-1_V12D07-332_C1,0,3,0,0,0,3
CAGGACAGCTGCCCTT-1_V12D07-332_C1,3,1,0,0,0,4
CAAACCAGGTCTGCAT-1_V12D07-332_C1,0,0,0,0,0,0
ACAAGCTATATGGAAG-1_V12D07-332_C1,1,1,1,0,0,3
TCGCCCACTGCGAGAG-1_V12D07-332_C1,2,2,1,0,1,6
AGCCGCAAATTCAAAT-1_V12D07-332_C1,0,3,0,0,0,3
TTAACGTTAAAGCCTG-1_V12D07-332_C1,0,3,0,0,0,3
CAGCGCCAACACGATA-1_V12D07-332_C1,2,3,0,0,0,5
ATCCAATGGTACCGAA-1_V12D07-332_C1,0,2,0,0,0,2
GTGCTGCAGATAAGGA-1_V12D07-332_C1,0,2,0,0,0,2
GGCCTTTGCAACTGGC-1_V12D07-332_C1,1,2,1,0,0,4
GTCGTACCTACGATTG-1_V12D07-332_C1,1,5,0,0,0,6
TAGAAATTCACGTATA-1_V12D07-332_C1,1,6,1,0,0,8
AGAATAAATCTTCAGG-1_V12D07-332_C1,0,3,0,0,0,3
CATTGCGAAATGGGCG-1_V12D07-332_C1,0,1,1,0,0,2
GTCTACTCAATTACAA-1_V12D07-332_C1,0,2,1,0,0,3
TGTAATGACCACAATA-1_V12D07-332_C1,0,1,1,0,0,2
AAAGTCGACCCTCAGT-1_V12D07-332_C1,1,3,0,0,0,4
TACTCGGCACGCCGGG-1_V12D07-332_C1,3,1,1,0,0,5
AGGTGTATCGCCATGA-1_V12D07-332_C1,1,3,2,0,0,6
TGTGCTTTACGTAAGA-1_V12D07-332_C1,1,1,0,0,0,2
AAACCTCATGAAGTTG-1_V12D07-332_C1,0,5,0,0,0,5
TATAGGGTACTCATGA-1_V12D07-332_C1,0,5,1,0,0,6
CCAGCTGATGGTACTT-1_V12D07-332_C1,0,0,1,0,0,1
AATATTGGAGTATTGA-1_V12D07-332_C1,1,5,0,0,0,6
GGCCCTCACCCACTTA-1_V12D07-332_C1,1,0,0,0,0,1
AACCAAGACTTCTCTG-1_V12D07-332_C1,0,7,1,0,0,8
TCGTATTACCCATTGC-1_V12D07-332_C1,2,3,1,0,0,6
ATTCGACGCCGGGCCT-1_V12D07-332_C1,2,2,2,1,0,7
GGCGCAGGACATCTTC-1_V12D07-332_C1,0,6,0,0,0,6
GTACTCCCTTATCGCT-1_V12D07-332_C1,1,4,0,0,0,5
TGGTCTGTTGGGCGTA-1_V12D07-332_C1,0,7,0,0,0,7
AATAACAACGCTCGGC-1_V12D07-332_C1,2,1,0,0,0,3
CATACCCGTACCCAGT-1_V12D07-332_C1,2,3,0,0,0,5
ACAATCCATTTAAACC-1_V12D07-332_C1,4,2,0,0,0,6
GTTACAATTGGTGACG-1_V12D07-332_C1,1,0,0,0,0,1
TTGCCCTGATCACGGG-1_V12D07-332_C1,1,1,1,0,0,3
CTAACCGCGCGCCCGT-1_V12D07-332_C1,1,2,0,0,0,3
CTAAAGAATGCCTACT-1_V12D07-332_C1,4,1,0,0,1,6
ACCCATCTTGAGGGTA-1_V12D07-332_C1,0,2,1,0,0,3
GATCTTTGCAGGGTAT-1_V12D07-332_C1,0,4,1,0,2,7
GGGTACTTCATGAACT-1_V12D07-332_C1,0,3,0,0,2,5
GCCGCTTGTGAGAAAC-1_V12D07-332_C1,0,2,0,0,0,2
CCTGTAAGACATGATA-1_V12D07-332_C1,2,4,0,0,0,6
CGACAGTTCGCGTTAT-1_V12D07-332_C1,1,2,2,0,0,5
ACGATGCATATGTTAT-1_V12D07-332_C1,0,3,0,0,0,3
TGTTCCGCTTCCATGA-1_V12D07-332_C1,0,4,1,0,0,5
GGATGACGCGAGTTTA-1_V12D07-332_C1,0,4,0,0,0,4
GAAGTTTCCACTCAAT-1_V12D07-332_C1,0,0,0,0,1,1
GCGAGGCCCGAGCAGA-1_V12D07-332_C1,1,1,1,0,0,3
CATACTATGTAATTGT-1_V12D07-332_C1,0,4,1,1,0,6
CCAATGTCACAGCAAG-1_V12D07-332_C1,0,2,0,0,0,2
GTTGGATTTGCGTTGG-1_V12D07-332_C1,0,2,0,0,0,2
GGGAGGATGCCCGAAA-1_V12D07-332_C1,0,2,0,1,0,3
GATCGCGGGCTCTCCA-1_V12D07-332_C1,0,5,2,0,1,8
GTTCGCCATAAGTGCC-1_V12D07-332_C1,0,4,0,0,0,4
AGATTATAGGACGTTT-1_V12D07-332_C1,0,3,0,0,1,4
TCGAGACCAACACCGT-1_V12D07-332_C1,1,3,0,0,0,4
TATGGGACCGAGCAGG-1_V12D07-332_C1,0,1,0,0,0,1
GATGCGTCCTGCATTC-1_V12D07-332_C1,0,1,0,0,2,3
TATGGTCTGAGTAACA-1_V12D07-332_C1,0,1,0,0,0,1
GCATAGAGCACTCAGG-1_V12D07-332_C1,0,3,1,0,1,5
CTTCATTGTCAGTGGA-1_V12D07-332_C1,1,3,0,0,1,5
GCAGATTAGGGATATC-1_V12D07-332_C1,1,1,1,0,0,3
CCTGTCGCCCGTAAAT-1_V12D07-332_C1,0,4,1,1,1,7
CAATTTCGTATAAGGG-1_V12D07-332_C1,0,1,0,0,0,1
GTACACTTACCTGAAG-1_V12D07-332_C1,0,0,1,0,1,2
CCAGCCTGGACCAATA-1_V12D07-332_C1,0,1,0,0,1,2
ATGGAGCAGGCCGTGA-1_V12D07-332_C1,0,2,0,0,0,2
GTCATTAGAGCGAACG-1_V12D07-332_C1,0,3,0,0,0,3
AAGACTGCAAGCTACT-1_V12D07-332_C1,1,4,0,1,1,7
CTAGTCACGTCTTAAG-1_V12D07-332_C1,0,0,0,1,1,2
ACTCTTGTATAGTAAC-1_V12D07-332_C1,1,3,0,0,2,6
ATTAGGCGATGCTTTC-1_V12D07-332_C1,2,2,0,2,0,6
TTCGGGACTAATCGCG-1_V12D07-332_C1,1,2,0,1,0,4
TGGACTGTTCGCTCAA-1_V12D07-332_C1,0,2,0,0,1,3
AACGTGCGAAAGTCTC-1_V12D07-332_C1,0,1,0,0,0,1
CCACCCAAGGAAAGTG-1_V12D07-332_C1,1,0,0,0,0,1
CCGCACAAAGACCAAC-1_V12D07-332_C1,1,2,0,0,0,3
GCGATTGTTAACGTTA-1_V12D07-332_C1,0,1,0,0,0,1
ACTCGTCAGTAATCCC-1_V12D07-332_C1,0,1,0,1,1,3
GGTGATAAGGAGCAGT-1_V12D07-332_C1,1,2,0,1,0,4
AAGAGGCATGGATCGC-1_V12D07-332_C1,0,1,0,0,1,2
CACGTTCGTGCTCTAG-1_V12D07-332_C1,0,2,0,0,0,2
CTATTTGGTTACGGAT-1_V12D07-332_C1,1,1,0,0,0,2
GTACAGAGGCAAGGGT-1_V12D07-332_C1,0,2,0,0,0,2
GGGCCGGCCGAAGTAC-1_V12D07-332_C1,0,2,0,0,0,2
CCTGAACGATATATTC-1_V12D07-332_C1,2,2,0,1,0,5
CCGGGCTGCTCCATAC-1_V12D07-332_C1,0,1,0,1,0,2
TACTTGTTAGTAGTCC-1_V12D07-332_C1,0,0,0,1,2,3
CCTAGGCGTAGCGATC-1_V12D07-332_C1,1,1,0,0,1,3
CTGGCGCACAGGTCTG-1_V12D07-332_C1,0,0,0,0,0,0
ACTTATACTTACCCGG-1_V12D07-332_C1,1,2,0,0,0,3
GAAGTCTCCCTAGCGA-1_V12D07-332_C1,1,1,0,0,0,2
ACCGATGGTAGCATCG-1_V12D07-332_C1,0,0,0,0,0,0
CGAGTTTATCGGACTG-1_V12D07-332_C1,0,1,0,0,0,1
CATAACGGACAGTCGT-1_V12D07-332_C1,1,0,0,1,0,2
TGACGATGCACTAGAA-1_V12D07-332_C1,0,2,1,1,0,4
TAGGGAGCTTGGGATG-1_V12D07-332_C1,1,2,0,0,0,3
AGGGTCGATGCGAACT-1_V12D07-332_C1,1,0,0,0,0,1
TATATCCCTGGGAGGA-1_V12D07-332_C1,0,2,0,1,0,3
CATCTTACACCACCTC-1_V12D07-332_C1,2,1,0,0,0,3
GTGCGACAGGGAGTGT-1_V12D07-332_C1,0,0,0,0,0,0
CCGATCTCAACCTTAT-1_V12D07-332_C1,0,1,0,0,0,1
ACGATCATCTTGTAAA-1_V12D07-332_C1,2,3,1,1,0,7
GAAAGAACAGCGTTAT-1_V12D07-332_C1,1,0,0,1,0,2
CTAGGTCTGAAGGAAT-1_V12D07-332_C1,2,1,2,0,1,6
ATATCAACCTACAGAG-1_V12D07-332_C1,2,0,0,0,0,2
AAATAGCTTAGACTTT-1_V12D07-332_C1,1,0,0,0,1,2
GCGACATGTAAACATC-1_V12D07-332_C1,4,0,0,0,0,4
ATAAGTAGGGCGACTC-1_V12D07-332_C1,0,0,0,0,0,0
GCGAGCGCATGCTCCC-1_V12D07-332_C1,1,0,1,1,0,3
AGGGACCGGCTGCGTT-1_V12D07-332_C1,0,1,0,0,0,1
CCTATGAAGTGGTGCC-1_V12D07-332_C1,0,0,0,0,1,1
GCTTACGTAGTTAGTA-1_V12D07-332_C1,0,0,1,0,1,2
CATACTTAGGCAATAC-1_V12D07-332_C1,0,1,0,0,0,1
CCTGTCCCTCACGTTA-1_V12D07-332_C1,0,2,1,0,0,3
CAATGTGCCAACCCTT-1_V12D07-332_C1,0,0,0,0,0,0
GTTAAGTTAGAGTGGG-1_V12D07-332_C1,1,3,0,1,0,5
CTGGGATACGCTACCC-1_V12D07-332_C1,1,0,0,0,1,2
AACCTGTCACGGAATT-1_V12D07-332_C1,0,1,0,0,0,1
ACTGCGGACACACCGT-1_V12D07-332_C1,0,1,0,0,1,2
CCGTGAGGCATTCATG-1_V12D07-332_C1,0,1,1,1,0,3
GCCCAGATGCTGGAGA-1_V12D07-332_C1,0,4,1,0,0,5
TCTGGCCGTTCAAGTT-1_V12D07-332_C1,0,1,0,0,0,1
ATACGAAGGCTTTCCA-1_V12D07-332_C1,0,1,0,0,0,1
GATCCGAATATAAGTG-1_V12D07-332_C1,0,1,0,0,0,1
GTGGAGCATGTCGGCC-1_V12D07-332_C1,0,2,0,0,0,2
ACTCTTCAGCTCCCGC-1_V12D07-332_C1,0,1,0,0,0,1
CCCGATAGCCTCGCCT-1_V12D07-332_C1,0,4,0,0,0,4
ACAGGTGTGTTGTTGC-1_V12D07-332_C1,0,0,0,0,0,0
TGAACTGCTATGACTT-1_V12D07-332_C1,0,0,0,0,0,0
TGACATATATGACGAT-1_V12D07-332_C1,0,1,0,0,0,1
AAGTCTTCTGTGGCCT-1_V12D07-332_C1,1,1,0,0,0,2
ACCAGACCATAACAAC-1_V12D07-332_C1,0,7,0,0,0,7
TGAGACGTACCTCTCA-1_V12D07-332_C1,2,2,3,0,0,7
GACCGTTACATGCGAC-1_V12D07-332_C1,0,1,0,0,0,1
GGTTCGGATTATACTA-1_V12D07-332_C1,0,1,0,0,0,1
CCTCCTGAGCCCACAT-1_V12D07-332_C1,0,2,0,0,0,2
CCGCGATTTGGTAGGT-1_V12D07-332_C1,2,0,1,0,0,3
AATCTCTACTGTGGTT-1_V12D07-332_C1,0,3,1,0,0,4
CCCTGACTAACAAATT-1_V12D07-332_C1,0,5,0,0,0,5
ACGCTGTGAGGCGTAG-1_V12D07-332_C1,0,1,0,0,0,1
GCATACGAGGTCTTTA-1_V12D07-332_C1,1,1,0,0,0,2
TCGGGATTCAAACATA-1_V12D07-332_C1,0,1,1,0,0,2
GGGCCCTACGAAAGGG-1_V12D07-332_C1,0,3,1,0,0,4
CGCCAAGAAGCCGAGT-1_V12D07-332_C1,2,5,1,0,0,8
GGTACATCTGGGACGA-1_V12D07-332_C1,1,3,1,0,0,5
GGATGCTGGCGTTCCT-1_V12D07-332_C1,1,6,0,0,0,7
CCGATTCGAGGGACCC-1_V12D07-332_C1,0,5,0,0,0,5
CCACTGGTGGCTGGTT-1_V12D07-332_C1,0,5,1,0,0,6
GACAGGCACACACTAT-1_V12D07-332_C1,0,2,0,0,0,2
TCAACGCGACCGGCAG-1_V12D07-332_C1,0,2,0,0,0,2
CTACGACTAGCTATAA-1_V12D07-332_C1,0,2,2,1,0,5
CGGTTGACCTGGCATA-1_V12D07-332_C1,2,3,0,0,0,5
ATCCTGAATCGCTGCG-1_V12D07-332_C1,3,1,0,0,0,4
GTTTCATATCGTCGCT-1_V12D07-332_C1,1,1,0,0,0,2
ATAAATATTAGCAGCT-1_V12D07-332_C1,0,3,0,0,0,3
AAGAGGATGTACGCGA-1_V12D07-332_C1,0,3,1,0,0,4
TCCTGCGTTGATACTC-1_V12D07-332_C1,1,2,1,0,0,4
CGTGCATTGTCGACGC-1_V12D07-332_C1,1,3,0,0,0,4
CCGGGTTCGAGGTTAC-1_V12D07-332_C1,1,7,0,0,0,8
CCCAATTTCACAACTT-1_V12D07-332_C1,0,3,0,1,0,4
TGATTTATTAGCTGTG-1_V12D07-332_C1,1,5,0,0,0,6
TGGAAGAAGGGAACGT-1_V12D07-332_C1,0,2,0,0,0,2
GACGCTTGCTTCTAAA-1_V12D07-332_C1,2,0,0,0,0,2
GGGAACGGGAGGTTAG-1_V12D07-332_C1,0,7,1,0,1,9
GCGGCTCTGACGTACC-1_V12D07-332_C1,0,5,0,0,0,5
ACGTTAGATTTGCCCG-1_V12D07-332_C1,1,5,0,0,0,6
GAGAGGGCGCGAGGTT-1_V12D07-332_C1,0,1,0,0,1,2
GCGTCTCTGCATTGGG-1_V12D07-332_C1,0,3,2,0,0,5
GCAGCACACAGCCCAG-1_V12D07-332_C1,0,0,2,0,0,2
CAGGCCGTTTGGGTGT-1_V12D07-332_C1,0,4,0,0,0,4
AACTCAAGTTAATTGC-1_V12D07-332_C1,0,2,1,0,0,3
CTTCGTAGATAGGTGA-1_V12D07-332_C1,0,4,1,0,0,5
TGCAGAGTACCGAGCA-1_V12D07-332_C1,1,4,1,0,0,6
GAAGTGATTTATCGTG-1_V12D07-332_C1,1,4,0,0,0,5
CGCTACGGGACATTTA-1_V12D07-332_C1,0,3,0,0,0,3
CCACACTGAGATATTA-1_V12D07-332_C1,0,3,0,0,0,3
CGATCCGACCCAGTGC-1_V12D07-332_C1,1,4,0,0,1,6
CTGTACTTCTTAGCAT-1_V12D07-332_C1,0,2,0,1,0,3
ACTTATTAGGATCGGT-1_V12D07-332_C1,0,2,0,0,0,2
TAGTCCGCAGAGAATG-1_V12D07-332_C1,1,1,0,0,1,3
TTCACGAAAGGATCAC-1_V12D07-332_C1,0,2,1,0,0,3
TACATTTCTAACGTGC-1_V12D07-332_C1,0,5,0,0,2,7
ACCATATCCGCAATAA-1_V12D07-332_C1,0,0,0,0,0,0
CACTCAAGAGCTATGG-1_V12D07-332_C1,0,0,0,0,0,0
TGTACGAACAAATCCG-1_V12D07-332_C1,0,2,0,0,1,3
ATCATCCAATATTTGT-1_V12D07-332_C1,0,2,0,0,0,2
CGCTATTCTTAGGCTC-1_V12D07-332_C1,0,2,0,0,0,2
TGGCAGCAGTAATAGT-1_V12D07-332_C1,1,4,0,0,1,6
TCACGTGCCCGATTCA-1_V12D07-332_C1,1,0,0,0,0,1
CATACGGCGTCTGGGC-1_V12D07-332_C1,0,0,0,0,1,1
CACATGATTCAGCAAC-1_V12D07-332_C1,0,3,0,0,1,4
GCTAGTAGAGCTTGTA-1_V12D07-332_C1,0,3,1,0,0,4
TGCTGTTGAAGAACTC-1_V12D07-332_C1,1,1,0,0,0,2
CGGAGCATGGCGATCC-1_V12D07-332_C1,0,0,0,0,0,0
TAGCGTTGGGTCTTAC-1_V12D07-332_C1,0,2,0,1,0,3
GTAGCGGCTATACACT-1_V12D07-332_C1,0,0,1,0,0,1
TAACATACAATGTGGG-1_V12D07-332_C1,2,0,0,0,0,2
TCTTCGAATAGACGTT-1_V12D07-332_C1,1,1,0,0,0,2
GATCGTGACTGATATC-1_V12D07-332_C1,0,1,0,0,0,1
GATCCGGGAATTAACA-1_V12D07-332_C1,0,1,0,0,0,1
TTATATACGCTGTCAC-1_V12D07-332_C1,1,1,0,0,0,2
GTCGCGTAACCCGTTG-1_V12D07-332_C1,0,1,0,0,0,1
AGCTCTAGACGTTCCA-1_V12D07-332_C1,2,2,0,0,0,4
GTCAAGCGGACTCGGG-1_V12D07-332_C1,2,0,0,0,0,2
CGAGGGACTGCGGTCG-1_V12D07-332_C1,1,6,1,0,0,8
AATCGCCTCAGCGCCA-1_V12D07-332_C1,1,1,0,1,0,3
CTTGTTGCTGAGTCAA-1_V12D07-332_C1,1,1,0,0,0,2
GATATGAGACACTAAC-1_V12D07-332_C1,0,1,0,1,0,2
TTATGATCTTAACGAA-1_V12D07-332_C1,0,1,0,0,0,1
CGCCGCCCATGCCTGT-1_V12D07-332_C1,0,0,0,0,0,0
CTGGGATAAATAATGG-1_V12D07-332_C1,1,7,0,1,0,9
GTGCCCGTTCGGATTC-1_V12D07-332_C1,0,2,0,0,1,3
TTCAATACTCTGAATC-1_V12D07-332_C1,0,1,0,0,0,1
CGCACATGTCCACTAC-1_V12D07-332_C1,0,0,0,0,0,0
AGAAGAGCGCCGTTCC-1_V12D07-332_C1,0,4,2,2,0,8
GATAACTCGCACTGTG-1_V12D07-332_C1,1,2,1,0,0,4
AGTCGACGGTCTCAAG-1_V12D07-332_C1,1,1,0,0,1,3
GTGACCGCACACTACG-1_V12D07-332_C1,0,3,0,0,0,3
GTATGTGGGTCTAGTT-1_V12D07-332_C1,0,1,0,0,0,1
CTTGAGTTAGGGTAAT-1_V12D07-332_C1,0,0,0,0,0,0
TTAGCTGATTTGCCGT-1_V12D07-332_C1,1,0,0,0,0,1
GCTGTTGCTACCGAAC-1_V12D07-332_C1,1,0,0,0,0,1
TATTACCATCCTGCTT-1_V12D07-332_C1,0,1,0,0,0,1
TTGAATTCACGTGAGG-1_V12D07-332_C1,1,1,0,1,0,3
CCATCTCACCAGTGAA-1_V12D07-332_C1,2,0,0,0,0,2
CGCACGTGCGCTATCA-1_V12D07-332_C1,0,1,0,0,0,1
ACCCGGATGACGCATC-1_V12D07-332_C1,0,1,0,0,0,1
CGCTAGAGACCGCTGC-1_V12D07-332_C1,1,1,0,0,0,2
ATAGTTCCACCCACTC-1_V12D07-332_C1,0,0,0,0,0,0
GCAGACCCAGCACGTA-1_V12D07-332_C1,1,0,0,0,0,1
TAGACTACCTAGCGTT-1_V12D07-332_C1,3,2,0,0,0,5
GGTTCTACTCGTCTGA-1_V12D07-332_C1,1,0,0,1,0,2
GACTCACCCACGTGAG-1_V12D07-332_C1,3,0,1,0,0,4
AGCTCTTCGTAACCTT-1_V12D07-332_C1,0,0,0,1,0,1
ACTATCCAGGGCATGG-1_V12D07-332_C1,2,0,0,0,0,2
AAGGATCGATCGCTTG-1_V12D07-332_C1,1,0,0,0,0,1
ATATCGGTAGGGAGAT-1_V12D07-332_C1,0,0,0,0,0,0
TTCCAGACGAGATTTA-1_V12D07-332_C1,0,0,0,0,0,0
GACCGACGTGAAAGCA-1_V12D07-332_C1,1,0,0,0,1,2
CCTGGAAACGTTCTGC-1_V12D07-332_C1,0,1,0,0,0,1
CCGGTAATGGCTAGTC-1_V12D07-332_C1,0,0,0,0,1,1
GCCGTGGAAGAAATGT-1_V12D07-332_C1,0,0,0,0,1,1
GTCTTGAGGAGCAGTG-1_V12D07-332_C1,1,2,0,0,0,3
TCCCAAAGCCCTAAAT-1_V12D07-332_C1,0,3,0,0,1,4
TTGAGCGCCACGTGAT-1_V12D07-332_C1,0,1,0,1,0,2
TTGAGTCCCGCTGCTG-1_V12D07-332_C1,0,2,1,0,0,3
ATGGAACCTTTGCACA-1_V12D07-332_C1,0,0,0,0,0,0
GCTAGCACCTGGGCCA-1_V12D07-332_C1,3,2,1,0,0,6
CGCCGTCTACCCATCG-1_V12D07-332_C1,1,1,1,0,0,3
GATAGGTGTCCCGGGC-1_V12D07-332_C1,2,0,0,0,1,3
AGGTATGCGGACATTA-1_V12D07-332_C1,1,2,1,0,0,4
TTGGTTCGCTCAAAGG-1_V12D07-332_C1,0,3,0,0,0,3
TCTGGAGCGTAAGAGT-1_V12D07-332_C1,0,3,1,0,0,4
TGCCTAAATTTAATAG-1_V12D07-332_C1,0,1,1,0,0,2
TAATTTCCGTCCAGTA-1_V12D07-332_C1,0,0,0,0,0,0
TCCTTCAATCCCTACG-1_V12D07-332_C1,0,0,0,0,0,0
TACCTATCCCTAGAGG-1_V12D07-332_C1,1,0,1,0,0,2
GCATGGGTACTGACGC-1_V12D07-332_C1,0,5,0,0,0,5
GTCGGGAACATGGTAG-1_V12D07-332_C1,0,5,1,0,0,6
GCAAATGAGGACACTT-1_V12D07-332_C1,2,0,2,0,0,4
GAATGGGCTTATCGAC-1_V12D07-332_C1,0,3,1,0,0,4
TGGTCGTGCAAGGCAA-1_V12D07-332_C1,1,1,2,0,0,4
CACCACGCCACACAGA-1_V12D07-332_C1,1,3,0,0,0,4
TGGTAAGCAGGATTGA-1_V12D07-332_C1,0,2,0,0,0,2
AGTGGCTCCGTCGGCC-1_V12D07-332_C1,1,5,0,0,0,6
GATCGGATAGAACCAT-1_V12D07-332_C1,2,5,0,0,0,7
GCTACAGTACGGACCG-1_V12D07-332_C1,3,0,0,0,0,3
TCTATTACTAGAGGAT-1_V12D07-332_C1,1,3,0,0,0,4
TTCAGGCGTCAAAGCC-1_V12D07-332_C1,2,1,0,0,0,3
AGACCGGGAAACCCTG-1_V12D07-332_C1,0,2,0,0,0,2
AGAGATCTCTAAAGCG-1_V12D07-332_C1,1,2,2,0,0,5
CCCTGCCCAATCCGCT-1_V12D07-332_C1,0,2,0,0,0,2
GTGGCGGTCCCAGCGT-1_V12D07-332_C1,0,0,0,0,0,0
GCATTGTAATTCATAT-1_V12D07-332_C1,3,2,1,0,0,6
CCGTTCCGAATCTCGG-1_V12D07-332_C1,0,2,0,0,0,2
AGCTTGATCTTAACTT-1_V12D07-332_C1,0,3,0,0,0,3
CCTGTACTCACGCCCA-1_V12D07-332_C1,0,2,0,0,0,2
AAGTGACGACCGAATT-1_V12D07-332_C1,0,4,0,0,0,4
CTCACTTGGCTGGTAA-1_V12D07-332_C1,0,2,0,0,0,2
CGCCTGGCCTACGTAA-1_V12D07-332_C1,1,2,1,0,0,4
CCCGTAAGTCTAGGCC-1_V12D07-332_C1,0,4,0,0,0,4
TTGGACATGTGGCTTA-1_V12D07-332_C1,0,4,1,0,0,5
ATTACGCGCTGGCAGG-1_V12D07-332_C1,1,5,0,0,0,6
ACGCGCTACACAGGGT-1_V12D07-332_C1,1,3,1,0,0,5
TACGTTTACCGGCAAT-1_V12D07-332_C1,1,2,0,0,0,3
CGAAACGCAATTCATG-1_V12D07-332_C1,1,3,0,0,0,4
TAGTCTAACAACGAGA-1_V12D07-332_C1,0,1,0,0,0,1
TTGCATGCTGATCACG-1_V12D07-332_C1,0,6,0,0,1,7
TCTGGGTAGCGCTCAT-1_V12D07-332_C1,0,2,1,0,0,3
ACATCGGTCAGCCGCG-1_V12D07-332_C1,1,1,0,0,1,3
AGATACCGGTGTTCAC-1_V12D07-332_C1,2,3,0,0,0,5
GATTACTGAATTTGGG-1_V12D07-332_C1,0,2,0,0,0,2
TCCAACTTTAAATTCT-1_V12D07-332_C1,0,3,0,0,1,4
TCCTAGCAAAGAAGCT-1_V12D07-332_C1,1,3,0,0,0,4
GTCTATCTGAGTTTCT-1_V12D07-332_C1,1,3,0,0,0,4
GATGTTCAATCCACGA-1_V12D07-332_C1,1,1,0,0,0,2
AGTTAAACACTTGCGA-1_V12D07-332_C1,0,5,1,0,0,6
AGCTCTTTACTCAGTT-1_V12D07-332_C1,0,4,2,0,0,6
ATCCAGGATTCGTGAA-1_V12D07-332_C1,1,3,0,0,1,5
AGTCAACACCACCATC-1_V12D07-332_C1,0,5,0,1,1,7
CGATACCTCGCGGACA-1_V12D07-332_C1,0,3,0,0,0,3
TACAACGCACAACTCA-1_V12D07-332_C1,0,0,0,0,0,0
AATTAAAGGTCGGCGT-1_V12D07-332_C1,0,5,0,0,1,6
TACGCAGTTCTTTCCT-1_V12D07-332_C1,1,3,0,0,0,4
GACCGTGCTGACGGTG-1_V12D07-332_C1,0,0,0,0,0,0
GGCAAATTACTTTACT-1_V12D07-332_C1,0,1,0,0,0,1
GGTACAAACATGCTAT-1_V12D07-332_C1,0,2,0,0,0,2
CGGGCCTTCTTTGTAA-1_V12D07-332_C1,0,3,0,0,2,5
CGTGAAGTTAATTCAC-1_V12D07-332_C1,0,2,0,0,1,3
ATAGTGAAGCGTTCTC-1_V12D07-332_C1,1,1,2,1,0,5
TACGCCATATTCTAAT-1_V12D07-332_C1,0,3,0,0,1,4
GCCGGGTTAGGGTCGC-1_V12D07-332_C1,0,2,0,0,0,2
TACATAGGCATACACC-1_V12D07-332_C1,0,1,0,0,0,1
GCCGATTGGCCAAGCT-1_V12D07-332_C1,0,3,1,0,1,5
CTGCCATGCATCACAT-1_V12D07-332_C1,0,1,0,0,1,2
TTATGAATGAAAGGGA-1_V12D07-332_C1,1,1,1,0,0,3
GCTGAGGCGTGAGTAT-1_V12D07-332_C1,0,1,1,0,0,2
GCGCCGTTCCACGATA-1_V12D07-332_C1,0,4,0,0,0,4
CGCATGGTGCGATGCT-1_V12D07-332_C1,0,1,0,0,1,2
AGGTTTCACACACCTT-1_V12D07-332_C1,1,4,0,0,0,5
CAAGGATCGCATGTTC-1_V12D07-332_C1,0,0,0,0,0,0
ACGTTAATGTCGAAGA-1_V12D07-332_C1,0,2,0,0,0,2
TCCAGAGCACCGGTTC-1_V12D07-332_C1,1,0,0,0,1,2
GATTCGACGGTTCACG-1_V12D07-332_C1,0,2,0,0,0,2
GTTTCTGCAGTCTCCC-1_V12D07-332_C1,0,0,0,0,2,2
GCTGCACGGTTTCTTA-1_V12D07-332_C1,0,4,0,1,0,5
CGTGCAGACTGGGACA-1_V12D07-332_C1,1,0,0,0,0,1
GTGTTACTATGCGTCC-1_V12D07-332_C1,0,0,0,0,0,0
TCCTCGGGCTGGGCTT-1_V12D07-332_C1,1,3,0,0,1,5
GTGAGGACACTTAAGG-1_V12D07-332_C1,0,1,0,0,0,1
ATACGCCGGCGAAACC-1_V12D07-332_C1,0,0,0,0,0,0
TCTGCCAGAAACTGCA-1_V12D07-332_C1,1,0,0,0,0,1
TTCTGCGGGTTAGCGG-1_V12D07-332_C1,0,0,0,0,0,0
CTCGGTACCACTGCTC-1_V12D07-332_C1,1,0,0,0,0,1
GTAAGTAACAGTCTGG-1_V12D07-332_C1,0,2,0,0,0,2
GTGCGTGTATATGAGC-1_V12D07-332_C1,0,2,1,1,0,4
ATTTGTCTTGGGAGCT-1_V12D07-332_C1,0,3,0,0,0,3
CCTCGGACCGGGATAG-1_V12D07-332_C1,0,3,0,0,0,3
TAGGTGCTCGCCTAGC-1_V12D07-332_C1,0,1,0,0,0,1
CTTTAGGAACACTGTT-1_V12D07-332_C1,0,0,0,0,0,0
TCGGGCCGTCGTGGTA-1_V12D07-332_C1,0,2,0,0,0,2
AGTGCTTGCACGAATA-1_V12D07-332_C1,1,1,0,0,0,2
TGCAGTTTCCTCCCAT-1_V12D07-332_C1,0,0,1,1,0,2
TGAGAGATTTACCACG-1_V12D07-332_C1,0,2,0,0,0,2
GAAACAGATGACCACC-1_V12D07-332_C1,1,0,1,0,0,2
AGCAACATATCTTATT-1_V12D07-332_C1,0,1,1,0,0,2
CAAGTGTGGTTGCAAA-1_V12D07-332_C1,1,1,0,0,0,2
GCCTCATCTGGAAATA-1_V12D07-332_C1,0,1,0,0,0,1
AACCCTACTGTCAATA-1_V12D07-332_C1,0,0,0,1,0,1
ACGTATTACTCCGATC-1_V12D07-332_C1,0,0,0,1,0,1
TCTGGGAACCTTTGAA-1_V12D07-332_C1,2,0,0,0,0,2
GCTCGCTCATGTCCAA-1_V12D07-332_C1,2,1,0,0,0,3
GCGCAAGAGCGCGCTG-1_V12D07-332_C1,1,1,0,1,0,3
TTGACGCTCCATGAGC-1_V12D07-332_C1,0,1,0,0,0,1
TATAGATGGTCGCAGT-1_V12D07-332_C1,0,0,0,0,0,0
TTACATGCCACAACTA-1_V12D07-332_C1,0,0,0,0,0,0
ACATGGCGCCAAAGTA-1_V12D07-332_C1,1,0,0,0,0,1
TATGGTTAGTGGGAGA-1_V12D07-332_C1,2,1,0,0,0,3
CATGACTTCGCTGAAT-1_V12D07-332_C1,1,0,0,0,0,1
ACCACCAATGTAACAA-1_V12D07-332_C1,0,0,0,0,0,0
TCTTAGAGCTCCAATT-1_V12D07-332_C1,0,0,0,1,0,1
CCACGAATTTAACCTC-1_V12D07-332_C1,0,0,0,0,0,0
TTCTTGCTAGCATCTC-1_V12D07-332_C1,1,0,0,0,0,1
ACACCTTACTACTTGC-1_V12D07-332_C1,1,1,0,0,0,2
AGTCGGTTGCGTGAGA-1_V12D07-332_C1,0,0,1,0,1,2
ACCTACAGTATGTGGT-1_V12D07-332_C1,1,1,0,0,0,2
GAGGATAAACAGTGCT-1_V12D07-332_C1,0,4,0,0,0,4
TTCCGGTATCTGTGTC-1_V12D07-332_C1,1,0,1,0,1,3
GGAGGCCGAAGTCGTC-1_V12D07-332_C1,0,1,0,0,1,2
TTCGCTAGGAAGTTGT-1_V12D07-332_C1,1,0,0,0,3,4
TAAAGACAACCCTTTA-1_V12D07-332_C1,0,1,0,0,0,1
GTTGCGCTAACATTAC-1_V12D07-332_C1,0,0,0,0,4,4
GCTGAACTCTCCAGGG-1_V12D07-332_C1,0,0,0,0,0,0
AGCCCTGTCGCACCGT-1_V12D07-332_C1,0,4,0,0,1,5
AGCGCTAGAGCGATGT-1_V12D07-332_C1,0,2,0,0,1,3
TGCGCCGTTAATAACG-1_V12D07-332_C1,0,3,0,0,0,3
TGACAACGCATGTCGC-1_V12D07-332_C1,2,1,1,0,0,4
CGTCTTGAGTGTGACG-1_V12D07-332_C1,2,6,0,0,0,8
GATAGGATTAATTACA-1_V12D07-332_C1,0,1,0,0,0,1
GATACCGTGTCGGAGT-1_V12D07-332_C1,1,2,0,0,0,3
TGTGTCGAAGTCGAGG-1_V12D07-332_C1,0,0,0,0,0,0
GGATCAGAGCCATCAG-1_V12D07-332_C1,0,0,0,0,0,0
GTCCCAATCATCCCGC-1_V12D07-332_C1,3,1,1,0,0,5
TGCCACACTAGAGGAA-1_V12D07-332_C1,0,0,1,0,0,1
TGAATTTCACTTGCCT-1_V12D07-332_C1,0,3,1,0,0,4
CTCAGATTGTGATAAG-1_V12D07-332_C1,1,3,1,0,0,5
CGGACGTTACTTGAAG-1_V12D07-332_C1,1,0,0,0,0,1
CCGCCTTGCGATGTCG-1_V12D07-332_C1,0,3,0,0,0,3
CCAGTCAAATCTCTTA-1_V12D07-332_C1,0,2,1,0,0,3
AAACAGCTTTCAGAAG-1_V12D07-332_C1,0,1,1,0,0,2
TAGCTGATGTGAAGCG-1_V12D07-332_C1,0,3,2,0,0,5
CTTATGCGCTCAGGGC-1_V12D07-332_C1,2,2,0,0,0,4
TGGCTCTTGTCGCGTA-1_V12D07-332_C1,0,1,1,0,0,2
TTGTGAGGCATGACGC-1_V12D07-332_C1,2,3,0,0,0,5
CATAAGCTCTCCGTCT-1_V12D07-332_C1,0,3,0,0,0,3
CCTTCTCAGCGTTCCT-1_V12D07-332_C1,0,1,1,0,0,2
TGCAGCTACGTACTTC-1_V12D07-332_C1,0,2,0,0,0,2
CTCTACACTGGCGATT-1_V12D07-332_C1,1,3,0,0,0,4
TGCAGATCGTCCTAGG-1_V12D07-332_C1,2,2,0,0,0,4
TGCCAAAGTCAGACTT-1_V12D07-332_C1,0,1,2,0,0,3
ACAATAGTCGTACGTT-1_V12D07-332_C1,0,6,1,0,0,7
CATGCCAACTCGCAAA-1_V12D07-332_C1,0,1,0,0,0,1
TGCAGAACTATATCGT-1_V12D07-332_C1,2,3,1,0,0,6
TCGTGTCACGCTGACA-1_V12D07-332_C1,0,5,2,1,0,8
TGATCAGGGAACTGCT-1_V12D07-332_C1,0,1,0,0,0,1
CTTGCAACCGCCTCCT-1_V12D07-332_C1,2,2,0,0,0,4
AGCCCATACATGTAAG-1_V12D07-332_C1,1,3,0,0,0,4
ATCCAATGGAGGGTCC-1_V12D07-332_C1,0,1,0,0,0,1
AAACCGGGTAGGTACC-1_V12D07-332_C1,0,0,1,0,0,1
GCAACCACGGCCGCGT-1_V12D07-332_C1,1,2,0,0,0,3
CGCTTATTCCCGGTCG-1_V12D07-332_C1,0,0,1,0,0,1
TTACTCTGGTACGTAC-1_V12D07-332_C1,1,0,0,0,0,1
GTGGTTTCCGCCTTTC-1_V12D07-332_C1,0,3,0,0,0,3
ATAGGCGGCTATAGAA-1_V12D07-332_C1,0,4,0,0,1,5
GTGCCATCACACGGTG-1_V12D07-332_C1,0,1,1,0,0,2
CCCAACATACGTCGCG-1_V12D07-332_C1,0,1,1,0,0,2
CGGTGCAGATAGAACG-1_V12D07-332_C1,0,1,0,0,0,1
GGGCGGGTTCCCTACG-1_V12D07-332_C1,1,5,1,0,0,7
TGAGCCATACAGTCTC-1_V12D07-332_C1,0,2,0,0,0,2
CTCCGCCCACATGAGG-1_V12D07-332_C1,0,2,1,0,1,4
GTTGAACCGGTTCCAT-1_V12D07-332_C1,1,4,0,0,0,5
TTGACTACCATATGGT-1_V12D07-332_C1,1,0,1,0,0,2
ACCATCGTATATGGTA-1_V12D07-332_C1,0,4,0,0,0,4
TGCGTAAGAACCTGAT-1_V12D07-332_C1,0,2,1,0,1,4
AGAAGGTTGCCGAATT-1_V12D07-332_C1,0,2,0,0,1,3
AGGACGACCCATTAGA-1_V12D07-332_C1,0,2,0,0,0,2
GGTGCTGGTACACATT-1_V12D07-332_C1,0,0,0,0,0,0
GCGCTATGCCGAGGCA-1_V12D07-332_C1,0,3,0,0,0,3
ACCCGGTTACACTTCC-1_V12D07-332_C1,2,3,0,0,1,6
TAACTCATCCGCGCGG-1_V12D07-332_C1,1,3,1,0,0,5
CACAATGAGCTGCTAT-1_V12D07-332_C1,0,1,1,0,2,4
GTTACTTTGGGCCTAG-1_V12D07-332_C1,2,2,0,0,0,4
GGGCCCGTCTTAAACA-1_V12D07-332_C1,1,2,0,0,0,3
GAAATTGTCTCTATAA-1_V12D07-332_C1,0,1,0,0,0,1
GGCGCATGAATTGATG-1_V12D07-332_C1,0,2,1,0,2,5
CATATAGGTACAGTCA-1_V12D07-332_C1,0,3,0,0,0,3
TCAACGAGGAGACAAA-1_V12D07-332_C1,0,5,0,0,0,5
TTGCACAATTCAGAAA-1_V12D07-332_C1,0,1,0,0,0,1
CATCGGACGGGTTAAT-1_V12D07-332_C1,0,1,0,0,1,2
ATTAAACATGCGGACC-1_V12D07-332_C1,1,2,0,0,0,3
TATCTACCACAGCGGG-1_V12D07-332_C1,0,4,0,0,0,4
CGAGACCCTAGAGTGT-1_V12D07-332_C1,0,0,1,0,0,1
ACATCGATCGTTTACC-1_V12D07-332_C1,2,0,0,0,0,2
ATCGACCCAATACAGA-1_V12D07-332_C1,0,1,0,0,0,1
GAATCTGAACATTCTC-1_V12D07-332_C1,0,1,1,0,0,2
AGTTCCTATTTATGTT-1_V12D07-332_C1,0,0,0,0,0,0
CAGTCTGTATACTGGG-1_V12D07-332_C1,2,4,0,1,0,7
GGAGACGACACCTTTG-1_V12D07-332_C1,1,1,0,0,0,2
CCTAAATTAACGGTTC-1_V12D07-332_C1,0,3,0,0,1,4
GCTACGACTTATTGGG-1_V12D07-332_C1,1,1,0,0,0,2
CTGTGCAGGGTAGGTC-1_V12D07-332_C1,0,1,0,0,0,1
ACGCCGCTAGACGACC-1_V12D07-332_C1,0,0,0,1,0,1
ACTTGACTCCCTCTTT-1_V12D07-332_C1,1,2,0,1,0,4
CGCCTCCCTCCTCTAT-1_V12D07-332_C1,1,0,0,0,0,1
CTAGATTTACGACGGC-1_V12D07-332_C1,2,1,0,0,5,8
GATGCTGTATTTCATC-1_V12D07-332_C1,0,1,0,0,0,1
TGCGTTTGTTGACACT-1_V12D07-332_C1,0,3,0,0,0,3
CGTGCCCTCCCGAAGA-1_V12D07-332_C1,0,1,2,0,0,3
ACTCTCTGACTTAGGT-1_V12D07-332_C1,2,1,0,0,0,3
CTGGGTAGGCAGTTAA-1_V12D07-332_C1,0,0,0,1,0,1
GTTTGGCCCAAGTTAT-1_V12D07-332_C1,0,0,0,0,0,0
GAATGTGGTCCGGATT-1_V12D07-332_C1,0,0,0,0,0,0
CCCAGTTAAGGCGCCG-1_V12D07-332_C1,0,1,0,0,0,1
CGGTACTAGAATCAAA-1_V12D07-332_C1,0,0,0,0,0,0
GCTTAATGTAACTAAC-1_V12D07-332_C1,0,1,0,1,0,2
AGGACAGTCGAATCCC-1_V12D07-332_C1,2,1,0,0,2,5
GACAGCCAGACCTGAC-1_V12D07-332_C1,1,3,0,0,0,4
GGCGAAATCTAACTTG-1_V12D07-332_C1,0,0,0,0,0,0
CTGGTAACACATAGAA-1_V12D07-332_C1,2,0,0,0,0,2
TAGCCATTTCAAAGTC-1_V12D07-332_C1,0,0,0,0,0,0
GGGATTTACCGCACCT-1_V12D07-332_C1,0,0,0,2,0,2
ATGCCATTTGCGACCA-1_V12D07-332_C1,1,0,0,0,0,1
GAATAGACGCGACCCA-1_V12D07-332_C1,1,0,0,0,0,1
TGTATGGCGCAGACAG-1_V12D07-332_C1,0,0,0,0,0,0
GGATGAAGATCGCTGA-1_V12D07-332_C1,0,0,0,0,0,0
CGACAATTTGATCTAA-1_V12D07-332_C1,1,1,0,0,0,2
AAAGTTGACTCCCGTA-1_V12D07-332_C1,0,0,0,0,0,0
CGCGGCTCAACTTGAA-1_V12D07-332_C1,0,0,0,0,0,0
CACGCGGAACTGTTGC-1_V12D07-332_C1,2,0,0,0,0,2
TCTTAGAGTGAACTCT-1_V12D07-332_C1,0,0,0,0,0,0
AGTCCATTGGCTGATG-1_V12D07-332_C1,1,0,0,0,0,1
TTAAGATAGGATTGAC-1_V12D07-332_C1,0,0,0,0,0,0
ACATCCTGGTAACTGT-1_V12D07-332_C1,1,0,0,1,0,2
CACCTTGGCGCCTTTG-1_V12D07-332_C1,0,0,0,0,0,0
GCTAGACCGTCTACTG-1_V12D07-332_C1,4,0,0,0,1,5
CGGCCCAGGTATATCC-1_V12D07-332_C1,3,0,3,0,1,7
GTCCATTACTGCTACG-1_V12D07-332_C1,0,1,0,0,0,1
GGGTTTAGGATAGGAT-1_V12D07-332_C1,3,4,0,0,0,7
TAATTAGGACATCCGT-1_V12D07-332_C1,0,0,0,0,0,0
GCTCCCAGTCGGTCCA-1_V12D07-332_C1,0,0,0,0,0,0
ATTCGTGCTATCTCTT-1_V12D07-332_C1,1,2,0,0,0,3
GTTAACTATGTTGTCA-1_V12D07-332_C1,1,1,0,0,0,2
GCTCCGCTCGCTTCAG-1_V12D07-332_C1,1,2,0,0,4,7
GCAACGGCTAGTTATG-1_V12D07-332_C1,1,1,0,0,4,6
AATCGCGCAGAGGACT-1_V12D07-332_C1,0,4,0,1,0,5
AGGTTACACCATGCCG-1_V12D07-332_C1,0,0,1,0,0,1
CGAGATTTCGCTCGGG-1_V12D07-332_C1,0,0,0,0,0,0
CGATAATACTCAGGTT-1_V12D07-332_C1,0,1,0,0,0,1
AAGGCAGGCTGTCTCC-1_V12D07-332_C1,0,0,0,0,0,0
GTAAGTCCACACTCTA-1_V12D07-332_C1,0,1,0,0,0,1
ATGAGGGCAGCGGCTA-1_V12D07-332_C1,0,2,0,0,0,2
GCCGCACTCCGTTTCA-1_V12D07-332_C1,1,0,0,0,1,2
GAGCACGGCGCCTCTT-1_V12D07-332_C1,0,5,0,0,2,7
ACAATTTGGCCATATT-1_V12D07-332_C1,0,1,0,0,0,1
CTGGTTCGCGAGCTAC-1_V12D07-332_C1,1,3,0,0,0,4
GACGGTCCTAGGGTGT-1_V12D07-332_C1,0,8,0,0,0,8
ACTCGCGATCTGACGC-1_V12D07-332_C1,1,1,0,0,0,2
GTGTACGAACCGTTCC-1_V12D07-332_C1,1,5,0,0,0,6
CTTTGACGTCGCTTCT-1_V12D07-332_C1,0,0,0,0,0,0
CGTTATCATACTTCCA-1_V12D07-332_C1,0,0,0,0,0,0
GCTATGCCAGCTTATG-1_V12D07-332_C1,0,5,0,0,0,5
CAGTCGGCCTAGATAT-1_V12D07-332_C1,0,3,2,0,0,5
CCCGTGAGGGCGGTGA-1_V12D07-332_C1,0,4,2,0,0,6
TCTCGTGTTACGAGGA-1_V12D07-332_C1,1,5,1,0,0,7
ACGTCTCGTTCCGGGA-1_V12D07-332_C1,0,5,0,0,0,5
CGAGAGCGCGTAGATA-1_V12D07-332_C1,0,3,2,0,0,5
GACAGATTTCTGGCTC-1_V12D07-332_C1,0,3,0,0,0,3
GGGCCTAAATGGGCTA-1_V12D07-332_C1,0,4,4,0,0,8
ACTTGTAGTCCCTTCA-1_V12D07-332_C1,1,3,0,0,0,4
CCCGAAGTTTCGCGAA-1_V12D07-332_C1,0,0,0,0,0,0
ACCATCCGCCAACTAG-1_V12D07-332_C1,0,4,0,0,0,4
TGCGAATATGGGATTT-1_V12D07-332_C1,3,4,0,0,0,7
TACATCCCTATCCCTG-1_V12D07-332_C1,1,5,1,0,0,7
GTGGGAAGACTGAATC-1_V12D07-332_C1,1,2,1,0,0,4
TCAACATCGACCGAGA-1_V12D07-332_C1,0,5,0,0,0,5
CTATGTGAGTCACGGC-1_V12D07-332_C1,2,4,0,0,0,6
CCGAACACTGGGCCTC-1_V12D07-332_C1,2,0,0,0,0,2
AAACTTGCAAACGTAT-1_V12D07-332_C1,0,1,0,0,0,1
AGGGCGAGCAGCTGAT-1_V12D07-332_C1,2,2,0,0,0,4
AACACGAGACGCGGCC-1_V12D07-332_C1,0,7,1,0,0,8
TGACGAATATTTCCCT-1_V12D07-332_C1,0,5,0,0,0,5
TCGGAGAGTATCGGGA-1_V12D07-332_C1,2,2,1,0,0,5
CAAATCTCTCACAAGG-1_V12D07-332_C1,0,4,1,0,0,5
AGGCCCTAGAACGCCA-1_V12D07-332_C1,0,1,0,0,0,1
TAGAGATCATGCAACT-1_V12D07-332_C1,2,0,1,0,0,3
TTGTTTCCATACAACT-1_V12D07-332_C1,1,1,0,0,0,2
GAGAGGTGCATTCTGG-1_V12D07-332_C1,0,2,0,0,0,2
GTGGACCAACCCGATT-1_V12D07-332_C1,2,2,0,0,0,4
CTGGGCCTGCTATATC-1_V12D07-332_C1,0,0,0,0,0,0
CATAGTCCACAAGAAC-1_V12D07-332_C1,3,3,1,0,0,7
TTGACATGAACGTGGA-1_V12D07-332_C1,2,2,0,0,0,4
GGTTACCACCCTCGGG-1_V12D07-332_C1,0,2,0,0,0,2
TACCGGTCGTTTCCAT-1_V12D07-332_C1,1,3,2,0,0,6
CGAGTACTAAAGAGGA-1_V12D07-332_C1,0,0,0,0,0,0
GCAAGAATTCCTTGGC-1_V12D07-332_C1,0,3,1,0,0,4
TCGCCGAAGTTGCGTC-1_V12D07-332_C1,1,5,0,0,0,6
TTGAGAGTACTGCTAA-1_V12D07-332_C1,1,1,2,0,0,4
GCCACAATTTAAGGAC-1_V12D07-332_C1,0,5,0,0,0,5
ATATTCAGTTAAACCT-1_V12D07-332_C1,0,2,4,0,0,6
TGAGTGCCTCTTAAAT-1_V12D07-332_C1,0,2,0,0,0,2
ATCAGACGGCACGCCG-1_V12D07-332_C1,1,0,0,0,0,1
GTGCGAAATCGAACAC-1_V12D07-332_C1,1,2,0,0,1,4
GTGCCGCTTCAAAGGT-1_V12D07-332_C1,0,3,1,0,0,4
GATACGATGGGAGTCA-1_V12D07-332_C1,0,3,0,0,0,3
GACACTGAGTTCAGTG-1_V12D07-332_C1,0,2,1,0,0,3
ATCCTGCGTGGAATGG-1_V12D07-332_C1,1,1,1,0,0,3
ATCCTACCTAAGCTCT-1_V12D07-332_C1,0,6,0,0,0,6
AGTGATATGAGTAGTT-1_V12D07-332_C1,0,5,2,0,0,7
ATGATGCAATGGTACA-1_V12D07-332_C1,0,3,1,0,0,4
GAAACCGAATTACCTT-1_V12D07-332_C1,0,0,1,0,0,1
AGTGACCTACTTTACG-1_V12D07-332_C1,1,1,1,0,1,4
CAAATGTCCTTCCGTG-1_V12D07-332_C1,0,0,1,0,0,1
TTACTGGGATATTTCA-1_V12D07-332_C1,0,3,2,0,1,6
CTTGCCCAGGCTCTAC-1_V12D07-332_C1,0,1,1,0,0,2
AAATCGTGTACCACAA-1_V12D07-332_C1,1,2,1,0,0,4
GTGATCATAGATCTGC-1_V12D07-332_C1,0,4,0,1,0,5
TGGCAGATTACGATCA-1_V12D07-332_C1,0,1,0,0,0,1
TCACCCTCTTAAGATT-1_V12D07-332_C1,0,4,0,1,1,6
CAGGATATATCGTTGT-1_V12D07-332_C1,0,2,0,0,1,3
CCTGACCACCGATGGT-1_V12D07-332_C1,0,4,0,0,0,4
CTAAAGGGAAATAGGA-1_V12D07-332_C1,0,1,0,0,0,1
CCGCTATCAGCACCAG-1_V12D07-332_C1,0,1,0,0,2,3
CTTTAGTGCTATTATT-1_V12D07-332_C1,1,2,0,0,1,4
CGGGAATTTATGTAAA-1_V12D07-332_C1,0,0,1,0,0,1
TACGACTGCCTCTTAG-1_V12D07-332_C1,0,0,1,1,1,3
AAACTGCTGGCTCCAA-1_V12D07-332_C1,0,2,1,0,2,5
GTACGTTTGCCCGTCA-1_V12D07-332_C1,0,1,0,0,0,1
GGCAAGGCGAAATAGC-1_V12D07-332_C1,0,1,0,0,0,1
GATCTTGGAGGGCATA-1_V12D07-332_C1,0,1,0,1,0,2
AGCGTGGTATTCTACT-1_V12D07-332_C1,0,2,1,1,0,4
CTAAGGGAATGATTGG-1_V12D07-332_C1,0,2,0,1,1,4
CATGGTAAGTAGCGTT-1_V12D07-332_C1,0,0,0,0,0,0
CGTTGAGCGACCGTCG-1_V12D07-332_C1,0,4,0,0,0,4
TGCCCGTACCGTTAAA-1_V12D07-332_C1,1,2,0,0,2,5
ACAAGGGCAGGCTCTG-1_V12D07-332_C1,0,3,0,1,0,4
GAGATCTTCCATGACA-1_V12D07-332_C1,0,1,0,0,2,3
AATGACGTAGGATGTC-1_V12D07-332_C1,2,3,0,1,0,6
GTGGTGGCCAAGTGAA-1_V12D07-332_C1,0,2,0,0,0,2
TCCCGTGTGCAATTTG-1_V12D07-332_C1,0,1,0,0,0,1
ACATCGTATGCAATGG-1_V12D07-332_C1,1,2,0,0,0,3
GCGAAACTTAACTGGA-1_V12D07-332_C1,0,1,0,0,0,1
AATTGAACGCTCTGGT-1_V12D07-332_C1,0,1,0,2,0,3
ACAAATGGTAGTGTTT-1_V12D07-332_C1,2,1,0,0,0,3
ATGGTCGCGTGGTTTC-1_V12D07-332_C1,1,0,0,0,0,1
TGTTATTGTATGTGGC-1_V12D07-332_C1,2,0,0,0,0,2
TTCCGGTTACCCACTT-1_V12D07-332_C1,0,1,1,0,0,2
GAGTGTGCGGTACCCA-1_V12D07-332_C1,0,0,0,0,0,0
CAAGATATTATAACGT-1_V12D07-332_C1,1,5,0,0,0,6
ACACACCAGGACCAGT-1_V12D07-332_C1,1,1,0,1,0,3
ATGGGCCTCGGCCTCT-1_V12D07-332_C1,1,1,0,1,0,3
AAGGTGATAAACCAGC-1_V12D07-332_C1,0,2,0,0,0,2
TCTTACTTATGCCTCT-1_V12D07-332_C1,0,0,0,0,0,0
AAAGTGTGATTTATCT-1_V12D07-332_C1,0,0,0,0,0,0
TGCTCCACAGTTCTTA-1_V12D07-332_C1,1,0,0,0,0,1
CTGGCTGATTCATCCT-1_V12D07-332_C1,3,0,0,0,2,5
TAAGGCTGAATCCCTC-1_V12D07-332_C1,1,2,0,2,0,5
TCTAGTGATATCGTGG-1_V12D07-332_C1,3,0,0,0,1,4
TCGAAGAACCGAGCAC-1_V12D07-332_C1,1,2,0,0,0,3
GACAAACATATGCAGG-1_V12D07-332_C1,0,0,0,0,0,0
AAGTCAATTGTCGTCA-1_V12D07-332_C1,1,0,0,0,0,1
AGTGAACAAACTTCTC-1_V12D07-332_C1,3,1,0,0,0,4
CATGATGGAAGTTAGC-1_V12D07-332_C1,0,0,0,0,0,0
AAGTGCCTTGACTGTA-1_V12D07-332_C1,0,2,0,0,0,2
ATCGCCAGTCAACATT-1_V12D07-332_C1,5,2,2,1,1,11
ACCGCGGTGGAAGTCG-1_V12D07-332_C1,0,0,0,0,1,1
TCTTCTATAACCCGCC-1_V12D07-332_C1,0,1,0,0,0,1
CACATTTCTTGTCAGA-1_V12D07-332_C1,1,0,0,0,0,1
TAGCGTCCCTCGATTG-1_V12D07-332_C1,1,1,0,0,0,2
GTTCGGATCGGGAACA-1_V12D07-332_C1,0,0,0,0,0,0
CAAACTCGCGACGCCG-1_V12D07-332_C1,2,0,0,0,0,2
GTCTTGTAGCTATTCA-1_V12D07-332_C1,0,1,0,0,0,1
TCTCGACGTATCGCCG-1_V12D07-332_C1,0,0,0,0,0,0
TTGCCAAGCAGAACCC-1_V12D07-332_C1,0,1,0,0,0,1
AAACCCGAACGAAATC-1_V12D07-332_C1,0,1,0,0,0,1
TTGAGCAGCCCACGGT-1_V12D07-332_C1,1,1,0,0,0,2
CGCCTTTAGCATGCTC-1_V12D07-332_C1,2,0,0,0,0,2
TGTGGCTCCCACCAAC-1_V12D07-332_C1,0,3,0,0,0,3
CCGCCGTTGAGGATAA-1_V12D07-332_C1,0,1,1,0,0,2
CAATACGAGAGTCTGA-1_V12D07-332_C1,0,1,0,0,1,2
CATCTAGTGAAGGGAA-1_V12D07-332_C1,0,1,0,0,0,1
GGTGGAGGTTGATACG-1_V12D07-332_C1,0,0,0,0,0,0
CCGCACACGAACGTGT-1_V12D07-332_C1,1,0,0,0,0,1
AGAACCCAGCGTGACA-1_V12D07-332_C1,0,1,0,0,0,1
GCGCTCGATCACCTGT-1_V12D07-332_C1,0,1,0,0,1,2
ATCATGGACTACCGAC-1_V12D07-332_C1,0,4,0,0,0,4
TACGCCGCCTCAGAAG-1_V12D07-332_C1,1,1,0,0,0,2
CGACCTACTAGACAAT-1_V12D07-332_C1,0,0,0,0,0,0
GAGTCTTGTAAAGGAC-1_V12D07-332_C1,0,0,0,0,0,0
AATATCCTAGCAAACT-1_V12D07-332_C1,0,1,0,0,0,1
CCCTAGGCAACAAGAG-1_V12D07-332_C1,0,0,1,0,0,1
ACAAAGAAGGTAGGCC-1_V12D07-332_C1,0,1,1,0,0,2
CCCTGGCTGTTCCTTC-1_V12D07-332_C1,1,3,0,0,0,4
TCGCCGCACCGCGTGA-1_V12D07-332_C1,0,5,4,0,0,9
TATAGCGCACGTTATC-1_V12D07-332_C1,1,4,2,0,0,7
TTATCTGACATTAGGA-1_V12D07-332_C1,0,1,1,0,0,2
AGTGGTGTTACCCGTG-1_V12D07-332_C1,0,8,1,0,0,9
GCCAAGAATACTTCTG-1_V12D07-332_C1,0,3,0,0,0,3
CCGGCGTGAGACTCTG-1_V12D07-332_C1,0,1,0,0,0,1
TTCCCGGCGCCAATAG-1_V12D07-332_C1,0,5,0,0,0,5
AAACAGGGTCTATATT-1_V12D07-332_C1,2,4,0,0,0,6
ACAGTAATACAACTTG-1_V12D07-332_C1,1,3,0,0,0,4
CGAACGGCCGGACAAC-1_V12D07-332_C1,0,1,0,0,0,1
GCAACACACTAGAACT-1_V12D07-332_C1,2,8,1,0,0,11
ACTCCCATTCCTAAAG-1_V12D07-332_C1,1,5,0,0,0,6
ACCTGCGTGTCATGTT-1_V12D07-332_C1,0,2,0,0,0,2
TACTTTCCGCACGCCA-1_V12D07-332_C1,0,4,0,0,0,4
AGGTCAGGTGAGAGTG-1_V12D07-332_C1,0,4,0,0,0,4
TCCTCCTAAGACATTC-1_V12D07-332_C1,1,4,0,0,0,5
ATGTGAAAGCCTAATG-1_V12D07-332_C1,0,3,1,0,0,4
AGTCGGCTCAACTTTA-1_V12D07-332_C1,1,3,0,0,0,4
CGATCTGTTGGAGGAC-1_V12D07-332_C1,0,2,0,0,0,2
ACGGGAGTGTCGGCCC-1_V12D07-332_C1,1,4,0,0,0,5
TTAACTTCAGGTAGGA-1_V12D07-332_C1,2,9,0,0,0,11
CCACGGAGCCATAAGA-1_V12D07-332_C1,0,7,0,0,0,7
CTTCTATGTTGAAGTA-1_V12D07-332_C1,1,3,0,0,0,4
CACCGTTGCGCGATAT-1_V12D07-332_C1,2,5,0,0,0,7
TCTAGCAATCTCCGCC-1_V12D07-332_C1,3,1,1,0,0,5
AGTTTGGCCAGACCTA-1_V12D07-332_C1,0,3,0,0,0,3
TTGTAAGGACCTAAGT-1_V12D07-332_C1,0,3,0,0,0,3
AAATTTGCGGGTGTGG-1_V12D07-332_C1,0,4,0,0,0,4
AAGTTCGGCCAACAGG-1_V12D07-332_C1,1,1,0,0,0,2
CCGCTTACCTCACTCT-1_V12D07-332_C1,0,4,0,0,1,5
ATCACGTGCTAATTAA-1_V12D07-332_C1,1,2,2,0,1,6
GGTGAAGTACAGGGAT-1_V12D07-332_C1,1,4,0,0,0,5
GCTGTATTACTGGCCC-1_V12D07-332_C1,1,4,0,0,0,5
AACGGCCATCTCCGGT-1_V12D07-332_C1,0,3,1,0,1,5
TAAGTAACATCTTGAC-1_V12D07-332_C1,1,2,1,0,0,4
TTCTTGAGCCGCGCTA-1_V12D07-332_C1,2,2,0,0,0,4
AGTGCGTAGCTCGTAA-1_V12D07-332_C1,1,2,1,0,0,4
GGGATGGTCGTAACCG-1_V12D07-332_C1,0,4,0,0,0,4
GTCTGGGCGGTCGAGA-1_V12D07-332_C1,1,2,1,0,0,4
CGGAACGTAAACATAG-1_V12D07-332_C1,0,1,1,0,1,3
TGCGACACCCTAGTGC-1_V12D07-332_C1,0,3,0,0,0,3
CAAACGAGTATCGCAG-1_V12D07-332_C1,0,1,0,0,0,1
TCAGTAGGGACTATAA-1_V12D07-332_C1,1,0,0,0,0,1
GCGGTTCCCTATCATG-1_V12D07-332_C1,1,3,0,0,0,4
GTGACTTCAGTAGTGC-1_V12D07-332_C1,1,4,0,0,0,5
CGTCACGTCCATTGGT-1_V12D07-332_C1,4,0,1,0,0,5
ATAAGTTACCGCGACG-1_V12D07-332_C1,1,1,0,0,1,3
CTGAATCCGAGACCTC-1_V12D07-332_C1,1,0,1,0,1,3
TACGACGCTTGCTGCG-1_V12D07-332_C1,0,1,1,0,0,2
GAATTCACCCGGGTGT-1_V12D07-332_C1,0,0,0,0,2,2
GGGTGACACCTTAACT-1_V12D07-332_C1,2,2,0,0,1,5
TGAGTAAATTAGCGTA-1_V12D07-332_C1,2,0,0,0,0,2
GAGTCCGCTTACCGGA-1_V12D07-332_C1,0,3,0,0,0,3
GGCGCGTTCGAGTTTA-1_V12D07-332_C1,0,0,1,0,4,5
ATTCATATACTGTCCA-1_V12D07-332_C1,0,3,0,0,0,3
ATAAACGGACCCGTAA-1_V12D07-332_C1,2,0,0,0,0,2
GTCGTACCATCTCGGG-1_V12D07-332_C1,0,1,1,0,2,4
ATAATAGCTGTTGAAT-1_V12D07-332_C1,1,0,0,0,1,2
TTCCGCGTGAGGCGAT-1_V12D07-332_C1,1,1,1,0,2,5
TACCGGCTCACTGCCC-1_V12D07-332_C1,2,0,0,0,1,3
GTATCTTTCATAACCA-1_V12D07-332_C1,0,3,0,0,0,3
GTTACCTACAACTTGC-1_V12D07-332_C1,0,0,0,0,2,2
TGACTATAATCCTTTC-1_V12D07-332_C1,0,0,0,0,0,0
AAATACCTATAAGCAT-1_V12D07-332_C1,0,3,0,0,0,3
TTATTAGAGCGTGTTC-1_V12D07-332_C1,0,2,1,0,0,3
ATGTGGACATCTTGAT-1_V12D07-332_C1,0,1,0,0,0,1
GTACGCTTCATTGCAC-1_V12D07-332_C1,0,0,1,1,1,3
CACATATTAGCAGGAT-1_V12D07-332_C1,0,1,0,0,1,2
CAAGAGGGCGGAGTAC-1_V12D07-332_C1,2,1,0,1,0,4
TCGCAAAGATGCATTT-1_V12D07-332_C1,3,2,0,0,0,5
GTCGTTATTCGCTTAT-1_V12D07-332_C1,0,1,0,1,0,2
TCGTGTACTATGGATG-1_V12D07-332_C1,2,3,4,0,2,11
GCGGAGAGGGAGAACG-1_V12D07-332_C1,3,2,0,0,1,6
TCACAGGGAATCGCAA-1_V12D07-332_C1,0,1,1,0,0,2
GACTGCACCAGCCCAG-1_V12D07-332_C1,0,1,0,1,0,2
TCCGCTGTCATCCCGG-1_V12D07-332_C1,0,0,0,0,0,0
AGATACTCAAGATCGA-1_V12D07-332_C1,1,2,0,0,0,3
ACTGAATGGCGAAAGT-1_V12D07-332_C1,0,0,1,0,0,1
TCCTACATCCACGGCC-1_V12D07-332_C1,0,0,1,0,0,1
TTCAGCCCTGGTCCAC-1_V12D07-332_C1,0,2,0,0,0,2
TTAGAGTTTAGAAGGA-1_V12D07-332_C1,0,0,0,0,0,0
GGTTAGCTATATGTCT-1_V12D07-332_C1,1,0,0,0,0,1
CTGGTTTCGAGCAAGA-1_V12D07-332_C1,0,1,1,1,0,3
TGGGCCCATACTAATT-1_V12D07-332_C1,0,0,0,0,0,0
ACTTATTTATGTGCCA-1_V12D07-332_C1,0,0,0,0,0,0
TTAGTTATTCGTGGCA-1_V12D07-332_C1,0,0,0,0,0,0
AACCGCTAAGGGATGC-1_V12D07-332_C1,1,0,0,0,0,1
ATACGTCCACTCCTGT-1_V12D07-332_C1,1,0,0,0,0,1
CGACACGCTCCGACAG-1_V12D07-332_C1,3,1,0,1,0,5
TCTGAACTCGTACCCG-1_V12D07-332_C1,0,0,1,0,0,1
AGGATATAGGGATTTA-1_V12D07-332_C1,0,0,0,0,0,0
GTGATCACTAACGCCT-1_V12D07-332_C1,0,1,0,0,0,1
ACCGGGCCTTTGTTGA-1_V12D07-332_C1,1,0,0,0,0,1
TTGACAGGAGCTCCCG-1_V12D07-332_C1,1,2,0,0,0,3
CTCTTCTATTGACTGG-1_V12D07-332_C1,2,4,0,1,0,7
CGTGGCCGAATATCTA-1_V12D07-332_C1,0,0,0,0,0,0
GGTTTAGCCTTTCTTG-1_V12D07-332_C1,1,0,0,0,0,1
TCAAGGTTACTACACC-1_V12D07-332_C1,2,1,0,0,0,3
TTGACTATTGTCCGGC-1_V12D07-332_C1,0,2,0,0,1,3
CGGGAATATAGTATAC-1_V12D07-332_C1,1,1,0,0,3,5
GCAACAGCAGTATGCG-1_V12D07-332_C1,0,2,0,0,0,2
ATCAAACACTGTTCCA-1_V12D07-332_C1,2,2,0,0,0,4
TGGGCAATAGTTGGGT-1_V12D07-332_C1,1,0,0,0,0,1
TGAATGTCAGCCGGCC-1_V12D07-332_C1,1,0,0,0,0,1
CGGCTCTAAAGCTGCA-1_V12D07-332_C1,2,0,0,0,0,2
GGACACAAGTTTACAC-1_V12D07-332_C1,2,1,0,0,0,3
CCGAGAAGTCGCATAA-1_V12D07-332_C1,1,1,0,1,0,3
AACTACCCGTTTGTCA-1_V12D07-332_C1,0,0,0,0,0,0
GCACAAACGAGGCGTG-1_V12D07-332_C1,0,1,0,1,0,2
CACACAGCTTGCGCTC-1_V12D07-332_C1,1,1,0,0,0,2
GTGCTTACATCAGCGC-1_V12D07-332_C1,0,0,0,0,0,0
GCAAACGTCGCCAGGT-1_V12D07-332_C1,1,0,0,0,0,1
GAATAGCATTTAGGGT-1_V12D07-332_C1,0,0,0,0,0,0
TACTGTTTCTCTGGTA-1_V12D07-332_C1,0,0,0,0,0,0
TCCTATCATAGGTAAC-1_V12D07-332_C1,1,1,0,0,0,2
TTCGGTGGAGACGCCC-1_V12D07-332_C1,0,1,0,0,0,1
TGTTGCCGTCGTCCCA-1_V12D07-332_C1,1,1,0,0,0,2
CCAACTTGATAGATCC-1_V12D07-332_C1,1,1,0,0,1,3
CAAAGGTCATCTGAAA-1_V12D07-332_C1,0,1,0,0,1,2
CTAGCTTAATGGTCCC-1_V12D07-332_C1,0,2,0,0,0,2
AGGCCACATTGGTTAC-1_V12D07-332_C1,2,0,0,0,1,3
TTAGGATGGGAGGGTA-1_V12D07-332_C1,0,0,0,0,0,0
TATGACCTTGCGCTGG-1_V12D07-332_C1,0,0,0,0,0,0
ATATACATGTATGGTA-1_V12D07-332_C1,0,0,0,0,0,0
TGTGTGACCATGAATC-1_V12D07-332_C1,1,0,0,0,0,1
CCCACTCCACGGTATC-1_V12D07-332_C1,0,4,2,0,0,6
GGGCAGACGTCACTGC-1_V12D07-332_C1,0,2,0,0,0,2
TCAAAGAGCTATCTGT-1_V12D07-332_C1,1,3,0,0,0,4
AGATGCATCCTGTGTC-1_V12D07-332_C1,0,0,0,0,0,0
GTGAAGTCACGACTCG-1_V12D07-332_C1,0,3,0,0,0,3
TGATTCAGGTCCCGCG-1_V12D07-332_C1,0,0,1,0,0,1
CGCCACAGGTCGCGAT-1_V12D07-332_C1,1,0,1,0,0,2
TTGAATCGTTGTATAA-1_V12D07-332_C1,0,4,0,0,0,4
TGGCCAATTTGGTACT-1_V12D07-332_C1,2,4,1,0,0,7
CGACCCTTAACGCCGG-1_V12D07-332_C1,0,4,0,0,0,4
TCGGCGTACTGCACAA-1_V12D07-332_C1,0,2,0,0,0,2
GAGTAAGGCCACGGGA-1_V12D07-332_C1,1,4,0,0,0,5
ATCAGCTCGTCCACTA-1_V12D07-332_C1,0,0,0,0,0,0
AGGATCACGCGATCTG-1_V12D07-332_C1,0,3,1,0,0,4
AAATGGCCCGTGCCCT-1_V12D07-332_C1,0,0,0,0,0,0
CAGTACCAGTTTACGT-1_V12D07-332_C1,1,3,1,0,0,5
GGTCGTAAGCTCGCAC-1_V12D07-332_C1,1,2,0,0,0,3
CGTTCATGGTGCGCGT-1_V12D07-332_C1,1,4,2,0,0,7
GACTACAAAGCGGTGG-1_V12D07-332_C1,1,4,1,0,0,6
CAGCTGGCGTAACCGT-1_V12D07-332_C1,2,2,0,0,0,4
ACTCGTAACCCGTCCT-1_V12D07-332_C1,0,4,3,0,0,7
CATATGTCAGGCTACG-1_V12D07-332_C1,0,4,2,0,0,6
GCCCGACTTCTTCCCG-1_V12D07-332_C1,0,4,2,0,0,6
CTGGCATCCGAATGAG-1_V12D07-332_C1,0,1,0,0,0,1
AAGTGCGTTAGAATCT-1_V12D07-332_C1,1,5,0,0,0,6
AGAAGTGATTCGTGAT-1_V12D07-332_C1,1,7,1,0,0,9
TACCTTAAGATTTCCC-1_V12D07-332_C1,0,1,1,0,0,2
AATGACAGCAATGTCT-1_V12D07-332_C1,1,2,0,0,0,3
TCAACGCAGGAAATAA-1_V12D07-332_C1,4,3,2,0,0,9
TATTCCTCCGCCCACT-1_V12D07-332_C1,2,0,0,0,0,2
ATCAAACGAAGGTTTG-1_V12D07-332_C1,1,6,1,0,0,8
TTGATTAGCTGTTTCT-1_V12D07-332_C1,0,2,0,0,0,2
CTGCTGAGGCCACGAA-1_V12D07-332_C1,0,1,3,0,0,4
CCGTGTTAAATTCCAT-1_V12D07-332_C1,0,4,0,0,0,4
CACGTCGGCAACCTCT-1_V12D07-332_C1,0,3,0,0,0,3
GTATTCTGAGAAACGA-1_V12D07-332_C1,0,1,3,0,0,4
CGGTGCGCGTTGGTCC-1_V12D07-332_C1,1,5,0,0,0,6
GTGATTCGCCGCTCAA-1_V12D07-332_C1,0,5,1,0,0,6
GCCCGCGCGTAAACGG-1_V12D07-332_C1,0,3,0,0,0,3
AACGTACTGTGGGTAC-1_V12D07-332_C1,0,3,0,0,0,3
GAGTATGCCCGCCTTG-1_V12D07-332_C1,0,2,1,0,0,3
TGATTCTGTCGCCGGT-1_V12D07-332_C1,0,1,1,0,1,3
GGGCGGCAAATGAATT-1_V12D07-332_C1,0,2,0,0,0,2
TTCCAATCTGGCTATC-1_V12D07-332_C1,0,2,2,0,0,4
GGAACCGTGTAAATTG-1_V12D07-332_C1,0,1,0,0,0,1
TTGGTCACACTCGTAA-1_V12D07-332_C1,0,3,2,0,0,5
CGAACCCGCATGCGTC-1_V12D07-332_C1,0,0,0,0,1,1
GGGCGTCACCACGTAA-1_V12D07-332_C1,3,0,0,0,2,5
TACCAGAAGTAGGTTC-1_V12D07-332_C1,2,0,1,0,0,3
TTGGATATCGTCTACG-1_V12D07-332_C1,3,0,0,0,2,5
TAGATATGGACTGGAA-1_V12D07-332_C1,2,0,0,0,0,2
GCGACGATAGTTGTAC-1_V12D07-332_C1,3,0,0,0,1,4
CTGGATTTACACTTGA-1_V12D07-332_C1,1,0,1,0,1,3
GTTATATTATCTCCCT-1_V12D07-332_C1,0,0,1,0,1,2
TATTCCACTCAGCTCG-1_V12D07-332_C1,1,0,0,0,0,1
CTGTTACCCAATCTAG-1_V12D07-332_C1,1,0,0,0,1,2
ACGCGAAGTCAGACGA-1_V12D07-332_C1,2,0,1,0,0,3
GATAGGTAACGTTGAC-1_V12D07-332_C1,1,0,0,0,1,2
TGTTCGTATTGCGGTG-1_V12D07-332_C1,0,0,0,0,2,2
GGTCAGTGGGTCCCAC-1_V12D07-332_C1,0,0,0,0,2,2
AATTCTAGAGTTAGGC-1_V12D07-332_C1,1,0,0,0,0,1
GTTTACGTTCCATCTG-1_V12D07-332_C1,1,0,1,0,0,2
AGACCCACCGCTGATC-1_V12D07-332_C1,1,0,0,0,0,1
TCTAGCATGCCCAGAA-1_V12D07-332_C1,4,0,0,0,0,4
CCCGCAGCGCGAACTA-1_V12D07-332_C1,0,0,0,0,0,0
CTCTATTTGGCTGCAG-1_V12D07-332_C1,1,0,3,1,0,5
TTCTGCCGCGCCTAGA-1_V12D07-332_C1,2,0,1,0,0,3
ACTCCCTAGAATAGTA-1_V12D07-332_C1,0,4,1,0,3,8
CCGAACCTTCCCGGCC-1_V12D07-332_C1,1,3,0,0,0,4
TCAGACGCTATAGAAG-1_V12D07-332_C1,0,2,0,0,1,3
CAGGCGCCATGCTAGG-1_V12D07-332_C1,0,2,0,0,0,2
CACTCGAGCTGAACAA-1_V12D07-332_C1,2,2,0,1,2,7
ACAAGGAAATCCGCCC-1_V12D07-332_C1,1,0,0,0,0,1
ACCACGTGCAGCTATA-1_V12D07-332_C1,0,0,0,1,0,1
ACGGCGACGATGGGAA-1_V12D07-332_C1,0,0,1,0,0,1
TTACTAAAGGACTTTA-1_V12D07-332_C1,1,1,0,0,0,2
GGCTGAAATAGCAAAG-1_V12D07-332_C1,1,1,0,1,1,4
TTAGACGAGTCACCTC-1_V12D07-332_C1,2,0,0,0,0,2
GTAGTCGCGGGAATCA-1_V12D07-332_C1,0,0,0,0,0,0
GCAAACCCTACATTAT-1_V12D07-332_C1,1,0,0,0,0,1
GTTAAAGTAGGACTGG-1_V12D07-332_C1,0,0,1,0,0,1
ACCCTCCCTTGCTATT-1_V12D07-332_C1,2,4,1,1,0,8
CATGTCTCATTTATGG-1_V12D07-332_C1,1,1,0,0,0,2
AATAGAATCTGTTTCA-1_V12D07-332_C1,2,1,1,1,0,5
TCTCATGAGATAGGGT-1_V12D07-332_C1,1,1,0,0,0,2
ATGACTATGCGACATT-1_V12D07-332_C1,1,2,0,0,0,3
CCTAACCCAAACAAGT-1_V12D07-332_C1,2,0,0,1,0,3
AGTCAAGATGACACTT-1_V12D07-332_C1,0,0,0,0,0,0
CGGGAGCTTCAGTGTA-1_V12D07-332_C1,1,2,0,0,0,3
CCACAGTACCCATCCT-1_V12D07-332_C1,2,0,0,0,0,2
GAGCGCGCACGAGTAG-1_V12D07-332_C1,0,0,0,1,0,1
ACCAGTGCGGGAGACG-1_V12D07-332_C1,3,3,0,1,0,7
TCCTTACGACGGTCCG-1_V12D07-332_C1,2,1,0,0,0,3
TAGTCGATCACGGGTT-1_V12D07-332_C1,0,0,0,0,0,0
AGACGAAGTGCCGGTC-1_V12D07-332_C1,1,0,0,0,0,1
CGCTGGTGACTACCCT-1_V12D07-332_C1,0,0,0,1,0,1
AGGCATTGTCGTAGGG-1_V12D07-332_C1,0,0,0,0,0,0
TGGTAGAATATATGGG-1_V12D07-332_C1,0,0,0,0,0,0
TTCTTATCCGCTGGGT-1_V12D07-332_C1,1,1,0,0,0,2
AGTTTGGCACGGGTTG-1_V12D07-332_C1,0,0,0,0,0,0
GCATCGGCCGTGTAGG-1_V12D07-332_C1,1,1,0,0,0,2
ATGCGAGTCCCACCAC-1_V12D07-332_C1,0,2,0,1,0,3
TCGGCGAACCCAAACC-1_V12D07-332_C1,0,2,0,0,0,2
AGAGTAAACTTCACTA-1_V12D07-332_C1,0,1,0,1,0,2
AAGCCGAAGCGGTTTA-1_V12D07-332_C1,1,0,0,0,0,1
CCCGAGTTTCTCCGTA-1_V12D07-332_C1,1,0,0,0,0,1
AATATCGAATCAATGC-1_V12D07-332_C1,1,0,0,0,0,1
GCGCCTCCCACTCCGA-1_V12D07-332_C1,0,0,0,0,0,0
CGTTAAACTAGTTAGG-1_V12D07-332_C1,1,0,0,1,0,2
TGAGTTAAAGACATTC-1_V12D07-332_C1,0,0,0,0,0,0
AACAGGTAGTATGGAT-1_V12D07-332_C1,0,0,1,1,0,2
GAACGCGGGTCACACG-1_V12D07-332_C1,0,0,0,0,0,0
TGTTTGAGATCGTCAG-1_V12D07-332_C1,0,2,0,0,0,2
ATCTCGTGAGCGAAAC-1_V12D07-332_C1,1,0,0,0,0,1
CTGAGAAAGTTCGGCG-1_V12D07-332_C1,0,0,0,0,0,0
ATTACCACACTGCCTG-1_V12D07-332_C1,1,0,0,0,0,1
CTGCTGTCTAACGAGC-1_V12D07-332_C1,0,0,0,0,0,0
CGTGGAAGCCTCGTAC-1_V12D07-332_C1,0,1,0,1,0,2
GGACTCACAAATTAGG-1_V12D07-332_C1,0,0,0,0,0,0
CTTTGCTGTCATGGAT-1_V12D07-332_C1,0,4,1,0,0,5
GGTGTTGGGCGTCTTA-1_V12D07-332_C1,0,0,0,0,0,0
TACCATGTATTGATTT-1_V12D07-332_C1,0,0,0,0,0,0
GGTCTCCAAGTAGTGC-1_V12D07-332_C1,0,1,0,0,0,1
ATCCTTCTGAAAGAAC-1_V12D07-332_C1,0,0,0,0,0,0
CCGGAAGTTATCAGTC-1_V12D07-332_C1,0,7,0,1,0,8
TTAGAGGGATATACAG-1_V12D07-332_C1,0,0,0,0,0,0
TTGTACACCTCGAACA-1_V12D07-332_C1,0,0,0,0,0,0
GTGGGTACTGAGCGTA-1_V12D07-332_C1,0,0,0,0,0,0
CTTAAGCAGCGAGCCG-1_V12D07-332_C1,0,2,2,0,0,4
GCATTGACTTGCGGAA-1_V12D07-332_C1,0,3,0,0,0,3
CCATAACCTGTGCAGT-1_V12D07-332_C1,1,3,1,0,0,5
GGGCTACTATTTCGTG-1_V12D07-332_C1,2,5,0,0,0,7
GGCGAGCGAAACGGCA-1_V12D07-332_C1,0,4,0,0,0,4
GGAGACCATCTACATA-1_V12D07-332_C1,1,2,0,0,0,3
AGACCAAACCACACCT-1_V12D07-332_C1,0,5,1,0,0,6
CGACGCATCCGTACCT-1_V12D07-332_C1,1,2,0,0,1,4
CCTAGGTAAAGGTAGC-1_V12D07-332_C1,0,2,0,0,1,3
AGCGGCGGTTAGCGGT-1_V12D07-332_C1,0,1,2,0,0,3
CTGGACGCAGTCCGGC-1_V12D07-332_C1,0,4,1,0,0,5
AGCCTAATACCCACGT-1_V12D07-332_C1,0,5,0,0,0,5
AATCTGGCTTTCTAGT-1_V12D07-332_C1,1,0,0,0,0,1
CACCCTTGGTGAGACC-1_V12D07-332_C1,1,0,0,0,0,1
GGATCTTGACTCAACC-1_V12D07-332_C1,1,2,0,0,0,3
ACGAGGATACCACTCT-1_V12D07-332_C1,0,2,0,0,0,2
GAGTTGATGGCAATTT-1_V12D07-332_C1,0,0,0,0,0,0
GTGGCAAACAGCGGCA-1_V12D07-332_C1,0,1,1,0,0,2
GATGTAACGAACCACC-1_V12D07-332_C1,1,4,0,0,0,5
AGCCGTGGCTAAATGT-1_V12D07-332_C1,3,2,1,0,0,6
CTCCCTCCTTTCGATC-1_V12D07-332_C1,1,1,0,0,0,2
TTGGAAGAATACAGTC-1_V12D07-332_C1,0,4,0,0,0,4
AGTTAAGTCAACCGCT-1_V12D07-332_C1,0,2,1,0,0,3
CTCATGGTAATTTGCG-1_V12D07-332_C1,1,2,0,0,0,3
AAAGTAGCATTGCTCA-1_V12D07-332_C1,1,4,0,0,0,5
TTGTGGTAGGAGGGAT-1_V12D07-332_C1,1,6,0,0,0,7
AGTCGTGGGCATTACG-1_V12D07-332_C1,1,1,0,0,0,2
ACCTAAGTACCTTTCA-1_V12D07-332_C1,1,4,0,0,0,5
GTAGAGGGAGACAAGT-1_V12D07-332_C1,0,0,0,0,0,0
GATCCTCGACACTGGC-1_V12D07-332_C1,1,1,0,0,0,2
CCTACATTCACAGACG-1_V12D07-332_C1,0,0,0,0,0,0
TTGACCGTGTTAATGA-1_V12D07-332_C1,2,4,0,0,0,6
TCTGTTACCCAGCATA-1_V12D07-332_C1,2,2,1,0,0,5
CTAACTGGTCCGGTTC-1_V12D07-332_C1,0,4,0,0,0,4
AGCGACAGGAACGGTC-1_V12D07-332_C1,1,3,0,0,0,4
TAATAGAACAGAGTTA-1_V12D07-332_C1,0,3,0,0,0,3
ACAGGTGGAGGTGAGG-1_V12D07-332_C1,0,3,0,0,0,3
TGCGAGAATATTACCC-1_V12D07-332_C1,0,2,1,0,0,3
TTGCGTCGGCCAACCG-1_V12D07-332_C1,1,3,1,0,0,5
AGGCTTCCCGAAGAAG-1_V12D07-332_C1,1,3,0,0,1,5
GCGGACCGCGTTGTGG-1_V12D07-332_C1,1,1,0,0,0,2
GTAATCTGATTCTTCG-1_V12D07-332_C1,1,6,0,0,0,7
CCGCGGAATGCGTCAC-1_V12D07-332_C1,0,2,0,0,0,2
TTCCACACAGATTTGA-1_V12D07-332_C1,0,5,0,0,0,5
CTTCTATTAATGCTAG-1_V12D07-332_C1,1,4,0,0,0,5
CATTTGAGTGGTACGT-1_V12D07-332_C1,2,4,1,0,0,7
TCACAGCAAACTCGAA-1_V12D07-332_C1,4,0,0,0,0,4
CAGACGAACCTGATAC-1_V12D07-332_C1,1,0,2,0,3,6
TAGCTAGAAGGCATGA-1_V12D07-332_C1,4,0,3,0,0,7
ATCCAGAGCAACAACC-1_V12D07-332_C1,1,0,3,0,1,5
TCCGGTTCGTCCGGTC-1_V12D07-332_C1,2,0,2,0,0,4
CGCGCATGTTTGATTG-1_V12D07-332_C1,1,0,1,0,2,4
TGGCGATCAAGTTATG-1_V12D07-332_C1,2,0,0,0,0,2
CCCTTTGACAGGTCTT-1_V12D07-332_C1,4,0,0,1,0,5
CAGAGACGGTCACCCA-1_V12D07-332_C1,2,0,1,0,0,3
TAGCTCGCCTGATAAC-1_V12D07-332_C1,3,0,2,0,0,5
TTGTGTTTCCCGAAAG-1_V12D07-332_C1,3,0,0,0,0,3
TATACACAGACGCCTT-1_V12D07-332_C1,3,0,1,0,0,4
ACATTAGTTTATATCC-1_V12D07-332_C1,3,0,0,0,0,3
CCATCGCAGTTAAACT-1_V12D07-332_C1,6,0,0,1,0,7
AATTAGCGCTGCAGCG-1_V12D07-332_C1,2,0,0,0,0,2
TCCGCTTATCCCATTA-1_V12D07-332_C1,5,0,0,0,0,5
GTTTGGGCTTGTGAGC-1_V12D07-332_C1,0,0,0,0,1,1
CTTGTCAACATTCGAG-1_V12D07-332_C1,1,0,0,0,1,2
GGACCAACAGGATAAC-1_V12D07-332_C1,0,0,0,0,0,0
AAGCTAGATCGAGTAA-1_V12D07-332_C1,3,1,0,0,1,5
TACCGTGCCTCGGACC-1_V12D07-332_C1,2,0,1,0,0,3
GTAGCCAAACATGGGA-1_V12D07-332_C1,3,0,0,0,0,3
TGCCAGTACGTGGAGA-1_V12D07-332_C1,0,2,1,0,1,4
ATAAGGTGGAGAACAT-1_V12D07-332_C1,0,2,0,1,0,3
CTTTAATATTGGTCGA-1_V12D07-332_C1,0,1,0,0,0,1
TGGTTCAACGGGTAAT-1_V12D07-332_C1,0,1,1,0,0,2
GCTGCTACTGCGTAGC-1_V12D07-332_C1,0,1,0,0,0,1
CTGCACAACTACATAT-1_V12D07-332_C1,0,4,0,1,0,5
ATATTCCACATAGTGA-1_V12D07-332_C1,1,0,1,0,0,2
TGGCAAACTAAATTAC-1_V12D07-332_C1,0,1,0,0,0,1
ACCGCAATAACTGCCT-1_V12D07-332_C1,0,2,0,0,0,2
TCGCACCAGGAGGCAG-1_V12D07-332_C1,0,6,0,0,0,6
ACTTCAGGCTGATCCC-1_V12D07-332_C1,0,3,0,0,0,3
ACAAATCGCACCGAAT-1_V12D07-332_C1,1,0,1,1,0,3
TCTGATGTATTCTGTC-1_V12D07-332_C1,1,1,0,0,0,2
CTTTACCGAATAGTAG-1_V12D07-332_C1,0,1,1,0,0,2
GCAGATCCATAAGACT-1_V12D07-332_C1,1,1,0,0,0,2
TTCCTCGGACTAACCA-1_V12D07-332_C1,0,0,1,1,0,2
TTATCCGGGATCTATA-1_V12D07-332_C1,0,1,1,2,1,5
CTGGAAGACACGGTGG-1_V12D07-332_C1,2,1,0,0,0,3
GTTCGTCTAAAGAACT-1_V12D07-332_C1,1,0,0,0,0,1
GTCTATTGGTTCCGGT-1_V12D07-332_C1,1,0,0,0,0,1
CTAGGCGCCCTATCAG-1_V12D07-332_C1,0,2,0,0,0,2
AACGGACGTACGTATA-1_V12D07-332_C1,0,0,0,0,0,0
AACACACGCTCGCCGC-1_V12D07-332_C1,2,0,0,0,0,2
GCTACTATAGTAGAGT-1_V12D07-332_C1,1,1,0,0,0,2
AGCATATCAATATGCT-1_V12D07-332_C1,0,2,1,0,0,3
CGAACAGTATGGGCGT-1_V12D07-332_C1,0,0,0,0,0,0
ACAATTGTGTCTCTTT-1_V12D07-332_C1,0,0,0,0,0,0
GATCGCTACCCGATTT-1_V12D07-332_C1,1,0,0,0,0,1
ATTGCGATCAGTAACT-1_V12D07-332_C1,0,0,0,0,0,0
CAGCAGTCCAGACTAT-1_V12D07-332_C1,0,1,0,0,0,1
AGAGGCTTCGGAAACC-1_V12D07-332_C1,2,0,0,0,0,2
AAACAAGTATCTCCCA-1_V12D07-332_C1,0,0,0,1,0,1
GGCAGCAAACCTATGC-1_V12D07-332_C1,0,1,0,1,0,2
ACTAGTTGCGATCGTC-1_V12D07-332_C1,4,0,0,0,0,4
TTGGACCATCTGGCAA-1_V12D07-332_C1,1,0,0,0,0,1
CCCTCCTCGCTCGTAT-1_V12D07-332_C1,1,1,1,1,0,4
GAGCGCAAATACTCCG-1_V12D07-332_C1,1,1,0,0,0,2
ATTACATGTCAGTCTT-1_V12D07-332_C1,0,2,0,0,0,2
TTGGGACGTAAGAGTT-1_V12D07-332_C1,0,0,0,0,0,0
CTTCGGCCAATTGTTT-1_V12D07-332_C1,0,1,0,0,0,1
AGACCGCTCCGCGGTT-1_V12D07-332_C1,1,2,0,0,0,3
GACCGCGTCTGACGTG-1_V12D07-332_C1,0,1,0,0,0,1
CCAAATAACAAGATTC-1_V12D07-332_C1,0,0,0,0,0,0
TCTTTAGAGTCTAACA-1_V12D07-332_C1,0,0,0,1,0,1
CTCCCAATGAGTCGCG-1_V12D07-332_C1,0,2,0,0,0,2
TAGTCTTTCCGAATTG-1_V12D07-332_C1,2,1,0,0,0,3
GAGTAAACCGGAAAGT-1_V12D07-332_C1,0,1,0,2,0,3
GATCTCGACGCTGTGG-1_V12D07-332_C1,1,0,1,0,0,2
CTGACATAGAAATAGA-1_V12D07-332_C1,0,0,0,0,0,0
TATACCGAGTGCCACA-1_V12D07-332_C1,1,0,0,0,0,1
TCCGAACGTTGCCGCT-1_V12D07-332_C1,1,0,0,0,0,1
GCAGAAGGTAATCTCC-1_V12D07-332_C1,0,0,0,0,1,1
GGTACTAAGTGCTTTG-1_V12D07-332_C1,0,2,0,1,0,3
CAGAATATTCGTTATC-1_V12D07-332_C1,3,3,0,0,0,6
TAATCAACCAAATGGG-1_V12D07-332_C1,0,5,0,0,2,7
TCTGCTTAGAACAAGC-1_V12D07-332_C1,0,2,0,0,0,2
AACTGAGTTATACTGA-1_V12D07-332_C1,0,0,0,0,0,0
CCTCAACGATCGCTGT-1_V12D07-332_C1,0,0,0,0,0,0
CGGTACGGCAAACCCA-1_V12D07-332_C1,0,0,0,0,0,0
CAGATGTTTGTCCCAA-1_V12D07-332_C1,0,0,0,0,0,0
GTTTGTTAGCCAAGTA-1_V12D07-332_C1,2,3,0,0,0,5
ACGTGACAAAGTAAGT-1_V12D07-332_C1,2,2,1,0,0,5
TTGTCACCGCGGTATC-1_V12D07-332_C1,1,1,2,0,0,4
GATCTAACCGTATTCA-1_V12D07-332_C1,1,5,0,0,0,6
ATGGAAATTTAAGGAG-1_V12D07-332_C1,0,4,0,0,0,4
ATTGATCACCACATTT-1_V12D07-332_C1,1,3,1,0,0,5
ACTGCTCGGAAGGATG-1_V12D07-332_C1,0,2,0,0,0,2
TCTAAAGAACAGTCTC-1_V12D07-332_C1,0,3,0,0,0,3
CTGGGTTGAGTTAAAG-1_V12D07-332_C1,0,0,1,0,0,1
CCCAGTAAACTTGGGA-1_V12D07-332_C1,0,0,1,0,0,1
AGATTCACAACCGATA-1_V12D07-332_C1,1,4,1,0,0,6
AGAAGGTACACTTCAC-1_V12D07-332_C1,0,0,0,0,0,0
GCAGGAACTTAGATCT-1_V12D07-332_C1,1,2,0,0,0,3
AATCTAGGTTTACTTG-1_V12D07-332_C1,0,0,0,0,0,0
CCCGGTGTATCGGAAT-1_V12D07-332_C1,1,1,0,0,0,2
TTATCCTCAAGGAATA-1_V12D07-332_C1,0,3,0,0,0,3
AGCATCATTTCGAAAG-1_V12D07-332_C1,1,1,0,0,0,2
CGCGAGTCTGCCGGGT-1_V12D07-332_C1,1,2,1,1,0,5
TGCGTCATGACTGAGC-1_V12D07-332_C1,0,2,0,0,0,2
GTATGAAATTTCACTC-1_V12D07-332_C1,2,4,0,0,0,6
TTGGTTGCGGTGCGCG-1_V12D07-332_C1,1,5,1,0,0,7
ACAGAACTGAGAACAA-1_V12D07-332_C1,1,1,0,0,0,2
CTACTATCATAGGTTT-1_V12D07-332_C1,1,1,1,0,0,3
CCTCTATCGATTAGCA-1_V12D07-332_C1,1,3,0,0,0,4
CCGTATCTCGTCGTAG-1_V12D07-332_C1,0,3,0,0,0,3
TCACGATGTCCGTGGA-1_V12D07-332_C1,1,8,1,0,0,10
TCAACAAAGATAATTC-1_V12D07-332_C1,0,3,0,0,0,3
ATGACGCGTTCTATCC-1_V12D07-332_C1,0,4,0,0,0,4
ATTTGCGCGAGTAGCT-1_V12D07-332_C1,1,1,0,0,0,2
TTCTTGGACGATCTGC-1_V12D07-332_C1,0,1,0,0,0,1
AGACGACGATGCCGCT-1_V12D07-332_C1,0,3,0,0,0,3
GGTCTCTGAATGGACT-1_V12D07-332_C1,0,1,1,0,0,2
GCTCAATCCGTTTATT-1_V12D07-332_C1,1,5,0,0,0,6
CCAGAAAGCAACTCAT-1_V12D07-332_C1,0,3,1,0,0,4
CACCGTTAGGGATCAC-1_V12D07-332_C1,0,0,0,0,0,0
AATAACACTAGAACAA-1_V12D07-332_C1,1,2,4,0,0,7
CACCCGGTTTGTGACT-1_V12D07-332_C1,0,3,1,0,0,4
CCACCAACTTTACTGT-1_V12D07-332_C1,0,4,0,0,0,4
AACTCTCAGTGTGCTC-1_V12D07-332_C1,0,1,1,0,0,2
AAACCGTTCGTCCAGG-1_V12D07-332_C1,0,2,1,0,0,3
CAGCGATTCCCTTCAA-1_V12D07-332_C1,0,5,0,0,0,5
GCTAGCTTGAATAGCT-1_V12D07-332_C1,0,2,1,0,0,3
TTGCGGCATCAGAAAG-1_V12D07-332_C1,0,2,1,0,0,3
AATAGAACAGAGTGGC-1_V12D07-332_C1,0,4,1,0,1,6
GCCATCGAGCTGCGTG-1_V12D07-332_C1,0,4,0,0,0,4
ACACTGATCAAGGTGT-1_V12D07-332_C1,3,6,0,0,0,9
ACCAACGCTTATTTAT-1_V12D07-332_C1,2,0,0,0,0,2
GACATCGATTTATAAC-1_V12D07-332_C1,7,0,2,0,1,10
CAGACACCGATCGCTG-1_V12D07-332_C1,2,0,0,0,0,2
CCAAGAAAGTGGGCGA-1_V12D07-332_C1,3,0,2,0,0,5
GGTAGACCGTTGGGCG-1_V12D07-332_C1,1,0,0,0,1,2
TCGTTAGGAGTCCCTA-1_V12D07-332_C1,2,0,1,0,1,4
ACGGCCAACATGGACT-1_V12D07-332_C1,3,0,0,0,1,4
GTGAGTGGTACAACGC-1_V12D07-332_C1,0,0,0,0,0,0
GAGACTTCGCGACCGA-1_V12D07-332_C1,1,0,0,0,0,1
GAAGTCAGTTGCACTA-1_V12D07-332_C1,3,0,0,0,0,3
GTTTGGTAGGGTCAAC-1_V12D07-332_C1,4,0,1,0,0,5
ACGGCACTTGCTTGGG-1_V12D07-332_C1,0,1,1,1,1,4
CCTCTGTACTATTCTA-1_V12D07-332_C1,3,0,1,0,0,4
CTATTCATGTGTCCCA-1_V12D07-332_C1,1,0,0,0,0,1
GCCCGATCTGTGGTCG-1_V12D07-332_C1,2,0,0,0,1,3
TTAGAAGAACATGACT-1_V12D07-332_C1,3,0,1,0,0,4
AGGATAAAGTCGGGAT-1_V12D07-332_C1,2,0,1,0,0,3
CGGCAAACATCGTGCG-1_V12D07-332_C1,5,0,0,0,1,6
CTAGTTACAACCCGGT-1_V12D07-332_C1,5,0,0,0,0,5
TTCGACAGAGCCCGTG-1_V12D07-332_C1,0,1,3,1,2,7
AAGCATACTCTCCTGA-1_V12D07-332_C1,4,0,0,0,2,6
GACGACGATCCGCGTT-1_V12D07-332_C1,0,0,0,0,0,0
GGTAGAAGACCGCCTG-1_V12D07-332_C1,1,1,0,0,1,3
GAGATGGGAGTCGACA-1_V12D07-332_C1,0,0,0,2,0,2
AACGATAATGCCGTAG-1_V12D07-332_C1,1,2,0,0,2,5
TGGTCCCACGCTACGG-1_V12D07-332_C1,0,0,0,0,0,0
CTGCTTGGCGATAGCT-1_V12D07-332_C1,1,0,0,0,0,1
ATCGGAGACAGACGGC-1_V12D07-332_C1,1,1,0,0,0,2
TAGCGTCCGGTGTGGT-1_V12D07-332_C1,2,2,0,0,0,4
GTTGAGTCCCGCCGGT-1_V12D07-332_C1,0,2,0,0,0,2
AAATAGGGTGCTATTG-1_V12D07-332_C1,1,1,1,0,0,3
AAGTGTTTGGAGACGG-1_V12D07-332_C1,0,1,0,0,0,1
AGCACTACCTCACCAG-1_V12D07-332_C1,0,5,0,1,0,6
TGCCTTGGCCAGGCAA-1_V12D07-332_C1,0,8,1,1,1,11
TCGTCTTAGGCGTTAA-1_V12D07-332_C1,1,0,0,0,0,1
TTCTGACCGGGCTCAA-1_V12D07-332_C1,1,2,1,1,0,5
CAGAACTTAGCCCTCT-1_V12D07-332_C1,0,0,0,0,0,0
AGCTCCTTCGCACATC-1_V12D07-332_C1,0,4,0,0,0,4
ACAGGCTTGCCCGACT-1_V12D07-332_C1,0,0,0,0,0,0
GCTATACGTCTCGGAC-1_V12D07-332_C1,0,4,0,0,0,4
GAGCCAGCTACCTGTG-1_V12D07-332_C1,0,0,0,0,0,0
TGCTAAGTGTCTATTT-1_V12D07-332_C1,0,2,0,0,0,2
GTCCTACGAATAGTCT-1_V12D07-332_C1,0,0,0,0,0,0
CAGTGTCGGCTGGCCC-1_V12D07-332_C1,1,0,0,0,0,1
CTATCGACGAAATACA-1_V12D07-332_C1,1,0,0,0,0,1
CATCATTACCCTGAGG-1_V12D07-332_C1,0,1,0,0,0,1
TAAGTTGCGACGTAGG-1_V12D07-332_C1,1,2,0,1,0,4
AGTGCACGCTTAAGAA-1_V12D07-332_C1,3,0,0,0,0,3
TGTGCCGGTGCCGGAA-1_V12D07-332_C1,0,1,0,0,0,1
AGGAGGCCTTCGCGCG-1_V12D07-332_C1,1,0,0,0,0,1
TCCGCGGCCCAATGAA-1_V12D07-332_C1,1,0,0,0,1,2
TCCGTTAAGCTAATAT-1_V12D07-332_C1,0,1,0,0,0,1
AAATCTAGCCCTGCTA-1_V12D07-332_C1,2,1,1,0,1,5
CGCAGGCGATCCAAAC-1_V12D07-332_C1,2,2,0,0,0,4
CCATATGGAAACTATA-1_V12D07-332_C1,5,0,0,0,0,5
CACCGTATCCCATCCG-1_V12D07-332_C1,6,0,0,0,0,6
GGTCAAGACTACTTCG-1_V12D07-332_C1,2,0,0,0,0,2
CCCGTTTCGCAGATGT-1_V12D07-332_C1,1,0,0,0,0,1
GTTATAATACGGTGAA-1_V12D07-332_C1,2,0,0,1,0,3
ACTTGTGGATGGAACG-1_V12D07-332_C1,0,0,0,0,0,0
GTTCGCTGAGACGTCT-1_V12D07-332_C1,0,0,0,0,0,0
GACACTGGAACCCGAT-1_V12D07-332_C1,2,1,0,0,0,3
CCCAGGTCTGAAGGCT-1_V12D07-332_C1,0,0,0,0,0,0
TCTCGAGGAGGTTCGC-1_V12D07-332_C1,2,1,0,0,0,3
ACTATCTGCCCGCGTA-1_V12D07-332_C1,1,0,0,0,0,1
CCTAAATTGTATCCTA-1_V12D07-332_C1,2,0,0,0,0,2
AGAAATTATGACTCGC-1_V12D07-332_C1,0,0,1,0,0,1
TCCAGCGCTATAAGCG-1_V12D07-332_C1,1,0,0,0,0,1
TCGTGTATTGGTCACG-1_V12D07-332_C1,1,0,0,0,0,1
CCACATACTGCACCCA-1_V12D07-332_C1,0,1,0,0,0,1
GTTGCGGACGGTCAGG-1_V12D07-332_C1,0,0,0,0,0,0
GTATTTAATGGCATAA-1_V12D07-332_C1,0,1,0,0,0,1
GTCGATAGGTGACTTT-1_V12D07-332_C1,0,0,0,0,0,0
AATAATCTTCGTATCG-1_V12D07-332_C1,0,0,0,0,0,0
ATTGTTCAACGATCCG-1_V12D07-332_C1,0,0,0,0,0,0
GTGCAGCGTAGAGTAG-1_V12D07-332_C1,0,2,0,0,0,2
TGTGGTAGGGTGCCTT-1_V12D07-332_C1,1,1,0,0,0,2
TGTGGACTATCTACGT-1_V12D07-332_C1,0,0,0,0,0,0
GGCGGGCTCTAAGAGT-1_V12D07-332_C1,0,3,0,0,0,3
TGTGCCAGAGGCAAAG-1_V12D07-332_C1,0,0,0,0,0,0
TGGCTTATGTATAATG-1_V12D07-332_C1,0,0,0,0,0,0
GCAAGCTGGAAACCGC-1_V12D07-332_C1,0,0,0,0,0,0
GATATCAAGCAGGAGC-1_V12D07-332_C1,2,4,0,0,0,6
CACCAATCATCCGTCT-1_V12D07-332_C1,1,0,0,0,0,1
CCACATGGCTCTTTAT-1_V12D07-332_C1,0,3,0,0,0,3
GTCCTACTCTACGGGC-1_V12D07-332_C1,2,1,1,0,0,4
CTCGAGACATACGATA-1_V12D07-332_C1,1,2,0,0,0,3
TATCAGTGGCGTAGTC-1_V12D07-332_C1,0,3,0,0,0,3
TGACAGGACAAGTCCA-1_V12D07-332_C1,0,6,0,0,0,6
TATTAACACCAAAGCA-1_V12D07-332_C1,0,4,1,0,0,5
TAGGCGATGAGGTCTC-1_V12D07-332_C1,1,3,1,0,0,5
CCGCCGGAACTTCTCG-1_V12D07-332_C1,0,5,1,0,0,6
GCCATTAGCCTCAAAC-1_V12D07-332_C1,1,5,1,0,0,7
GTTAGGCTACCCGTTT-1_V12D07-332_C1,1,4,0,0,0,5
GGGTATTCTAGCAAAC-1_V12D07-332_C1,0,1,2,0,0,3
GCCCTAGCCGTCGCGA-1_V12D07-332_C1,0,3,1,0,0,4
CAGATCCTGGTTTGAA-1_V12D07-332_C1,0,4,0,0,0,4
CTTCAGTGGTCGCCTA-1_V12D07-332_C1,1,1,2,0,0,4
GGGCAACCGCACGTGC-1_V12D07-332_C1,0,4,0,0,0,4
GACCCAATTATGATAC-1_V12D07-332_C1,0,4,0,0,0,4
GAAGCTCGGACCCGTC-1_V12D07-332_C1,0,4,0,0,0,4
CGTCGGGTCTAAGCGC-1_V12D07-332_C1,2,4,3,0,0,9
GAGGCCCGACTCCGCA-1_V12D07-332_C1,2,6,0,0,0,8
TTGCCATAGCCCGCTC-1_V12D07-332_C1,1,4,2,0,0,7
TAACATACACGCGATC-1_V12D07-332_C1,1,6,0,0,0,7
CCGACGGGCATGAGGT-1_V12D07-332_C1,1,6,0,0,0,7
AATGTGCCCGAGGTGT-1_V12D07-332_C1,0,2,0,0,0,2
AGCTGTAACCTCAATC-1_V12D07-332_C1,0,5,0,0,0,5
CGAGTGAAGGTACCAG-1_V12D07-332_C1,0,4,0,0,0,4
AGTCTCACAAGACTAC-1_V12D07-332_C1,0,1,1,0,0,2
AAATTGATAGTCCTTT-1_V12D07-332_C1,1,3,0,0,0,4
TAAGTCGCCGAGTATC-1_V12D07-332_C1,0,4,0,0,0,4
GCGGAGAAACTTCGCA-1_V12D07-332_C1,1,4,0,0,0,5
GGCAAAGGCGCCAATA-1_V12D07-332_C1,0,2,0,0,0,2
ATTTCCGGGTTCTGCG-1_V12D07-332_C1,1,2,0,0,0,3
TAAACCCAGGAGGGCA-1_V12D07-332_C1,0,4,1,0,0,5
TTCGGGCGCTAGTCTT-1_V12D07-332_C1,0,3,2,0,0,5
GTGGAGTCGGCGGTTG-1_V12D07-332_C1,3,2,0,0,0,5
GCACGCCTACTTAGAT-1_V12D07-332_C1,0,7,0,0,0,7
CAATATTCTTGACCTA-1_V12D07-332_C1,0,2,0,0,0,2
CGTTTGTGTAGAGGGT-1_V12D07-332_C1,1,0,0,0,0,1
CATAGCGTTGCCCACC-1_V12D07-332_C1,1,5,2,0,0,8
TGATACATTTAGCCGT-1_V12D07-332_C1,0,2,0,0,0,2
TTCCGGCCTTGAGGCT-1_V12D07-332_C1,0,3,1,0,0,4
CCTATACCGTCCTGTC-1_V12D07-332_C1,0,2,0,1,0,3
TCGTTGCTATCCGGTC-1_V12D07-332_C1,0,4,1,0,0,5
TGGCGACTGCTCCAAA-1_V12D07-332_C1,1,3,0,0,0,4
CAGAGGCGATGCATGA-1_V12D07-332_C1,0,2,0,0,0,2
TCACAGGAGAATAAGA-1_V12D07-332_C1,2,0,0,0,0,2
GGGTTAACATTTGAGT-1_V12D07-332_C1,3,0,0,0,0,3
GCGGGCGAGCCTTACC-1_V12D07-332_C1,0,0,5,0,2,7
TGCCAATGGGTACTCT-1_V12D07-332_C1,3,0,1,0,0,4
AGGGACTCTACGCGAC-1_V12D07-332_C1,2,0,0,0,0,2
GACGCCGTAAAGGCTA-1_V12D07-332_C1,2,0,0,0,0,2
AAAGGCTCTCGCGCCG-1_V12D07-332_C1,2,0,0,0,0,2
CTGGCTGGTTGTCAGT-1_V12D07-332_C1,1,0,2,0,3,6
ACATCCCGGCCATACG-1_V12D07-332_C1,3,0,0,0,1,4
CTCTTGTCCCGCTTGG-1_V12D07-332_C1,6,0,0,0,0,6
TACGCCTCCATTCCGA-1_V12D07-332_C1,7,0,2,0,0,9
CGGAGCAATTTAATCG-1_V12D07-332_C1,3,0,1,0,1,5
AACTAGGCTTGGGTGT-1_V12D07-332_C1,1,0,0,0,1,2
GCGTCGCCAGGGTGAT-1_V12D07-332_C1,1,0,0,0,0,1
GTTGGTCATGCTATCC-1_V12D07-332_C1,4,0,1,0,1,6
GCTGGCGGCGCATGCT-1_V12D07-332_C1,0,0,0,0,0,0
TGAGCGGAAAGTGTTC-1_V12D07-332_C1,1,0,1,0,1,3
CTTTCTGTGCGGGCTT-1_V12D07-332_C1,2,0,0,0,2,4
ATCTAATATCCTACGG-1_V12D07-332_C1,1,0,0,0,1,2
AACCTTTAAATACGGT-1_V12D07-332_C1,1,0,0,0,0,1
TTCACTCGAGCACCTA-1_V12D07-332_C1,1,0,1,0,0,2
CTGCACTCCAGTACAG-1_V12D07-332_C1,1,2,0,0,0,3
CCATTTCTACCTATTA-1_V12D07-332_C1,1,1,0,0,0,2
CAAGCGGCACATAATT-1_V12D07-332_C1,1,0,0,1,0,2
GTTAACATCACTTAAA-1_V12D07-332_C1,1,1,2,0,0,4
ATATAAATGTAGCTGC-1_V12D07-332_C1,1,0,0,1,0,2
GCCTCTATACATAGCA-1_V12D07-332_C1,2,1,0,0,0,3
GTGTCGTATAGCGTTC-1_V12D07-332_C1,0,3,0,1,0,4
ATACGTACTTAGCCAC-1_V12D07-332_C1,1,4,0,0,0,5
GCTATCATACTCATGG-1_V12D07-332_C1,0,2,0,0,0,2
TATCCAATTGGTTATC-1_V12D07-332_C1,0,3,0,0,1,4
TCTCCCTGGGCAGCGT-1_V12D07-332_C1,0,5,0,0,1,6
CCTATAATGAGTGCCC-1_V12D07-332_C1,0,1,1,0,0,2
CAATGCGAGAAGTATC-1_V12D07-332_C1,1,4,0,0,0,5
TACCAATAAAGTACCA-1_V12D07-332_C1,0,1,0,0,0,1
GCTAGGCACCACGGAG-1_V12D07-332_C1,0,2,0,0,1,3
GGTGGACTGCTCTGGC-1_V12D07-332_C1,1,0,1,1,1,4
TATTCCGAGCTGTTAT-1_V12D07-332_C1,0,2,0,0,0,2
TTGAGAAGTTTAGCAT-1_V12D07-332_C1,0,2,0,1,0,3
GTCCGGACCTGAAATT-1_V12D07-332_C1,1,2,0,0,1,4
CTGTGGTCGGGAGATA-1_V12D07-332_C1,0,1,0,2,0,3
CATGTAAGAGACATTT-1_V12D07-332_C1,0,0,0,0,0,0
CACGTTTCGTACACAC-1_V12D07-332_C1,0,1,0,1,0,2
CATCCTCTCAAAGATC-1_V12D07-332_C1,1,0,0,0,0,1
GATTAACCGAAAGCCC-1_V12D07-332_C1,0,0,0,0,0,0
AACGCTGTTGCTGAAA-1_V12D07-332_C1,1,1,0,0,0,2
TTCAGCTGGCGTGCCC-1_V12D07-332_C1,0,0,1,0,0,1
TAGAGGTTCTACTTGT-1_V12D07-332_C1,1,3,0,0,0,4
GTATCAAACGTTAGCT-1_V12D07-332_C1,0,0,0,0,0,0
AATCATGTAAAGACTC-1_V12D07-332_C1,0,1,1,1,0,3
AGTCACTAGCTCTCGA-1_V12D07-332_C1,1,1,0,0,0,2
GCGAAACGATCGGGAG-1_V12D07-332_C1,0,0,0,0,0,0
CATGGATTGTCTTCCG-1_V12D07-332_C1,0,0,0,0,0,0
ATTGGATTACAGCGTA-1_V12D07-332_C1,1,0,0,0,0,1
CACACACGCTAACGAG-1_V12D07-332_C1,0,0,0,0,0,0
CTATGGGAAGCGGAAT-1_V12D07-332_C1,1,2,0,0,0,3
TGCCTAATTGAAGATT-1_V12D07-332_C1,1,1,0,1,0,3
TGGCAATGGGACGGCG-1_V12D07-332_C1,1,0,0,0,0,1
ACCTCCGCCCTCGCTG-1_V12D07-332_C1,0,1,0,0,0,1
CGGCAATAAGATCGCC-1_V12D07-332_C1,1,1,0,0,1,3
CCTTGACCACTTTATT-1_V12D07-332_C1,1,0,0,0,0,1
TCATTTAGAAGTGTGA-1_V12D07-332_C1,0,0,0,0,0,0
CAGAATAACACACGGA-1_V12D07-332_C1,0,0,0,0,0,0
TCTGAGCAATTGACTG-1_V12D07-332_C1,0,0,0,0,0,0
CAACGTGGTGGAGTCT-1_V12D07-332_C1,0,0,0,0,0,0
CACAGTTCGCTTCCCA-1_V12D07-332_C1,1,0,0,1,0,2
TCTCTCGCCGCACATA-1_V12D07-332_C1,1,0,0,0,0,1
TGGGCAGGCCACCGCA-1_V12D07-332_C1,0,1,0,0,0,1
CTCCTGTTCAAGGCAG-1_V12D07-332_C1,0,0,0,1,0,1
TATTTGATTTGCACAG-1_V12D07-332_C1,2,2,0,0,0,4
GCCACTCCTTACGGTA-1_V12D07-332_C1,0,0,0,0,0,0
ACCGATATTTAATCAT-1_V12D07-332_C1,0,1,0,0,0,1
TTATTATCTGGAAGGC-1_V12D07-332_C1,1,0,0,0,0,1
TACATGCCGGAATTGT-1_V12D07-332_C1,1,2,0,0,0,3
GGCACTCAGCCGACCC-1_V12D07-332_C1,0,2,0,0,1,3
AAACCGGAAATGTTAA-1_V12D07-332_C1,1,1,0,0,0,2
AGACAGGCATCTCAGC-1_V12D07-332_C1,0,0,0,0,0,0
GTGGTGATGGTTTGTG-1_V12D07-332_C1,0,2,0,1,1,4
CCGATATGACGTAAGG-1_V12D07-332_C1,4,0,0,0,0,4
CATACACAAAGTCAGC-1_V12D07-332_C1,0,0,0,0,0,0
TGCCGTTCTTAATCGG-1_V12D07-332_C1,0,0,0,0,0,0
TCGAGTCTACGATTCG-1_V12D07-332_C1,0,0,0,0,0,0
ACTTCCAGTGGAAGCT-1_V12D07-332_C1,0,0,0,0,0,0
CAATTGGGCCGCACTC-1_V12D07-332_C1,0,2,0,0,0,2
AAATCGCGGAAGGAGT-1_V12D07-332_C1,0,0,0,0,0,0
ATATCAATTCCAGCCT-1_V12D07-332_C1,0,0,2,0,1,3
CTTTGTCGAATGCTCC-1_V12D07-332_C1,0,4,0,0,0,4
TGAGGCATGTACTGTG-1_V12D07-332_C1,1,2,1,0,0,4
TTCGCCGCTCGCGCTA-1_V12D07-332_C1,0,2,1,0,0,3
GACTCCTTCCAATTGA-1_V12D07-332_C1,0,3,0,0,0,3
ACCGAAGAGTCTGGTT-1_V12D07-332_C1,0,4,0,0,0,4
TGGCATGAAGTTTGGG-1_V12D07-332_C1,0,6,1,0,0,7
ACGAGGTTTACAACGT-1_V12D07-332_C1,0,3,0,0,0,3
AACCCATCCCATGATC-1_V12D07-332_C1,0,1,1,0,0,2
TCGACAACTGAACCCG-1_V12D07-332_C1,0,2,1,0,0,3
TATCTTGCAATACAAC-1_V12D07-332_C1,0,2,0,0,0,2
TATTATGTTTGCCTGC-1_V12D07-332_C1,0,7,2,0,0,9
GTCAAAGAAGTGGTGT-1_V12D07-332_C1,0,0,0,0,0,0
GGGACAGAGTTACTCC-1_V12D07-332_C1,0,5,2,0,0,7
AGCAACCGAAAGTAAT-1_V12D07-332_C1,0,3,0,0,0,3
CTCTCTAACTGCCTAG-1_V12D07-332_C1,1,3,0,0,0,4
ATACGGAACGTCGTTT-1_V12D07-332_C1,0,3,0,0,0,3
TCGGTCCCGACAATAG-1_V12D07-332_C1,1,5,0,0,0,6
CGCGCAAATGTCCAGA-1_V12D07-332_C1,0,5,0,0,0,5
TCTAATACTGCCTCAG-1_V12D07-332_C1,0,4,0,0,0,4
CTCGGTTGTCGGCCCT-1_V12D07-332_C1,0,2,0,0,0,2
GGTAACCGGGAGGATA-1_V12D07-332_C1,0,3,0,0,0,3
CAGGCGCACGGTGGTC-1_V12D07-332_C1,0,5,1,0,0,6
TCATCGATGGTCCCAA-1_V12D07-332_C1,2,4,0,0,0,6
CAAAGATTATTGGGCC-1_V12D07-332_C1,0,4,0,0,0,4
ACAATGAATACGGAGA-1_V12D07-332_C1,2,3,0,0,0,5
GCTCCTGACATACTGG-1_V12D07-332_C1,0,3,1,0,0,4
GATGACAAGTAGGGCA-1_V12D07-332_C1,1,2,3,0,0,6
TACGCCGAGGGTACCC-1_V12D07-332_C1,1,5,0,0,0,6
AAGCGTCCCTCATCGA-1_V12D07-332_C1,0,4,0,0,0,4
CACTCCTATGTAAGAT-1_V12D07-332_C1,0,4,1,0,0,5
TCGAGCCAGGCAGGCC-1_V12D07-332_C1,0,4,0,0,0,4
TCGTCAAGTACGCGCA-1_V12D07-332_C1,2,1,0,0,0,3
CCCGTAGCTGGGAAGA-1_V12D07-332_C1,1,4,0,0,0,5
ACCCTATGCCATATCG-1_V12D07-332_C1,0,3,1,0,0,4
GTGGTATAGTCTGCCG-1_V12D07-332_C1,1,0,0,0,0,1
CCGGTTTGTAATTGTG-1_V12D07-332_C1,1,5,0,0,0,6
GTCGCCGTTGTGTGTT-1_V12D07-332_C1,0,4,0,0,0,4
TACTGAACAGATTTAG-1_V12D07-332_C1,0,7,0,0,0,7
TATTAACCTGACCGCG-1_V12D07-332_C1,1,4,1,0,0,6
CTGTAGCCATCTCACT-1_V12D07-332_C1,0,2,0,0,0,2
TACTATGGTTCCTCAG-1_V12D07-332_C1,0,2,0,0,0,2
GAGTCAGACCAGAATC-1_V12D07-332_C1,1,1,0,0,0,2
TAAGGCATAACATCAA-1_V12D07-332_C1,6,0,2,0,0,8
CTTCCGCTCCGTGAAG-1_V12D07-332_C1,2,0,0,0,0,2
GGGCTATGATCGATGG-1_V12D07-332_C1,6,1,0,0,0,7
GGTCGGTCGTCCACAG-1_V12D07-332_C1,3,0,1,0,0,4
GGGACCCGTATATCTT-1_V12D07-332_C1,2,0,0,0,0,2
GAAAGCAGTGCACTTT-1_V12D07-332_C1,2,0,0,0,1,3
AGCGCATAATGAATCG-1_V12D07-332_C1,1,0,1,0,1,3
GCTGCTAAGTAGTCGA-1_V12D07-332_C1,2,0,0,0,0,2
AATAGTCCGTCCCGAC-1_V12D07-332_C1,4,0,2,0,0,6
AGCAGCCAGATGAATA-1_V12D07-332_C1,2,0,1,0,0,3
CCTCGCGCTGTGCGAT-1_V12D07-332_C1,2,0,1,0,0,3
TTGTGTATGCCACCAA-1_V12D07-332_C1,3,0,2,0,0,5
TGCTCGGCGAAACCCA-1_V12D07-332_C1,2,0,1,0,0,3
CGATTAAATATCTCCT-1_V12D07-332_C1,2,0,0,0,0,2
TGCCGTGGATCGTCCT-1_V12D07-332_C1,2,0,1,0,0,3
GTGGACGCATTTGTCC-1_V12D07-332_C1,4,0,1,0,0,5
ACCCGGAAACTCCCAG-1_V12D07-332_C1,3,0,1,0,0,4
CCGCATGTGGTACGAT-1_V12D07-332_C1,1,0,1,0,2,4
GCAAACCTTGGCCATA-1_V12D07-332_C1,3,0,1,0,0,4
ATTCACTGATGTTGGA-1_V12D07-332_C1,0,3,0,0,0,3
ACTCCCTAATGCTAAA-1_V12D07-332_C1,0,0,0,0,1,1
TCCTAAATTGGGAAGC-1_V12D07-332_C1,0,3,1,0,0,4
GAACAGATTACTAAAT-1_V12D07-332_C1,0,0,0,1,0,1
ATACAGGCCCTCCAAT-1_V12D07-332_C1,0,1,1,0,0,2
CGATTCGCCTGGCTGC-1_V12D07-332_C1,0,1,1,0,1,3
TCCGCCTGTCTACAAG-1_V12D07-332_C1,0,0,2,0,0,2
CACATCTCACCGACGA-1_V12D07-332_C1,0,2,0,0,0,2
CGTCGTCCTTCGCGAA-1_V12D07-332_C1,0,3,0,0,0,3
CGTTGAATACCGCGCT-1_V12D07-332_C1,0,1,0,0,0,1
ACCAATATGCAAGTTA-1_V12D07-332_C1,1,1,0,0,0,2
ACGGATGGTGCGGATA-1_V12D07-332_C1,0,2,0,0,0,2
CACCCTAACAAGATCT-1_V12D07-332_C1,0,2,0,0,1,3
AAGCTCTTTCATGGTG-1_V12D07-332_C1,0,0,0,0,1,1
CATGGGTATGCCTTAT-1_V12D07-332_C1,2,0,0,0,0,2
GCGCGTCATTGGTACA-1_V12D07-332_C1,0,0,0,0,0,0
TCTGAAGCACGTGGTC-1_V12D07-332_C1,1,1,1,0,0,3
AAGTTCACTCCAAGCT-1_V12D07-332_C1,1,1,0,1,1,4
TTGGACCTATAACAGT-1_V12D07-332_C1,0,0,0,0,0,0
ATCAGCCTCATGCTGC-1_V12D07-332_C1,1,1,0,0,0,2
AGTACTCTTATGCCCA-1_V12D07-332_C1,1,0,0,0,0,1
GCGCTTAAATAATTGG-1_V12D07-332_C1,1,0,0,0,0,1
TTGTGAACCTAATCCG-1_V12D07-332_C1,0,0,0,1,0,1
AGTCGTCGACCACCAA-1_V12D07-332_C1,0,3,0,0,0,3
TCCTTTAAATCCGCTT-1_V12D07-332_C1,2,0,0,1,0,3
ACTGAAACGCCGTTAG-1_V12D07-332_C1,1,2,2,1,0,6
GCACACACTGGTAGCC-1_V12D07-332_C1,1,2,0,0,0,3
TAAGGGCCTGTCCGAT-1_V12D07-332_C1,0,3,0,0,0,3
GCTAGAGTAGAGATGT-1_V12D07-332_C1,1,3,0,0,0,4
CACAGGGCCATATAGT-1_V12D07-332_C1,0,0,1,0,0,1
CCATGCCCTAGATTTC-1_V12D07-332_C1,2,0,0,0,0,2
TCGCGTAGCAGTGTCC-1_V12D07-332_C1,2,0,0,0,0,2
GACGAGGCTAATAAAC-1_V12D07-332_C1,1,1,1,0,0,3
CTACACTCGCAGATGG-1_V12D07-332_C1,0,1,0,1,0,2
ACGCATACGTTTACTA-1_V12D07-332_C1,0,0,0,0,0,0
GGAGCAACATTTCAAG-1_V12D07-332_C1,1,0,1,1,0,3
CGAGAGGGTAGCCGCG-1_V12D07-332_C1,0,1,0,0,0,1
TCGTGTTCGACCACAA-1_V12D07-332_C1,0,0,0,1,0,1
TCTACCCAATAGAGAG-1_V12D07-332_C1,1,2,0,0,0,3
ATAAACGTTGCACCAC-1_V12D07-332_C1,1,0,0,0,0,1
TCAACTGCAGAGTCAG-1_V12D07-332_C1,2,0,0,2,0,4
AGCTCCATATATGTTC-1_V12D07-332_C1,0,0,0,0,0,0
GTAACATCTAAGATAA-1_V12D07-332_C1,0,1,0,0,0,1
CCGACAATAGGCCGCC-1_V12D07-332_C1,2,2,0,0,0,4
ATGCTTAGGAGTTGAT-1_V12D07-332_C1,1,0,0,2,0,3
AACCCGAGCAGAATCG-1_V12D07-332_C1,1,0,0,0,0,1
CGGGTTTGTTAGGGCT-1_V12D07-332_C1,0,1,0,3,0,4
AGGCACGTGACTGTCC-1_V12D07-332_C1,1,0,0,0,1,2
GACAAGAGATGAGATT-1_V12D07-332_C1,0,0,0,0,0,0
AGCCCTTGGACATCCC-1_V12D07-332_C1,1,1,0,1,0,3
GCAGTTCGATCCGAGC-1_V12D07-332_C1,0,0,0,0,0,0
TCGAGGGCAACAGACG-1_V12D07-332_C1,1,2,0,0,0,3
ACTTTGTCGACGCACT-1_V12D07-332_C1,2,0,0,0,0,2
GAGTATCAAAGTTACA-1_V12D07-332_C1,0,0,0,0,0,0
CCAGGCTGGCGTCTGA-1_V12D07-332_C1,0,0,0,0,0,0
GGACTCTTCCGGTTGA-1_V12D07-332_C1,0,3,2,0,0,5
TCCCAGCACACGACAT-1_V12D07-332_C1,0,1,0,0,2,3
GCTCCATGAGTGCAGA-1_V12D07-332_C1,1,4,0,0,0,5
GCAGTGCGGGCGGATG-1_V12D07-332_C1,0,0,0,0,0,0
GCGTTCTGACTAAGCG-1_V12D07-332_C1,0,0,0,0,1,1
ATTTGGAGATTGCGGT-1_V12D07-332_C1,0,0,0,0,0,0
AAGGGTTTGATTTCAG-1_V12D07-332_C1,0,0,0,0,0,0
CCGGCCGCGAGCATAT-1_V12D07-332_C1,0,0,0,0,0,0
GAGTTCTGTGGGTGCT-1_V12D07-332_C1,0,0,0,0,0,0
AAACGAAGATGGAGTA-1_V12D07-332_C1,1,4,0,0,0,5
AATTACGAGACCCATC-1_V12D07-332_C1,0,1,0,0,0,1
CCTTTGAATTATGGCT-1_V12D07-332_C1,2,7,1,0,0,10
CATGGTATTAGTTTGT-1_V12D07-332_C1,0,2,0,0,0,2
AACGAAAGTCGTCCCA-1_V12D07-332_C1,0,3,0,0,0,3
ACATAAGTCGTGGTGA-1_V12D07-332_C1,0,3,0,0,0,3
GCACAACCTCGGGCGT-1_V12D07-332_C1,0,5,1,0,0,6
ATGCACGCGCTGTTCA-1_V12D07-332_C1,0,3,0,0,0,3
CGATGTTGTTATCTAC-1_V12D07-332_C1,1,3,0,0,0,4
GTCTCCTGCCAGTATG-1_V12D07-332_C1,1,2,1,0,0,4
GATGCCTTCTGCGGCA-1_V12D07-332_C1,1,4,1,0,0,6
ACCGGTCAGGTACACC-1_V12D07-332_C1,0,1,0,0,0,1
GTGGAGCGTTTACCGA-1_V12D07-332_C1,2,3,0,0,0,5
AGGCGGTTTGTCCCGC-1_V12D07-332_C1,2,1,0,0,0,3
TCCCTGGCGTATTAAC-1_V12D07-332_C1,2,3,0,0,0,5
AAACACCAATAACTGC-1_V12D07-332_C1,0,7,1,0,0,8
TGGACGCAATCCAGCC-1_V12D07-332_C1,0,3,2,0,0,5
GGAACCTTGACTCTGC-1_V12D07-332_C1,1,0,0,0,0,1
GTATCTCAGTCTTGAC-1_V12D07-332_C1,1,4,0,0,0,5
GCTGAATCTTCCAATC-1_V12D07-332_C1,0,6,2,0,0,8
AGATGCAAGACGTGCA-1_V12D07-332_C1,1,2,0,0,0,3
TTAAGGCCCGTACTTT-1_V12D07-332_C1,0,2,1,0,0,3
AGTATGCTGGAGACCA-1_V12D07-332_C1,0,3,1,0,0,4
GCGGCAAAGTATTGCC-1_V12D07-332_C1,0,3,0,0,0,3
GCGCAAATATATTCAA-1_V12D07-332_C1,1,3,1,0,0,5
GAAGAAACGATATTGT-1_V12D07-332_C1,1,2,0,0,0,3
GGACCTCTAGGCCGCC-1_V12D07-332_C1,1,2,1,0,0,4
AACAGCTGTGTGGCAA-1_V12D07-332_C1,1,3,0,0,0,4
TCGAATATCCCGCAGG-1_V12D07-332_C1,1,2,2,0,0,5
GCGACCCAACCATCTG-1_V12D07-332_C1,0,7,0,0,0,7
AGAGAAGGAGTACAAT-1_V12D07-332_C1,0,1,0,0,0,1
GGCTCCTCCACCTGTT-1_V12D07-332_C1,0,5,1,0,0,6
TCAGTGTATACGTCAT-1_V12D07-332_C1,1,5,0,0,0,6
ATTATTATGTCCGTCA-1_V12D07-332_C1,0,3,0,0,0,3
TTAGGTCATAACCGAC-1_V12D07-332_C1,0,5,2,0,0,7
AAGATGGCACCGGACC-1_V12D07-332_C1,1,3,1,0,0,5
CTACAAGAAATAACCC-1_V12D07-332_C1,1,3,0,0,0,4
ACTATTTCCGGGCCCA-1_V12D07-332_C1,0,0,2,0,1,3
TTGTTTCACATCCAGG-1_V12D07-332_C1,0,6,0,0,0,6
CGCTGTGTGGATGTTG-1_V12D07-332_C1,1,4,0,0,0,5
TCAACATAGCGCCCTA-1_V12D07-332_C1,0,3,0,0,0,3
GGCCGTTTGGGTTTCA-1_V12D07-332_C1,0,3,1,0,0,4
TACTCTTTCGTCTTCA-1_V12D07-332_C1,0,6,0,0,0,6
TTCGCGCGCCATACGA-1_V12D07-332_C1,0,3,1,0,0,4
CGGAAAGAATCAAACG-1_V12D07-332_C1,2,4,1,0,0,7
AGGCAGGGAGCGTACT-1_V12D07-332_C1,5,0,0,0,0,5
CCTTTAAGGGAGCACT-1_V12D07-332_C1,2,0,1,0,0,3
CGCCCAGCACGCCTAG-1_V12D07-332_C1,7,1,1,0,0,9
AGTATTTGGCACGACC-1_V12D07-332_C1,3,0,2,0,0,5
TATCCGCACCGTCGGG-1_V12D07-332_C1,2,0,0,0,0,2
ACCCGTGTCATCAGTA-1_V12D07-332_C1,6,0,1,0,0,7
CAACTGCTCATCCGAT-1_V12D07-332_C1,2,0,0,0,0,2
CCGGAGCGTACTTTCT-1_V12D07-332_C1,6,0,1,0,0,7
TACCGTAGGTTAACTA-1_V12D07-332_C1,3,0,0,0,0,3
TGAGGAGTGCCAGCTT-1_V12D07-332_C1,8,0,0,0,0,8
CCAGTCTTGTCATAGA-1_V12D07-332_C1,2,0,0,0,0,2
GGGCAGAGCAATCGTT-1_V12D07-332_C1,5,1,3,0,3,12
TACCAAATAGCCCAGA-1_V12D07-332_C1,2,1,0,0,0,3
TACCTACTCCCAGTAT-1_V12D07-332_C1,1,0,1,0,0,2
TGTGAGACTAGCCCAA-1_V12D07-332_C1,3,0,0,0,0,3
ATACCTAACCAAGAAA-1_V12D07-332_C1,3,0,2,1,0,6
GTCGGGAAGCAGAAAC-1_V12D07-332_C1,1,0,0,0,0,1
AATTAACGGATTTCCA-1_V12D07-332_C1,5,0,1,0,0,6
GAACCCTCTGTGTTCT-1_V12D07-332_C1,2,0,0,0,0,2
ATATAAAGCGCTCGTG-1_V12D07-332_C1,4,0,0,0,0,4
CCTGGTCGAATGTGGG-1_V12D07-332_C1,2,1,0,0,0,3
CTAGGTTCGGACGTGA-1_V12D07-332_C1,1,0,0,0,1,2
TCGGGAGACAGCGTAC-1_V12D07-332_C1,1,0,0,1,0,2
CATAAGAAGCTTGGCT-1_V12D07-332_C1,0,2,2,0,0,4
AAGCACCCTGCGTATC-1_V12D07-332_C1,1,3,0,0,0,4
AGTTTGCACCTGCCTC-1_V12D07-332_C1,1,2,0,0,0,3
GACTGCAAATCGAGCT-1_V12D07-332_C1,0,3,0,0,0,3
GTGTATATCAGCGGGC-1_V12D07-332_C1,0,0,0,0,0,0
CTTCAACTCCACTTGG-1_V12D07-332_C1,0,2,1,0,0,3
ACTTACGCATCCACGC-1_V12D07-332_C1,2,2,0,1,1,6
CATGAGATGCACTCTC-1_V12D07-332_C1,0,2,0,0,1,3
GAGCACCTGTGTCCAG-1_V12D07-332_C1,1,0,0,1,0,2
CGCGACCGCGACAGAT-1_V12D07-332_C1,2,0,0,0,0,2
GTCCCGCGACGTTATG-1_V12D07-332_C1,1,1,0,0,0,2
GCAGTGTGGCTATAGG-1_V12D07-332_C1,0,0,1,0,1,2
ATACTGCCTTACACCG-1_V12D07-332_C1,1,0,0,0,0,1
TACAGAAACGGTGGGC-1_V12D07-332_C1,1,0,1,2,0,4
GGCGCGGAGATCTTTC-1_V12D07-332_C1,0,0,0,0,1,1
CGTTAATGTCCCGACG-1_V12D07-332_C1,0,0,0,0,0,0
GCTAACTGAAGTCTGA-1_V12D07-332_C1,0,4,1,0,0,5
AGTGATAACCTGCGCG-1_V12D07-332_C1,0,1,0,0,0,1
TATGATCTTCTCTTTA-1_V12D07-332_C1,0,0,0,0,1,1
TGTACCTACACGAGGG-1_V12D07-332_C1,0,2,0,0,0,2
ATATCGTTCCTCGAAC-1_V12D07-332_C1,1,6,1,1,0,9
CGGCGCCATCAATCCC-1_V12D07-332_C1,0,1,0,0,0,1
CCTGTTTGAAGACACG-1_V12D07-332_C1,2,1,0,0,0,3
GCCACTCAGAGCGCGA-1_V12D07-332_C1,1,1,0,1,0,3
TCGGCTTGTATCGACG-1_V12D07-332_C1,1,0,0,0,0,1
TAGATGGTTCCTTACT-1_V12D07-332_C1,2,0,0,0,1,3
ATCGTTAGCTAGCGGA-1_V12D07-332_C1,0,0,0,0,0,0
ACAGCGACATTCTCAT-1_V12D07-332_C1,0,1,0,0,0,1
ATTCAACCATTTAAGG-1_V12D07-332_C1,1,1,0,0,0,2
CACTCTTCTGCTAGCC-1_V12D07-332_C1,0,0,0,1,0,1
CTAACTGATAATCGCC-1_V12D07-332_C1,1,0,0,0,0,1
TGATGTCAATTAAGTG-1_V12D07-332_C1,0,1,0,1,0,2
CGCCGTTCAGCATAGT-1_V12D07-332_C1,1,0,0,0,0,1
ATACTACCCGTACCAC-1_V12D07-332_C1,1,2,0,0,0,3
CCACTGTTTGGATTAA-1_V12D07-332_C1,1,0,0,0,0,1
CACTACGGGAGCTGCC-1_V12D07-332_C1,0,0,0,0,0,0
GACCAAACGTTGACTG-1_V12D07-332_C1,0,0,0,1,0,1
AAGAGGCCCTTTGGAA-1_V12D07-332_C1,1,1,0,0,0,2
ACACGTAGGCCACAAG-1_V12D07-332_C1,0,0,0,0,0,0
TACTCTTACTTTACTG-1_V12D07-332_C1,0,1,0,0,0,1
AGAGCCGCCGAGATTT-1_V12D07-332_C1,0,0,0,0,0,0
GGCCTGCTTCTCCCGA-1_V12D07-332_C1,0,0,0,0,0,0
TCAAGCGCGGACGGTA-1_V12D07-332_C1,0,1,0,1,0,2
ACACTGGGACAGTCGT-1_V12D07-332_C1,2,0,0,0,0,2
TGTGTAGTAGCACGTG-1_V12D07-332_C1,1,0,0,0,0,1
CTAGCCACAGGCGAGC-1_V12D07-332_C1,0,1,0,0,0,1
CTATCGCGTAGAGAAC-1_V12D07-332_C1,1,0,0,0,0,1
GTTCCCGTAAACATAT-1_V12D07-332_C1,0,0,0,0,0,0
TCTTTCCTTCGAGATA-1_V12D07-332_C1,0,1,0,0,0,1
ATATTGGAGAGGCCTT-1_V12D07-332_C1,1,0,0,0,0,1
AGGCGATAACTGGCGT-1_V12D07-332_C1,0,1,0,0,1,2
ACCCGGAGCACCACAA-1_V12D07-332_C1,0,2,0,0,0,2
TGAGCTCAACTGTATA-1_V12D07-332_C1,0,1,0,0,0,1
ACGACCCATGAGTTGC-1_V12D07-332_C1,0,1,0,0,0,1
CGGTCAGTCCATATTT-1_V12D07-332_C1,0,1,0,0,0,1
TCCGGCTGTCGGGTCG-1_V12D07-332_C1,0,2,0,0,0,2
ATTCCCGAAGGTACAG-1_V12D07-332_C1,0,0,0,0,0,0
CTAACAGCACAATAAC-1_V12D07-332_C1,0,0,0,0,0,0
TTGTGCGGAAGCGGAT-1_V12D07-332_C1,0,0,0,0,0,0
GGGCACTATTGACCAT-1_V12D07-332_C1,0,0,0,0,0,0
CCATAGAGGCTGCCAG-1_V12D07-332_C1,0,2,1,0,0,3
CCGAAGCATTGACCAA-1_V12D07-332_C1,2,2,0,0,0,4
TACTGAGGGAAGAAAG-1_V12D07-332_C1,0,2,2,0,0,4
TATGTAGAAACCCGGC-1_V12D07-332_C1,1,1,1,0,0,3
TGGTTAACTTACATTT-1_V12D07-332_C1,1,5,1,0,0,7
AGAACCCTCAATTGGG-1_V12D07-332_C1,0,2,1,0,0,3
CCTATATCGTGTCACG-1_V12D07-332_C1,0,1,1,0,0,2
ACGGCTGGATGTAGAA-1_V12D07-332_C1,0,2,2,0,0,4
CTCGCATTGCATAGCC-1_V12D07-332_C1,1,1,3,0,0,5
ACTTTGGTCGTGCTCC-1_V12D07-332_C1,1,3,1,0,0,5
GCTGGTTTAGGCCATA-1_V12D07-332_C1,1,2,1,0,0,4
TGTCGTTATCACATAT-1_V12D07-332_C1,0,0,1,0,0,1
ACACATGATCAAATCT-1_V12D07-332_C1,0,1,2,0,0,3
TATCCATCTCGGTTAG-1_V12D07-332_C1,0,2,0,0,0,2
CTCGTCGAGGGCTCAT-1_V12D07-332_C1,0,5,1,0,0,6
ATCAATGCCGTGGCTG-1_V12D07-332_C1,2,1,0,0,0,3
GAAACATAGGAAACAG-1_V12D07-332_C1,0,2,0,0,0,2
TAATAGGTCACCAGAA-1_V12D07-332_C1,0,3,0,0,0,3
CACCAGTCAGCATGCA-1_V12D07-332_C1,0,2,3,0,0,5
GAGCGCTGTTAGGTAA-1_V12D07-332_C1,0,2,1,0,0,3
CCCTATGTAGAGCAGA-1_V12D07-332_C1,0,2,2,0,0,4
GATCGCTATATCTCAG-1_V12D07-332_C1,0,5,1,0,0,6
AAGGGACTATGCATTC-1_V12D07-332_C1,0,5,1,0,0,6
CTCGGGTTCTCTGGCC-1_V12D07-332_C1,0,4,0,0,0,4
TATATATCGAGAAATG-1_V12D07-332_C1,0,2,0,0,0,2
ACCCGAGCGAAATTAC-1_V12D07-332_C1,0,5,0,0,0,5
TTGTTTCATTAGTCTA-1_V12D07-332_C1,0,7,0,0,0,7
ATGGGACCTGCTGAAC-1_V12D07-332_C1,0,4,0,0,0,4
TGCGACGGCCGAACGT-1_V12D07-332_C1,1,0,0,0,0,1
AGCTAACAAGCAATGT-1_V12D07-332_C1,2,2,1,0,0,5
CGTGTCTCGTTACGAC-1_V12D07-332_C1,1,0,1,0,0,2
CTAAATCCGGTGTACA-1_V12D07-332_C1,1,3,1,0,0,5
GAATAGTGCTCGATTA-1_V12D07-332_C1,1,3,1,0,0,5
AACAATACATTGTCGA-1_V12D07-332_C1,0,1,0,0,0,1
CACATCGTGCACGCGC-1_V12D07-332_C1,1,1,0,0,0,2
ACCGTGACCACGTGGG-1_V12D07-332_C1,0,7,0,0,0,7
CCCAATGAGATTTGCA-1_V12D07-332_C1,0,1,0,0,0,1
TCAGCAGTAGGCCCTG-1_V12D07-332_C1,2,3,2,0,0,7
CTACTCAAGGTATAGT-1_V12D07-332_C1,0,4,1,0,0,5
TAGTAGCTTATACCAG-1_V12D07-332_C1,1,3,1,0,0,5
ACGTTCGTTCAGGAAA-1_V12D07-332_C1,0,5,1,0,0,6
TTAGAATAAGGGTCGG-1_V12D07-332_C1,0,1,0,0,0,1
TTCTAGAAAGTCTTAT-1_V12D07-332_C1,0,4,0,0,0,4
CCTTCAGTTAAAGTGA-1_V12D07-332_C1,0,2,0,0,0,2
TAGCTAGTGATGATGG-1_V12D07-332_C1,0,7,0,0,0,7
AGCCCGGTAGCCTGTA-1_V12D07-332_C1,0,4,0,0,0,4
TACCTCAGTTGTCTGT-1_V12D07-332_C1,2,0,1,0,0,3
GACGGGTTGGCCCGTA-1_V12D07-332_C1,2,4,0,1,0,7
GAAACCTATACAAATG-1_V12D07-332_C1,2,0,2,0,0,4
TCCACCTCTAGCCTTT-1_V12D07-332_C1,2,0,0,0,0,2
AAGACCCAACTGAACA-1_V12D07-332_C1,4,0,2,0,0,6
CATACACGGTTCCCAC-1_V12D07-332_C1,2,0,1,0,0,3
ACTACGCGTTAGAATT-1_V12D07-332_C1,3,0,1,0,0,4
CTTGGCCAAGCTGGGA-1_V12D07-332_C1,6,0,1,0,0,7
TTACCCTAGGGATTGG-1_V12D07-332_C1,3,0,1,0,0,4
TTCGCACTGTACGACA-1_V12D07-332_C1,2,0,1,0,0,3
TAGGTGTTCCACAGAT-1_V12D07-332_C1,3,0,2,0,0,5
GAAGCCTGCACATTCC-1_V12D07-332_C1,1,0,5,0,1,7
GGCTTTCAATAAGGGT-1_V12D07-332_C1,0,0,1,0,0,1
TCCAGGGTATATACGA-1_V12D07-332_C1,2,0,1,0,0,3
CTCGCCGAATGTAGGG-1_V12D07-332_C1,0,0,1,0,1,2
AGGAAGCTGTCCGCCG-1_V12D07-332_C1,1,3,0,0,0,4
GTCTCAAGGCCCGGCT-1_V12D07-332_C1,3,0,0,0,0,3
ACCGACACATCTCCCA-1_V12D07-332_C1,0,3,1,0,0,4
TATACGCGTCATCACT-1_V12D07-332_C1,0,4,2,0,0,6
ATCTGGGCTGTTCTTG-1_V12D07-332_C1,0,3,0,0,0,3
TCAAATTTGAGACTCA-1_V12D07-332_C1,0,4,0,0,0,4
GTTAAGGGTGCGATGT-1_V12D07-332_C1,1,2,2,0,0,5
AGCAAAGGCCGCTAGT-1_V12D07-332_C1,1,4,0,0,0,5
TTATAGGTAATTGTCT-1_V12D07-332_C1,0,0,0,0,0,0
TTGTGCAGCCACGTCA-1_V12D07-332_C1,0,2,0,0,0,2
ACGGACTCTCAAAGCG-1_V12D07-332_C1,0,5,0,1,0,6
ATGCTCTGGCGCGGTA-1_V12D07-332_C1,0,0,0,0,0,0
ATAATCTTGGAGAACC-1_V12D07-332_C1,0,2,0,0,0,2
CTCATTGCTCTAACAA-1_V12D07-332_C1,0,2,0,0,0,2
TAGGTGACGATAACCT-1_V12D07-332_C1,0,1,0,0,0,1
CGGATCCTCAAGGACT-1_V12D07-332_C1,0,1,0,0,0,1
GGGCGTGGTTTCCCAG-1_V12D07-332_C1,1,2,1,0,0,4
TGGCTATGTGACATAC-1_V12D07-332_C1,0,4,0,0,1,5
CTTAGTGTAGTAGCAT-1_V12D07-332_C1,0,3,1,0,0,4
GGATTGCTGTGACTCC-1_V12D07-332_C1,0,2,1,0,0,3
ACTTCCATGCGGGACA-1_V12D07-332_C1,7,0,0,0,2,9
ACTCAAGTGCAAGGCT-1_V12D07-332_C1,0,1,1,0,1,3
ACAAGGATGCTTTAGG-1_V12D07-332_C1,0,1,0,1,0,2
TTGAACGACGTGCTGA-1_V12D07-332_C1,0,1,0,0,0,1
ATTCATCGTTGAGGCA-1_V12D07-332_C1,1,2,1,1,0,5
TGCAACCCATCTGCGG-1_V12D07-332_C1,1,0,0,0,0,1
AGTGCTAAACACAGCA-1_V12D07-332_C1,0,0,0,0,0,0
AACTCCAGAGCGTGTT-1_V12D07-332_C1,1,1,0,0,0,2
TCTCCACAAGTTGAAT-1_V12D07-332_C1,1,0,0,1,0,2
CTTTGCATCGCTCTTG-1_V12D07-332_C1,1,2,0,0,0,3
TCACAAACCGAGGTAC-1_V12D07-332_C1,0,1,0,0,0,1
CCGTAGGAAATCCCTG-1_V12D07-332_C1,0,0,0,1,1,2
AAACATTTCCCGGATT-1_V12D07-332_C1,2,0,0,0,0,2
GCCTCCGACAATTCAC-1_V12D07-332_C1,2,3,0,0,0,5
TCTGCATACCTTGCTT-1_V12D07-332_C1,0,0,0,0,0,0
ACCCATTTGTCCCTCT-1_V12D07-332_C1,0,3,0,0,0,3
CTGCAGAGAATCAGAG-1_V12D07-332_C1,0,0,0,0,0,0
GGAAACTAAATGGGCC-1_V12D07-332_C1,1,0,1,0,0,2
CAACCTACCGAGCAGT-1_V12D07-332_C1,0,0,0,0,0,0
CCGTAGGGTTGTTTAC-1_V12D07-332_C1,1,1,0,0,0,2
GGTTTGTGACCTGAGG-1_V12D07-332_C1,0,2,0,0,0,2
TAACCTAGGGAGTCCA-1_V12D07-332_C1,1,0,0,0,0,1
TTCCATCGACAGCGTG-1_V12D07-332_C1,2,1,0,0,0,3
ATCTCCCACGGAATAT-1_V12D07-332_C1,2,0,0,0,0,2
GTTTCAAACGAGTTGT-1_V12D07-332_C1,1,0,0,0,0,1
GGAACTTTGGCGATTA-1_V12D07-332_C1,3,1,0,0,0,4
CTGCAAGCACGTTCCG-1_V12D07-332_C1,1,0,0,0,0,1
CACAGTCCCGCTTCGC-1_V12D07-332_C1,0,0,0,0,0,0
TACGCTCGGTATTGGA-1_V12D07-332_C1,0,0,0,0,0,0
CTGGTAAAGTGTGGGC-1_V12D07-332_C1,0,0,0,1,0,1
CAACCAGTGGCCTACC-1_V12D07-332_C1,0,0,0,0,0,0
TCTTCGCGGTGAGAGG-1_V12D07-332_C1,1,2,0,1,0,4
TTCGGGTTGCCACGGG-1_V12D07-332_C1,0,0,0,1,1,2
ACCGATAGGCATAACC-1_V12D07-332_C1,3,3,0,0,0,6
CTTATAGATGGCTGTT-1_V12D07-332_C1,0,0,0,1,1,2
AGACGCCCACTTCGCC-1_V12D07-332_C1,0,0,1,0,0,1
AGGTCGCCTCCCAACA-1_V12D07-332_C1,0,0,0,0,2,2
CCTCACGTCAGCTAAT-1_V12D07-332_C1,1,1,0,0,1,3
CCACCTGTATGGAATA-1_V12D07-332_C1,2,6,0,0,0,8
GGACTCGAAGCTTTCA-1_V12D07-332_C1,0,1,1,0,0,2
AAGCCGGAGAGCAGGA-1_V12D07-332_C1,0,0,0,0,1,1
GCCTATCAGGTAAGAT-1_V12D07-332_C1,0,1,0,1,0,2
TCAGAGTGTGAGCATG-1_V12D07-332_C1,2,3,0,0,0,5
AAACATGGTGAGAGGA-1_V12D07-332_C1,0,0,0,0,0,0
ATCATTGTACCGCATT-1_V12D07-332_C1,0,0,0,0,0,0
TCAGCTTGAGCTTTCG-1_V12D07-332_C1,0,0,0,0,0,0
CCGCGCAAGATACCCA-1_V12D07-332_C1,0,0,0,0,0,0
CTATACTTAAAGCGAG-1_V12D07-332_C1,2,0,0,0,0,2
ACCGTCCACTGGGCCC-1_V12D07-332_C1,1,3,1,0,0,5
AAGACCAAATAACTCA-1_V12D07-332_C1,1,3,0,0,0,4
TGTTTCTGAAGCGTGC-1_V12D07-332_C1,0,4,0,0,0,4
TTCTCTTACAGGTGAT-1_V12D07-332_C1,1,2,0,0,0,3
AATTCATTGTCATGCA-1_V12D07-332_C1,0,2,0,0,0,2
GCCCGAGAGTCTAAAT-1_V12D07-332_C1,1,4,2,0,0,7
ATATAGAGTATTGGTC-1_V12D07-332_C1,0,1,1,0,0,2
TTGAAGGATGGGCGCC-1_V12D07-332_C1,0,3,0,0,0,3
TAGTACCACAACTTTC-1_V12D07-332_C1,0,1,2,0,0,3
ATCCCATCCACAGCGC-1_V12D07-332_C1,0,3,0,0,0,3
CTTAGGTATAGACCAG-1_V12D07-332_C1,0,2,0,0,0,2
TGACTCCGAATCATAC-1_V12D07-332_C1,0,4,0,0,0,4
ACTACATCCCGACAAG-1_V12D07-332_C1,0,8,1,0,0,9
TTGCCGCAGACCTACA-1_V12D07-332_C1,1,5,0,0,0,6
TAAGAGGGACAGGGAC-1_V12D07-332_C1,0,3,0,0,0,3
CGAATGAAGTCATTGC-1_V12D07-332_C1,0,2,1,0,0,3
AAGGGAACGACTGGCT-1_V12D07-332_C1,0,3,0,0,0,3
CGAATCTGCTCGACGC-1_V12D07-332_C1,0,4,0,0,0,4
ATCGTGGAAAGTCTGG-1_V12D07-332_C1,2,0,0,0,0,2
CCTATGGCTCCTAGTG-1_V12D07-332_C1,1,3,0,0,0,4
CGTCGCTTGGTTATAC-1_V12D07-332_C1,0,1,0,0,0,1
TGCTTAGAGAGAATGC-1_V12D07-332_C1,0,6,0,0,0,6
GATTGCTCCAGTTGCA-1_V12D07-332_C1,1,2,0,0,0,3
CGTGCTTCTACCTAAA-1_V12D07-332_C1,1,2,0,0,0,3
ACTCCAATATCATCAT-1_V12D07-332_C1,3,3,0,0,0,6
GCCGACCCACGACTGC-1_V12D07-332_C1,0,4,1,0,0,5
GAGGGTAGTAACAAAG-1_V12D07-332_C1,0,4,0,0,0,4
GGCCGAGACTCTGGTG-1_V12D07-332_C1,1,2,0,0,0,3
TATATAGGGCTTTACG-1_V12D07-332_C1,0,3,0,0,0,3
TGCCGGATGTACGAGC-1_V12D07-332_C1,2,5,0,0,0,7
AGGTAGATCGAGATAT-1_V12D07-332_C1,1,4,2,0,0,7
GATCAACATAAAGGGA-1_V12D07-332_C1,0,2,0,0,0,2
TAACAGCGTTTGTGCT-1_V12D07-332_C1,1,1,0,0,0,2
CTATAGGCGTTGATGT-1_V12D07-332_C1,0,1,0,0,0,1
GGTTTAATTACCATCG-1_V12D07-332_C1,0,2,0,0,0,2
CTCTTCTGGAAGTTAG-1_V12D07-332_C1,0,5,0,0,0,5
ATCTGACATGGAAGGA-1_V12D07-332_C1,1,2,0,0,0,3
TACGTACTAGTGCTGA-1_V12D07-332_C1,1,3,0,0,0,4
ATGACTATCAGCTGTG-1_V12D07-332_C1,1,2,0,0,0,3
CTTTGGGATTGTTGCA-1_V12D07-332_C1,0,10,0,0,0,10
AGACTGTTACCGGGTC-1_V12D07-332_C1,1,3,0,0,0,4
TCCTAACCGTCGGGCA-1_V12D07-332_C1,1,3,0,0,0,4
ACGCAAACTAATAGAT-1_V12D07-332_C1,1,2,1,0,0,4
AAGTGAGTCGGGTTTA-1_V12D07-332_C1,0,1,0,0,0,1
TAAAGCGGTATTTCCA-1_V12D07-332_C1,1,2,1,0,0,4
CTCCTCCAGCTCACAC-1_V12D07-332_C1,0,3,0,0,0,3
CGGTCCGTCGCAAGCC-1_V12D07-332_C1,0,2,0,0,0,2
CCTATATTTGTCCTGG-1_V12D07-332_C1,1,3,0,0,0,4
TCCAATAAAGGCTACC-1_V12D07-332_C1,2,2,0,0,0,4
AAAGGCTACGGACCAT-1_V12D07-332_C1,1,2,1,0,0,4
CGTGACCAGTCCTCTG-1_V12D07-332_C1,0,3,0,0,0,3
GATCTGCTATCTAAGG-1_V12D07-332_C1,0,2,0,0,1,3
CGAATGACGCATAATG-1_V12D07-332_C1,0,0,0,0,0,0
GCTCAATGTAATACCG-1_V12D07-332_C1,1,1,0,0,0,2
CTATGCCCGAATGCAA-1_V12D07-332_C1,1,2,0,0,1,4
CACAGGGCCGTTGTCA-1_V12D07-332_C1,0,1,0,0,0,1
TCAATACGCCGTCATG-1_V12D07-332_C1,0,3,0,0,0,3
AGCGGACACTTCGTAG-1_V12D07-332_C1,0,2,1,0,0,3
ATACGTTATGCACGGA-1_V12D07-332_C1,0,5,0,0,0,5
GAGTAGATACTAGTTG-1_V12D07-332_C1,1,4,1,0,0,6
CCAGCTCGAACGCATT-1_V12D07-332_C1,0,3,0,0,0,3
TGCTTCCCAAGCAGTA-1_V12D07-332_C1,0,7,1,0,0,8
GTAGACACGCCTGACT-1_V12D07-332_C1,0,5,0,0,1,6
CTCACATTTACTAAAT-1_V12D07-332_C1,2,2,1,1,0,6
GAATGCGAATCGGTTC-1_V12D07-332_C1,0,7,1,0,0,8
TAAGGCCCGTCACCCT-1_V12D07-332_C1,0,2,0,1,0,3
GAGTATGCGCGTGCAT-1_V12D07-332_C1,1,1,0,0,0,2
ATCCACATCGACAGAA-1_V12D07-332_C1,0,1,0,0,0,1
TAGACGAAACGCCAAT-1_V12D07-332_C1,1,1,0,0,0,2
CAGCAGTCTGTGCTGC-1_V12D07-332_C1,1,3,1,0,2,7
CTCACTGTGATACTTA-1_V12D07-332_C1,0,6,0,0,0,6
TTAATTGCTTTGGGTG-1_V12D07-332_C1,2,4,0,2,0,8
GTAGTCTACGATATTG-1_V12D07-332_C1,1,1,0,0,0,2
TTGCCGCTTTCTAGTA-1_V12D07-332_C1,1,1,0,0,0,2
GAACCTTTAACGATCC-1_V12D07-332_C1,1,4,0,2,0,7
TGGACCAATCTAAGAT-1_V12D07-332_C1,1,0,2,0,0,3
CTAGTAGAAAGGGATT-1_V12D07-332_C1,3,0,0,0,0,3
AACCTCGCTTTAGCCC-1_V12D07-332_C1,2,3,0,0,0,5
GAGTGTCAACCAGAAA-1_V12D07-332_C1,0,1,0,0,0,1
GTGATCCTTGTCATGA-1_V12D07-332_C1,0,2,0,1,0,3
CTCAACTAACCCGGAT-1_V12D07-332_C1,0,1,0,0,0,1
AGTGGCGTCTGAAGGT-1_V12D07-332_C1,0,0,0,0,0,0
GGGAAGGGCTTTCTCA-1_V12D07-332_C1,1,1,0,0,1,3
AGGCCTGAGAATCTCG-1_V12D07-332_C1,0,2,1,0,1,4
AGCCACAGGTTACCCG-1_V12D07-332_C1,0,0,0,1,0,1
TGCAATCTAACACGGT-1_V12D07-332_C1,0,1,0,1,0,2
GTTTGGGTTTCGCCCG-1_V12D07-332_C1,1,0,0,0,2,3
CCTATGTCCACTCCAC-1_V12D07-332_C1,1,1,1,0,0,3
CTGCCTTTCTAGTAAA-1_V12D07-332_C1,0,0,0,0,0,0
TTAGTAAACCTGCTCT-1_V12D07-332_C1,2,2,0,1,0,5
TTGTGGTGGTACTAAG-1_V12D07-332_C1,3,0,0,0,0,3
CCTCCTGTTGTGTCGT-1_V12D07-332_C1,1,0,0,0,3,4
ACAAAGCATGACCTAG-1_V12D07-332_C1,0,0,0,0,0,0
ATAGCAACTAGGGAAG-1_V12D07-332_C1,0,2,1,0,0,3
CCGCTCTTCCGAACTA-1_V12D07-332_C1,0,1,0,0,0,1
TAGAATAGCCGATGAA-1_V12D07-332_C1,0,0,0,0,0,0
GGTCTCCGTCCAGGTT-1_V12D07-332_C1,0,0,0,0,0,0
TAATTACGTCAGTAGA-1_V12D07-332_C1,0,0,0,0,0,0
TACGTAAAGCGGAGTG-1_V12D07-332_C1,1,1,0,0,0,2
GCTACAATCGAGGATA-1_V12D07-332_C1,2,1,0,1,0,4
TCAGCCAATCCGTAAA-1_V12D07-332_C1,1,1,0,3,0,5
ATCATAGCCCTATGTA-1_V12D07-332_C1,1,0,0,0,0,1
GAGGCCTGTTGATACA-1_V12D07-332_C1,0,1,0,0,0,1
ATATACGCTCGTGACG-1_V12D07-332_C1,3,1,0,0,0,4
CCCTTTAATGGAGTTC-1_V12D07-332_C1,1,2,0,1,0,4
TTACACGATCTGCGAC-1_V12D07-332_C1,2,1,0,0,0,3
TCGCATAAAGGGCGCA-1_V12D07-332_C1,2,1,0,0,0,3
TGTAGCCATCCCATTC-1_V12D07-332_C1,3,1,0,0,0,4
GGGTCTATCGCTTTCC-1_V12D07-332_C1,1,1,0,0,0,2
GGAGGGTCAAGTAAGA-1_V12D07-332_C1,0,1,0,0,0,1
TACGGCATGGACGCTA-1_V12D07-332_C1,0,1,0,0,0,1
CACGTCAATCAATGGA-1_V12D07-332_C1,1,0,0,0,0,1
CGCTTGGACGGATAGA-1_V12D07-332_C1,1,1,0,0,0,2
CGCGGTACGGTATACA-1_V12D07-332_C1,0,0,0,0,0,0
CCTACTCAACACGATT-1_V12D07-332_C1,2,3,0,0,0,5
CGTTTGGTGTTGTGGG-1_V12D07-332_C1,0,1,0,1,0,2
GTTGTTGCAAGATGGC-1_V12D07-332_C1,0,1,0,0,0,1
CATTCGTCGTAGCGGT-1_V12D07-332_C1,0,0,0,0,0,0
CAGCCTCGATAGCGGT-1_V12D07-332_C1,1,1,0,0,0,2
TCATAAGTCCAAGAAG-1_V12D07-332_C1,0,0,1,1,1,3
AAAGTGCCATCAATTA-1_V12D07-332_C1,0,0,0,0,0,0
GTTGCAGTCGACAACA-1_V12D07-332_C1,0,0,0,0,0,0
TAAATGGGCTACTGAG-1_V12D07-332_C1,0,0,0,0,1,1
GGACAAGCCATGATCG-1_V12D07-332_C1,0,0,0,0,0,0
TCCAATGCGTCGCCGC-1_V12D07-332_C1,0,0,0,0,0,0
AAAGAATGACCTTAGA-1_V12D07-332_C1,0,0,0,0,0,0
CCTATTATTCCGGCCG-1_V12D07-332_C1,0,0,0,0,0,0
CAGTAAGGGACGTCTC-1_V12D07-332_C1,1,2,0,0,0,3
GGGATGGACCCGCGTC-1_V12D07-332_C1,1,0,0,0,0,1
GACGCATACCCGTCGG-1_V12D07-332_C1,1,2,0,0,0,3
GGGCAGGATTTCTGTG-1_V12D07-332_C1,0,4,0,0,0,4
TATCTGAGCCGATATT-1_V12D07-332_C1,0,5,0,0,0,5
AATGTATGGCACTGTA-1_V12D07-332_C1,0,1,1,0,0,2
GCCTTTGTCAGTGGAC-1_V12D07-332_C1,0,3,0,0,0,3
AACCATAGGGTTGAAC-1_V12D07-332_C1,4,0,0,0,0,4
AAACTTAATTGCACGC-1_V12D07-332_C1,1,1,4,0,0,6
TAGGCGGCTGCAAAGA-1_V12D07-332_C1,1,6,0,0,0,7
TCCATCAATACTAATC-1_V12D07-332_C1,0,3,1,0,0,4
ACCTCGAACTTATGCT-1_V12D07-332_C1,1,1,0,0,0,2
ACAAACCATGCGTCCT-1_V12D07-332_C1,0,4,2,0,0,6
ACACCGGTCTGACCGC-1_V12D07-332_C1,1,6,0,0,0,7
ATGGCAGCATTACGAT-1_V12D07-332_C1,0,2,0,0,0,2
CTGGTGAATGGGCCTA-1_V12D07-332_C1,1,3,0,0,0,4
CACAGAGACGAGGACG-1_V12D07-332_C1,0,1,2,0,0,3
GCACAAACCCTAGATG-1_V12D07-332_C1,1,1,1,0,0,3
ACTATGTCCAGCTGCC-1_V12D07-332_C1,0,3,0,0,0,3
AAGCCGCCGTGAAATC-1_V12D07-332_C1,0,5,1,0,0,6
ATGGGTGTATACCTCC-1_V12D07-332_C1,3,1,1,0,0,5
TAAGCGCGAATCAAAT-1_V12D07-332_C1,2,3,0,0,0,5
AGCCCGGCATTAGAGG-1_V12D07-332_C1,0,4,1,0,0,5
GTGATCAAGCGTGCAC-1_V12D07-332_C1,1,2,0,0,0,3
CTGCCTTTAATACCTT-1_V12D07-332_C1,1,1,3,0,0,5
TACCTCCACACCAATG-1_V12D07-332_C1,1,3,1,1,0,6
GAGCATCAACAACTTG-1_V12D07-332_C1,2,4,1,0,0,7
CATACGAACTAGCTGG-1_V12D07-332_C1,0,1,0,0,0,1
GGGAACGGTTTCAGAT-1_V12D07-332_C1,0,3,1,0,0,4
AGGGTGCCGTTCTTTA-1_V12D07-332_C1,2,2,0,0,0,4
ACGACTGGTCATACTC-1_V12D07-332_C1,0,0,1,0,0,1
GGATCTTACTGCCCTT-1_V12D07-332_C1,1,1,0,0,0,2
TACTCCTCTAGTTGAC-1_V12D07-332_C1,0,4,2,0,0,6
GTAGCTCCGGGAGGCT-1_V12D07-332_C1,1,1,0,0,0,2
GGACTCGTGAGTGGTC-1_V12D07-332_C1,1,1,0,0,0,2
GTAGTTCGAAGGCGAA-1_V12D07-332_C1,1,3,1,0,0,5
CTCAAACCACTGCCCG-1_V12D07-332_C1,0,2,0,0,0,2
GAGGGAGTCAGATCGC-1_V12D07-332_C1,1,4,1,0,0,6
GCGTCCCTAAGACATA-1_V12D07-332_C1,1,2,0,0,0,3
TCTCTTACCGCGAACC-1_V12D07-332_C1,0,3,3,0,0,6
GGCTACTATACACTCC-1_V12D07-332_C1,0,2,1,0,0,3
CGTTGCCCGCGTGGGA-1_V12D07-332_C1,0,3,0,0,0,3
TATAGAGTCGCTTGAA-1_V12D07-332_C1,0,3,0,0,0,3
ATGTTGTAGTCTGTTT-1_V12D07-332_C1,0,4,0,0,0,4
AGTATACACAGCGACA-1_V12D07-332_C1,1,1,1,0,0,3
TGTGGTTGCTAAAGCT-1_V12D07-332_C1,0,0,0,0,0,0
TGATTCCCGGTTACCT-1_V12D07-332_C1,1,4,0,0,0,5
CACTGACGATTGTGGA-1_V12D07-332_C1,0,1,1,0,0,2
AACATTGTGACTCGAG-1_V12D07-332_C1,0,3,0,0,0,3
GTCCAATATTTAGCCT-1_V12D07-332_C1,1,5,0,0,0,6
GCTCTTTCCGCTAGTG-1_V12D07-332_C1,1,5,0,0,0,6
GGGTCAGGAGCTAGAT-1_V12D07-332_C1,0,1,1,0,0,2
AGGTGGTGACCTTCGC-1_V12D07-332_C1,1,1,0,0,0,2
CCCGGGTCGTTCAGGG-1_V12D07-332_C1,0,2,1,0,0,3
AGCCAAGCTTTGTGTC-1_V12D07-332_C1,0,3,0,0,0,3
TGTGGCGGGCTTCTGG-1_V12D07-332_C1,1,2,0,0,1,4
CGAGGGTATCCAGGTG-1_V12D07-332_C1,0,3,1,0,0,4
CGTTCAGACCCGCGAA-1_V12D07-332_C1,0,0,0,0,0,0
TCATATGAGCTTTGTT-1_V12D07-332_C1,0,4,0,0,0,4
AGTTGACGGTCCTTGC-1_V12D07-332_C1,0,2,0,0,0,2
ATAATTAGCTAAGTAG-1_V12D07-332_C1,0,3,1,0,0,4
GGTCTTGAGCGCTCTT-1_V12D07-332_C1,0,5,1,0,0,6
CGTTGTCGGCAATTGA-1_V12D07-332_C1,0,4,1,0,0,5
TCTTGCTCCCGATACT-1_V12D07-332_C1,0,4,0,0,0,4
AGCAGAAGGAGAAAGA-1_V12D07-332_C1,1,4,1,0,0,6
GAAGCCACTGATTATG-1_V12D07-332_C1,1,5,0,0,0,6
TGCTCTTGAGAGTTTG-1_V12D07-332_C1,0,2,0,0,0,2
GACATCCGTCGAACTG-1_V12D07-332_C1,0,4,1,0,0,5
AGATATAATACGACTA-1_V12D07-332_C1,0,2,0,0,0,2
TCGCTACTGGCTTTGA-1_V12D07-332_C1,1,2,1,0,0,4
GTGACAGCTTCCCACT-1_V12D07-332_C1,5,1,2,0,0,8
GTGACGCAGGTTTCAT-1_V12D07-332_C1,0,2,0,0,0,2
GGGAAGACGGTCTGTC-1_V12D07-332_C1,0,0,0,0,0,0
CGTCGCATGTGAGCCA-1_V12D07-332_C1,0,0,0,0,0,0
AGAAGGTTGTAGGTCG-1_V12D07-332_C1,1,0,1,0,0,2
GGCCGGCGTCTGCTAT-1_V12D07-332_C1,0,3,0,0,0,3
TTGACCAGGAACAACT-1_V12D07-332_C1,0,3,0,0,0,3
AGTCGTATAAAGCAGA-1_V12D07-332_C1,2,1,0,0,0,3
GGCGTAGGGAAAGCTG-1_V12D07-332_C1,0,1,0,0,0,1
AAACCTAAGCAGCCGG-1_V12D07-332_C1,1,0,0,0,0,1
ATTGCCTTTATGTTTG-1_V12D07-332_C1,1,1,0,0,0,2
CAGGCAGTCTTACCAG-1_V12D07-332_C1,0,0,0,0,0,0
AGCTAAGTACGCAGGC-1_V12D07-332_C1,1,0,0,0,0,1
AAATCCGATACACGCC-1_V12D07-332_C1,0,1,0,0,0,1
CGAGAGCTTTCACTAC-1_V12D07-332_C1,2,0,0,0,0,2
CGCCCAGCGTTTCACG-1_V12D07-332_C1,0,0,0,0,0,0
TTAAGTATTGTTATCC-1_V12D07-332_C1,0,2,0,3,0,5
AAACGGGCGTACGGGT-1_V12D07-332_C1,0,3,0,1,0,4
GTATCCTTTGGTAACC-1_V12D07-332_C1,1,0,0,1,0,2
CATAGTCAAATACATA-1_V12D07-332_C1,0,2,1,0,0,3
TCTATGCTATAACGAC-1_V12D07-332_C1,0,0,0,1,0,1
ACGTTCTGTACAAGTC-1_V12D07-332_C1,0,1,0,1,0,2
CGCGAAGTGGCATACT-1_V12D07-332_C1,0,0,0,0,0,0
ACCAACCGCACTCCAC-1_V12D07-332_C1,0,1,0,0,0,1
GTCATGCGCGAGGGCT-1_V12D07-332_C1,0,1,0,0,0,1
TAGGCTAAAGTGGCAC-1_V12D07-332_C1,0,0,0,1,0,1
TGGCTACACTCTACCT-1_V12D07-332_C1,1,0,0,1,2,4
TGTCCACGGCTCAACT-1_V12D07-332_C1,0,1,2,1,0,4
AATTGCAGCAATCGAC-1_V12D07-332_C1,0,0,0,0,0,0
GTCAACCAGGCCTATA-1_V12D07-332_C1,1,1,0,0,0,2
ATCTTATCGCACACCC-1_V12D07-332_C1,2,0,0,1,0,3
GTCTATTGCATGCTCG-1_V12D07-332_C1,0,0,0,0,0,0
GCACGTGGTTTACTTA-1_V12D07-332_C1,1,0,0,0,0,1
ATTCGCGCCTTGAGAG-1_V12D07-332_C1,0,2,0,2,1,5
AGCGATGCGCCTAATA-1_V12D07-332_C1,2,0,0,0,0,2
TCTATAGGTGGGTAAT-1_V12D07-332_C1,0,1,0,0,0,1
AGATACCAATAGAACC-1_V12D07-332_C1,1,0,0,0,0,1
CGTGTATGGGAGCTGA-1_V12D07-332_C1,0,1,0,0,0,1
ATGTACATGCGGTGAG-1_V12D07-332_C1,1,6,0,0,0,7
TTGGCTCAATATGTGT-1_V12D07-332_C1,1,0,0,0,0,1
GTTCGGAGCACTCAAC-1_V12D07-332_C1,0,0,0,0,0,0
TCCCTCTTCTCAAGGG-1_V12D07-332_C1,0,0,0,0,0,0
TTACGTATCTATGACA-1_V12D07-332_C1,2,4,1,0,0,7
CCCATATAGGTCGATT-1_V12D07-332_C1,5,3,0,0,0,8
GTCCACGTCGCATTCG-1_V12D07-332_C1,1,0,0,0,0,1
AATTGTGGTTGCCAAA-1_V12D07-332_C1,2,0,0,0,1,3
AGGAACGAACGACTTC-1_V12D07-332_C1,0,0,0,0,0,0
TAATTCCAATGCTTCA-1_V12D07-332_C1,0,0,0,0,0,0
AGGGCCCTAATGTTCT-1_V12D07-332_C1,0,0,0,0,0,0
AGGTGTTGCCGACCAC-1_V12D07-332_C1,0,1,0,0,0,1
CTGAGAGTAGAAATAC-1_V12D07-332_C1,0,1,0,1,0,2
TAGAAGAAGGGTTACA-1_V12D07-332_C1,2,1,0,0,0,3
GGTGACTGATAGAGAG-1_V12D07-332_C1,0,0,0,0,0,0
TACCCTCGGTAACCCT-1_V12D07-332_C1,1,0,0,0,0,1
TGTAAGACTGATAAGA-1_V12D07-332_C1,0,0,0,0,0,0
GTCACTCATGAGCGAT-1_V12D07-332_C1,0,0,0,0,0,0
CGGTTTACTGAACATT-1_V12D07-332_C1,0,0,0,0,0,0
GAGATCGATCTTACTC-1_V12D07-332_C1,0,0,0,0,0,0
TCTTTCATCCGTCCTT-1_V12D07-332_C1,0,0,0,0,0,0
TCGGATCTGGATGACC-1_V12D07-332_C1,1,1,0,0,0,2
GTCCTAGGATACCTTA-1_V12D07-332_C1,0,1,0,0,0,1
TGTACCCGACCCTAAT-1_V12D07-332_C1,1,2,1,0,0,4
AGGTTCTCCTTTCCGG-1_V12D07-332_C1,0,2,3,0,0,5
AATTGCGTGGATTACA-1_V12D07-332_C1,0,2,1,0,0,3
CGATAGCGATACAGTG-1_V12D07-332_C1,1,5,0,0,0,6
CGCCCTAATTGTTCAA-1_V12D07-332_C1,1,2,0,0,0,3
ATTATGAGACCCAATT-1_V12D07-332_C1,1,2,2,0,0,5
CCTCCTAGCTAGAGTC-1_V12D07-332_C1,0,1,2,0,0,3
CGAAGGGTTTCAGATT-1_V12D07-332_C1,0,4,1,0,0,5
CACAAGCTAAGAAAGG-1_V12D07-332_C1,1,2,1,0,0,4
CACCGGTAGAGACATT-1_V12D07-332_C1,1,2,1,0,0,4
ACTCATGGCAGCCTTC-1_V12D07-332_C1,0,3,1,0,0,4
CATCCAATATAGTTTG-1_V12D07-332_C1,1,4,1,0,0,6
CAGATATGAAGATGAC-1_V12D07-332_C1,1,1,1,0,0,3
GCAAAGGGCGTTAGCC-1_V12D07-332_C1,0,1,0,0,0,1
CTGTTGTTCAGTCGTA-1_V12D07-332_C1,0,6,1,0,0,7
AAAGGCCCTATAATAC-1_V12D07-332_C1,2,3,0,0,0,5
AACATTGAAGTTGATC-1_V12D07-332_C1,1,1,0,0,0,2
GCTAGCGATAGGTCTT-1_V12D07-332_C1,0,2,1,0,0,3
ATTGCCTATTAGACCG-1_V12D07-332_C1,0,9,1,0,0,10
GGGCGTTTACATTCAT-1_V12D07-332_C1,0,2,0,0,0,2
CCTCTACAAGGATTGG-1_V12D07-332_C1,1,1,1,0,0,3
AGTGACTGTGACACAA-1_V12D07-332_C1,1,4,0,0,0,5
AGCCCTCCCTGGTGGC-1_V12D07-332_C1,0,2,2,0,0,4
CGGTTGAGTATCCTTC-1_V12D07-332_C1,0,3,1,0,0,4
CATTATCCCATTAACG-1_V12D07-332_C1,1,0,0,0,0,1
AATGTGCTAATCTGAG-1_V12D07-332_C1,0,1,1,0,0,2
CTTAGTTGAGGAATCG-1_V12D07-332_C1,0,7,0,0,0,7
CTTCTGGGCGTACCTA-1_V12D07-332_C1,1,3,1,0,0,5
AGTCAAATGATGTGAT-1_V12D07-332_C1,0,5,0,0,0,5
TGAACAAGCAGGGACT-1_V12D07-332_C1,2,1,0,0,0,3
AATACCGGAGGGCTGT-1_V12D07-332_C1,0,4,0,0,0,4
GTTTGGTGATCGGTGC-1_V12D07-332_C1,1,3,1,0,0,5
GACTGCTGGTGAGAAA-1_V12D07-332_C1,0,4,1,0,0,5
CGATCCTCGCAACATA-1_V12D07-332_C1,0,5,3,0,0,8
CCAACCTTATGTAACT-1_V12D07-332_C1,0,3,1,0,0,4
CGTGGTACCCAAAGGC-1_V12D07-332_C1,1,2,0,0,0,3
AACCCGACAACCCGTG-1_V12D07-332_C1,0,3,0,0,0,3
TATGTAAAGTGCTTAA-1_V12D07-332_C1,0,2,1,0,0,3
GCAAGTGTAAAGCATG-1_V12D07-332_C1,1,6,0,0,0,7
GTAACTGCCCAAGGAG-1_V12D07-332_C1,1,1,1,0,0,3
GGTGCATAAATGATTA-1_V12D07-332_C1,2,0,1,0,0,3
TAGTCCCGGAGACCAC-1_V12D07-332_C1,0,2,0,0,0,2
CGGCCAGAGCGACCAT-1_V12D07-332_C1,0,5,1,0,0,6
TGAATGAGTGTTTCCC-1_V12D07-332_C1,1,3,2,0,0,6
TTCACTTCCTAGAACG-1_V12D07-332_C1,1,1,1,0,0,3
CGCTTAGTATTGATAC-1_V12D07-332_C1,0,3,0,0,0,3
AACGCGACCTTGGGCG-1_V12D07-332_C1,0,2,0,0,0,2
GTGCACCAGCTTCAAC-1_V12D07-332_C1,0,1,0,0,0,1
TTCTATTAAACGCAGC-1_V12D07-332_C1,0,2,1,0,0,3
TGGCAAGCACAAGTCG-1_V12D07-332_C1,1,0,1,0,0,2
ATCTGCTGTTATCGCC-1_V12D07-332_C1,1,3,0,0,0,4
AATTCCAAGCATGTAC-1_V12D07-332_C1,0,3,0,0,1,4
AAACGGTTGCGAACTG-1_V12D07-332_C1,0,3,1,0,0,4
GAAGGAGTCGAGTGCG-1_V12D07-332_C1,0,3,1,0,0,4
GGCAAGCCCATAGTGG-1_V12D07-332_C1,1,5,0,0,0,6
TGACCAAATCTTAAAC-1_V12D07-332_C1,1,1,1,0,0,3
TTCGGTACTGTAGAGG-1_V12D07-332_C1,1,3,0,0,0,4
ATGTACGATGACGTCG-1_V12D07-332_C1,0,4,2,0,0,6
ATCTAGCTTGTGAGGG-1_V12D07-332_C1,0,3,0,0,0,3
AGCGGGTCTGACACTC-1_V12D07-332_C1,1,1,0,0,0,2
GAGGTACGCGTGTCCC-1_V12D07-332_C1,1,3,1,0,0,5
GCACTGCCTACCTTTA-1_V12D07-332_C1,0,2,0,0,0,2
GGAGCGAGGCCTACTT-1_V12D07-332_C1,1,4,0,0,0,5
AAACTCGGTTCGCAAT-1_V12D07-332_C1,0,1,0,0,0,1
GGCGCTTCATTCCCTG-1_V12D07-332_C1,1,3,2,0,0,6
TGCTCGGTGGGTCACC-1_V12D07-332_C1,0,5,0,0,0,5
AAGCGCAGGGCTTTGA-1_V12D07-332_C1,0,3,0,0,0,3
GACCTTCCACGTCTAC-1_V12D07-332_C1,1,3,0,0,0,4
GTTAGCCCATGACATC-1_V12D07-332_C1,2,1,0,0,0,3
AATTCGATTCGAGGAT-1_V12D07-332_C1,0,1,0,0,0,1
AGTCTTTAAAGTGTCC-1_V12D07-332_C1,0,1,0,0,0,1
GACTAGGCCGTTAGGT-1_V12D07-332_C1,0,0,1,0,0,1
TCCAAGCCTAGACACA-1_V12D07-332_C1,0,1,0,0,0,1
GATTGGGAAAGGTTGT-1_V12D07-332_C1,0,1,0,0,0,1
GATGAGGAACCTTCGG-1_V12D07-332_C1,0,1,1,0,0,2
TGAATACCGACGCGTA-1_V12D07-332_C1,1,2,0,1,0,4
AATCGTGAGCCGAGCA-1_V12D07-332_C1,0,2,1,0,0,3
GCGAAGAATCTGACGG-1_V12D07-332_C1,0,1,0,0,1,2
GAACAACTGGGATGAA-1_V12D07-332_C1,0,0,1,0,0,1
TCGCCGACATATTCGC-1_V12D07-332_C1,1,0,2,0,0,3
CGTAGAGAGTAATTAT-1_V12D07-332_C1,0,3,0,0,0,3
CGATAGTCGTACTGCA-1_V12D07-332_C1,1,6,0,0,0,7
CGCATGCCGAATGCGT-1_V12D07-332_C1,1,1,0,0,0,2
CTCTAGCCCTCGGAAA-1_V12D07-332_C1,2,1,0,1,0,4
TCCAACTCAGCTATCT-1_V12D07-332_C1,0,1,1,0,0,2
GTCTAGTGAGCCGCTT-1_V12D07-332_C1,0,1,0,0,1,2
TACCGAATAATTGTAA-1_V12D07-332_C1,1,0,0,0,0,1
ATATAACACGGGCGCA-1_V12D07-332_C1,0,0,0,0,0,0
GCATGCTAATAACGAT-1_V12D07-332_C1,0,0,0,0,0,0
TCCGGGCTTGACGGGA-1_V12D07-332_C1,1,2,0,0,0,3
ATTATTCAGAGTCACT-1_V12D07-332_C1,1,1,0,0,0,2
TAGCAGTATGACTAAA-1_V12D07-332_C1,0,1,0,0,0,1
TATGAAGAATTAAGGT-1_V12D07-332_C1,0,1,1,0,0,2
CAAGGCCAGTGGTGCA-1_V12D07-332_C1,0,1,0,0,0,1
TGCGTACGGCTAATTG-1_V12D07-332_C1,0,1,0,1,0,2
CAGATAATGGGCGGGT-1_V12D07-332_C1,0,2,0,0,0,2
GAGAACGGTTCTGACT-1_V12D07-332_C1,1,0,0,0,0,1
CGCTTCGGTCTAAGAC-1_V12D07-332_C1,0,1,0,1,1,3
AGCATTACGAGGCAAG-1_V12D07-332_C1,0,1,0,0,0,1
AAGTTGTGATGTTATA-1_V12D07-332_C1,0,1,0,0,0,1
TTGCTCATAGTACGTG-1_V12D07-332_C1,0,0,1,0,0,1
TACTTAAACATGTACA-1_V12D07-332_C1,3,1,0,0,0,4
AGTGAGTCGAATTAAC-1_V12D07-332_C1,0,1,0,0,0,1
TAGGCCTATATAGTCT-1_V12D07-332_C1,0,2,0,1,0,3
ACTCGCCGTTCGATAA-1_V12D07-332_C1,2,2,0,0,0,4
GGTACGTTGCGGCCGG-1_V12D07-332_C1,0,1,0,1,0,2
TATTGCCGGGCTTGTA-1_V12D07-332_C1,1,0,0,0,0,1
GGTAAACTCTGCGCTG-1_V12D07-332_C1,1,2,0,0,0,3
TCCCTTGTCTGAAACT-1_V12D07-332_C1,2,0,0,0,0,2
CATGATCGCTTTGAGA-1_V12D07-332_C1,1,0,0,0,0,1
GGACGGGCGACCAACC-1_V12D07-332_C1,3,0,0,0,0,3
GAGAGGCCTATGTGTA-1_V12D07-332_C1,0,0,0,0,0,0
TCGTAACTCCCAAGAC-1_V12D07-332_C1,3,0,1,0,0,4
CGTATCTAGAACTAAG-1_V12D07-332_C1,1,0,1,0,0,2
GCACCTTCCCGAAGGT-1_V12D07-332_C1,1,0,1,0,0,2
TACCTCTTTACCATCC-1_V12D07-332_C1,0,1,0,0,0,1
TGACTCTAACTGGTAA-1_V12D07-332_C1,0,0,0,0,0,0
GAGAAACTGGATCCCA-1_V12D07-332_C1,2,0,0,0,0,2
ATCCGGACCAGCCTGA-1_V12D07-332_C1,2,0,0,0,0,2
TTATTTAGGTTCCTTA-1_V12D07-332_C1,0,0,0,0,0,0
CGAATTCCCGGTTCAA-1_V12D07-332_C1,0,0,0,2,0,2
TAGTTTGATCGGTCGC-1_V12D07-332_C1,0,0,0,0,0,0
AGTCGAAACGATTCAG-1_V12D07-332_C1,0,0,0,0,0,0
ACGTCGGGCAACTCGG-1_V12D07-332_C1,0,0,0,0,0,0
ACTTGCTCTATCTACC-1_V12D07-332_C1,0,0,0,0,0,0
ATTACGGGCTACGGTT-1_V12D07-332_C1,0,0,0,0,0,0
GCAAACGTAAGCGACC-1_V12D07-332_C1,1,2,0,0,0,3
TTCGGACTGGGCATGG-1_V12D07-332_C1,0,1,0,0,0,1
GGGCCATTCGTGCTGG-1_V12D07-332_C1,1,1,0,0,0,2
GAGTTGTCACCAGTCT-1_V12D07-332_C1,0,2,0,0,0,2
AGTAATTTGCAAGCGT-1_V12D07-332_C1,1,0,0,0,0,1
GTGGCCGGTTTCTCGG-1_V12D07-332_C1,1,2,2,0,0,5
ATCTTAGGGCATTAAT-1_V12D07-332_C1,1,3,0,0,0,4
CTACATATCGCGGGAC-1_V12D07-332_C1,0,5,1,0,0,6
ATGGTATTTACTGATT-1_V12D07-332_C1,0,4,0,0,0,4
CCGTCAACCTCTGGCG-1_V12D07-332_C1,1,1,0,0,0,2
GCTTCGACGTTCAATC-1_V12D07-332_C1,0,5,0,0,0,5
GACCGATTAAATATGT-1_V12D07-332_C1,1,4,2,0,0,7
GTCGAATTTGGGCGCT-1_V12D07-332_C1,0,1,0,0,0,1
TCACGGCCCAAGAGAG-1_V12D07-332_C1,0,1,0,0,0,1
CTACGATCCTATCCTA-1_V12D07-332_C1,1,0,0,0,0,1
TGCAGTGGTAGGGAAC-1_V12D07-332_C1,0,1,1,0,0,2
TTGCCTAATCCAAAGT-1_V12D07-332_C1,0,3,2,0,0,5
AGCGAGACGTGAAGGC-1_V12D07-332_C1,0,3,1,0,0,4
TTCTACCTCAATCGGT-1_V12D07-332_C1,0,4,0,0,0,4
TACGCTGCTGTGTTAA-1_V12D07-332_C1,0,2,1,0,0,3
TAGTCCTGCACTAAGC-1_V12D07-332_C1,0,2,0,0,0,2
AGCACACGTTTAGACT-1_V12D07-332_C1,0,2,2,0,0,4
GTTCGACAATTGTATA-1_V12D07-332_C1,0,3,0,0,0,3
CCATGTTCATCTATAT-1_V12D07-332_C1,0,3,0,1,0,4
CCCTCGATAATACACA-1_V12D07-332_C1,0,0,1,0,0,1
ACTGCCCGCCATTCTC-1_V12D07-332_C1,1,2,0,1,0,4
CTATATCCAGCCTGGC-1_V12D07-332_C1,0,4,0,0,0,4
CGCACGTCTGTTTATG-1_V12D07-332_C1,0,5,3,0,0,8
AATCAGGTTTCATTTA-1_V12D07-332_C1,2,5,2,0,0,9
AGAGAAACACCAGAAA-1_V12D07-332_C1,2,4,0,0,0,6
ACCCGATTGGTTCCGA-1_V12D07-332_C1,0,3,1,0,0,4
TACCAGGAATCCCGTC-1_V12D07-332_C1,0,3,1,0,0,4
AAGTGCTTCTCTATTG-1_V12D07-332_C1,1,3,0,0,0,4
TGCATGTGACCCATAG-1_V12D07-332_C1,0,2,1,0,0,3
TAGATTCAAAGTGCGG-1_V12D07-332_C1,1,4,3,0,0,8
AGGGTCAGAGCACTCG-1_V12D07-332_C1,2,3,1,0,0,6
GTGAGATAACCTTATA-1_V12D07-332_C1,2,3,1,0,0,6
GTGTCAGTGTACGTGG-1_V12D07-332_C1,0,3,0,0,0,3
CTGTAGTGAGGATCGA-1_V12D07-332_C1,0,5,1,0,0,6
GATAGTGCGAGTAAGT-1_V12D07-332_C1,1,3,0,0,0,4
AGGGTTCAGACGGTCC-1_V12D07-332_C1,2,0,2,0,0,4
GGACTCGACAGCGCAT-1_V12D07-332_C1,0,6,0,0,0,6
CACTCTCAAGCATCGA-1_V12D07-332_C1,0,2,1,0,0,3
GAGCGGAATGCGGTGT-1_V12D07-332_C1,1,1,0,0,0,2
CAGTTCGAGGACCCGA-1_V12D07-332_C1,0,4,1,0,0,5
CGTAACTTCGACACTT-1_V12D07-332_C1,2,2,1,0,0,5
TGATCACCACACTGAC-1_V12D07-332_C1,2,1,1,0,0,4
CATACTTCTTTCTCCG-1_V12D07-332_C1,1,2,0,0,0,3
CAAGTAAGTGATAGAC-1_V12D07-332_C1,0,1,3,0,0,4
AGCCCGCAACAAGCAG-1_V12D07-332_C1,1,1,0,0,0,2
GCTCCATGCAAAGCAA-1_V12D07-332_C1,0,4,1,0,0,5
TCGTACCGACGTCAAG-1_V12D07-332_C1,0,5,1,0,0,6
ATTATCGGAATGTACG-1_V12D07-332_C1,3,2,0,0,0,5
ACCTACTATAAATCTA-1_V12D07-332_C1,1,2,2,0,0,5
TATCCTATCAACTGGT-1_V12D07-332_C1,1,4,0,0,0,5
GCGCGGTCTAGTAACT-1_V12D07-332_C1,0,1,1,0,0,2
CCTTCGTATAGAATCC-1_V12D07-332_C1,0,3,0,0,0,3
TGGGCGATACAATAAG-1_V12D07-332_C1,0,4,0,0,0,4
TGACATGTAACGTGAC-1_V12D07-332_C1,0,1,0,0,0,1
TTGGGAAGACGAGCCG-1_V12D07-332_C1,1,1,1,0,0,3
GGTGTAAATCGATTGT-1_V12D07-332_C1,1,3,0,0,0,4
GAACTGTGGAGAGACA-1_V12D07-332_C1,1,2,0,0,0,3
TCCACATCGTATATTG-1_V12D07-332_C1,1,4,1,0,0,6
CCTATGGTCAAAGCTG-1_V12D07-332_C1,2,4,1,0,0,7
TCCTTGTCCTTTAATT-1_V12D07-332_C1,1,2,1,0,0,4
AAGTTTATGGGCCCAA-1_V12D07-332_C1,0,1,0,0,0,1
GTCCGGGTTCACATTA-1_V12D07-332_C1,0,2,2,0,0,4
ATGTAGCGCGCGTAGG-1_V12D07-332_C1,0,3,0,0,0,3
TACGGAAGCCAAACCA-1_V12D07-332_C1,0,1,0,0,0,1
GCCCTGAGGATGGGCT-1_V12D07-332_C1,0,6,0,0,0,6
CGGGCGATGGATCACG-1_V12D07-332_C1,0,5,0,0,0,5
TGCGGACTTGACTCCG-1_V12D07-332_C1,0,1,0,0,0,1
TAATACTAGAACAGAC-1_V12D07-332_C1,0,3,1,0,0,4
TCAAATTGTTGTGCCG-1_V12D07-332_C1,1,3,0,0,0,4
GGGCAGTCAACGCCAA-1_V12D07-332_C1,0,1,1,0,0,2
TCGCTGCCAATGCTGT-1_V12D07-332_C1,0,0,0,0,0,0
TACGTGGGCCCAGGGC-1_V12D07-332_C1,3,1,0,0,0,4
GCCTACGTTCTGTGCA-1_V12D07-332_C1,2,0,1,0,0,3
TTGCGTGTGTAGGCAT-1_V12D07-332_C1,0,3,0,0,0,3
TCCTAAAGATTCAGAC-1_V12D07-332_C1,0,0,1,0,0,1
TGGGTGCACAAGCCAT-1_V12D07-332_C1,0,1,0,1,0,2
GGGAGCGACCGTAGTG-1_V12D07-332_C1,0,0,0,0,0,0
CATAGAGGAGATACTA-1_V12D07-332_C1,0,4,0,1,0,5
CTTCGATTGCGCAAGC-1_V12D07-332_C1,0,1,0,0,0,1
GTGCCTGAGACCAAAC-1_V12D07-332_C1,2,2,1,0,0,5
TCATCCTCAGCTGCTT-1_V12D07-332_C1,1,2,0,0,0,3
TGCAACTACTGGTTGA-1_V12D07-332_C1,0,3,1,0,0,4
ATGTTGATTAGAGACT-1_V12D07-332_C1,0,0,0,1,0,1
GTTTCTAGAGGCGCGG-1_V12D07-332_C1,0,0,0,1,0,1
TACAAGGGCTTCTTTA-1_V12D07-332_C1,0,2,0,0,0,2
ACAGGCACGGATCCTT-1_V12D07-332_C1,0,0,0,0,0,0
CCCAAGTCATTACACT-1_V12D07-332_C1,1,1,0,1,0,3
ACTCTGACCTAATAGA-1_V12D07-332_C1,1,3,0,1,0,5
GGATGGCTTGAAGTAT-1_V12D07-332_C1,0,0,0,0,0,0
ACCCTCCCGTCAGGGC-1_V12D07-332_C1,1,1,0,0,0,2
AGCTTCTTCTCGAGCA-1_V12D07-332_C1,2,0,1,0,0,3
TTGCGCTTGATCAATA-1_V12D07-332_C1,0,0,1,2,0,3
TGGGTGTAATAGATTT-1_V12D07-332_C1,0,1,0,0,0,1
CATGGTTTATTAATCA-1_V12D07-332_C1,0,3,1,0,0,4
TTGCCTTCTCGCCGGG-1_V12D07-332_C1,0,0,0,0,0,0
TTAAAGTAAGTCGCCA-1_V12D07-332_C1,1,0,0,0,1,2
AGTTGGCAAGGCTAGA-1_V12D07-332_C1,1,2,0,0,0,3
CCGCACTTGCAATGAC-1_V12D07-332_C1,2,1,1,1,0,5
AATGTTGTCGTGAGAC-1_V12D07-332_C1,0,0,0,0,0,0
CCAAGGTTGCCCTTTC-1_V12D07-332_C1,2,0,1,0,0,3
TGTGACTAGAGTTTGC-1_V12D07-332_C1,1,0,0,0,0,1
TTGTGATCTGTTCAGT-1_V12D07-332_C1,0,2,0,0,0,2
GGAGTTGATTCTGTGT-1_V12D07-332_C1,0,0,0,1,0,1
GTAGTGAGCAACCTCA-1_V12D07-332_C1,2,0,0,0,0,2
AAGACATACGTGGTTT-1_V12D07-332_C1,0,1,0,0,0,1
CATCCCGAGATTCATA-1_V12D07-332_C1,0,1,0,0,0,1
GGCCGCAGGAACCGCA-1_V12D07-332_C1,2,1,0,0,0,3
CCAGAAACTGATGCGA-1_V12D07-332_C1,1,1,1,1,0,4
ACCCGTAGTCTAGTTG-1_V12D07-332_C1,1,0,0,0,0,1
AGGGTCTGGACGCAGT-1_V12D07-332_C1,0,0,0,0,0,0
TTGAAACCCTCATTCC-1_V12D07-332_C1,0,0,0,0,0,0
TCAATCCCGCGCCAAA-1_V12D07-332_C1,0,0,0,0,0,0
AGGACATCGGCACACT-1_V12D07-332_C1,0,0,0,0,0,0
GACAAGACGCCCGTGC-1_V12D07-332_C1,0,1,0,1,0,2
GAGTAAATTAAGAACC-1_V12D07-332_C1,0,0,0,0,0,0
TAAGTCGGTGAGCTAG-1_V12D07-332_C1,0,0,0,0,0,0
CTTACTGACTCCTCTG-1_V12D07-332_C1,4,1,0,0,0,5
TTAACTGATCGTTTGG-1_V12D07-332_C1,0,0,0,0,0,0
GGGCGATCCATAGGCC-1_V12D07-332_C1,0,0,0,0,0,0
CGTATTGTTTGGCGCC-1_V12D07-332_C1,0,0,0,0,0,0
CGCGTGGGCCTGTGTT-1_V12D07-332_C1,0,0,0,0,0,0
AAATCTGCCCGCGTCC-1_V12D07-332_C1,0,0,0,0,0,0
GCTGAAGGGTTCTTGG-1_V12D07-332_C1,0,0,0,0,0,0
TAATTGCGCTGATTAC-1_V12D07-332_C1,0,3,0,0,0,3
TCGCGCGTTTACATGA-1_V12D07-332_C1,0,3,2,0,0,5
TAACTGAAATACGCCT-1_V12D07-332_C1,0,1,0,0,0,1
CCTGTCGTGTATGAAG-1_V12D07-332_C1,0,3,2,0,0,5
CGGGAACGCCCTGCAT-1_V12D07-332_C1,0,2,1,0,0,3
AGTTGCGGTCCTCAAC-1_V12D07-332_C1,1,0,1,0,0,2
GGGTCCTTGGAAGAAG-1_V12D07-332_C1,0,4,0,0,0,4
CGGGAAGTACCGTGGC-1_V12D07-332_C1,0,3,0,0,0,3
ACGGTCACCGAGAACA-1_V12D07-332_C1,0,6,0,1,0,7
TAGACTCAGTTGGCCT-1_V12D07-332_C1,0,2,1,0,0,3
CCTTCCGCAACGCTGC-1_V12D07-332_C1,0,3,1,0,0,4
CAGTGTTAATCTCTCA-1_V12D07-332_C1,0,0,0,0,0,0
CAGGCCAGTACCACCT-1_V12D07-332_C1,0,1,0,0,0,1
GATCGCTGTGGTGCGT-1_V12D07-332_C1,0,1,1,0,0,2
GTATCTCGGGCGCTTT-1_V12D07-332_C1,2,0,1,0,0,3
CCGGGCTAAGAATTTC-1_V12D07-332_C1,0,3,0,0,0,3
CTTCACGCCCTGGTAC-1_V12D07-332_C1,1,3,1,0,0,5
CGGATGAATGCTGTGA-1_V12D07-332_C1,1,1,0,0,0,2
CTCTGCAGGCATTCTT-1_V12D07-332_C1,1,1,2,1,0,5
TCAAAGTCACGGCGTC-1_V12D07-332_C1,1,4,1,0,0,6
TGGGTTTCGGGCGTAC-1_V12D07-332_C1,0,3,0,0,0,3
TGCTATGGCAAAGGGA-1_V12D07-332_C1,0,2,0,0,0,2
TTCACGGTCGTCACGT-1_V12D07-332_C1,1,3,1,0,0,5
CGTAAAGCAAGAAATC-1_V12D07-332_C1,0,2,0,0,0,2
CTGATCCCTTTATGCA-1_V12D07-332_C1,1,3,2,0,0,6
GAGTATACCCTAATCA-1_V12D07-332_C1,0,3,1,0,0,4
CCACGGCAGGTGTAGG-1_V12D07-332_C1,0,1,1,0,0,2
ACGTACTTTGGCACGG-1_V12D07-332_C1,0,3,0,0,0,3
CCTGAGAATAAATGCA-1_V12D07-332_C1,1,5,4,0,0,10
TTGATGCCGCTCGTCG-1_V12D07-332_C1,2,8,0,0,0,10
GCCAGGAAAGAACACT-1_V12D07-332_C1,3,1,2,0,0,6
TCCGACCGCTAATCAA-1_V12D07-332_C1,2,1,2,0,0,5
TATATCAAAGTGATCT-1_V12D07-332_C1,0,9,1,0,0,10
CCTCGGTTTCCTTGCC-1_V12D07-332_C1,2,3,1,1,0,7
TAAATTTAGTAACACC-1_V12D07-332_C1,1,3,1,0,0,5
CTCGTTACGGCTACCA-1_V12D07-332_C1,0,0,2,0,0,2
GCCGTCGGTTTCGGGC-1_V12D07-332_C1,1,1,1,0,0,3
GTTCCGTCCGCCTGCA-1_V12D07-332_C1,0,1,0,0,0,1
CTAGGGATAGGGACAA-1_V12D07-332_C1,0,3,2,0,0,5
GTCCAGGCACGTGTGC-1_V12D07-332_C1,0,5,3,0,0,8
GAGGAATATCTCTTTG-1_V12D07-332_C1,1,4,1,0,0,6
CGTTCAAGGAAACGGA-1_V12D07-332_C1,0,1,0,0,0,1
GTGGGAACAAACCGGG-1_V12D07-332_C1,0,4,2,0,0,6
GGGCACGTAGTACTGT-1_V12D07-332_C1,2,1,0,0,0,3
ACTACAAAGAGAGGTG-1_V12D07-332_C1,1,2,0,0,0,3
GGTGTAGGTAAGTAAA-1_V12D07-332_C1,0,5,1,0,0,6
CCTGTTCAACCTCGGG-1_V12D07-332_C1,0,0,4,0,0,4
TGAGGTGTGTGGCGGA-1_V12D07-332_C1,1,6,0,0,0,7
ATTGTCTGTTTCATGT-1_V12D07-332_C1,0,3,2,0,0,5
GCCGGTCGTATCTCTC-1_V12D07-332_C1,2,3,0,0,0,5
ATATGGGATAGCAACT-1_V12D07-332_C1,0,2,2,0,0,4
GATAGAACCCGCTAGG-1_V12D07-332_C1,1,0,0,0,0,1
ATCCCATTTCCGTGGG-1_V12D07-332_C1,0,2,4,1,0,7
GATGCTACCTTCGATG-1_V12D07-332_C1,0,2,0,0,0,2
TGCAAAGTTCGTCTGT-1_V12D07-332_C1,0,3,4,0,0,7
GTTCAGTCGCCAAATG-1_V12D07-332_C1,0,3,1,0,0,4
GTCTCCGCCTCAATAC-1_V12D07-332_C1,0,0,2,1,0,3
AGTAGAAGGCGCCTCA-1_V12D07-332_C1,0,4,1,0,0,5
GTTGTAGATTTATGAG-1_V12D07-332_C1,0,1,4,1,0,6
CTATTTGCTTGGAGGA-1_V12D07-332_C1,0,2,0,0,0,2
AGCCATATAGTATGTG-1_V12D07-332_C1,0,3,3,0,0,6
TGTTCCGGCCTGAGCT-1_V12D07-332_C1,0,4,0,0,0,4
TGCCGTGGGACCCAAT-1_V12D07-332_C1,0,3,4,0,0,7
TTGCAAGAAGACTCCT-1_V12D07-332_C1,0,4,0,0,0,4
CCGCTCCAGGGCGATC-1_V12D07-332_C1,0,6,0,1,0,7
CAAACCCTCCGGCGGG-1_V12D07-332_C1,0,1,0,0,0,1
CGGACCTTTACGTCCC-1_V12D07-332_C1,0,6,0,0,0,6
ACGTAGGAGAGTCGCT-1_V12D07-332_C1,0,4,2,0,0,6
CTGCGACCTCGCCGAA-1_V12D07-332_C1,0,7,1,1,0,9
GGCCCAGCTGGTTTGC-1_V12D07-332_C1,0,1,1,1,0,3
GGATTAATCATGGACC-1_V12D07-332_C1,1,6,0,1,0,8
GAGATGGCTTTAATCA-1_V12D07-332_C1,0,4,0,0,0,4
AGTACAGAAGCTTATA-1_V12D07-332_C1,0,5,3,0,0,8
GCGGCTTTAGCAAGTT-1_V12D07-332_C1,0,2,2,0,0,4
ACCGAGTCTCCTTATT-1_V12D07-332_C1,0,3,1,2,0,6
GACCACACTTCCCTTT-1_V12D07-332_C1,1,1,0,0,0,2
TGTAGCCAATTCCGTT-1_V12D07-332_C1,0,4,1,0,0,5
CTCGTCTGTGCCTTCG-1_V12D07-332_C1,2,1,0,0,0,3
GGACTCTTTGACTAAG-1_V12D07-332_C1,0,4,1,2,0,7
TCATCGACGACCGTCG-1_V12D07-332_C1,0,2,0,0,0,2
TACTACGTGCAATGCG-1_V12D07-332_C1,0,2,2,0,0,4
CCCTACTTGAACAATG-1_V12D07-332_C1,0,2,0,1,0,3
GCAGCTGTCAACGCAT-1_V12D07-332_C1,0,2,2,1,0,5
ATCTACCATCTGCTCC-1_V12D07-332_C1,0,1,0,0,0,1
TCTCAAATCAATCGGG-1_V12D07-332_C1,0,1,0,0,0,1
ACTCCGGCCGACCACT-1_V12D07-332_C1,0,1,0,0,0,1
TACACCTCTTCGAATC-1_V12D07-332_C1,0,4,1,0,0,5
GTGGCTGTTTCTGTTC-1_V12D07-332_C1,0,3,0,0,0,3
ACGACTCTAGGGCCGA-1_V12D07-332_C1,0,0,2,0,0,2
TCGTTTACGCGACCCT-1_V12D07-332_C1,0,0,0,1,0,1
AGGATATCCGACTGCA-1_V12D07-332_C1,0,2,0,0,0,2
GACACTTCCAATTACC-1_V12D07-332_C1,1,1,0,0,0,2
ACGGTACAGTTCAATG-1_V12D07-332_C1,1,1,1,1,0,4
CTTGATGACCATCCAG-1_V12D07-332_C1,0,0,0,0,0,0
CTGGTAAAGACTTACA-1_V12D07-332_C1,0,1,3,1,0,5
CTTGCCCACCCACGCA-1_V12D07-332_C1,0,0,1,0,0,1
CATTACGCAGGAAGGG-1_V12D07-332_C1,1,0,4,0,0,5
GGACAACCATGAAGCC-1_V12D07-332_C1,0,0,0,0,0,0
GTTATCAAGCTATCGA-1_V12D07-332_C1,0,2,0,0,0,2
AGGTGCACGTCCACAT-1_V12D07-332_C1,0,1,0,0,0,1
AAAGAATGTGGACTAA-1_V12D07-332_C1,0,3,1,1,0,5
ACCAAGTCATCGGCAG-1_V12D07-332_C1,0,4,0,0,0,4
AGTAACTATAGCAGCC-1_V12D07-332_C1,0,0,0,1,0,1
GGGAAAGAATGCCAAC-1_V12D07-332_C1,2,0,1,0,0,3
AATCGGTATAGCCCTC-1_V12D07-332_C1,2,0,0,1,0,3
GGCACTGCGGTGGTTT-1_V12D07-332_C1,0,2,0,0,0,2
CGTCCTCATCGCGTGC-1_V12D07-332_C1,0,2,1,1,0,4
CTTAACTTACAGTATA-1_V12D07-332_C1,0,0,0,0,0,0
GTGAGTCGACTAATAG-1_V12D07-332_C1,1,1,1,2,0,5
TGTACTTCCGGGCATG-1_V12D07-332_C1,0,2,0,2,0,4
CACAAACCGCAGAACT-1_V12D07-332_C1,1,1,6,1,0,9
GCTTTACACAACTGGG-1_V12D07-332_C1,0,3,0,1,0,4
CACCGATGATGGGTAC-1_V12D07-332_C1,0,0,1,1,0,2
TCAATATACAGGAGGC-1_V12D07-332_C1,0,0,0,0,0,0
AACGACCTCCTAGCCG-1_V12D07-332_C1,0,1,0,1,0,2
GTTACCAAGGCGTACG-1_V12D07-332_C1,3,2,0,0,1,6
TAGCTCACTGTGTTTG-1_V12D07-332_C1,1,0,1,0,0,2
TCGGCAGGGTTAAGGG-1_V12D07-332_C1,0,0,0,0,0,0
TGTTAACAAAGTGACT-1_V12D07-332_C1,0,1,0,0,0,1
CAGAGCGATGGATGCT-1_V12D07-332_C1,2,1,0,0,1,4
CATAGTGGGCACGCCT-1_V12D07-332_C1,0,1,2,0,0,3
AAACGCTGGGCACGAC-1_V12D07-332_C1,1,0,0,0,0,1
TGTTCTCATACTATAG-1_V12D07-332_C1,0,0,1,0,0,1
AGCCTTGTCACTGATA-1_V12D07-332_C1,0,0,0,0,0,0
TGACAGAAATCTTGCT-1_V12D07-332_C1,0,1,0,0,0,1
TAGCCATGATTGCCTA-1_V12D07-332_C1,0,0,0,0,0,0
CGAAGCCACAGCATGG-1_V12D07-332_C1,0,6,0,0,0,6
ACCCGTAGCAGAGAAT-1_V12D07-332_C1,2,1,1,2,0,6
AGCTTGATCAGGGTAG-1_V12D07-332_C1,0,4,2,0,0,6
CTATAAGTAGGGTTTG-1_V12D07-332_C1,0,2,1,0,0,3
TATAGTTAGGTGTACT-1_V12D07-332_C1,0,5,0,0,0,5
TACGCTGATAGTTGTA-1_V12D07-332_C1,0,4,1,0,0,5
TTCTCAATTGCTACAA-1_V12D07-332_C1,1,3,3,3,0,10
GTTGCCCTAACGGGTG-1_V12D07-332_C1,1,1,1,0,0,3
GACATTTCGCCCAGCC-1_V12D07-332_C1,0,4,0,0,0,4
GTAACTACGTAGACCT-1_V12D07-332_C1,0,2,3,2,0,7
CCAGTGTACAGACCGA-1_V12D07-332_C1,0,2,0,0,0,2
GCCCGATGCCCAGTTC-1_V12D07-332_C1,0,3,1,1,0,5
CGAACCTCTTTCCTAG-1_V12D07-332_C1,0,1,3,0,0,4
CATGCACATGAGAGGC-1_V12D07-332_C1,0,3,1,6,0,10
CCAAATCAAAGGGCAA-1_V12D07-332_C1,0,6,1,0,0,7
GTAGTTTAAGCACACG-1_V12D07-332_C1,0,4,3,7,0,14
TAAGTGAATAGTCTAC-1_V12D07-332_C1,0,3,1,0,0,4
GGTCCACGTCTATTTG-1_V12D07-332_C1,0,0,1,9,0,10
CCCTCAGATCGAGAAC-1_V12D07-332_C1,0,2,3,0,0,5
ACATTCGCGCGGAATA-1_V12D07-332_C1,0,1,1,7,0,9
CTATGAACACCTTGCC-1_V12D07-332_C1,0,0,0,0,0,0
CGAATGGTAGGTCGTC-1_V12D07-332_C1,0,5,3,3,0,11
TCGACATAGCGTAGCG-1_V12D07-332_C1,0,5,3,0,0,8
GACGTTGCTCGGCGGC-1_V12D07-332_C1,0,2,2,8,0,12
CTCGAGGCAAGTTTCA-1_V12D07-332_C1,0,1,6,0,0,7
GCTGGGAGCGCGTCAA-1_V12D07-332_C1,0,4,5,1,0,10
GACGATATCACTGGGT-1_V12D07-332_C1,0,2,4,1,0,7
CAGCTCTGGGCTCACT-1_V12D07-332_C1,0,5,5,2,0,12
TAGTCTGCGGCACATT-1_V12D07-332_C1,0,4,4,3,0,11
TGGTCGATATACCTCT-1_V12D07-332_C1,0,4,3,2,0,9
TTCAGTTCAAGAGGAG-1_V12D07-332_C1,0,7,2,1,0,10
GTCTGTAGGTTGAACA-1_V12D07-332_C1,0,4,5,0,0,9
GAGAGTCTCGGGAGAG-1_V12D07-332_C1,0,1,1,7,0,9
TTGTTTGTATTACACG-1_V12D07-332_C1,0,0,7,2,0,9
GCACAGCACGGGCCGA-1_V12D07-332_C1,0,3,4,1,0,8
AAACAGTGTTCCTGGG-1_V12D07-332_C1,0,0,7,2,0,9
TGGAGAATAATCGTCC-1_V12D07-332_C1,0,1,2,7,0,10
CGCCGCGTTCTGAACG-1_V12D07-332_C1,0,1,4,0,0,5
CATGCGTTGAGAGGAG-1_V12D07-332_C1,0,0,2,6,0,8
TACGCTCCTAGAACTG-1_V12D07-332_C1,0,3,6,0,0,9
CCTTGTGAACGTGGTT-1_V12D07-332_C1,0,0,7,2,0,9
TTAAAGGCGATGCTCG-1_V12D07-332_C1,0,4,6,0,0,10
TAAAGTGCACGTCTCG-1_V12D07-332_C1,0,1,10,4,0,15
TGTCCGCAAACAATTC-1_V12D07-332_C1,0,2,8,0,0,10
AGGCCTATCATACCAA-1_V12D07-332_C1,0,1,6,6,0,13
ACTGGGATGCCAGTGC-1_V12D07-332_C1,0,5,4,0,0,9
CGATCCACCATTGTTG-1_V12D07-332_C1,0,1,3,2,0,6
GGGCATGCATGTCGAG-1_V12D07-332_C1,0,4,5,0,0,9
TCCAGGCAGGACGATC-1_V12D07-332_C1,0,4,7,2,0,13
CAATGACCCTTAATTT-1_V12D07-332_C1,0,4,3,0,0,7
ATCAAGATCCCAGGAC-1_V12D07-332_C1,0,3,8,3,0,14
CTCAGAGCTAATGTCG-1_V12D07-332_C1,0,2,5,0,0,7
CTGCGATTTCGAGATT-1_V12D07-332_C1,0,3,4,3,0,10
ATGGTATTGGGAACCG-1_V12D07-332_C1,0,4,8,0,0,12
TAGGTTCTGCTGAGAA-1_V12D07-332_C1,0,3,4,2,0,9
GCCTGTCCCGGTGCAT-1_V12D07-332_C1,0,6,3,0,0,9
GGCCTGCTCTGATGTT-1_V12D07-332_C1,0,2,4,3,0,9
TAGAGGGAGTTTATCT-1_V12D07-332_C1,0,3,5,0,0,8
CTCTACATCCTGCGTG-1_V12D07-332_C1,0,0,4,2,0,6
ACACATTTCCGTAGAC-1_V12D07-332_C1,0,4,7,0,0,11
TGGGTGTTAAGTAGAA-1_V12D07-332_C1,0,4,6,0,0,10
GAGCTCAACATGAGCG-1_V12D07-332_C1,0,4,2,0,0,6
GCACACAGCTATTACC-1_V12D07-332_C1,0,6,3,1,0,10
GCGACGGTAGTCTCCT-1_V12D07-332_C1,0,3,5,0,0,8
GTATCAAGGTACTTCC-1_V12D07-332_C1,0,5,8,0,0,13
GGAAAGGGAATTGAGC-1_V12D07-332_C1,0,4,3,0,0,7
TACACAGCCGTGGTGC-1_V12D07-332_C1,0,4,3,0,0,7
CGGTTGGGCAGGGTCC-1_V12D07-332_C1,0,3,7,0,0,10
GCACGCCGATTCCCGC-1_V12D07-332_C1,0,3,2,0,0,5
CGCTTTCCGCCAAGGT-1_V12D07-332_C1,0,3,2,0,0,5
TGCCCGATAGTTAGAA-1_V12D07-332_C1,0,9,0,0,0,9
TCAGAACGGCGGTAAT-1_V12D07-332_C1,0,5,1,0,0,6
CCACTCAGATCCGCAA-1_V12D07-332_C1,0,3,2,1,0,6
GAAGGGTCATTAAGAC-1_V12D07-332_C1,0,3,3,0,0,6
GCGGTCTTGCTTTCAC-1_V12D07-332_C1,0,1,8,2,0,11
GGAAGGACACCGTATA-1_V12D07-332_C1,0,3,5,0,0,8
CGCGGGAATTCCTTTC-1_V12D07-332_C1,0,4,4,0,0,8
TCTATCCGATTGCACA-1_V12D07-332_C1,0,1,0,0,0,1
TACTCGTTTGAATCAA-1_V12D07-332_C1,0,5,2,0,0,7
GTCTGCCGACTCGACG-1_V12D07-332_C1,0,1,3,0,0,4
TACGGGTAATAACATA-1_V12D07-332_C1,0,6,0,0,0,6
CCAGTTCGGTAACTCA-1_V12D07-332_C1,0,4,2,0,0,6
CGTGCACACCACTGTA-1_V12D07-332_C1,0,3,2,1,0,6
CTTCAGTTGGACAACG-1_V12D07-332_C1,0,6,2,0,0,8
TGATCTATCACACTCT-1_V12D07-332_C1,0,3,9,0,0,12
TAGCAGATACTTAGGG-1_V12D07-332_C1,0,2,5,0,0,7
CACCGGGCATCACAAG-1_V12D07-332_C1,0,5,1,2,0,8
AGTGGCCCGCAAATGG-1_V12D07-332_C1,0,2,1,0,0,3
CTCGCTAGGTAAGCGA-1_V12D07-332_C1,0,4,4,0,0,8
GATAGATAGTACAGTC-1_V12D07-332_C1,0,6,2,0,0,8
CGAGACTACTGCTGCT-1_V12D07-332_C1,0,7,2,0,0,9
ACATTTGAAACCTAAC-1_V12D07-332_C1,0,3,0,0,0,3
GACACAGCCGGGACTG-1_V12D07-332_C1,0,4,4,1,0,9
ACGGAACACGAGTGCC-1_V12D07-332_C1,0,6,3,0,0,9
ACGCCAGTGCGTTTGC-1_V12D07-332_C1,0,4,5,1,0,10
GCACCTAGGCGAGTCC-1_V12D07-332_C1,0,9,0,0,0,9
TCACTATCCCTTCGGT-1_V12D07-332_C1,0,3,3,0,0,6
TGAGTGTAACAACGGG-1_V12D07-332_C1,0,3,2,0,0,5
ATTGGTTGTGCATTAC-1_V12D07-332_C1,0,1,1,5,0,7
CTGGCGATTTACATGT-1_V12D07-332_C1,0,4,3,0,0,7
TCCACCAAGACATAGG-1_V12D07-332_C1,0,5,3,5,0,13
AACGTCGCTGCACTTC-1_V12D07-332_C1,0,4,5,0,0,9
GTCTCCCGAGTCCCGT-1_V12D07-332_C1,0,6,2,4,0,12
AGCCCGCACTACAATG-1_V12D07-332_C1,0,3,1,0,0,4
GGCACGCTGCTACAGT-1_V12D07-332_C1,0,3,2,5,0,10
GCTTGAGTGACCTCTG-1_V12D07-332_C1,0,7,2,0,0,9
ATAGCCATAACAGTCA-1_V12D07-332_C1,0,8,1,2,0,11
TAGGAGGCTCGAGAAC-1_V12D07-332_C1,0,9,0,0,0,9
GTCGGGTGAAGTACCG-1_V12D07-332_C1,0,2,5,0,0,7
CACCCGCGTTTGACAC-1_V12D07-332_C1,0,4,1,0,0,5
TCTCAGGCTACTCGCT-1_V12D07-332_C1,0,6,3,0,0,9
TAGATTCTCTAGCAAA-1_V12D07-332_C1,0,4,0,0,0,4
CCCATTATTGTATCCT-1_V12D07-332_C1,0,8,0,0,0,8
GTTAATAGCGTCATTA-1_V12D07-332_C1,0,7,0,0,0,7
TACTCATTGACGCATC-1_V12D07-332_C1,0,2,1,0,0,3
TAGTGACAAGCTCTAC-1_V12D07-332_C1,0,7,0,0,0,7
ATCGCCGTGGTTCATG-1_V12D07-332_C1,0,4,4,1,0,9
CTGCTCTCAACACACC-1_V12D07-332_C1,0,8,1,0,0,9
GCATGACACAAAGGAA-1_V12D07-332_C1,0,0,1,0,0,1
CAACGATCGATCCAAT-1_V12D07-332_C1,0,4,4,1,0,9
CGCCAGTAGTACCTTG-1_V12D07-332_C1,0,4,1,4,0,9
CTCCCTTGTATCAAGG-1_V12D07-332_C1,0,6,2,2,0,10
ACTTTATACACCACTT-1_V12D07-332_C1,0,4,1,2,0,7
AGATCTGGAGAGGATA-1_V12D07-332_C1,0,1,5,3,0,9
TCATCCATCTGATCAC-1_V12D07-332_C1,0,0,8,6,0,14
AGAACACGGCGATGGT-1_V12D07-332_C1,0,7,3,0,0,10
CCGCTCCGGATAAGCT-1_V12D07-332_C1,0,0,3,7,0,10
TGGTCGGGTACAGGGC-1_V12D07-332_C1,0,1,7,0,0,8
ACGGACGCAGCGACAA-1_V12D07-332_C1,0,3,3,6,0,12
ACATGCTTACGGCAGC-1_V12D07-332_C1,0,2,6,0,0,8
CAGGGAGATAGGCCAG-1_V12D07-332_C1,0,2,3,2,0,7
TCGCCACCCGGATTAC-1_V12D07-332_C1,0,2,2,0,0,4
TCTTGGTCAATGATAC-1_V12D07-332_C1,0,3,1,3,0,7
CATAGGGACACTTGTG-1_V12D07-332_C1,0,1,4,0,0,5
CACGAGCAAACCAGAC-1_V12D07-332_C1,0,3,4,3,0,10
GGGATATTGATCGCCA-1_V12D07-332_C1,0,1,7,0,0,8
TAATGTCGGTTCATGG-1_V12D07-332_C1,0,0,7,3,0,10
CGATTTGTCATTAATG-1_V12D07-332_C1,0,2,7,0,0,9
TTAAGATACCCAGAGA-1_V12D07-332_C1,0,5,7,0,0,12
CGACCGTTGGTATTCG-1_V12D07-332_C1,0,3,1,0,0,4
ACTACCATCCGAGGGC-1_V12D07-332_C1,0,0,5,0,0,5
TCTACGCACGATCTCC-1_V12D07-332_C1,0,3,2,0,0,5
AAGCCACTTGCAGGTA-1_V12D07-332_C1,0,3,3,0,0,6
ACGTTGTCGTTGAAAG-1_V12D07-332_C1,0,6,3,0,0,9
ACCGCTAGTCATTGGT-1_V12D07-332_C1,0,1,5,0,0,6
CATGAGTCCATCACGG-1_V12D07-332_C1,0,6,1,0,0,7
ATGTCTTGTTTGACTC-1_V12D07-332_C1,0,3,1,0,0,4
TCCCAAACATCCTCTA-1_V12D07-332_C1,0,0,7,0,0,7
CAACGCGATGAGCCAA-1_V12D07-332_C1,0,2,5,0,0,7
GACACCCAAAGACGCG-1_V12D07-332_C1,0,11,2,0,0,13
ACGTTCACTATGCCGC-1_V12D07-332_C1,0,2,7,0,0,9
ATGGACTGCTTAGTTG-1_V12D07-332_C1,0,3,5,0,0,8
CCATGGCAAACGCTCA-1_V12D07-332_C1,0,6,0,0,0,6
TTGTCTCGGCAAGATG-1_V12D07-332_C1,0,4,3,0,0,7
TTCGAACGAAACATGC-1_V12D07-332_C1,0,4,2,0,0,6
GGAAAGTCTTGATTGT-1_V12D07-332_C1,0,7,1,0,0,8
ATCATAGATCGACGAG-1_V12D07-332_C1,0,4,2,0,0,6
GATTAGAAACAAGCGT-1_V12D07-332_C1,0,7,0,0,0,7
GCTGCGAAGAATTATT-1_V12D07-332_C1,0,4,4,0,0,8
TTCCAGTGGGTTTCGT-1_V12D07-332_C1,0,3,2,0,0,5
GCTCATTGATCATATC-1_V12D07-332_C1,0,8,1,0,0,9
ATACGAGGTTTGTAAG-1_V12D07-332_C1,0,6,2,0,0,8
GTCTATACACGCATGG-1_V12D07-332_C1,0,2,4,0,0,6
GATTTGCGCTAACACC-1_V12D07-332_C1,0,5,6,0,0,11
TGGTGCCCTGCCTTAC-1_V12D07-332_C1,0,4,3,0,0,7
TCGAATCGCAGGGTAG-1_V12D07-332_C1,0,4,4,0,0,8
GGTAGGCCAATATCAC-1_V12D07-332_C1,0,3,8,0,0,11
CGTAAATAACAAAGGG-1_V12D07-332_C1,0,4,5,0,0,9
GACTCTAGAGTTCCAA-1_V12D07-332_C1,0,10,0,0,0,10
ACTTGTTACCGGATCA-1_V12D07-332_C1,0,5,0,0,0,5
GGCATTGAACATCTCA-1_V12D07-332_C1,0,6,1,0,0,7
AACCCGCTGTATTCCA-1_V12D07-332_C1,0,5,2,0,0,7
TAACAGGTTCCCTTAG-1_V12D07-332_C1,0,4,2,0,0,6
GTTCTTGTAACTCAAT-1_V12D07-332_C1,0,5,4,0,0,9
GATTCTGTTAATGAGT-1_V12D07-332_C1,0,5,2,0,0,7
GGACACCTCGGTGTTG-1_V12D07-332_C1,0,3,1,0,0,4
CGATCGAGAAGCACCA-1_V12D07-332_C1,0,0,5,0,0,5
CTGCTCTGACGGCAAA-1_V12D07-332_C1,0,3,9,0,0,12
CCCAGGAAGAATTCGA-1_V12D07-332_C1,0,7,5,0,0,12
TGTCGTGGGTATAGGC-1_V12D07-332_C1,0,6,1,0,0,7
ATATGTCTAGAGCGTG-1_V12D07-332_C1,0,4,4,0,0,8
GCGGGCAGACGGGTGA-1_V12D07-332_C1,0,4,2,0,0,6
CGAAGATCAGTTTCAT-1_V12D07-332_C1,0,4,0,0,0,4
ACGCCACTCGAAACAG-1_V12D07-332_C1,0,1,8,0,0,9
CTTAGATGTTTCATCC-1_V12D07-332_C1,0,1,5,0,0,6
GCGAATGGACTAGCGA-1_V12D07-332_C1,0,4,4,0,0,8
TAAATTGTGGGTAAAG-1_V12D07-332_C1,0,0,4,0,0,4
ATTTATACTGGTAAAG-1_V12D07-332_C1,0,0,3,0,0,3
GCGTCGTAACATGGTC-1_V12D07-332_C1,0,4,5,0,0,9
CGGTATGGGCACTCTG-1_V12D07-332_C1,0,4,6,0,0,10
CTATCACAACGCTGGA-1_V12D07-332_C1,0,6,1,0,0,7
ACCACACGGTTGATGG-1_V12D07-332_C1,0,4,6,0,0,10
TCAGCGCACGCCGTTT-1_V12D07-332_C1,0,5,1,0,0,6
AATGTTAAGACCCTGA-1_V12D07-332_C1,0,7,1,0,0,8
CTTACATAGATTTCTT-1_V12D07-332_C1,0,2,0,0,0,2
AACATAGCGTGTATCG-1_V12D07-332_C1,0,5,0,0,0,5
AGCAGTCGAAGCATGC-1_V12D07-332_C1,0,3,1,0,0,4
GTACTACGGCCTCGTT-1_V12D07-332_C1,0,6,0,0,0,6
TTGGCCAAATTGTATC-1_V12D07-332_C1,0,5,0,0,0,5
TCAGAGGACGCGTTAG-1_V12D07-332_C1,0,8,0,0,0,8
AGTAATCTAAGGGTGG-1_V12D07-332_C1,0,6,1,0,0,7
AATTATACCCAGCAAG-1_V12D07-332_C1,0,6,2,0,0,8
CCCTACCCACACCCAG-1_V12D07-332_C1,0,8,1,0,0,9
CTCTGTCCATGCACCA-1_V12D07-332_C1,0,3,2,0,0,5
TCGCCTCCTTCGGCTC-1_V12D07-332_C1,0,4,0,0,0,4
CCTGATTCGCGAAGAA-1_V12D07-332_C1,0,6,0,0,0,6
GACTTCAACGCATCAA-1_V12D07-332_C1,0,2,5,0,0,7
GCTTCCCGTAAGCTCC-1_V12D07-332_C1,0,6,0,0,0,6
AGAACTGTACTTTGTA-1_V12D07-332_C1,0,5,2,0,0,7
CCTTAAGTACGCAATT-1_V12D07-332_C1,0,7,1,0,0,8
GGCCAATTGTATAGAC-1_V12D07-332_C1,0,6,2,0,0,8
AGAATACAGGCTATCC-1_V12D07-332_C1,0,1,2,0,0,3
AATACCTGATGTGAAC-1_V12D07-332_C1,0,1,6,0,0,7
TAGAGTGTTCCGGGTA-1_V12D07-332_C1,0,7,1,0,0,8
GCTTCCATGTAACCGC-1_V12D07-332_C1,0,5,1,0,0,6
GGTTCGCATTTGCCGT-1_V12D07-332_C1,0,5,0,0,0,5
TCAATCCGGGAAGTTT-1_V12D07-332_C1,0,6,1,0,0,7
CCGGAAGTGCAATATG-1_V12D07-332_C1,0,3,3,0,0,6
CTCATAAATGTGTATA-1_V12D07-332_C1,0,4,0,0,0,4
GACGGGCATCGAATTT-1_V12D07-332_C1,0,4,5,0,0,9
GCTAAGCCCAGTATGC-1_V12D07-332_C1,0,7,1,0,0,8
GCTATAAGGGCCAGGA-1_V12D07-332_C1,0,4,3,0,0,7
GCGGATTACTTGTTCT-1_V12D07-332_C1,0,2,2,0,0,4
TACAACAGCGCATACA-1_V12D07-332_C1,0,6,3,0,0,9
TCTAACCTAGCCTGCG-1_V12D07-332_C1,0,9,0,0,0,9
TCTACCCGCATCATTT-1_V12D07-332_C1,0,8,6,0,0,14
GTCTTACCACGCCAAG-1_V12D07-332_C1,0,8,3,0,0,11
AATAACGTCGCGCCCA-1_V12D07-332_C1,0,2,2,0,0,4
CGTTTCGGTTATATGC-1_V12D07-332_C1,0,7,0,0,0,7
TACGCTGCACGGTCGT-1_V12D07-332_C1,0,3,5,0,0,8
CGTTAAATACGACCAG-1_V12D07-332_C1,0,3,3,0,0,6
TCGACTGACGATGGCT-1_V12D07-332_C1,0,0,0,0,0,0
ACGCTACTGAATGGGC-1_V12D07-332_C1,0,3,1,0,0,4
AAGGGTTAGCCATGCG-1_V12D07-332_C1,0,2,4,0,0,6
ACGTTTCGGTGCACTT-1_V12D07-332_C1,0,4,0,0,0,4
TTAACCCGAGGCGTGT-1_V12D07-332_C1,0,3,1,0,0,4
GCCCGTCAAGCCCAAT-1_V12D07-332_C1,0,5,0,0,0,5
ATTCGTCCCGAGGTTA-1_V12D07-332_C1,0,4,0,0,0,4
TCAAATTATGTTCGAC-1_V12D07-332_C1,0,0,4,0,0,4
AACGTTCTACCATTGT-1_V12D07-332_C1,0,9,0,0,0,9
CAACGAGCTTATTATG-1_V12D07-332_C1,0,2,7,0,0,9
TTGTGGAGACAGCCGG-1_V12D07-332_C1,0,1,3,0,0,4
GGTTAGGGATGCTAAT-1_V12D07-332_C1,0,10,2,0,0,12
CCAGGCGAGATGGTCT-1_V12D07-332_C1,0,4,5,0,0,9
GTGCCAAACGTTTCGA-1_V12D07-332_C1,0,5,3,0,0,8
TTAGAGTATTGTCGAG-1_V12D07-332_C1,0,4,7,0,0,11
CTCCTAGTAATCGTGA-1_V12D07-332_C1,0,1,7,0,0,8
GGAAACAGAGCTTGGG-1_V12D07-332_C1,0,4,1,0,0,5
TTAGCCATAGGGCTCG-1_V12D07-332_C1,0,3,5,0,0,8
TTGTTGGCAATGACTG-1_V12D07-332_C1,0,5,4,0,0,9
GGTGGGATTAGGTCCC-1_V12D07-332_C1,0,3,11,0,0,14
AATAGGCACGACCCTT-1_V12D07-332_C1,0,4,5,2,0,11
GAGGTCCGTTCGCTGT-1_V12D07-332_C1,0,2,4,0,0,6
TGACAACTTAAAGGTG-1_V12D07-332_C1,0,1,8,1,0,10
AGCTAAGCTCCGTCCG-1_V12D07-332_C1,0,3,6,0,0,9
CTAGCCCGGGAGACGA-1_V12D07-332_C1,0,10,3,0,0,13
CCCAGATTCCCGTGAC-1_V12D07-332_C1,0,4,1,0,0,5
GCCCGTTCACACAATT-1_V12D07-332_C1,0,6,1,0,0,7
ACAAACTCCATCAGAG-1_V12D07-332_C1,0,2,5,0,0,7
GGTTCCGTACGACTAA-1_V12D07-332_C1,0,7,6,0,0,13
TTGCGGAAAGCTGCCC-1_V12D07-332_C1,0,8,0,0,0,8
GGAACTCGTGAATACG-1_V12D07-332_C1,0,8,4,1,0,13
GGTTACCGCTCCCTAC-1_V12D07-332_C1,0,7,2,0,0,9
AGCGACTTTGAAGACA-1_V12D07-332_C1,0,0,1,4,0,5
CCGTTTCCTTTCCGTG-1_V12D07-332_C1,0,4,8,0,0,12
TGGATGGCATCTTGGA-1_V12D07-332_C1,0,5,2,5,0,12
CAAGTCGTTGAAATCT-1_V12D07-332_C1,0,6,4,0,0,10
TGCAAACGTACTAGTT-1_V12D07-332_C1,0,2,2,5,0,9
GGCTGTCCTACTGCGG-1_V12D07-332_C1,0,3,1,0,0,4
TACTGCATGATTAAAT-1_V12D07-332_C1,0,1,0,8,0,9
CGGACCTCTGTAGTTA-1_V12D07-332_C1,0,6,6,0,0,12
CCCTAGCTCTAAGGTC-1_V12D07-332_C1,0,11,5,0,0,16
GTAACAGGTTAACGGC-1_V12D07-332_C1,0,8,5,0,0,13
CCCGCAAATAATCATC-1_V12D07-332_C1,0,2,0,6,0,8
AATCCCGCTCAGAGCC-1_V12D07-332_C1,0,4,7,1,0,12
AACGTCATCCGGCTTG-1_V12D07-332_C1,0,6,1,1,0,8
CTCGTGGCACTGAAAG-1_V12D07-332_C1,0,4,5,2,0,11
CTTTATCCGACGCATG-1_V12D07-332_C1,0,3,3,3,0,9
AAATGACTGATCAAAC-1_V12D07-332_C1,0,5,1,0,0,6
TTCGTGCATGTTATAG-1_V12D07-332_C1,0,4,4,4,0,12
ATCAAAGAGCCGTGGT-1_V12D07-332_C1,0,2,0,0,0,2
ATGTCATAATAAACGA-1_V12D07-332_C1,0,4,3,3,0,10
CTTAATCGACTTAGTA-1_V12D07-332_C1,0,5,1,0,0,6
CTAAAGGATGAGATAC-1_V12D07-332_C1,0,2,3,6,0,11
GTGCTATCCAGCTGGA-1_V12D07-332_C1,0,1,3,0,0,4
GACAGAGGTCTTCAGT-1_V12D07-332_C1,0,1,0,6,0,7
TCGATTTACGAAACGA-1_V12D07-332_C1,0,2,7,0,0,9
AGGCTTAAGTTGCACA-1_V12D07-332_C1,0,5,4,6,0,15
TAGGATCTTAACCGCA-1_V12D07-332_C1,0,2,7,1,0,10
GACTTTCGAGCGGTTC-1_V12D07-332_C1,0,1,3,7,0,11
CCCTGGGAGGGATCCT-1_V12D07-332_C1,0,1,6,0,0,7
TAGTAGTTGCCGGACA-1_V12D07-332_C1,0,2,4,8,0,14
GCCCTAAGTGCAGGAT-1_V12D07-332_C1,0,8,3,0,0,11
ACTTGGGCTTTCGCCA-1_V12D07-332_C1,0,3,5,2,0,10
CATGATACGGTGAAAC-1_V12D07-332_C1,0,6,1,0,0,7
TCCTGCAGCCGCCAAT-1_V12D07-332_C1,0,8,0,1,0,9
GTCCGTTAGAGGGCCT-1_V12D07-332_C1,0,7,0,0,0,7
GCTTTATTAAGTTACC-1_V12D07-332_C1,0,11,0,1,0,12
AATCGAGGTCTCAAGG-1_V12D07-332_C1,0,7,5,0,0,12
GTGCTGTTAGAACATA-1_V12D07-332_C1,0,2,2,7,0,11
GGCTTCTCGTGGGTGG-1_V12D07-332_C1,0,7,0,0,0,7
CCTACAGTTGAGGGAG-1_V12D07-332_C1,0,10,0,2,0,12
TATCCCTCGATCTGCA-1_V12D07-332_C1,0,7,0,0,0,7
CCGGTATCTGGCGACT-1_V12D07-332_C1,0,11,2,0,0,13
CTCTAACACCGGCAGC-1_V12D07-332_C1,0,2,0,0,0,2
CTTCATCACCAGGGCT-1_V12D07-332_C1,0,7,2,5,0,14
GGCTGGCAATCCCACG-1_V12D07-332_C1,0,11,3,0,0,14
CAAACCATAAGCGTAT-1_V12D07-332_C1,0,6,5,1,0,12
CATGTGGGCTCATCAC-1_V12D07-332_C1,0,7,1,0,0,8
CCCGTGACAGTGCCTT-1_V12D07-332_C1,0,9,0,0,0,9
GATTATCTTGCATTAT-1_V12D07-332_C1,0,6,2,0,0,8
GAGTCCACCAGGTTTA-1_V12D07-332_C1,0,5,1,1,0,7
TGTACTATCGCTCGTT-1_V12D07-332_C1,0,5,0,0,0,5
TTAGCGAATAGATAGG-1_V12D07-332_C1,0,7,0,0,0,7
ACATACAATCAAGCGG-1_V12D07-332_C1,0,9,2,0,0,11
ATTCGTGTACCCATTC-1_V12D07-332_C1,0,8,0,0,0,8
GCTAGCAACGCACCTA-1_V12D07-332_C1,0,7,1,0,0,8
ACCTCAGCGAGGCGCA-1_V12D07-332_C1,0,7,0,0,0,7
TCCGGGCCACTAACGG-1_V12D07-332_C1,0,5,1,0,0,6
TCCCAATATCGACGAC-1_V12D07-332_C1,0,5,0,0,0,5
GGATTGAAGTAGCCTC-1_V12D07-332_C1,0,7,3,0,0,10
GGCGCACAGTTTACCT-1_V12D07-332_C1,0,5,0,0,0,5
CCCGGCACGTGTCAGG-1_V12D07-332_C1,0,2,3,0,0,5
AGTAAGGGACAGAATC-1_V12D07-332_C1,0,6,3,0,0,9
TTGCGCACAACCACGT-1_V12D07-332_C1,0,8,1,0,0,9
CCTGCTACAACCATAC-1_V12D07-332_C1,0,2,4,0,0,6
CTGGGCTACTGGAGAG-1_V12D07-332_C1,0,3,1,0,0,4
AGCTACGAATGGTGGT-1_V12D07-332_C1,0,6,6,0,0,12
ATTCGTTTATCGTATT-1_V12D07-332_C1,0,10,0,0,0,10
GGCATTCCCTCCCTCG-1_V12D07-332_C1,0,7,1,1,0,9
AGTTATTCAGACTGTG-1_V12D07-332_C1,0,10,0,0,0,10
CCACTTTCCTTCTAGG-1_V12D07-332_C1,0,1,2,1,0,4
CGCAGTTCTATCTTTC-1_V12D07-332_C1,0,2,6,0,0,8
AGGAGCGTTTATTATC-1_V12D07-332_C1,0,3,4,0,0,7
GACAGGTAATCCGTGT-1_V12D07-332_C1,0,3,4,0,0,7
TTCCCAAAGTACTGAT-1_V12D07-332_C1,0,0,7,0,0,7
CTGCAGGGTGACGCTC-1_V12D07-332_C1,0,3,3,0,0,6
TCATGGAGGCCTTTGT-1_V12D07-332_C1,0,2,7,0,0,9
ATGGCCCGAAAGGTTA-1_V12D07-332_C1,0,2,6,0,0,8
CGTAATATGGCCCTTG-1_V12D07-332_C1,0,1,4,0,0,5
AGAGTCTTAATGAAAG-1_V12D07-332_C1,0,8,0,0,0,8
GAACGTTTGTATCCAC-1_V12D07-332_C1,0,1,2,0,0,3
ATTGAATTCCCTGTAG-1_V12D07-332_C1,0,5,1,0,0,6
TACCTCACCAATTGTA-1_V12D07-332_C1,0,3,3,0,0,6
AGTCGAATTAGCGTAA-1_V12D07-332_C1,0,4,0,0,0,4
TTGAAGTGCATCTACA-1_V12D07-332_C1,0,2,0,0,0,2
