key,neuron,other,oligo,microglia,astrocyte,n_cells
ACGCCTGACACGCGCT-1_V12D07-335_D1,0,2,1,0,0,3
TACCGATCCAACACTT-1_V12D07-335_D1,0,2,1,0,0,3
ATTAAAGCGGACGAGC-1_V12D07-335_D1,0,0,0,0,0,0
GATAAGGGACGATTAG-1_V12D07-335_D1,0,1,0,0,0,1
GTGCAAATCACCAATA-1_V12D07-335_D1,0,0,0,0,0,0
TGTTGGCTGGCGGAAG-1_V12D07-335_D1,0,2,0,0,0,2
GCATCCTCTCCTATTA-1_V12D07-335_D1,0,0,0,0,0,0
GCGAGGGACTGCTAGA-1_V12D07-335_D1,0,2,0,0,0,2
TGGTACCGGCACAGCC-1_V12D07-335_D1,0,1,0,0,0,1
GCGCGTTTAAATCGTA-1_V12D07-335_D1,0,4,0,0,0,4
TGCCTTGCCCTTACGG-1_V12D07-335_D1,0,2,0,0,0,2
GACGACTTTCCAAGAA-1_V12D07-335_D1,0,0,0,0,0,0
CCAGTGAGCTCCTTGT-1_V12D07-335_D1,0,0,0,0,0,0
ATACCCTGGCTCAAAT-1_V12D07-335_D1,0,0,0,0,0,0
GGGTTTCCGGCTTCCA-1_V12D07-335_D1,1,1,0,0,0,2
TAACCGTCCAGTTCAT-1_V12D07-335_D1,0,0,0,0,0,0
AAACAACGAATAGTTC-1_V12D07-335_D1,11,1,0,1,0,13
CAAGGGAGTGTATTTG-1_V12D07-335_D1,0,0,0,0,0,0
CCAAGCTTGATCTCCT-1_V12D07-335_D1,23,0,0,0,0,23
TTATTTCATCCCAAAC-1_V12D07-335_D1,13,2,0,1,0,16
GAGCGCTATGTCAGGC-1_V12D07-335_D1,18,2,0,0,0,20
TATGGCAGACTTTCGA-1_V12D07-335_D1,3,8,0,0,0,11
CTTCGTGCCCGCATCG-1_V12D07-335_D1,20,0,0,0,0,20
AAACGGGTTGGTATCC-1_V12D07-335_D1,11,2,1,0,0,14
TGCAAACCCACATCAA-1_V12D07-335_D1,14,1,1,0,0,16
GACGGGATGTCTTATG-1_V12D07-335_D1,16,0,0,0,0,16
GGCGAGCATCGAGGAC-1_V12D07-335_D1,1,2,0,0,0,3
CGCGTGCTATCAACGA-1_V12D07-335_D1,0,1,0,0,0,1
TGAAACCTCAACTCAC-1_V12D07-335_D1,0,1,0,0,0,1
CACATAAGGCGACCGT-1_V12D07-335_D1,1,1,0,0,0,2
TGACCCAACTCACATT-1_V12D07-335_D1,0,2,1,0,0,3
ATACGCCGATCTACCG-1_V12D07-335_D1,0,1,0,0,0,1
ACTTATCTGATCTATA-1_V12D07-335_D1,0,1,0,0,0,1
GTGTGAGCCGAGGTGC-1_V12D07-335_D1,0,0,1,0,0,1
GATGATTTGAAACTGG-1_V12D07-335_D1,0,1,1,0,0,2
GGGAACCACCTGTTTC-1_V12D07-335_D1,0,2,0,0,0,2
GTTCGTTGCGGACCAG-1_V12D07-335_D1,0,1,2,2,0,5
TGAGGTTGATCCCAAG-1_V12D07-335_D1,0,1,3,0,0,4
GATGCCACACTACAGC-1_V12D07-335_D1,0,0,1,0,0,1
AGGCAAAGAGGAATCA-1_V12D07-335_D1,0,1,0,0,0,1
AAGTAAGCTTCCAAAC-1_V12D07-335_D1,0,0,0,0,0,0
AACGTAGTCTACCCAT-1_V12D07-335_D1,0,0,7,1,0,8
GTTTGAGCGGTTATGT-1_V12D07-335_D1,3,1,0,0,0,4
GAAGCAAGGCAATGTT-1_V12D07-335_D1,0,2,3,1,0,6
TCACTCAGCGCATTAG-1_V12D07-335_D1,4,0,0,0,0,4
TACAATGAAACCAGCA-1_V12D07-335_D1,0,2,2,1,0,5
GTGCGCTTACAAATGA-1_V12D07-335_D1,13,0,0,0,0,13
GCACTCCCACAGTCCC-1_V12D07-335_D1,0,2,0,1,0,3
CGAAGACTGCCCGGGA-1_V12D07-335_D1,0,2,0,0,0,2
CAGGATCCGCCCGACC-1_V12D07-335_D1,0,3,0,0,0,3
CACGATTGGTCGTTAA-1_V12D07-335_D1,1,9,0,0,0,10
GGTTGTATCGTGAAAT-1_V12D07-335_D1,2,8,0,0,0,10
TCTTATGGGTAGTACC-1_V12D07-335_D1,0,3,6,0,0,9
TACAAGCTGTTCACTG-1_V12D07-335_D1,0,7,2,2,0,11
GTATCTTGTTGCTCAC-1_V12D07-335_D1,0,2,1,0,0,3
ATACCAGGTGAGCGAT-1_V12D07-335_D1,1,2,3,0,0,6
CCTAAACAGGGTCCGT-1_V12D07-335_D1,0,0,7,1,0,8
ATGGTGCTCAAAGCCA-1_V12D07-335_D1,0,6,3,0,0,9
CAAATGCGGAGTGTTC-1_V12D07-335_D1,0,5,3,1,0,9
CGTGCCCGACATTTGT-1_V12D07-335_D1,0,3,5,0,0,8
GTATCTCCCTAACTGT-1_V12D07-335_D1,1,4,2,0,0,7
ATTTGCCTAGTTACGA-1_V12D07-335_D1,1,3,8,0,0,12
ACGTCCTAAACGAGAT-1_V12D07-335_D1,0,12,2,1,0,15
CTGGGATCGCCCAGAT-1_V12D07-335_D1,0,3,3,0,0,6
CTGCAAATGGGCTCCA-1_V12D07-335_D1,0,4,3,0,0,7
CATTATAACAGGGTCC-1_V12D07-335_D1,0,6,0,0,0,6
ACCTTTCCTTTAGAAG-1_V12D07-335_D1,1,6,1,0,0,8
ATAGATTTGCAGTCGG-1_V12D07-335_D1,0,1,2,0,0,3
CTCGGGCATCGTCGGG-1_V12D07-335_D1,0,3,1,0,0,4
GTGGCGGGCCGTAGCT-1_V12D07-335_D1,1,2,2,0,0,5
CAACAGTGCCAAACGG-1_V12D07-335_D1,0,1,1,0,0,2
TGCGGGTATTGGGATC-1_V12D07-335_D1,0,2,5,0,0,7
GTCTCGCCAACACGCC-1_V12D07-335_D1,0,0,2,0,0,2
CTGGGCGGCCAAATGT-1_V12D07-335_D1,1,2,5,0,0,8
TAAAGGAGAAACTAGT-1_V12D07-335_D1,0,3,3,0,0,6
TCCCACGGAGGGAGCT-1_V12D07-335_D1,0,2,4,0,0,6
AGCTTCAATACTTTGA-1_V12D07-335_D1,1,2,3,0,0,6
TTCCACATTTCTCGTC-1_V12D07-335_D1,0,2,2,0,0,4
ACAAACCGACAAGGCG-1_V12D07-335_D1,0,2,2,0,0,4
AGACGGGATTGGTATA-1_V12D07-335_D1,0,1,2,0,0,3
AACCTAAAGCCGTCCG-1_V12D07-335_D1,1,1,6,1,0,9
TACAAATTGCGGAGGT-1_V12D07-335_D1,0,2,2,0,0,4
CCCGCTAGAGGGTTAA-1_V12D07-335_D1,0,1,1,0,0,2
CATTGCAAAGCATAAT-1_V12D07-335_D1,0,1,1,0,0,2
TGTACGCTATCAGCTT-1_V12D07-335_D1,0,1,0,0,0,1
TTCTTCGCAATAGAGC-1_V12D07-335_D1,0,0,0,0,0,0
TGTGATTCCAGCGCTT-1_V12D07-335_D1,0,2,3,0,0,5
ATTCAGGATCGCCTCT-1_V12D07-335_D1,1,0,3,0,0,4
GCCCATGGGTGCAATG-1_V12D07-335_D1,0,1,0,0,0,1
TTCCCGACGCTTCACT-1_V12D07-335_D1,0,3,1,0,0,4
AGCGGTTGAGATGTAC-1_V12D07-335_D1,0,0,0,0,0,0
GCTGTCTGTGATCGAC-1_V12D07-335_D1,0,4,1,0,0,5
AAAGACATGAAGTTTA-1_V12D07-335_D1,0,1,2,0,0,3
CAACAGAATAACGCTA-1_V12D07-335_D1,0,0,1,0,0,1
TGCGGTCTACGAGTAA-1_V12D07-335_D1,0,0,0,0,0,0
AAGACTCACGCCCACT-1_V12D07-335_D1,0,0,0,0,0,0
CTTTGAAACATATTCC-1_V12D07-335_D1,0,0,1,0,0,1
CTGGGCACTAGTCGGA-1_V12D07-335_D1,0,0,0,0,0,0
CGCCCTTACATCCACC-1_V12D07-335_D1,0,0,0,0,0,0
CACGACCACAGACTTT-1_V12D07-335_D1,0,0,0,0,0,0
CAATCCATTATCCGTT-1_V12D07-335_D1,0,1,0,0,0,1
GTGGCGTGCACCAGAG-1_V12D07-335_D1,0,0,0,0,0,0
CGGAGTCCTAACCTGG-1_V12D07-335_D1,0,3,1,0,0,4
GGTCCCATAACATAGA-1_V12D07-335_D1,0,0,0,0,0,0
ATCTCATAAACCTACC-1_V12D07-335_D1,0,0,0,0,0,0
TGCATGGCAGTCTTGC-1_V12D07-335_D1,0,3,0,0,0,3
TTGCAGGTCATGAAGT-1_V12D07-335_D1,1,2,0,0,0,3
AGCTGCATTTGAGGTG-1_V12D07-335_D1,0,0,0,0,0,0
TAATCAGGAATGCTGC-1_V12D07-335_D1,0,3,0,0,0,3
CCATCATAAGAACAGG-1_V12D07-335_D1,0,1,1,0,0,2
TCGTATCACCAAGCTA-1_V12D07-335_D1,0,1,0,0,0,1
ATTCAGATGAATCCCT-1_V12D07-335_D1,0,2,0,1,0,3
AAAGGTCAACGACATG-1_V12D07-335_D1,0,2,0,0,0,2
AGCTGCTGTGCCGAAT-1_V12D07-335_D1,1,0,1,0,0,2
CTAGCGCCAATCCTAC-1_V12D07-335_D1,0,0,0,0,0,0
GCTCGACCGAACTGAA-1_V12D07-335_D1,0,2,2,0,0,4
ACAGTGCAGCGCATTT-1_V12D07-335_D1,0,0,0,0,0,0
CGGCTGAAGGTTACGC-1_V12D07-335_D1,0,0,0,0,0,0
CACCTCTACGAGTGTG-1_V12D07-335_D1,0,1,0,0,0,1
ATACGACAGATGGGTA-1_V12D07-335_D1,0,1,1,0,0,2
ACTTCCTGTCGTGCGA-1_V12D07-335_D1,1,0,1,1,0,3
CGTAACGGAACGATCA-1_V12D07-335_D1,0,1,2,0,0,3
AAATCACTCCTAAACG-1_V12D07-335_D1,0,0,0,0,0,0
CTCCGAGTAAATCCGC-1_V12D07-335_D1,0,0,1,0,0,1
ACGCTAGTATCAGTGC-1_V12D07-335_D1,0,0,4,1,0,5
AGAGTGAACAGACACC-1_V12D07-335_D1,0,0,2,0,0,2
ACACCCGTAAATCTGT-1_V12D07-335_D1,0,0,5,1,0,6
GCTTTGCTGCCGGGTA-1_V12D07-335_D1,0,0,1,0,0,1
ACAGGAGGCGCAGCCG-1_V12D07-335_D1,4,0,0,0,0,4
AGGCAATACGGAGGAC-1_V12D07-335_D1,9,3,0,0,0,12
TGGTGTGACAGACGAT-1_V12D07-335_D1,0,0,0,0,0,0
ATCTATCGATGATCAA-1_V12D07-335_D1,20,1,0,0,0,21
CGGTAACAAGATACAT-1_V12D07-335_D1,2,2,0,0,0,4
TCGCCGGAGAGTCTTA-1_V12D07-335_D1,22,0,0,0,0,22
GGAGGAGTGTGTTTAT-1_V12D07-335_D1,0,1,0,0,0,1
TTAGGTGTGACTGGTC-1_V12D07-335_D1,0,2,0,0,0,2
CAGGGCTAACGAAACC-1_V12D07-335_D1,3,3,0,0,0,6
CCCGTGGGTTAATTGA-1_V12D07-335_D1,10,2,0,0,0,12
GACCGACCGCTAATAT-1_V12D07-335_D1,0,0,0,0,0,0
GGTATCAAGCATAGAA-1_V12D07-335_D1,0,0,0,0,0,0
TGCATGAGTAGATTCG-1_V12D07-335_D1,0,0,0,0,0,0
AATTCCAACTTGGTGA-1_V12D07-335_D1,0,0,0,0,0,0
TGCCGATGTCATCAAT-1_V12D07-335_D1,0,0,0,0,0,0
GCTGGGTCCGCTGTTA-1_V12D07-335_D1,0,0,0,0,0,0
TGAACACCCGAAGCAG-1_V12D07-335_D1,0,0,0,0,0,0
AACATTGGTCAGCCGT-1_V12D07-335_D1,0,0,0,0,0,0
GTGGGTCTTCTTTGCG-1_V12D07-335_D1,0,0,0,0,0,0
CATCGAATGGATCTCT-1_V12D07-335_D1,0,0,0,0,0,0
GCTACACTGTCCGAAC-1_V12D07-335_D1,0,1,0,1,0,2
CGGGTTGTAGCTTTGG-1_V12D07-335_D1,0,0,1,0,0,1
CCTAAGTGTCTAACCG-1_V12D07-335_D1,2,3,2,0,0,7
TCTGTGACTGACCGTT-1_V12D07-335_D1,1,1,0,0,0,2
TTATCATACTCGCAAA-1_V12D07-335_D1,5,2,1,0,0,8
AGCGTAGCGCTAGACC-1_V12D07-335_D1,3,1,0,0,0,4
TCCCTCCGAAATCGTT-1_V12D07-335_D1,15,5,0,0,0,20
AGGTCGCCACTTCGGT-1_V12D07-335_D1,22,2,0,0,0,24
CTAGCAACTAATTTAC-1_V12D07-335_D1,3,1,1,0,0,5
TTGCTAGCTACCAATC-1_V12D07-335_D1,5,5,0,0,0,10
GCCGGTTTGGGCGGAT-1_V12D07-335_D1,0,1,0,0,0,1
TGTAACTTGTCAACCT-1_V12D07-335_D1,0,2,0,0,0,2
CGAGATGTTGCCTATA-1_V12D07-335_D1,0,2,0,0,0,2
GTTACGAAATCCACGC-1_V12D07-335_D1,0,3,1,0,0,4
CTTGTCGTACGTGTCA-1_V12D07-335_D1,0,1,0,0,0,1
GCGTCCAGCTCGTGGC-1_V12D07-335_D1,0,1,1,0,0,2
CCCTTCTCGTACGCGA-1_V12D07-335_D1,0,0,0,0,0,0
CCAAAGTCCCGCTAAC-1_V12D07-335_D1,0,0,1,0,0,1
CCGCTTCGCGGTTAAC-1_V12D07-335_D1,0,1,1,0,0,2
GTTACGGCCCGACTGC-1_V12D07-335_D1,0,0,1,0,0,1
CCCGCTTGCCCTCGTC-1_V12D07-335_D1,0,2,3,0,0,5
TAGTGAGAAGTGGTTG-1_V12D07-335_D1,0,1,1,0,0,2
CGCTACCGCCCTATGA-1_V12D07-335_D1,0,2,1,0,0,3
AAACAATCTACTAGCA-1_V12D07-335_D1,0,4,0,0,0,4
GCGCGATGGGTCAAGT-1_V12D07-335_D1,0,0,2,1,0,3
ATAAACCATTGGACGG-1_V12D07-335_D1,0,2,4,0,0,6
TCGGGCACTTCTGGAT-1_V12D07-335_D1,0,3,2,1,0,6
TCTGTGGCTACATTTC-1_V12D07-335_D1,0,1,3,0,0,4
CTCTGTGCCTGCTATG-1_V12D07-335_D1,0,7,4,0,0,11
CACGACTAAAGTTCTG-1_V12D07-335_D1,0,2,2,0,0,4
GAGGAGTAATTCCTAC-1_V12D07-335_D1,2,9,0,0,0,11
AGAGGTATCTCGGTCC-1_V12D07-335_D1,0,6,9,0,0,15
GGCGTACCCTATATAA-1_V12D07-335_D1,0,6,2,0,0,8
GCCGGAAACACATCTT-1_V12D07-335_D1,0,1,1,0,0,2
AAATGTGGGTGCTCCT-1_V12D07-335_D1,1,0,1,0,0,2
ACCAGGAGTGTGATCT-1_V12D07-335_D1,0,2,3,0,0,5
TGTGGAGGAAGCTTAA-1_V12D07-335_D1,0,0,5,2,0,7
AAGGAGAACTTATAAG-1_V12D07-335_D1,1,1,10,1,0,13
CCCTCGGGAGCCTTGT-1_V12D07-335_D1,0,2,4,2,1,9
ACTGTTTAGTGTAGGC-1_V12D07-335_D1,0,0,2,1,0,3
CGTCAGTTTATCGTCT-1_V12D07-335_D1,1,2,3,2,0,8
GCGTGTATGTCGTATT-1_V12D07-335_D1,0,1,2,4,0,7
ACAATCGATCTTTATA-1_V12D07-335_D1,0,5,1,0,0,6
CAGCCCTCACAGGCAG-1_V12D07-335_D1,0,2,3,0,0,5
CGCGTCATATTAAACC-1_V12D07-335_D1,0,2,3,0,0,5
GAAGACTTCAATGCCG-1_V12D07-335_D1,0,3,5,0,0,8
TTGCGGCGACTCATGC-1_V12D07-335_D1,0,1,1,0,0,2
ACCAAACTAGAAATCC-1_V12D07-335_D1,1,4,2,0,0,7
TTACTGTTTCTCTACG-1_V12D07-335_D1,0,1,2,1,0,4
GACCAGGTCATTCATA-1_V12D07-335_D1,0,2,4,0,0,6
TTCTTCCCTTTGATAT-1_V12D07-335_D1,0,3,5,0,0,8
ACGCCCAGCTGTCGAT-1_V12D07-335_D1,0,6,0,0,0,6
AGTAGCGTGAACGAAC-1_V12D07-335_D1,0,1,1,0,0,2
CCTCGACCCACTGCCT-1_V12D07-335_D1,0,0,0,0,0,0
AGTTATTGAAAGGTAA-1_V12D07-335_D1,0,0,2,0,0,2
TCAGTTACGGAATGAT-1_V12D07-335_D1,0,0,0,0,0,0
GAATCTATACTCGGAC-1_V12D07-335_D1,0,1,0,0,0,1
TCGGCTAACTTCCCTT-1_V12D07-335_D1,0,0,0,0,0,0
ACGTGGTCGAATGTGC-1_V12D07-335_D1,0,0,1,0,0,1
ATATCGTGCCAGACCC-1_V12D07-335_D1,0,0,1,0,0,1
GTAGCTAGTAAGCGCG-1_V12D07-335_D1,1,2,3,0,0,6
ACGCTTAGTGTCTCTC-1_V12D07-335_D1,0,2,1,0,0,3
TCCGGCCTGCATCGAT-1_V12D07-335_D1,0,3,0,0,0,3
TAGTGGAACTCATACA-1_V12D07-335_D1,0,1,2,0,0,3
ATCATCTGCCCAGTGT-1_V12D07-335_D1,0,2,0,0,0,2
GTTATTAAATACGACC-1_V12D07-335_D1,1,3,3,0,0,7
GCGCTAAGTATGCATG-1_V12D07-335_D1,0,2,0,0,0,2
CCTGACGCAACCTTTA-1_V12D07-335_D1,0,2,0,0,0,2
CCCAAGAATGCACGGT-1_V12D07-335_D1,0,1,1,0,0,2
AACTGGGTTCGAGCCG-1_V12D07-335_D1,0,0,0,0,0,0
GGTTCCACCCGCTTCT-1_V12D07-335_D1,0,1,3,0,0,4
CATGCACGTGTTACTG-1_V12D07-335_D1,1,0,2,1,0,4
AGCGTTCCGATTTAAA-1_V12D07-335_D1,0,0,3,0,0,3
CCTACGCGACCTTACA-1_V12D07-335_D1,0,1,1,0,0,2
CGAATTACATGGTGTT-1_V12D07-335_D1,0,0,0,0,0,0
GAGGTCTTAGTGGGTC-1_V12D07-335_D1,0,0,1,0,0,1
GCCGCTAGATACGCAG-1_V12D07-335_D1,0,0,0,0,0,0
GTCACCTGTCTATGTC-1_V12D07-335_D1,0,0,0,0,0,0
CCGATTGGTCAATGAA-1_V12D07-335_D1,1,3,1,0,0,5
CCTGTGCGGATTGTAA-1_V12D07-335_D1,0,0,0,0,0,0
TTACGTAGCGCGTGCT-1_V12D07-335_D1,0,1,0,0,0,1
GGAGGCGAAGAACCGC-1_V12D07-335_D1,0,0,0,0,0,0
GGGTCACGTGCTTATG-1_V12D07-335_D1,0,2,0,0,0,2
GCTCCGGACGTTGATA-1_V12D07-335_D1,0,1,0,0,0,1
ATGTTTGTAAGATCAT-1_V12D07-335_D1,0,0,0,0,0,0
TGACCCAGCATTCCCG-1_V12D07-335_D1,0,1,1,0,0,2
TGGTCGTTTGATAGAT-1_V12D07-335_D1,1,4,0,0,0,5
TGTAATGCCTTCGGAC-1_V12D07-335_D1,0,2,1,0,0,3
TGCTCACACAACAACC-1_V12D07-335_D1,0,4,0,0,0,4
TACGATCCAAGCCACT-1_V12D07-335_D1,0,2,1,0,0,3
TTGTAACTTCATAGCG-1_V12D07-335_D1,0,1,0,0,0,1
AGATTCAAGCGGGTCG-1_V12D07-335_D1,0,2,0,0,0,2
CTCAGCAGACTGCCGA-1_V12D07-335_D1,0,2,2,0,0,4
GTAACATCAGCTCATC-1_V12D07-335_D1,0,3,0,0,0,3
ATGGAACAGAATAAAC-1_V12D07-335_D1,0,2,0,0,0,2
GGGCCTATACAACCGG-1_V12D07-335_D1,0,0,1,0,0,1
TCAAACAATTAGGACA-1_V12D07-335_D1,0,3,0,0,0,3
AAACCACTACACAGAT-1_V12D07-335_D1,0,2,1,0,0,3
AAACGACAGTCTTGCC-1_V12D07-335_D1,0,3,1,0,0,4
TTGAGGGTCGAACGCG-1_V12D07-335_D1,0,2,2,0,0,4
TGTTGATCACTGTTTA-1_V12D07-335_D1,0,1,0,0,0,1
AGGGTGTGCTACACGC-1_V12D07-335_D1,0,1,2,0,0,3
GTAGTTAGACAATATA-1_V12D07-335_D1,0,0,1,1,0,2
AATGGCCGCCAATGCG-1_V12D07-335_D1,0,1,3,0,0,4
TCGGCGGTATTAGATT-1_V12D07-335_D1,0,0,3,0,0,3
GGGTCACTGAGTAGTG-1_V12D07-335_D1,0,0,2,0,0,2
GAATTATGCAACCTAC-1_V12D07-335_D1,0,1,2,1,0,4
GATCTTAGTGAACGTG-1_V12D07-335_D1,0,3,4,0,0,7
CTAATGCGCCCAACAA-1_V12D07-335_D1,0,1,0,0,0,1
GCCACCCATTCCACTT-1_V12D07-335_D1,0,3,2,1,0,6
TACTCACAACGTAGTA-1_V12D07-335_D1,1,0,2,0,0,3
GTTCGGTGTGGATTTA-1_V12D07-335_D1,0,7,0,0,0,7
TCTTTCGGCGGGACAC-1_V12D07-335_D1,0,2,0,0,0,2
GGAGACATTCACGGGC-1_V12D07-335_D1,0,1,1,0,0,2
GGGATTATCTCACAAC-1_V12D07-335_D1,0,1,0,0,0,1
TAGAACGCCAGTAACG-1_V12D07-335_D1,1,1,0,0,0,2
ACGAGTCGCCGGCGTT-1_V12D07-335_D1,1,4,1,0,0,6
TGATGGGACTAAGTCA-1_V12D07-335_D1,0,1,1,0,0,2
TGCGAGAAACGTTACG-1_V12D07-335_D1,0,1,0,0,0,1
TCGCCTCGACCTGTTG-1_V12D07-335_D1,1,0,0,0,0,1
AACTCGATAAACACGT-1_V12D07-335_D1,0,0,0,0,0,0
AGGAAAGCCTCTGATG-1_V12D07-335_D1,0,0,0,0,0,0
GAAGGACTAAATTGAA-1_V12D07-335_D1,0,0,0,0,0,0
GTATCGGGACGAGCTG-1_V12D07-335_D1,0,0,0,0,0,0
CCTGTGCATAGGAGAC-1_V12D07-335_D1,0,0,0,0,0,0
CATACGGGTGCATGAT-1_V12D07-335_D1,0,0,0,0,0,0
CCACTAAACTGAATCG-1_V12D07-335_D1,0,0,0,0,0,0
AAATTGCGGCGGTTCT-1_V12D07-335_D1,0,2,2,0,0,4
AGTCCAGCGGGTACGT-1_V12D07-335_D1,0,1,2,1,0,4
CATTCAGGTCAGTGCG-1_V12D07-335_D1,0,1,0,0,0,1
CTAAAGTCCGAAGCTA-1_V12D07-335_D1,0,3,1,0,0,4
AATCAGACTGCAGGAC-1_V12D07-335_D1,0,1,2,0,0,3
AGTATCCATAATAACG-1_V12D07-335_D1,0,3,0,0,0,3
CTGGCTGCTAACGTAA-1_V12D07-335_D1,0,2,1,0,0,3
GTTCCAAGACAGCGAC-1_V12D07-335_D1,1,2,0,0,0,3
AAGACTAACCCGTTGT-1_V12D07-335_D1,1,2,0,0,0,3
GATTAATCCTGGCTCA-1_V12D07-335_D1,8,3,0,0,0,11
CGCGCAAGGAACTACA-1_V12D07-335_D1,4,3,0,0,0,7
CAGTAGCGAGGTAGTA-1_V12D07-335_D1,18,1,0,0,0,19
ACGGCGGGTTGCCCTG-1_V12D07-335_D1,17,1,0,1,0,19
CTAGGCGGCAGAGAAT-1_V12D07-335_D1,1,2,0,0,0,3
GTGCGCAGCTTGCTCC-1_V12D07-335_D1,0,0,0,0,0,0
TCACTATCGTGCAATC-1_V12D07-335_D1,0,0,0,0,0,0
TATGATTCTGCTTGGT-1_V12D07-335_D1,0,2,0,0,0,2
TAAGATTTAGCGGGAG-1_V12D07-335_D1,0,0,0,0,0,0
TTACGGTGTCACCGAG-1_V12D07-335_D1,0,3,2,0,0,5
CTACACTAGCTTGTTC-1_V12D07-335_D1,0,1,1,0,0,2
TGAGCAGTCGTGAAGT-1_V12D07-335_D1,0,0,0,0,0,0
CGCTGAGGACGTCCAA-1_V12D07-335_D1,0,0,1,0,0,1
GTGTATGACTTTAAAG-1_V12D07-335_D1,0,1,2,0,0,3
CTAAACGGGTGTAATC-1_V12D07-335_D1,1,3,0,0,0,4
TGTACTGTGCCAAAGT-1_V12D07-335_D1,0,7,0,0,0,7
GGCCACAAGCGATGGC-1_V12D07-335_D1,0,0,2,0,0,2
GTCAATTGTACTGAAG-1_V12D07-335_D1,0,2,3,0,0,5
AGGGACAGCACGGCGG-1_V12D07-335_D1,0,4,4,0,0,8
AGCTTATAGAGACCTG-1_V12D07-335_D1,0,1,3,0,0,4
AACTAGCGTATCGCAC-1_V12D07-335_D1,1,5,4,0,1,11
AACTTTAGCTGCTGAG-1_V12D07-335_D1,0,0,4,0,0,4
CCCAAGACAGAGTATG-1_V12D07-335_D1,0,0,1,0,0,1
GGCATCAACGAGCACG-1_V12D07-335_D1,0,0,5,1,0,6
ATGCATTCCGTGATGG-1_V12D07-335_D1,0,8,0,0,0,8
TTATAGATGCACATTA-1_V12D07-335_D1,0,4,2,0,0,6
GAACCATCTGGGAGAC-1_V12D07-335_D1,0,5,3,0,0,8
TGCTATACAAACGGAC-1_V12D07-335_D1,0,2,0,0,0,2
ACTTGCCATATTGTAC-1_V12D07-335_D1,1,4,4,0,0,9
TATTCCGGCAGTCCTA-1_V12D07-335_D1,0,2,3,0,0,5
GACGGACCGCGTTCCT-1_V12D07-335_D1,0,0,11,1,0,12
ATGTGTAGTTTAGTCA-1_V12D07-335_D1,1,1,5,1,0,8
ATACCAGCAAATTGCT-1_V12D07-335_D1,0,1,1,0,0,2
AAGTTTACTAATGGCA-1_V12D07-335_D1,0,5,1,1,0,7
CTCTCGATGTGCGCCT-1_V12D07-335_D1,0,1,1,0,0,2
GATTGACACTCTGCTC-1_V12D07-335_D1,0,5,3,0,0,8
TATCACAGCACGGGCA-1_V12D07-335_D1,0,2,5,0,0,7
ACCGTTCCCGCTCTGA-1_V12D07-335_D1,0,2,1,1,0,4
CCGCCACCACAATCCA-1_V12D07-335_D1,0,0,1,0,0,1
CATTCACTGACAGCTA-1_V12D07-335_D1,0,3,2,0,0,5
CGGCTGCAAGATTAAG-1_V12D07-335_D1,0,2,0,0,0,2
CATGAACCTCTTATCA-1_V12D07-335_D1,0,4,3,0,0,7
TTAATGCGAGGTAACT-1_V12D07-335_D1,0,3,4,0,0,7
AATAAGTCCTCGAGAC-1_V12D07-335_D1,1,1,0,0,0,2
ACCAGCCCGGTCTTTG-1_V12D07-335_D1,0,3,7,0,0,10
CTACGAACTAGGTCGA-1_V12D07-335_D1,1,1,1,0,0,3
ACATCTCAACGCGTAA-1_V12D07-335_D1,0,1,0,0,0,1
CACTACTCAGTTCTGT-1_V12D07-335_D1,0,2,0,0,0,2
CCGACTCGCATAGTCT-1_V12D07-335_D1,0,1,0,0,0,1
CATTTATCGTTCAAGA-1_V12D07-335_D1,0,2,3,0,0,5
CAAACGTGGTCTTGCG-1_V12D07-335_D1,0,1,3,0,0,4
TAGAAACCACTAAGTA-1_V12D07-335_D1,0,0,2,0,0,2
ACTGATTTAGTGATTC-1_V12D07-335_D1,1,0,1,0,0,2
TCGTATTTCGTCCGGA-1_V12D07-335_D1,0,1,2,0,0,3
CGGAAATTTCACATCC-1_V12D07-335_D1,1,1,0,0,0,2
ATCCACGCTAAATGTT-1_V12D07-335_D1,2,0,3,0,0,5
GTTCAATCTATGTCAA-1_V12D07-335_D1,1,1,0,0,0,2
ATAAAGGTCAAGTACG-1_V12D07-335_D1,0,0,0,0,0,0
CAACTCCAACGTTTAG-1_V12D07-335_D1,0,0,1,0,0,1
TAGGAACAGCCTCCAG-1_V12D07-335_D1,0,1,1,0,0,2
ATGGGAACGGAAGCGG-1_V12D07-335_D1,0,0,0,0,0,0
CACACGTTTCAATGGG-1_V12D07-335_D1,0,1,0,0,0,1
GGTGTTCTGTTTCTAC-1_V12D07-335_D1,1,2,3,0,0,6
AGTAACGTTCATCCTG-1_V12D07-335_D1,1,0,0,0,0,1
GTATAGTGGCCCATGT-1_V12D07-335_D1,1,1,1,0,0,3
TCTACACGTTCATGCA-1_V12D07-335_D1,0,0,0,0,0,0
AATCTGGGTAGACCCT-1_V12D07-335_D1,0,1,0,0,0,1
TCGGTTAGCCATGTAG-1_V12D07-335_D1,0,0,1,0,0,1
TGCCATGGCTTATAAG-1_V12D07-335_D1,0,2,0,0,0,2
TAAGTAAATGTGCCGC-1_V12D07-335_D1,0,0,3,0,0,3
GTGTCCGATAAGGCAT-1_V12D07-335_D1,0,1,0,0,0,1
TGGCACGAGCTCGAGT-1_V12D07-335_D1,0,1,1,0,0,2
ACCGGTCTGAGTACGG-1_V12D07-335_D1,0,0,1,0,0,1
GAACTTAGCGCCCGGT-1_V12D07-335_D1,0,2,0,0,0,2
AGTAGCTAGACGCCGA-1_V12D07-335_D1,0,0,0,0,0,0
ATAGGAATCTAAGCTT-1_V12D07-335_D1,0,1,1,3,0,5
CTTCCTGCATATTTAC-1_V12D07-335_D1,0,2,0,0,0,2
CAATATGTAGATTTAC-1_V12D07-335_D1,1,1,0,0,0,2
ACAAGGCCTACCAGCC-1_V12D07-335_D1,0,1,0,0,0,1
TTATAGTCCAAGGTGC-1_V12D07-335_D1,0,3,0,0,0,3
AAACGCCCGAGATCGG-1_V12D07-335_D1,0,3,0,0,0,3
CCTCGTTACGCCTGTT-1_V12D07-335_D1,0,0,0,0,0,0
GAACGGTGTAAAGCAG-1_V12D07-335_D1,0,0,0,0,0,0
ACGCATAAATGACATG-1_V12D07-335_D1,0,2,0,0,0,2
GGTTCGATGCTGAGTT-1_V12D07-335_D1,0,2,0,0,0,2
CTTTGGCAGACAGAGT-1_V12D07-335_D1,0,0,1,0,0,1
TTCGTGGGCTGGAAGC-1_V12D07-335_D1,0,1,0,0,0,1
CAAAGGTTAAATTCAG-1_V12D07-335_D1,0,0,0,0,0,0
GTTTGGCGTCAGGCAC-1_V12D07-335_D1,0,1,0,0,0,1
GCTTTCTATCTCAACT-1_V12D07-335_D1,0,1,0,0,0,1
TGCATCTCCGGATCTT-1_V12D07-335_D1,0,2,0,0,0,2
CTGAAACGGCCCTCAG-1_V12D07-335_D1,0,2,1,0,0,3
TAGCAGTAAATACGCG-1_V12D07-335_D1,0,1,0,0,0,1
CGGGCTACTTAAATTG-1_V12D07-335_D1,0,0,2,0,0,2
ATTATGCTCAGTATTG-1_V12D07-335_D1,0,2,2,0,0,4
TGATGCTCACGTAGTC-1_V12D07-335_D1,1,2,2,0,0,5
GTCTAAGATGCCCAGC-1_V12D07-335_D1,0,0,0,0,0,0
AACCCGATAGGGCTTC-1_V12D07-335_D1,0,0,3,0,0,3
CGCTATCGTGGCTTTA-1_V12D07-335_D1,0,2,3,0,0,5
CGTCTCTCGCCGAGGC-1_V12D07-335_D1,0,1,3,1,0,5
AGTGGGAGTATACACG-1_V12D07-335_D1,1,3,0,0,0,4
GGTCTTGGTGTTAACT-1_V12D07-335_D1,0,0,0,0,0,0
GGCTGGCAGCTTTATG-1_V12D07-335_D1,0,1,1,1,0,3
CGCCAATTATTGCGTT-1_V12D07-335_D1,0,1,1,0,0,2
GGTAACCGGCAAAGGT-1_V12D07-335_D1,0,1,0,1,0,2
TGGGACCATTGGGAGT-1_V12D07-335_D1,0,3,2,0,0,5
CTGCAGGTGCTCGGCC-1_V12D07-335_D1,1,1,0,0,0,2
CCGGTGCGAGTGATAG-1_V12D07-335_D1,0,1,0,0,0,1
GGGTACACTCTGGAGG-1_V12D07-335_D1,0,1,0,0,0,1
TAGCCAGAGGGTCCGG-1_V12D07-335_D1,3,2,0,0,0,5
CTTGTGAGGACAGCGG-1_V12D07-335_D1,0,3,2,0,0,5
GAAGGGCATAACCATG-1_V12D07-335_D1,0,1,0,0,0,1
CAACATGGCCTGATAA-1_V12D07-335_D1,0,2,0,0,0,2
CAATTTGACCGGGAAG-1_V12D07-335_D1,2,2,0,0,0,4
TCTGACTGTAATGGTT-1_V12D07-335_D1,0,2,1,0,0,3
TTCATAGCCTTGTAAC-1_V12D07-335_D1,0,3,2,0,0,5
TGGAAACGGAGTGAAC-1_V12D07-335_D1,2,1,0,0,0,3
ATCGCACGATTGTTCA-1_V12D07-335_D1,3,0,1,0,0,4
CGCCACCCGCATTAAC-1_V12D07-335_D1,0,1,2,0,0,3
TGGACCACGGCGTTGA-1_V12D07-335_D1,0,2,1,0,0,3
GTATATGTTACGGCGG-1_V12D07-335_D1,0,2,1,0,0,3
GTATTCTTACCGTGCT-1_V12D07-335_D1,0,0,1,1,0,2
TTCAGAGTAACCTGAC-1_V12D07-335_D1,0,2,1,0,0,3
GCGGTAACCCAAATGA-1_V12D07-335_D1,0,0,0,0,0,0
CTACGTGTTGCCACCA-1_V12D07-335_D1,0,0,0,0,0,0
CTAGATAAACTCCTCG-1_V12D07-335_D1,0,0,0,0,0,0
TCCATTAGTTGGATAG-1_V12D07-335_D1,1,0,1,0,0,2
CTGGCTCCTGCGGGAT-1_V12D07-335_D1,0,2,2,0,0,4
CAGTCTCTCGGCTAAT-1_V12D07-335_D1,0,1,1,0,0,2
GTATGACGTGGGAAAC-1_V12D07-335_D1,0,1,0,1,0,2
AGTCACTCCGCCTCAT-1_V12D07-335_D1,2,3,4,0,0,9
GCAGCGGTGGGCATTA-1_V12D07-335_D1,1,1,2,0,0,4
TATGGAGTTTCTCGTT-1_V12D07-335_D1,18,2,0,0,0,20
ACTCAACGAATGTATT-1_V12D07-335_D1,16,2,0,0,0,18
AACACGCGGCCGCGAA-1_V12D07-335_D1,0,2,0,0,0,2
CGATATTAGCCGCAGG-1_V12D07-335_D1,0,0,0,0,0,0
AGCGTCTGAACCCGCA-1_V12D07-335_D1,0,2,0,0,0,2
GATGTCCGGATCACAT-1_V12D07-335_D1,0,0,1,0,0,1
GGTCACGTTAGATTCA-1_V12D07-335_D1,0,1,0,0,0,1
TTAAGGATACGGAGGT-1_V12D07-335_D1,0,1,2,0,0,3
GTGCGGGACCATCGGC-1_V12D07-335_D1,0,0,0,0,0,0
CCATCTTGTTCACAAT-1_V12D07-335_D1,0,0,0,0,0,0
TCCGAGAAGGCTAAGC-1_V12D07-335_D1,0,2,1,0,0,3
TGGCGGTGTGCGATTG-1_V12D07-335_D1,0,2,2,0,0,4
ATCCTGCTGCAGATAG-1_V12D07-335_D1,0,0,3,0,0,3
TTATGCGTCCCGGTCC-1_V12D07-335_D1,0,3,1,0,0,4
CATAATGAGCGGGCGA-1_V12D07-335_D1,0,1,1,0,0,2
AGACATAGATCCTTCC-1_V12D07-335_D1,0,2,0,0,0,2
GGTGAAACCGGGAATG-1_V12D07-335_D1,0,4,3,0,0,7
AACTGGTGTGGGCCTT-1_V12D07-335_D1,0,0,0,0,0,0
GTAGCGCTGTTGTAGT-1_V12D07-335_D1,0,2,4,0,0,6
TTGTTTGTGTAAATTC-1_V12D07-335_D1,0,1,2,0,0,3
GGATCAAAGGACGAGG-1_V12D07-335_D1,0,2,3,0,0,5
CGTAGCGCCGACGTTG-1_V12D07-335_D1,0,0,1,0,0,1
CAAGTGAACTTTGGTT-1_V12D07-335_D1,0,2,2,0,0,4
GTAGACAACCGATGAA-1_V12D07-335_D1,0,3,2,0,0,5
CAATGGTCGGCCTGGG-1_V12D07-335_D1,0,2,0,1,0,3
ACAGATTAGGTTAGTG-1_V12D07-335_D1,3,6,0,0,0,9
GTTATCACCTTCTGAA-1_V12D07-335_D1,0,2,2,1,0,5
TGGTATCGGTCTGTAT-1_V12D07-335_D1,0,3,0,0,0,3
GGAATAACCTCAAGAA-1_V12D07-335_D1,0,3,4,0,0,7
ATTATCTCGACAGATC-1_V12D07-335_D1,0,2,6,1,0,9
CCGAGGGATGTTAGGC-1_V12D07-335_D1,0,8,2,0,0,10
TGAGATCAAATACTCA-1_V12D07-335_D1,0,4,2,0,0,6
AAACGAAGAACATACC-1_V12D07-335_D1,0,2,4,1,0,7
CTGGTCCTAACTTGGC-1_V12D07-335_D1,1,3,2,0,0,6
TGCACGAGTCGGCAGC-1_V12D07-335_D1,0,0,2,0,0,2
ATAGTCTTTGACGTGC-1_V12D07-335_D1,0,2,1,0,0,3
TGGAGCTAAAGTTCCC-1_V12D07-335_D1,0,1,1,0,0,2
GGGTGGTCCAGCCTGT-1_V12D07-335_D1,1,0,2,0,0,3
CATGCATGGAGACCCT-1_V12D07-335_D1,0,2,2,0,0,4
ACACGGCACTATGCAT-1_V12D07-335_D1,0,3,3,0,0,6
CCCTGGTATGGGCGGC-1_V12D07-335_D1,0,1,1,0,0,2
GGAGGATTGAAAGGAG-1_V12D07-335_D1,0,3,3,0,0,6
CCGCTGGTGCCATTCA-1_V12D07-335_D1,1,2,1,0,0,4
GTTAGAGTGTGCCGCT-1_V12D07-335_D1,0,2,1,0,0,3
TCGGAATGACCATCAA-1_V12D07-335_D1,0,1,3,0,0,4
TTCAATTAGCCATAAT-1_V12D07-335_D1,0,1,4,0,0,5
GATGTGTTGTCACAAG-1_V12D07-335_D1,0,2,2,0,0,4
TCTTTCTCTTAAGGAG-1_V12D07-335_D1,0,2,1,0,0,3
ACCCTTTAGTTCTCCA-1_V12D07-335_D1,0,3,0,0,0,3
ACCACAACTCAGAACA-1_V12D07-335_D1,0,3,4,0,0,7
TATGATAAATCTAACG-1_V12D07-335_D1,0,1,2,0,0,3
GATCCTCTTGCGCTTA-1_V12D07-335_D1,0,0,2,0,0,2
TTCTACCTTTATGTTG-1_V12D07-335_D1,0,2,0,0,0,2
GAAATACCTGCTGGCT-1_V12D07-335_D1,0,0,3,1,0,4
ATTCTGAGTATGAACT-1_V12D07-335_D1,0,0,2,0,1,3
GGATTAAGCTAAGGTC-1_V12D07-335_D1,0,1,1,0,0,2
AGTACGTGGCCTGTCT-1_V12D07-335_D1,0,9,1,2,0,12
TCAGGGTGCACGAAAC-1_V12D07-335_D1,0,0,0,0,0,0
AAATTTACCGAAATCC-1_V12D07-335_D1,0,0,0,0,0,0
TTGAGGCATTTAACTC-1_V12D07-335_D1,0,4,0,0,2,6
AACCAGTATCACTCTT-1_V12D07-335_D1,0,3,0,0,0,3
CACCGGAGATATCTCC-1_V12D07-335_D1,0,0,0,0,0,0
GACTGGGCGCCGCAAC-1_V12D07-335_D1,0,0,0,0,0,0
CACGTCTATGATGTGG-1_V12D07-335_D1,0,0,1,0,0,1
TTAAGACGAACGAACC-1_V12D07-335_D1,0,0,0,0,0,0
TGACCAGCTTCAAAGT-1_V12D07-335_D1,0,0,0,0,0,0
AGAGTTAGAGACCGAT-1_V12D07-335_D1,0,0,0,0,0,0
TTCGGACTGATGCCTT-1_V12D07-335_D1,0,2,1,0,0,3
CTCGAATGGAACGTAT-1_V12D07-335_D1,0,1,0,0,0,1
GGACGGCTTGCGCAAC-1_V12D07-335_D1,0,1,1,0,0,2
CTAAGTACAGGGCTAC-1_V12D07-335_D1,0,0,0,0,0,0
ACAAATTCAGATCTGA-1_V12D07-335_D1,0,2,0,0,0,2
CATGGAAATGGGACCA-1_V12D07-335_D1,0,1,1,0,0,2
GGTGGACCACGTGTTA-1_V12D07-335_D1,0,1,0,0,0,1
CACGACGTAATAGTAA-1_V12D07-335_D1,0,3,0,0,0,3
CGGGTTCGGCACGTAT-1_V12D07-335_D1,0,1,0,0,0,1
CTGGGCTATCCTTTGG-1_V12D07-335_D1,2,3,2,1,0,8
GTATTAGGGTTCGCGT-1_V12D07-335_D1,0,1,0,0,0,1
TCATTCGTATAATTTG-1_V12D07-335_D1,0,0,0,0,0,0
AATAGCAAGCCTCCTG-1_V12D07-335_D1,0,1,2,0,0,3
CATCTACCCGAGAACG-1_V12D07-335_D1,0,1,1,0,0,2
GCTTCAGTGGGATTAC-1_V12D07-335_D1,0,3,0,0,0,3
TCTGTGATGGAGGTTG-1_V12D07-335_D1,1,0,0,0,0,1
ATCCACTTTCAGACTA-1_V12D07-335_D1,0,0,0,0,0,0
ATGGTTACGAAACATG-1_V12D07-335_D1,0,0,0,0,0,0
GGCCCAATCTAGAGGG-1_V12D07-335_D1,0,2,1,1,0,4
GATGGTGAAATAACCC-1_V12D07-335_D1,0,3,0,1,0,4
AGAGGGACAATTGTCC-1_V12D07-335_D1,0,3,0,0,0,3
CGCGTACATTCTGGAA-1_V12D07-335_D1,0,2,1,1,0,4
CAAGAAACCCTAAACT-1_V12D07-335_D1,0,2,2,0,0,4
TTGGTGCGGTGTTGAA-1_V12D07-335_D1,0,0,0,0,0,0
GGTTCCCTAGTGTCTC-1_V12D07-335_D1,0,0,2,1,0,3
CGATAACCAATTTGAG-1_V12D07-335_D1,0,3,3,0,0,6
GCCCACTGGTCCACAA-1_V12D07-335_D1,0,0,2,2,0,4
GAGGGCCGGCAGAGTC-1_V12D07-335_D1,0,1,5,0,0,6
CGACACGGATGCCCAC-1_V12D07-335_D1,0,1,4,0,0,5
CTGTCTGTGGCTGGCT-1_V12D07-335_D1,0,2,2,0,0,4
ATATTATCCCGTATTT-1_V12D07-335_D1,0,0,0,0,0,0
GCGCTGGCGGAAAGTC-1_V12D07-335_D1,0,3,1,0,0,4
ATCTAACGTCCCTATG-1_V12D07-335_D1,0,1,0,0,0,1
GTCAGACAGCGTTGGA-1_V12D07-335_D1,0,2,0,0,0,2
GCCAGGCTTAGTGGTA-1_V12D07-335_D1,0,1,0,0,0,1
ATTCAAAGTACCTGTT-1_V12D07-335_D1,0,4,1,0,0,5
TGGACGTAGGCGAATC-1_V12D07-335_D1,0,4,0,1,0,5
ACACATTGACGCAACA-1_V12D07-335_D1,0,1,0,0,0,1
GATATCAGTATGTATC-1_V12D07-335_D1,0,2,1,0,0,3
TGGGCCTTGCCTGCAT-1_V12D07-335_D1,0,1,0,0,0,1
CAAAGTCAGGTTAGCT-1_V12D07-335_D1,1,1,1,0,0,3
GGATCCCTACCAGCTA-1_V12D07-335_D1,0,0,1,0,0,1
ATCGTCCAATCGAGTC-1_V12D07-335_D1,0,1,4,0,0,5
ACATGGCTCAATTTAG-1_V12D07-335_D1,0,2,0,0,0,2
AGGCCCAGTGACTGGT-1_V12D07-335_D1,1,2,1,0,0,4
GCTTCCAGCTTAGATT-1_V12D07-335_D1,1,1,0,0,0,2
TGCTTGAAACCATGCA-1_V12D07-335_D1,0,3,0,0,0,3
CAATATTGGACTAGTG-1_V12D07-335_D1,0,1,0,0,0,1
CGTGCTGGCCTAGTCG-1_V12D07-335_D1,0,1,0,0,0,1
CCTGCGATAGAACTGT-1_V12D07-335_D1,0,0,0,0,0,0
GGGTAATGCTGTGTTT-1_V12D07-335_D1,0,2,0,0,0,2
AACGCGAACGGCAACA-1_V12D07-335_D1,0,1,2,0,0,3
TGTCGGCATGGTGGAA-1_V12D07-335_D1,0,0,0,0,0,0
AGCGTACGAGAGCTAG-1_V12D07-335_D1,0,2,2,0,0,4
ATACTCTCGCCACTCT-1_V12D07-335_D1,0,1,0,0,0,1
AATCCATGCAAGGGTG-1_V12D07-335_D1,0,3,0,0,0,3
TTAAACAGAGTCCCGC-1_V12D07-335_D1,1,2,2,0,0,5
CCACAGCTGAAATCAT-1_V12D07-335_D1,0,1,0,0,0,1
CGGTTCCGGCTTCTTG-1_V12D07-335_D1,0,4,2,0,0,6
GACGTGAGACTCCATG-1_V12D07-335_D1,0,1,0,0,0,1
TCGTTGGCTCGTCAAT-1_V12D07-335_D1,0,0,0,0,0,0
GGTGAACGGGCTAGCC-1_V12D07-335_D1,2,2,0,0,0,4
GCACTGTGCAAATGTA-1_V12D07-335_D1,0,1,1,0,0,2
ACGAGAACCCATCACG-1_V12D07-335_D1,14,4,0,0,0,18
CCAGCTACGCCTCATA-1_V12D07-335_D1,9,1,1,0,0,11
TCCCGGTCAGGAATTT-1_V12D07-335_D1,2,3,0,0,0,5
TCGCATTCAATGACTT-1_V12D07-335_D1,3,2,0,0,0,5
CTGGTTCAACGCATCA-1_V12D07-335_D1,0,1,0,0,0,1
GGTGATTTCATCTTGT-1_V12D07-335_D1,0,2,1,0,0,3
CACCCTTTCCTCGCTC-1_V12D07-335_D1,0,0,0,1,0,1
CAACTTGTAGTGGGCA-1_V12D07-335_D1,0,0,1,0,0,1
AATATCAAGGTCGGAT-1_V12D07-335_D1,0,1,0,0,0,1
ACTCAGACCTGCTTCT-1_V12D07-335_D1,0,1,0,0,0,1
TTGGAGTCTCCCTTCT-1_V12D07-335_D1,0,2,2,0,0,4
GGATACTCATGAATTG-1_V12D07-335_D1,0,2,0,0,0,2
TGGGCACAAACAGAAC-1_V12D07-335_D1,0,3,0,0,0,3
GAGCCACGGTAGTAGG-1_V12D07-335_D1,0,3,0,0,0,3
TCGATAGGCTAGTCGC-1_V12D07-335_D1,0,1,0,0,0,1
TAACCGCCCGCAGTGC-1_V12D07-335_D1,0,0,0,0,0,0
GCCTATTTGCTACACA-1_V12D07-335_D1,0,0,2,0,0,2
TTGACGATTCAGCACG-1_V12D07-335_D1,0,1,0,0,0,1
TTAAACCGGTAGCGAC-1_V12D07-335_D1,0,2,3,0,0,5
ACCGAAAGGGCCCTGC-1_V12D07-335_D1,0,2,2,1,0,5
ACGTTCCGCGCTCCGT-1_V12D07-335_D1,0,3,2,0,0,5
ATACCAGGCTAATAGA-1_V12D07-335_D1,0,3,3,0,0,6
CGGCTTTGTATGATAA-1_V12D07-335_D1,0,4,3,0,0,7
CTTGACCCGAAAGATA-1_V12D07-335_D1,0,3,4,0,0,7
CGCAGAAACATTTGCG-1_V12D07-335_D1,0,4,6,0,0,10
GACCCGTCGCCGGCTA-1_V12D07-335_D1,0,1,3,0,0,4
AATCGGGACACTACGA-1_V12D07-335_D1,0,5,1,2,0,8
GTCACAAAGTTTCCAA-1_V12D07-335_D1,0,2,2,0,0,4
TATATTCGCGTCGATA-1_V12D07-335_D1,0,3,3,0,0,6
CCTCCCGACAATCCCT-1_V12D07-335_D1,0,3,1,0,0,4
CGACATGCGATCTTCT-1_V12D07-335_D1,0,4,2,1,0,7
AACACGACTGTACTGA-1_V12D07-335_D1,0,2,4,0,0,6
CCCAACCACACTAACA-1_V12D07-335_D1,0,1,0,0,0,1
CACCGCCGACCAGCGA-1_V12D07-335_D1,0,1,1,0,0,2
TGGTATCGCATCCCAA-1_V12D07-335_D1,1,0,2,0,0,3
CAGAGTGATTTAACGT-1_V12D07-335_D1,0,2,0,1,0,3
AACCCTGGTGGAACCA-1_V12D07-335_D1,0,0,0,0,0,0
GTCAGTTGTGCTCGTT-1_V12D07-335_D1,0,1,0,0,0,1
ATTGACGTAACTCGGT-1_V12D07-335_D1,0,2,2,0,0,4
GATGTCGGTCAACTGC-1_V12D07-335_D1,0,0,1,0,0,1
AGGGCAGCGGCGTGGT-1_V12D07-335_D1,0,1,0,0,0,1
ACATCGTTAACCTAGT-1_V12D07-335_D1,0,1,4,0,0,5
TCCATTGTGACCTCGT-1_V12D07-335_D1,1,0,2,0,0,3
TGTTTAATACTTCATC-1_V12D07-335_D1,0,2,0,0,0,2
TTGCTGGCCGGGCTTC-1_V12D07-335_D1,0,1,0,0,0,1
CATATTATTTGCCCTA-1_V12D07-335_D1,1,2,1,0,0,4
CTGCCTAGCCACCAAG-1_V12D07-335_D1,0,0,1,0,0,1
ACGAGATATTTGCTTA-1_V12D07-335_D1,0,1,0,0,0,1
GACTACAATTGCTCGT-1_V12D07-335_D1,0,0,1,0,0,1
AACGTGATGAAGGACA-1_V12D07-335_D1,0,2,2,0,0,4
ACTCTCTTATACACGA-1_V12D07-335_D1,0,3,0,0,1,4
CGCATCATGGCTTCAG-1_V12D07-335_D1,0,2,0,0,0,2
CGGCTCTTCGTCGAAC-1_V12D07-335_D1,0,0,0,0,0,0
ATTCTTCGTACTTATG-1_V12D07-335_D1,0,2,1,0,0,3
AGTGAGGGTTTCTGAC-1_V12D07-335_D1,0,0,0,0,0,0
GCCAGGCGTTCGCATG-1_V12D07-335_D1,0,0,0,0,0,0
GACTAACACAGCACCT-1_V12D07-335_D1,0,3,0,0,0,3
CAATGGAATCTACATA-1_V12D07-335_D1,0,1,1,0,0,2
GTGGTCAGCGAAGTAT-1_V12D07-335_D1,0,0,0,0,0,0
ATGGCTGGAAATGGCC-1_V12D07-335_D1,0,0,0,0,0,0
ATCAGGTCGCCATTGC-1_V12D07-335_D1,0,0,0,0,0,0
TATCACCATGTAAAGT-1_V12D07-335_D1,0,0,0,0,0,0
AGCGCTTATGGGCAAG-1_V12D07-335_D1,0,1,0,0,0,1
AAGCGGCGTCATGGGT-1_V12D07-335_D1,0,0,0,0,0,0
ACTAATACGTCAGGCG-1_V12D07-335_D1,1,1,1,0,0,3
GGCTGAGCATCGTAAG-1_V12D07-335_D1,0,1,0,0,0,1
CGGTTGGGTTCAAGTT-1_V12D07-335_D1,0,0,1,0,0,1
GACTGATTGGTCACAA-1_V12D07-335_D1,0,0,0,0,0,0
AGACGGGCCGATTTAA-1_V12D07-335_D1,0,0,0,0,0,0
ACCAGTGCCCGGTCAA-1_V12D07-335_D1,0,2,0,0,0,2
GTCCTTTAATGACTTC-1_V12D07-335_D1,1,3,0,0,0,4
CCTACAAGTCCGGAAT-1_V12D07-335_D1,0,3,0,0,0,3
GCCTGCTACACTGAGA-1_V12D07-335_D1,0,1,0,0,0,1
GACTCGGTCGGCGGAT-1_V12D07-335_D1,0,2,0,0,0,2
CTAGACATATATGTAG-1_V12D07-335_D1,0,2,0,0,0,2
TCGCCCAACTGACTCC-1_V12D07-335_D1,0,0,0,0,0,0
AAACTAACGTGGCGAC-1_V12D07-335_D1,0,0,0,0,0,0
AACTGAGGTCAGCGTC-1_V12D07-335_D1,0,0,1,0,0,1
ACAATGATTCTTCTAC-1_V12D07-335_D1,0,1,0,0,0,1
ATAAGTACCCGATTGT-1_V12D07-335_D1,1,3,0,1,0,5
ATTGGGAGTTCTGTAA-1_V12D07-335_D1,0,0,0,0,0,0
CGAACATAGTCAGAAA-1_V12D07-335_D1,0,0,0,0,0,0
TAGCTCAGATCCTAGT-1_V12D07-335_D1,0,2,0,0,0,2
GTGTCGTATTCACCTT-1_V12D07-335_D1,0,0,0,1,0,1
CTCACCGATCCAAACT-1_V12D07-335_D1,0,0,1,0,0,1
ATATGTGCACAAACCA-1_V12D07-335_D1,0,1,0,0,0,1
CAGTCCAACGCCTTCT-1_V12D07-335_D1,2,1,0,0,0,3
TCGTCCGGGTACACTC-1_V12D07-335_D1,0,3,1,1,0,5
GCAGAAACGTAATCCA-1_V12D07-335_D1,0,3,3,0,0,6
TTCGAGCCGGCGCTAC-1_V12D07-335_D1,0,1,3,0,0,4
GGAAGATAAGACTGTA-1_V12D07-335_D1,0,1,6,0,0,7
ATAAGCAAACACCGAG-1_V12D07-335_D1,0,0,0,0,0,0
GCATAAATTGAACGCC-1_V12D07-335_D1,0,1,3,1,0,5
CGCCGGTGTCGCAGTA-1_V12D07-335_D1,0,1,0,1,0,2
GACCTGGTCTGGGCGT-1_V12D07-335_D1,0,0,0,0,0,0
AGCCGCTTGATTAGCG-1_V12D07-335_D1,0,0,0,0,0,0
CCCGGCTAGGTGAGAA-1_V12D07-335_D1,2,1,1,0,0,4
CGAGCCGAGCACTCGA-1_V12D07-335_D1,1,1,0,0,0,2
TAGTGCTTGAATCCTT-1_V12D07-335_D1,0,0,0,0,0,0
CAACCGCACCTAGACA-1_V12D07-335_D1,0,2,0,0,0,2
ACCACTGTTCAAGAAG-1_V12D07-335_D1,0,1,0,0,0,1
AGATGCTATAACGAGC-1_V12D07-335_D1,0,5,0,2,0,7
AATTACTCGTACGCTC-1_V12D07-335_D1,1,2,1,0,0,4
CGTCAATCTTTAACAT-1_V12D07-335_D1,0,1,1,0,0,2
CCAAAGCAGTTGGTTG-1_V12D07-335_D1,2,0,0,0,0,2
CCATATTGGATCATGA-1_V12D07-335_D1,0,2,1,0,0,3
CGTACCGAAAGTCTAG-1_V12D07-335_D1,0,3,1,0,0,4
CTCGAGATCCAAAGCA-1_V12D07-335_D1,0,0,0,0,0,0
TGGATAGAGTAACAGA-1_V12D07-335_D1,0,2,0,0,0,2
TCACAGATCCTCAAAC-1_V12D07-335_D1,2,1,0,0,0,3
AGAGCTACGAAAGCAT-1_V12D07-335_D1,0,0,0,0,0,0
TGCGTGATTGGGTGTC-1_V12D07-335_D1,0,1,0,0,0,1
CACATGTTTGGACATG-1_V12D07-335_D1,0,0,0,0,0,0
TTCGCATCCGGAAGCA-1_V12D07-335_D1,0,4,0,0,0,4
CCCTAGTGTCAGGTGT-1_V12D07-335_D1,0,1,1,0,0,2
TTACCGCCTTAGGGAA-1_V12D07-335_D1,0,2,1,0,0,3
CCAGTCCATTATTCGA-1_V12D07-335_D1,0,0,1,1,0,2
CGTAAACGCTTGAGTG-1_V12D07-335_D1,0,0,1,0,0,1
ATTCCTTCCAGGCGGT-1_V12D07-335_D1,0,2,1,0,0,3
TTCCTTTCTGTGTTGC-1_V12D07-335_D1,1,1,0,0,0,2
AGTTGACATCGGCTGG-1_V12D07-335_D1,1,2,1,0,0,4
AACTCGATGGCGCAGT-1_V12D07-335_D1,0,2,0,2,0,4
GATAAGGCAGATGCAA-1_V12D07-335_D1,0,2,0,1,0,3
GGCTGGCTAGCTTAAA-1_V12D07-335_D1,1,1,0,0,0,2
CCTCATGCAGCTACGA-1_V12D07-335_D1,0,1,0,0,0,1
GACGCCTGTTGCAGGG-1_V12D07-335_D1,0,3,1,0,0,4
TAATTAGATGGATATG-1_V12D07-335_D1,0,1,1,0,0,2
GAGGGCATCGCGTATC-1_V12D07-335_D1,0,4,1,0,0,5
CTTGTGAGTCTTTGAC-1_V12D07-335_D1,0,2,0,0,0,2
TCAACACATTGGGTAA-1_V12D07-335_D1,0,1,0,0,0,1
ACTGTATACGCGAGCA-1_V12D07-335_D1,8,2,1,0,0,11
GTGAAACGTGCTCCAC-1_V12D07-335_D1,6,4,3,0,0,13
CGAGTGCTATAGTTCG-1_V12D07-335_D1,5,0,0,0,0,5
GTACTGCATGAAGCGT-1_V12D07-335_D1,9,2,1,0,0,12
GTAACTTGCGGCAGTC-1_V12D07-335_D1,0,2,2,0,0,4
GAATCGCCGGACACGG-1_V12D07-335_D1,0,3,0,0,0,3
GGGAGTAATGGCTGGC-1_V12D07-335_D1,0,1,0,0,0,1
CATGAACCGACATTTG-1_V12D07-335_D1,0,1,1,0,0,2
TCTGTCATACAAGAGC-1_V12D07-335_D1,0,1,2,0,0,3
GTCGTCAATTATAAGG-1_V12D07-335_D1,0,1,0,0,0,1
TAAAGAGCCCGAAACC-1_V12D07-335_D1,0,2,4,0,0,6
GTACTGAGGTCGTAAC-1_V12D07-335_D1,0,1,0,0,0,1
AAAGACCCAAGTCGCG-1_V12D07-335_D1,0,1,1,0,0,2
CGTCAGTGCGCACAAG-1_V12D07-335_D1,0,1,0,0,0,1
TGTATCCTTATTCCAT-1_V12D07-335_D1,0,0,0,0,0,0
ATTCTCGTCTCTTTAG-1_V12D07-335_D1,0,1,1,0,0,2
AAAGTCACTGATGTAA-1_V12D07-335_D1,0,1,1,0,0,2
TGTCTACAGTTTCTGT-1_V12D07-335_D1,0,2,1,0,0,3
TTAACGTCGCAAGACC-1_V12D07-335_D1,0,1,3,0,0,4
CTATGTCTATTGAAAC-1_V12D07-335_D1,0,0,1,0,0,1
TCGGGTGAAACTGCTA-1_V12D07-335_D1,0,1,3,0,0,4
TGTCCCGACATAGCAC-1_V12D07-335_D1,0,1,5,0,0,6
ACAGCATAGAGCCAGT-1_V12D07-335_D1,0,4,4,0,0,8
ATATTCCCACAGGTCA-1_V12D07-335_D1,0,3,3,0,0,6
TTGGATCGACTTCTGG-1_V12D07-335_D1,0,4,3,0,0,7
CACCATCGGAGGAGAC-1_V12D07-335_D1,1,1,1,0,0,3
TCGTTCGTTATTATGT-1_V12D07-335_D1,0,2,3,0,0,5
CTTAACTTCGAAGTAC-1_V12D07-335_D1,0,3,3,0,0,6
GCACAAGTGTCGGAAG-1_V12D07-335_D1,0,0,4,1,0,5
TACCAGCTAGGTTTAA-1_V12D07-335_D1,0,2,3,0,0,5
ACGTACAGATTTCTCT-1_V12D07-335_D1,0,1,1,0,0,2
AATTTGGTTCCAAAGA-1_V12D07-335_D1,0,2,1,0,0,3
GTAAGGATTTGTCGGA-1_V12D07-335_D1,0,1,0,0,0,1
CATCATCTACCCGGAC-1_V12D07-335_D1,0,0,2,0,0,2
ACGATGGATCCGATGC-1_V12D07-335_D1,0,2,1,0,0,3
CACTCAGCTCTTGAGG-1_V12D07-335_D1,0,0,0,0,0,0
TAGATCCGAAGTCGCA-1_V12D07-335_D1,0,1,1,1,0,3
TGAAACTTATGCAAGC-1_V12D07-335_D1,0,0,0,0,0,0
GCGATTCTGGAAGCAG-1_V12D07-335_D1,0,2,3,0,0,5
CAAACTATTGAGCTTC-1_V12D07-335_D1,0,0,0,0,0,0
TAGAATTAAGGGCAAC-1_V12D07-335_D1,0,0,1,0,0,1
CGAAACATAGATGGCA-1_V12D07-335_D1,0,0,0,0,0,0
GATGGTGCCCTAGGCA-1_V12D07-335_D1,0,2,2,0,0,4
CCCGCAGGGCCCAAAG-1_V12D07-335_D1,0,1,1,0,0,2
ACAGCGCACCCGCAGC-1_V12D07-335_D1,0,0,0,0,0,0
GGTAAATGTGCGTTAC-1_V12D07-335_D1,0,0,0,0,0,0
GTCCTTCTAGTGGGTT-1_V12D07-335_D1,0,4,1,0,0,5
GGAAGCTCGCTTACAG-1_V12D07-335_D1,0,0,0,1,0,1
CACCGATACACCGAGC-1_V12D07-335_D1,0,0,0,0,0,0
CAGCCGGGCCCTCTAT-1_V12D07-335_D1,0,1,0,0,0,1
CGGAGCTTATAACACC-1_V12D07-335_D1,0,0,0,0,0,0
ATTACAACTACCGGCC-1_V12D07-335_D1,0,0,0,0,0,0
TCCTCTGGCCCATTAG-1_V12D07-335_D1,0,0,0,0,0,0
CGGCACCGTTAGCGCC-1_V12D07-335_D1,0,0,1,0,0,1
TCGGTCCCTGACTCCA-1_V12D07-335_D1,0,2,2,0,1,5
TGGTTGGAGGATCCTG-1_V12D07-335_D1,0,1,0,0,0,1
CTGCGGTAGTCACGTG-1_V12D07-335_D1,0,0,0,0,0,0
GTGCCTCAGTGTACGG-1_V12D07-335_D1,0,8,0,0,3,11
ATCGTTCACTTTCGCC-1_V12D07-335_D1,1,4,0,0,0,5
ACTTACCGGGCGCGCA-1_V12D07-335_D1,0,1,0,0,0,1
CTAGACTGCATTTCGT-1_V12D07-335_D1,0,0,0,0,0,0
TTGCCGGTGATCCCTC-1_V12D07-335_D1,0,3,0,0,0,3
CTGTCACGCCAGGCGC-1_V12D07-335_D1,0,3,0,0,0,3
CGGTATAGGTATTAGC-1_V12D07-335_D1,0,0,0,0,0,0
CCAACGCTTGCCAGGG-1_V12D07-335_D1,0,1,0,0,0,1
CGTTGAGTAATTGCGT-1_V12D07-335_D1,0,0,0,0,0,0
TGTATTTACCTAATGC-1_V12D07-335_D1,0,2,0,0,0,2
TAAATGCCGTCTCATG-1_V12D07-335_D1,0,2,1,0,0,3
CGGTTTATGAAGGAAC-1_V12D07-335_D1,0,3,0,0,0,3
GCAAGATGTGTTCGCG-1_V12D07-335_D1,0,2,0,0,0,2
AAAGGTAAGCTGTACC-1_V12D07-335_D1,1,4,1,0,0,6
GTACGTCACGTATTAA-1_V12D07-335_D1,0,3,0,1,0,4
AGTACCTTCGAGTGCT-1_V12D07-335_D1,0,1,0,0,0,1
ATTGTGACTTCGCTGC-1_V12D07-335_D1,0,0,1,0,0,1
TGTATCAGACTGAAGC-1_V12D07-335_D1,0,1,0,0,0,1
GAGACCCTGCAACGCC-1_V12D07-335_D1,0,2,1,0,0,3
TGGGTGGGATGTCATT-1_V12D07-335_D1,0,3,1,0,0,4
GGCTAATGATTGAAAT-1_V12D07-335_D1,0,1,0,0,0,1
ATAACGTTACCTCCAC-1_V12D07-335_D1,0,0,0,0,0,0
TGCGAGATGGCGGCCA-1_V12D07-335_D1,0,0,0,0,0,0
CACACTTGTATTGCGA-1_V12D07-335_D1,0,2,0,0,0,2
GCTGGTGACTCGTAGT-1_V12D07-335_D1,0,2,0,1,0,3
CGACACCGCTTAAGGA-1_V12D07-335_D1,0,0,2,0,0,2
GTAACAACTGACCTTG-1_V12D07-335_D1,0,1,0,0,0,1
CAACTGAGGGTATGAC-1_V12D07-335_D1,0,1,1,1,0,3
CTAATTATGAAGCGTA-1_V12D07-335_D1,0,2,5,0,0,7
CCGATCTTAAGAGGCT-1_V12D07-335_D1,0,2,3,0,0,5
CGACTCGGTACACGGT-1_V12D07-335_D1,0,1,4,0,0,5
TGCTGCGTCAGAGTTA-1_V12D07-335_D1,0,1,3,0,0,4
AGAGTTGCAGGCCTCC-1_V12D07-335_D1,0,0,6,1,0,7
ACTGGCGAACCTGCGT-1_V12D07-335_D1,0,1,5,0,0,6
ACTAAGGACGCACACC-1_V12D07-335_D1,0,0,2,1,0,3
CGTCCAGATGGCTCCA-1_V12D07-335_D1,0,6,0,0,0,6
ACTATCGCCGGCTAAA-1_V12D07-335_D1,0,0,1,0,0,1
GATAGCGTACCACGCG-1_V12D07-335_D1,1,2,0,0,0,3
AGGACTTATAGGAGAA-1_V12D07-335_D1,0,3,0,0,0,3
TAGTCGGGATTCTTCG-1_V12D07-335_D1,0,1,0,0,0,1
ACCATTAAGGGTGTCA-1_V12D07-335_D1,0,1,0,0,0,1
TTAATGTGTTTGCAGG-1_V12D07-335_D1,1,1,2,0,0,4
TCCGCAGCCACCTAGC-1_V12D07-335_D1,0,0,1,0,0,1
GAGGAGATCCTCATGC-1_V12D07-335_D1,0,0,0,0,0,0
GGTCCTTCATACGACT-1_V12D07-335_D1,0,1,0,0,0,1
CCCTGTTGGCAAAGAC-1_V12D07-335_D1,0,1,0,0,0,1
GTGCCTAGCTATGCTT-1_V12D07-335_D1,0,1,0,0,0,1
GTCATCTCCTACAGCT-1_V12D07-335_D1,0,2,0,0,0,2
GCGAGAAACGGGAGTT-1_V12D07-335_D1,0,2,2,0,0,4
CGTCGCGGCGGGATTT-1_V12D07-335_D1,0,0,0,0,0,0
CATTGTGTGCTAGATC-1_V12D07-335_D1,0,2,0,0,0,2
CGCGGCAGTATTACGG-1_V12D07-335_D1,0,2,0,0,0,2
GAAATGGGATGTAAAC-1_V12D07-335_D1,1,2,1,0,0,4
CATTCCCTAAGTACAA-1_V12D07-335_D1,0,2,0,0,0,2
AGTTCTGCGTTGTATC-1_V12D07-335_D1,0,1,0,0,0,1
ACCCTATAGGACTGAG-1_V12D07-335_D1,0,2,1,0,0,3
TTAGATAGGTCGATAC-1_V12D07-335_D1,0,1,1,0,0,2
ATTGATAGCAACGAGA-1_V12D07-335_D1,0,1,0,0,0,1
TCTCGGCTCCAGGACT-1_V12D07-335_D1,0,3,0,0,0,3
CTTGAGGTTATCCCGA-1_V12D07-335_D1,0,2,0,0,0,2
AAGAAGGATCAGTTAG-1_V12D07-335_D1,0,1,1,0,0,2
GTACGACGGCGCTGCG-1_V12D07-335_D1,0,2,1,0,0,3
CTTATGTTGACTACCA-1_V12D07-335_D1,0,0,0,0,0,0
CGGCACTCAAGAAAGT-1_V12D07-335_D1,0,1,2,0,0,3
GTCAAAGTTTACATAG-1_V12D07-335_D1,0,1,0,0,0,1
CTCCTAAGTTATGTCT-1_V12D07-335_D1,0,3,0,0,0,3
ACTGTGCTAGTAGATC-1_V12D07-335_D1,0,2,1,0,0,3
GTTTGGCCGCTCAGCG-1_V12D07-335_D1,0,1,0,0,0,1
TTATCCAATCGAACTC-1_V12D07-335_D1,0,1,0,0,0,1
CCGTACCCAAGCGCCA-1_V12D07-335_D1,0,1,0,0,0,1
CATACAAAGCCGAACC-1_V12D07-335_D1,0,1,0,0,0,1
GGTCGGTAATTAGACA-1_V12D07-335_D1,1,0,1,0,0,2
AGCGGGAAGGGTCCAT-1_V12D07-335_D1,0,0,0,0,0,0
GCCCACCAAGGCTGTC-1_V12D07-335_D1,2,3,0,0,0,5
GTAGACGTCGTTACAT-1_V12D07-335_D1,0,2,0,0,0,2
GAGCATCATCCCTGGG-1_V12D07-335_D1,10,2,0,0,0,12
AGGTAACCTCCTATTC-1_V12D07-335_D1,4,3,0,0,0,7
GGTTTGAGTGCTGGAA-1_V12D07-335_D1,0,0,0,0,0,0
GCACTAGTCGCGCTAT-1_V12D07-335_D1,0,1,0,0,0,1
GGTAACTATGTATCTG-1_V12D07-335_D1,0,1,0,0,0,1
GCGGTCCCTAGACGCA-1_V12D07-335_D1,0,1,0,0,0,1
CGAGCGTTGATCAGCC-1_V12D07-335_D1,0,1,1,0,0,2
AATCCAAGGGCCTGAG-1_V12D07-335_D1,0,0,1,0,0,1
CCGTGCCCATGACGGC-1_V12D07-335_D1,0,1,0,0,0,1
GAAATTCACATCGCTG-1_V12D07-335_D1,0,1,0,0,0,1
CTCTGCGAAGCAAGCA-1_V12D07-335_D1,0,0,0,0,0,0
AGTAGGTAACATACAT-1_V12D07-335_D1,0,0,1,0,0,1
ATTGGGAATATCTTGG-1_V12D07-335_D1,0,0,1,0,0,1
TAGAGCTACGAAGAAC-1_V12D07-335_D1,0,0,2,0,0,2
TGCGGCATAGTTCAAC-1_V12D07-335_D1,0,1,2,0,0,3
CCGCCGGTCAACACAC-1_V12D07-335_D1,0,0,0,0,0,0
TCGTATAGTGCAATTA-1_V12D07-335_D1,0,1,1,0,0,2
TAGTTTATTCTTGCTT-1_V12D07-335_D1,0,1,1,0,0,2
GATATCTCATGCAATA-1_V12D07-335_D1,0,1,4,0,0,5
CGTTTAAGCGGAGCAC-1_V12D07-335_D1,1,3,1,0,0,5
CATGCTGGCTCCAATT-1_V12D07-335_D1,0,4,2,0,0,6
GAAACAGCCATGCAGT-1_V12D07-335_D1,0,5,4,0,0,9
AGTTTCGCAGGTCGGA-1_V12D07-335_D1,0,2,4,0,0,6
CTCATGGCTCACAATC-1_V12D07-335_D1,0,3,6,1,0,10
AACCGTTGTGTTTGCT-1_V12D07-335_D1,0,2,2,1,0,5
ACCCTTCATCTGCGAA-1_V12D07-335_D1,0,2,2,0,0,4
TGCGGTGAAATTTCAT-1_V12D07-335_D1,0,6,4,0,0,10
CAAATTGTCAGCAAGC-1_V12D07-335_D1,0,2,1,0,0,3
GAGGTACATCCATCTT-1_V12D07-335_D1,0,6,0,0,0,6
AAATGGCATGTCTTGT-1_V12D07-335_D1,0,1,0,0,0,1
TCATCCCAGAGGGTGG-1_V12D07-335_D1,1,3,1,0,0,5
CGTAGCGAATTGTCAG-1_V12D07-335_D1,0,1,0,0,0,1
CCTAGTTAGTCGCATG-1_V12D07-335_D1,1,0,1,0,0,2
GAAACTCTAATGAAGG-1_V12D07-335_D1,0,1,2,0,0,3
TTGTATCACACAGAAT-1_V12D07-335_D1,0,0,0,0,0,0
TTCAAGCCGAGCTGAG-1_V12D07-335_D1,0,1,0,0,0,1
AGGTACGATATTGCCA-1_V12D07-335_D1,0,2,0,1,0,3
TTAAGCCGACAACTTC-1_V12D07-335_D1,0,2,1,0,0,3
GTCTTAGTACAGCCGG-1_V12D07-335_D1,1,0,3,0,1,5
TGGGTAAGGTTCCCGC-1_V12D07-335_D1,1,0,1,1,0,3
CTACGCCATTTCCGAT-1_V12D07-335_D1,0,1,0,0,0,1
GACCGTCAGGTCGTGA-1_V12D07-335_D1,0,0,1,0,0,1
TAGTTAAGATAGGATA-1_V12D07-335_D1,0,1,0,0,0,1
GAATATTCGGAGTCCC-1_V12D07-335_D1,0,0,0,0,0,0
CAAACTACGATAGAGA-1_V12D07-335_D1,0,0,0,0,0,0
CAGGAAGACTTTATAT-1_V12D07-335_D1,0,3,3,0,0,6
TTCGTAATCCCAGCGG-1_V12D07-335_D1,0,0,0,0,0,0
GTGAGGAGCGGTTGAG-1_V12D07-335_D1,0,1,1,0,0,2
CAATCCCTATACCAGC-1_V12D07-335_D1,0,0,0,0,0,0
AGGGAAACGAGGTACT-1_V12D07-335_D1,0,0,0,0,0,0
TCCTGCCAACTGGAGA-1_V12D07-335_D1,0,0,0,0,0,0
AATTTGGGACATAGTA-1_V12D07-335_D1,0,1,0,0,0,1
AACTCCTAATCCCATG-1_V12D07-335_D1,0,0,0,0,0,0
GCTCATTACTGCATGT-1_V12D07-335_D1,0,3,0,0,0,3
TCTCGAACGAGGTCAC-1_V12D07-335_D1,0,1,0,0,0,1
TCACTACGACCAATGC-1_V12D07-335_D1,0,1,0,0,0,1
GTGATGCACAACATCT-1_V12D07-335_D1,0,1,0,0,0,1
CCGACGTAAACACAAC-1_V12D07-335_D1,0,1,0,0,0,1
TGGGATGCACTCATTC-1_V12D07-335_D1,0,0,0,0,0,0
TTCCATCATGCGGTGA-1_V12D07-335_D1,0,0,0,0,0,0
TGCACAGTGAAGTTAT-1_V12D07-335_D1,0,1,0,0,0,1
CTATTGTGTTTGGTCA-1_V12D07-335_D1,0,1,0,0,0,1
TGCGAGCCCTTCCGCG-1_V12D07-335_D1,0,1,0,0,0,1
TTGAAAGGTGTAAAGG-1_V12D07-335_D1,0,1,0,0,0,1
GGTGCAGAGCCTATCG-1_V12D07-335_D1,1,2,0,0,0,3
ACTATATGCTGTGTTC-1_V12D07-335_D1,1,3,0,0,0,4
TCCTGGCGCTGCCTGG-1_V12D07-335_D1,0,2,0,0,0,2
GAGCCGAGCGTTTATT-1_V12D07-335_D1,0,0,1,0,0,1
AGAATGCGGGTTCGGA-1_V12D07-335_D1,0,3,0,0,0,3
ATGCGACAATTGGTCC-1_V12D07-335_D1,0,0,0,0,0,0
TTCCGGCTCGACTTCT-1_V12D07-335_D1,0,3,0,0,0,3
TGATTATGGCACGCAG-1_V12D07-335_D1,0,2,0,0,0,2
GGTTTGACAAGAAGCT-1_V12D07-335_D1,0,2,0,0,0,2
GCAGCTATGGACAGGT-1_V12D07-335_D1,0,1,0,0,0,1
CACCATGATCGCAAAG-1_V12D07-335_D1,0,0,0,0,0,0
GTCGGAAGGATACCAG-1_V12D07-335_D1,0,1,0,0,0,1
GGCCCAGTTATCAGCA-1_V12D07-335_D1,0,4,0,1,0,5
GGGCCTATTTAAGTAT-1_V12D07-335_D1,0,2,2,0,1,5
GTTGTTACATTGCGCT-1_V12D07-335_D1,0,1,0,0,0,1
CAACTCCGTAACTTGC-1_V12D07-335_D1,0,1,0,0,0,1
GATCTTTGCTCAAAGA-1_V12D07-335_D1,0,1,3,0,0,4
TCGCTTAATTACGAAG-1_V12D07-335_D1,0,1,1,0,0,2
CGATCATTAGAGGCAC-1_V12D07-335_D1,0,2,2,0,0,4
TGTTCTCTACTCCCTA-1_V12D07-335_D1,0,0,7,1,0,8
GCTTAGGGAAGCGGTA-1_V12D07-335_D1,0,1,2,1,0,4
CAGGTTTAGTACTACA-1_V12D07-335_D1,0,0,1,1,0,2
AAGCGGAGTGCGCGCA-1_V12D07-335_D1,1,0,4,1,0,6
TCAGATGGAGACGTAG-1_V12D07-335_D1,0,0,4,1,0,5
TCGCACTAACGTTTGT-1_V12D07-335_D1,1,3,0,0,0,4
CACGTCGGGTTCTAGA-1_V12D07-335_D1,0,3,1,0,0,4
GGAGTACACATGAGCT-1_V12D07-335_D1,0,0,0,0,0,0
GTGTGTCGACGTCGCT-1_V12D07-335_D1,0,2,0,0,0,2
GAAGCTCTTTGCTTAG-1_V12D07-335_D1,0,1,1,0,0,2
ACACCGAGCGCTCTTT-1_V12D07-335_D1,0,1,0,0,0,1
CGTAATAATTACGAGT-1_V12D07-335_D1,1,1,0,0,0,2
CATCAACACCTACTAA-1_V12D07-335_D1,0,2,0,0,0,2
CCAAGTTTCTACAGAT-1_V12D07-335_D1,0,1,0,0,0,1
ACGGGTCATGTGACTT-1_V12D07-335_D1,0,1,1,0,0,2
AGTGTGCTAAGATCGC-1_V12D07-335_D1,0,1,2,0,0,3
GGCGGTTTGCCGGTGC-1_V12D07-335_D1,0,3,0,0,0,3
GTATAATCTCCCGGAT-1_V12D07-335_D1,0,0,0,0,0,0
TAGTCCGTATGCATAA-1_V12D07-335_D1,1,2,2,0,0,5
CACTTCGTCTTATCTC-1_V12D07-335_D1,0,0,1,0,0,1
CATCCGCAGGCCCGAA-1_V12D07-335_D1,0,0,0,0,3,3
CCCTGATGTAACTCGT-1_V12D07-335_D1,0,1,0,0,0,1
CCATAGTCAGTAACCC-1_V12D07-335_D1,0,0,0,0,0,0
CGGGCCATAGCCGCAC-1_V12D07-335_D1,0,2,1,0,0,3
CTCCGGCTTGTAGACA-1_V12D07-335_D1,0,2,1,0,0,3
AACTTGCGTTCTCGCG-1_V12D07-335_D1,0,0,0,0,0,0
AATGAGTTCGCATATG-1_V12D07-335_D1,0,0,0,0,0,0
CGAGGCCAGGCATTGG-1_V12D07-335_D1,0,0,0,0,0,0
TCTGCGTCCGGTTTCT-1_V12D07-335_D1,0,0,0,0,0,0
CAATCCTGCCGTGGAG-1_V12D07-335_D1,0,0,2,0,0,2
CTGAGCAAGTAACAAG-1_V12D07-335_D1,0,0,0,0,0,0
GGGTACCCACGGTCCT-1_V12D07-335_D1,0,1,1,0,0,2
ACGGAATTTAGCAAAT-1_V12D07-335_D1,0,2,0,0,0,2
GGGCGGTCCTATTGTC-1_V12D07-335_D1,0,0,0,0,0,0
ATGTTACGAGCAATAC-1_V12D07-335_D1,0,2,1,0,0,3
AACCATGGGATCGCTA-1_V12D07-335_D1,0,3,0,0,0,3
TCGCATCCCTAAGTGT-1_V12D07-335_D1,0,3,0,0,0,3
ACTTAGTACGACAAGA-1_V12D07-335_D1,0,0,2,0,0,2
GAGCTCTCGGACCTAA-1_V12D07-335_D1,0,0,0,0,0,0
TCTATTACGCTGGCGA-1_V12D07-335_D1,1,4,0,2,0,7
AGATACGACTTCATAT-1_V12D07-335_D1,0,6,0,0,0,6
CGCTATACCGCCCACT-1_V12D07-335_D1,0,1,0,0,0,1
CAGTGTCCGCAGAATG-1_V12D07-335_D1,0,0,0,1,0,1
CCATCCATACCAAGTC-1_V12D07-335_D1,2,1,1,0,0,4
AACCCAGAGACGGAGA-1_V12D07-335_D1,0,1,0,0,0,1
GAAGAACGGTGCAGGT-1_V12D07-335_D1,2,1,0,0,0,3
GATAAATCGGTGGATG-1_V12D07-335_D1,1,4,2,0,0,7
CAGCTCGTGCTTGTGT-1_V12D07-335_D1,12,0,0,0,0,12
GAGTACGGGTATACAA-1_V12D07-335_D1,20,1,0,0,0,21
CATCGCCCGCGGCCAA-1_V12D07-335_D1,0,1,1,0,0,2
TCTTACAGAGGTACCG-1_V12D07-335_D1,0,1,0,0,0,1
TGGAAGACGAACACCA-1_V12D07-335_D1,0,0,1,0,0,1
GTTGTCGTGTTAGTTG-1_V12D07-335_D1,0,1,1,0,0,2
CCAAGGAACAGAGAGG-1_V12D07-335_D1,0,2,0,0,0,2
CTGCACCTGGAACCGC-1_V12D07-335_D1,0,1,1,0,0,2
CGCTTTCATACCGGTG-1_V12D07-335_D1,0,0,0,0,0,0
GTTCTTCCCTCGATGT-1_V12D07-335_D1,0,1,0,0,0,1
ATTTAACTCGTATTAC-1_V12D07-335_D1,0,2,0,0,0,2
AACGATAGAAGGGCCG-1_V12D07-335_D1,0,2,1,0,0,3
TATCCTGCATGGGAAT-1_V12D07-335_D1,0,2,3,0,0,5
AGGCCCATTGTACAGG-1_V12D07-335_D1,0,0,1,0,0,1
CCGGCGCATATTGGAT-1_V12D07-335_D1,0,1,0,0,0,1
ATCTGTAATTGTACCC-1_V12D07-335_D1,0,2,4,0,0,6
GAGCGAGGGAGTACCG-1_V12D07-335_D1,0,2,3,0,0,5
TTATTAGGGAAGCATC-1_V12D07-335_D1,0,1,3,0,0,4
CTTCTTACGTCGTATA-1_V12D07-335_D1,0,3,1,0,0,4
GAAGTGCTGGATAGCT-1_V12D07-335_D1,0,5,1,0,0,6
GTGCAACAAATGTGGC-1_V12D07-335_D1,0,1,2,0,0,3
CATGCGTTAGACAGAA-1_V12D07-335_D1,0,4,2,0,0,6
ACACACTTTCTACACG-1_V12D07-335_D1,0,2,4,1,0,7
AGCCCTAAGCGAAGTT-1_V12D07-335_D1,0,3,2,0,0,5
ATTAATTCGGTCACTC-1_V12D07-335_D1,0,2,4,0,0,6
AACAGGAAATCGAATA-1_V12D07-335_D1,0,3,2,0,0,5
ACGTTTAGTTGTGATC-1_V12D07-335_D1,1,0,3,0,0,4
TCCTTCAGTGGTCGAA-1_V12D07-335_D1,0,2,0,0,0,2
CGAACGCCCAGTGCCG-1_V12D07-335_D1,0,4,1,0,0,5
CCTCGAAGTGGACGGG-1_V12D07-335_D1,0,3,0,0,0,3
CTCTGTTTGAGGATTC-1_V12D07-335_D1,0,2,0,0,0,2
TGGGCACGTTCTATGG-1_V12D07-335_D1,0,1,1,0,0,2
ACTATTCGTCCGTGGT-1_V12D07-335_D1,0,1,1,0,0,2
CCTCTGGCCTAGACGG-1_V12D07-335_D1,2,0,0,0,0,2
CCATAAACAACCCGAC-1_V12D07-335_D1,0,1,1,0,0,2
CATAGTACATTGAGAG-1_V12D07-335_D1,0,1,0,0,0,1
ATTTCATTATTTCGCG-1_V12D07-335_D1,0,0,0,0,0,0
CAACTATATCGAATGC-1_V12D07-335_D1,0,0,0,0,0,0
CTAGTATTCGGAATTA-1_V12D07-335_D1,0,2,1,0,0,3
GTGGAACCTACATGCG-1_V12D07-335_D1,1,1,2,0,0,4
CCTAAAGGCTGACGCT-1_V12D07-335_D1,0,1,0,0,0,1
CGTGACATTGGGTCGT-1_V12D07-335_D1,0,0,0,0,0,0
CCAATCGGTAGATCGA-1_V12D07-335_D1,0,2,0,0,0,2
ATTGTCGCAATACCTT-1_V12D07-335_D1,0,0,0,0,0,0
AAATTACACGACTCTG-1_V12D07-335_D1,0,0,0,0,0,0
CACTCCTCTCGGTCGG-1_V12D07-335_D1,0,0,0,1,0,1
AAATAACCATACGGGA-1_V12D07-335_D1,0,0,1,0,0,1
AGTTACTCTATCGTGG-1_V12D07-335_D1,0,1,0,0,0,1
CGTTAGCTCACAACTG-1_V12D07-335_D1,0,0,0,0,0,0
GAATGTATGGCAGGTC-1_V12D07-335_D1,0,0,0,0,0,0
GCAACCACCAGACCGG-1_V12D07-335_D1,0,0,0,0,0,0
TCACTCGTGCAACGGC-1_V12D07-335_D1,1,0,0,0,0,1
AAACAGAGCGACTCCT-1_V12D07-335_D1,0,0,2,0,0,2
CAGCCTCTCCTCAAGA-1_V12D07-335_D1,0,3,1,0,0,4
TTGCGTGAACGCTTAG-1_V12D07-335_D1,1,0,0,0,0,1
CCGCCTGCGAATTGGT-1_V12D07-335_D1,0,0,0,0,0,0
AGATGAGGGTTGCGAT-1_V12D07-335_D1,0,1,0,1,0,2
CGGTGGGCTCCAGCCT-1_V12D07-335_D1,0,0,2,0,0,2
GGCAGCGGTAATCCTA-1_V12D07-335_D1,0,1,0,0,0,1
GCTAGCAGGGAGTGGG-1_V12D07-335_D1,0,0,0,0,0,0
CTCAAGACATTAGCGC-1_V12D07-335_D1,0,1,0,0,0,1
CACGGCGCGCCAAAGG-1_V12D07-335_D1,0,1,0,0,0,1
TGCAATTTGGGCACGG-1_V12D07-335_D1,0,2,0,1,0,3
ATGCCAATCGCTCTGC-1_V12D07-335_D1,1,3,1,0,0,5
GCTGGACCCAAAGTGG-1_V12D07-335_D1,0,0,0,0,0,0
ATTCCTAAGACGTGGA-1_V12D07-335_D1,0,1,0,0,0,1
TCCGGAGGAAGGGCTG-1_V12D07-335_D1,0,1,1,0,0,2
TCGGTGACCGCTCCGG-1_V12D07-335_D1,0,2,1,0,0,3
TCCGAAGTAGTCACCA-1_V12D07-335_D1,0,2,0,2,0,4
CATGTAGGAGCGCCAA-1_V12D07-335_D1,0,0,0,0,0,0
CACAAGAAAGATATTA-1_V12D07-335_D1,0,0,0,0,0,0
AGGGTCAGTAACCCTA-1_V12D07-335_D1,0,0,0,0,0,0
TAAGCCCTTACGACCA-1_V12D07-335_D1,0,0,0,0,0,0
ATACCGTCATCCATAA-1_V12D07-335_D1,0,0,0,0,0,0
GGACGTCCATAGTTGG-1_V12D07-335_D1,0,1,0,0,0,1
CATCAAACTGGCGCCC-1_V12D07-335_D1,0,2,0,0,0,2
AAACGTGTTCGCCCTA-1_V12D07-335_D1,0,2,0,0,0,2
AAATTGGTGAGAAGCA-1_V12D07-335_D1,2,0,1,0,0,3
GGTCATTGTAGTCATA-1_V12D07-335_D1,0,0,1,0,0,1
TGCAGTGAGGCTCGGG-1_V12D07-335_D1,0,2,3,2,0,7
GAACATTAGTATGTTA-1_V12D07-335_D1,0,0,2,0,0,2
GGTTTGCGAACACGTA-1_V12D07-335_D1,0,0,2,1,0,3
ACACAAATATTCCTAG-1_V12D07-335_D1,0,1,2,0,0,3
TTGGGTTTATTCAGCG-1_V12D07-335_D1,0,0,1,0,0,1
ATTCGCAGAGGACACT-1_V12D07-335_D1,0,0,3,0,0,3
GATTTAGTGCGTACTG-1_V12D07-335_D1,0,1,1,2,0,4
TAGAAACACAATAGTG-1_V12D07-335_D1,0,1,0,0,0,1
CAGTAGATGATGTCCG-1_V12D07-335_D1,1,2,0,0,0,3
TCTTAACTCGGATGTA-1_V12D07-335_D1,0,1,0,0,0,1
TACATCTTGTTTCTTG-1_V12D07-335_D1,0,1,0,0,0,1
TTCATAGGGTGTCCAT-1_V12D07-335_D1,0,1,0,0,0,1
TGAAGTAGCTTACGGA-1_V12D07-335_D1,0,4,0,0,0,4
GCACAAGTGGATCATA-1_V12D07-335_D1,0,1,1,0,0,2
GGGCGAATTTCTCCAC-1_V12D07-335_D1,0,2,0,0,0,2
ATGTTCCTGCCCACCT-1_V12D07-335_D1,0,3,0,0,0,3
GCTCAACCTCTTAGAG-1_V12D07-335_D1,0,0,0,0,0,0
ATAGCTGCTCTTGTTA-1_V12D07-335_D1,0,1,0,0,0,1
CGTCAGCTATTTACTC-1_V12D07-335_D1,0,1,0,0,0,1
ATCTGATAGTGTCTTA-1_V12D07-335_D1,0,1,0,0,0,1
TGCACTATGTGAGTGC-1_V12D07-335_D1,0,1,0,0,0,1
CCGACAAACACATGAG-1_V12D07-335_D1,1,0,0,0,1,2
GCCTTGTATATGCAGT-1_V12D07-335_D1,0,2,1,0,0,3
ATAATACCGTTAGCCG-1_V12D07-335_D1,0,0,0,0,0,0
ACACTCCAATGTCACT-1_V12D07-335_D1,0,0,1,0,0,1
AGTTGCTGACTGATAT-1_V12D07-335_D1,1,1,0,0,0,2
GGCGCTCCTCATCAAT-1_V12D07-335_D1,0,1,1,0,0,2
TGCCTGACATCGGTCA-1_V12D07-335_D1,0,1,0,0,0,1
TTGGCCATCTTGCGCT-1_V12D07-335_D1,1,0,0,0,0,1
CAGTGGTTGCACATGA-1_V12D07-335_D1,1,0,1,0,0,2
AGAATTGTTTGACATA-1_V12D07-335_D1,1,0,0,0,0,1
AAATGCTCGTTACGTT-1_V12D07-335_D1,1,0,2,0,0,3
CACCTAATAGAGTCGT-1_V12D07-335_D1,0,0,0,0,0,0
CATTTCTAGCAGACTA-1_V12D07-335_D1,0,1,0,0,0,1
CCGAAAGTGGTGAGCA-1_V12D07-335_D1,1,3,1,0,0,5
AGTCAGCCACCGCCTG-1_V12D07-335_D1,0,1,1,0,0,2
TCATCACTCGAGCTCG-1_V12D07-335_D1,0,1,0,0,0,1
CTCAGGACTCACCTGT-1_V12D07-335_D1,1,3,0,0,0,4
CGGTGTACTTGATCCC-1_V12D07-335_D1,1,1,1,0,0,3
CCTACGGCTCAGTCGA-1_V12D07-335_D1,0,0,0,0,0,0
GTACTTGGGCACTTCT-1_V12D07-335_D1,0,2,0,0,0,2
TGATTTCCTCCTGACG-1_V12D07-335_D1,0,2,0,0,0,2
CCTCACCAATCTTGAC-1_V12D07-335_D1,0,5,0,0,0,5
GGTGAGATGCAGATAA-1_V12D07-335_D1,0,4,1,0,0,5
GCTAGTTTCATTGAGG-1_V12D07-335_D1,0,0,0,0,0,0
AGGACATCGCACGTCG-1_V12D07-335_D1,0,3,0,0,0,3
GTGGACGTGCTGAGAC-1_V12D07-335_D1,0,5,1,0,0,6
TAAGGAACTTGTGGGA-1_V12D07-335_D1,2,3,0,0,0,5
TCGCTGTGCGTAAATC-1_V12D07-335_D1,0,0,1,0,0,1
GCATCCCTAACTTTGA-1_V12D07-335_D1,1,2,0,0,0,3
CACCCACACGTCACCC-1_V12D07-335_D1,1,4,2,2,0,9
CCCTCATTCTGGAATT-1_V12D07-335_D1,23,1,0,0,0,24
AGGGCGTGATCGGCTA-1_V12D07-335_D1,22,2,0,0,0,24
GGTGCGGATAAGTGGC-1_V12D07-335_D1,0,0,1,0,0,1
TAATATTGAAATTCGC-1_V12D07-335_D1,1,1,0,0,0,2
CTTACACTGGGAAATA-1_V12D07-335_D1,0,1,0,0,0,1
ACCAAGAACGCGTGTC-1_V12D07-335_D1,0,0,1,0,0,1
GCCTTCAGCCCTACCG-1_V12D07-335_D1,0,2,0,0,0,2
GATGCTACAAGCGCCT-1_V12D07-335_D1,0,1,1,0,0,2
CCGGGACCCGCAGAGA-1_V12D07-335_D1,0,2,1,0,0,3
GTTCCAGTCTGACCAT-1_V12D07-335_D1,0,2,1,0,0,3
ATGATCGGGAATAGAC-1_V12D07-335_D1,0,3,2,0,0,5
TTGGATTGGGTACCAC-1_V12D07-335_D1,0,2,0,0,0,2
TACCTCACGCTTGTAC-1_V12D07-335_D1,0,0,0,0,0,0
CATGGCAGGAAGATCG-1_V12D07-335_D1,0,3,1,1,0,5
ATGACGCCGGCTCTAA-1_V12D07-335_D1,0,1,3,0,0,4
AGCGACATCCCATTCA-1_V12D07-335_D1,0,3,2,0,0,5
AGTAATGTCTTGCCGC-1_V12D07-335_D1,0,3,0,1,0,4
TTCTTAGTGGCTCAGA-1_V12D07-335_D1,0,4,1,0,0,5
CGTCTGGAAGGGCCCG-1_V12D07-335_D1,0,5,1,0,0,6
ACGTGCGCCTCGTGCA-1_V12D07-335_D1,0,0,2,0,0,2
AGAGCGGGCTAATCAT-1_V12D07-335_D1,0,3,7,1,0,11
GCGTCGAAATGTCGGT-1_V12D07-335_D1,1,1,7,0,0,9
AACTGATATTAGGCCT-1_V12D07-335_D1,0,0,7,0,0,7
CGAGCTGGGCTTTAGG-1_V12D07-335_D1,0,5,2,0,0,7
GGGTGTTTCAGCTATG-1_V12D07-335_D1,0,3,3,0,0,6
TTAATTTCAGACGCGG-1_V12D07-335_D1,1,3,1,0,0,5
ACTGCCGTCGTAACTC-1_V12D07-335_D1,0,1,0,0,0,1
GTGCACGAAAGTGACT-1_V12D07-335_D1,0,0,4,0,0,4
ATCTCCCTGCAATCTA-1_V12D07-335_D1,0,2,0,0,0,2
ACGCCAGATGATTTCT-1_V12D07-335_D1,0,1,2,0,0,3
AGCTATTTAATCCAAC-1_V12D07-335_D1,0,1,1,0,0,2
CCACGAGAAGAGAATC-1_V12D07-335_D1,0,0,3,0,0,3
GATTCCGCGTTTCCGT-1_V12D07-335_D1,0,1,0,0,0,1
GTCGGATGTAGCGCGC-1_V12D07-335_D1,0,2,0,0,0,2
TATTTATACCGAGTAG-1_V12D07-335_D1,0,1,0,0,0,1
GTAGGTGATCCGTGTA-1_V12D07-335_D1,1,2,1,0,0,4
AGTTAAGCGGTCCCGG-1_V12D07-335_D1,0,1,0,0,0,1
CTGGCGACATAAGTCC-1_V12D07-335_D1,0,0,1,0,0,1
TTGGCCTAGAATTTCG-1_V12D07-335_D1,0,2,0,0,0,2
GGCATATCGGTTCTGC-1_V12D07-335_D1,0,1,0,0,1,2
GGGCGTCCACTGGCTC-1_V12D07-335_D1,1,0,1,0,0,2
TTACCCATTGCCGGGT-1_V12D07-335_D1,0,0,0,0,0,0
TTAGACACGATCGTTG-1_V12D07-335_D1,0,0,0,0,0,0
GCGCTGATCCAGACTC-1_V12D07-335_D1,0,0,0,0,0,0
TTCGGCAACCCGCTGA-1_V12D07-335_D1,0,0,0,0,0,0
GATATTTCCTACATGG-1_V12D07-335_D1,0,0,0,0,0,0
CTGCGTTACGATATAA-1_V12D07-335_D1,0,0,1,0,0,1
TAATAAACAAGGAGAT-1_V12D07-335_D1,0,0,0,0,0,0
AACCTTTACGACGTCT-1_V12D07-335_D1,0,2,0,0,0,2
AGTCCCGCCTTTAATT-1_V12D07-335_D1,0,1,0,0,0,1
TGAGATTAGGCCCTAA-1_V12D07-335_D1,0,0,2,0,0,2
AGTGTATTGCGCATTG-1_V12D07-335_D1,0,2,0,0,0,2
GTTGGATTCAGTGGCT-1_V12D07-335_D1,0,1,0,0,0,1
TAAAGCTGCAATAGGG-1_V12D07-335_D1,0,1,0,1,0,2
AGTAGGAAGGAAGTTG-1_V12D07-335_D1,0,0,1,0,1,2
TATCACTTCGAGTAAC-1_V12D07-335_D1,0,0,1,0,0,1
TGATCTACGCTGATCT-1_V12D07-335_D1,0,2,0,0,0,2
GGATCATCCCGTACGC-1_V12D07-335_D1,0,1,0,0,0,1
TGACACTTCTCTTTGC-1_V12D07-335_D1,0,2,0,0,0,2
AGCCCTTCTAATCCGA-1_V12D07-335_D1,0,0,0,0,0,0
CACCGCGTCCACTCTA-1_V12D07-335_D1,1,3,0,2,0,6
TAATTGGAATCGGGAA-1_V12D07-335_D1,1,3,0,0,0,4
TCGTAAGCTCCGAGGA-1_V12D07-335_D1,1,1,0,0,0,2
TATATTACAAATGTCG-1_V12D07-335_D1,0,0,0,0,0,0
CGCGAGAGGGACTTGT-1_V12D07-335_D1,0,1,0,0,0,1
GGACCTACGGTAACGT-1_V12D07-335_D1,0,0,0,0,0,0
GAAATATGCTTGAATG-1_V12D07-335_D1,0,0,0,0,0,0
CCGTATTAGCGCAGTT-1_V12D07-335_D1,0,0,0,0,0,0
AGGCGTCTATGGACGG-1_V12D07-335_D1,0,0,0,0,0,0
AACATCGATACGTCTA-1_V12D07-335_D1,0,0,0,0,0,0
TGAATATGCTATAAAC-1_V12D07-335_D1,0,0,0,0,0,0
ACCAAACACCCAGCGA-1_V12D07-335_D1,1,0,1,0,0,2
TGGCTTGTACAAGCTT-1_V12D07-335_D1,0,2,2,0,1,5
GAATGAAGGTCTTCAG-1_V12D07-335_D1,0,2,0,0,0,2
AGATACCAGCACTTCA-1_V12D07-335_D1,0,0,0,0,1,1
GCGGTCCCGGTGAAGG-1_V12D07-335_D1,0,4,0,1,0,5
GAGGCATTTGCAGCAG-1_V12D07-335_D1,0,2,1,0,0,3
GGCAAGCCAGGGATAG-1_V12D07-335_D1,0,0,0,6,0,6
TCTACGGGCTCAGTTG-1_V12D07-335_D1,0,0,4,2,0,6
TCTGCGAATCGTTCGC-1_V12D07-335_D1,0,0,0,3,0,3
AGCTCGTTGATGGAAA-1_V12D07-335_D1,0,0,1,3,0,4
TGAATGAGATACAGCA-1_V12D07-335_D1,0,0,2,0,0,2
ACCCTTGCCTGGGTCG-1_V12D07-335_D1,0,1,7,2,0,10
GGCGAACCGTTCTGAT-1_V12D07-335_D1,1,0,0,0,0,1
GCGATGTCTGTGCTTG-1_V12D07-335_D1,0,1,0,0,0,1
ATTAACACCTGAGATA-1_V12D07-335_D1,0,1,0,0,0,1
GAAATCTGACCAAGTT-1_V12D07-335_D1,0,1,0,0,0,1
CCTGACAAACTCGCGC-1_V12D07-335_D1,1,1,0,0,0,2
ATGTCATTTCCCATTG-1_V12D07-335_D1,1,0,0,0,0,1
GCGGTGCGGAGCATCG-1_V12D07-335_D1,0,2,0,0,0,2
CGGAAAGCAAATGTGC-1_V12D07-335_D1,0,1,0,0,0,1
GCTGAGCAACGGTTCT-1_V12D07-335_D1,0,0,0,0,0,0
TCACTCTTCGTCTGTC-1_V12D07-335_D1,0,1,0,0,0,1
GATCTTCATTGTCCTC-1_V12D07-335_D1,2,2,0,0,0,4
ACTCGATGTATTTCAT-1_V12D07-335_D1,1,2,0,0,0,3
TGAAGAGCGGTCCTAG-1_V12D07-335_D1,0,1,0,0,0,1
TAAACGTCGTCAATGA-1_V12D07-335_D1,0,0,0,0,0,0
ACGTTATTGGTCACTC-1_V12D07-335_D1,0,2,0,1,0,3
ATAGCCTCAGTACCCA-1_V12D07-335_D1,1,2,0,0,0,3
CGGGAGTATACCGCCG-1_V12D07-335_D1,0,2,0,0,0,2
GTCCTACAGGCGGCTC-1_V12D07-335_D1,1,3,1,0,0,5
CGGATAAGCGGACATG-1_V12D07-335_D1,0,2,0,0,0,2
AACTTCTGCGTCTATC-1_V12D07-335_D1,0,1,1,0,0,2
GGGTTCAGACGAACAA-1_V12D07-335_D1,0,1,0,0,0,1
AGTCTGGACATCCTTG-1_V12D07-335_D1,0,1,1,0,0,2
TTGAACGAATCCTTTG-1_V12D07-335_D1,0,1,0,0,0,1
GAAATACTAAACGTTT-1_V12D07-335_D1,0,0,1,0,0,1
CCCGCGCAATGCACCC-1_V12D07-335_D1,0,1,0,0,0,1
TTCGGCTAGAGATGGT-1_V12D07-335_D1,0,1,1,0,0,2
GACACGAGTTAGAGGA-1_V12D07-335_D1,0,1,1,0,0,2
GAGGTCCCAAAGATCT-1_V12D07-335_D1,0,1,0,0,0,1
TAACTCCATGGAGGCT-1_V12D07-335_D1,0,0,0,0,0,0
CTTGTTTATGTAGCCA-1_V12D07-335_D1,0,1,2,0,0,3
GATGGCGCACACATTA-1_V12D07-335_D1,0,3,0,0,0,3
ATAATAGTGTAGGGAC-1_V12D07-335_D1,0,4,0,0,0,4
CGCTATTCAATGTATG-1_V12D07-335_D1,0,1,2,0,0,3
ATATTGCTGTCAAAGT-1_V12D07-335_D1,1,4,1,0,0,6
GGATTCAGTACGGTGG-1_V12D07-335_D1,0,1,0,0,0,1
TTCTTAGTGAACGGTG-1_V12D07-335_D1,2,0,2,0,0,4
AATGGTTCTCACAAGC-1_V12D07-335_D1,0,3,0,0,0,3
TATACACGCAAAGTAT-1_V12D07-335_D1,0,1,1,0,0,2
CTTCATAGCTCAAGAA-1_V12D07-335_D1,0,4,1,0,0,5
CAACGGTTCTTGATAC-1_V12D07-335_D1,0,2,0,0,0,2
ACACCCGAGAAATCCG-1_V12D07-335_D1,1,3,0,0,0,4
TCTATCATGCAGTTAC-1_V12D07-335_D1,0,3,2,0,0,5
CCCGCCATGCTCCCGT-1_V12D07-335_D1,0,3,0,0,0,3
CGCTTCCACTGAAATC-1_V12D07-335_D1,0,1,0,0,0,1
CACTGTCCAAGTGAGA-1_V12D07-335_D1,1,3,1,0,0,5
ATTACTAGCCTCTTGC-1_V12D07-335_D1,1,6,2,0,0,9
CATAGTAGCATAGTAG-1_V12D07-335_D1,1,3,0,0,0,4
CAACTCCTTGATCCCG-1_V12D07-335_D1,15,2,0,0,0,17
AAGTAGAAGACCGGGT-1_V12D07-335_D1,12,2,0,0,0,14
GCGGGAACCAGGCCCT-1_V12D07-335_D1,1,2,1,1,0,5
ATTAGATTGATAGCGG-1_V12D07-335_D1,4,2,1,1,0,8
CTCGGTCCGTAGCCTG-1_V12D07-335_D1,0,3,1,0,0,4
TGGCTTTGGGTAGACA-1_V12D07-335_D1,0,3,2,0,0,5
TATCCATATCATGCGA-1_V12D07-335_D1,0,0,0,0,0,0
GGAGTGCCGCCCTGGA-1_V12D07-335_D1,0,1,0,0,0,1
TGAGAATGCTTTACCG-1_V12D07-335_D1,0,0,0,0,0,0
TTAACCAACCCTCCCT-1_V12D07-335_D1,0,3,0,0,0,3
TGTTTCGGTACTTCTC-1_V12D07-335_D1,0,0,1,0,0,1
TTGCTGAAGGAACCAC-1_V12D07-335_D1,0,0,1,0,0,1
TATTTAGTCTAGATCG-1_V12D07-335_D1,0,3,1,0,0,4
CTCCGGCCTAATATGC-1_V12D07-335_D1,0,2,2,0,0,4
TTGTGGCCCTGACAGT-1_V12D07-335_D1,0,0,2,0,0,2
TCGCCGGTCGATCCGT-1_V12D07-335_D1,0,3,2,0,0,5
CCATAGGTTGGCGTGG-1_V12D07-335_D1,0,6,0,1,3,10
GAACGACCGAATGATA-1_V12D07-335_D1,0,8,5,0,0,13
TCCGATAATTGCCATA-1_V12D07-335_D1,1,6,1,0,0,8
CATTACGTCGGCCCGT-1_V12D07-335_D1,0,2,2,0,0,4
CAAGCACCAAATGCCT-1_V12D07-335_D1,0,1,5,0,0,6
TGCATGGATCGGATCT-1_V12D07-335_D1,0,1,5,0,0,6
GAAATCGCGCGCAACT-1_V12D07-335_D1,0,2,8,0,0,10
CTGAAAGAGATCCGAC-1_V12D07-335_D1,0,2,6,0,0,8
CACCTCGATGGTGGAC-1_V12D07-335_D1,0,1,1,0,0,2
ATTTGTTCCAGGGCTC-1_V12D07-335_D1,0,1,1,1,0,3
TGGGCCACAAGAGCGC-1_V12D07-335_D1,1,2,2,0,0,5
CCTTCTTGATCCAGTG-1_V12D07-335_D1,1,1,0,1,0,3
CCTCGCCAGCAAATTA-1_V12D07-335_D1,0,1,0,0,0,1
TTCATGGCGCAACAGG-1_V12D07-335_D1,0,1,2,0,0,3
TTAATCAGTACGTCAG-1_V12D07-335_D1,0,2,2,0,0,4
CCTATCTATATCGGAA-1_V12D07-335_D1,0,1,0,0,1,2
ATTATACTTTGCTCGT-1_V12D07-335_D1,0,2,0,0,0,2
ATGGATCCGGCGTCCG-1_V12D07-335_D1,0,1,0,0,0,1
CGCCCGCTTCCGTACA-1_V12D07-335_D1,0,1,0,0,0,1
GGATTCCGCTATACCC-1_V12D07-335_D1,2,2,2,0,0,6
CGGTCTATCAACCCGT-1_V12D07-335_D1,1,2,2,0,0,5
ATGCCGGTTGATGGGA-1_V12D07-335_D1,0,0,0,0,0,0
TCATGCAGGTTCTCAT-1_V12D07-335_D1,0,3,1,0,0,4
TGAGCTTTAATGACGC-1_V12D07-335_D1,1,1,0,0,0,2
TCCCTTAGATTACTCG-1_V12D07-335_D1,0,0,0,0,0,0
ATATCTCCCTCGTTAA-1_V12D07-335_D1,0,1,0,0,0,1
AGCTCTTCCCAGTGCA-1_V12D07-335_D1,0,5,3,0,0,8
TCGCTAAACCGCTATC-1_V12D07-335_D1,0,0,0,0,0,0
CACATTCTTTCGATGG-1_V12D07-335_D1,0,0,0,0,0,0
GATATGCGGTAGCCAA-1_V12D07-335_D1,0,0,0,0,0,0
CGTTTCACTTCGGGCG-1_V12D07-335_D1,0,0,0,0,0,0
CCAATTACGGGTCGAG-1_V12D07-335_D1,0,1,0,0,0,1
GCAGGTAGAGTATGGT-1_V12D07-335_D1,0,0,0,0,0,0
GTCGTATTGGCGTACA-1_V12D07-335_D1,0,2,0,0,0,2
GAAATTAGCACGGATA-1_V12D07-335_D1,0,0,0,0,0,0
AATGCACCAAGCAATG-1_V12D07-335_D1,0,1,0,0,0,1
AGGACGCTCGATGTTG-1_V12D07-335_D1,0,1,0,2,0,3
GGCTAAAGGGCGGGTC-1_V12D07-335_D1,0,0,0,0,0,0
CATCTATCCCGTGTCT-1_V12D07-335_D1,0,0,0,0,0,0
CAGTAACTATTTATTG-1_V12D07-335_D1,1,1,1,0,0,3
CATATACTACTGATAA-1_V12D07-335_D1,0,4,0,0,0,4
GCGTTCGGAGACCGGG-1_V12D07-335_D1,0,0,0,0,0,0
AAGTTCAGTCTGCGTA-1_V12D07-335_D1,0,3,0,0,0,3
CGAAGCTATAAATTCA-1_V12D07-335_D1,1,0,0,0,0,1
CGCGGTCACAAACCAA-1_V12D07-335_D1,1,2,0,0,0,3
GGGAATGAGCCCTCAC-1_V12D07-335_D1,0,0,1,0,0,1
ACGGAGCGCAAATTAC-1_V12D07-335_D1,0,3,0,1,0,4
CGTTCTTCGCACACCT-1_V12D07-335_D1,0,1,1,0,0,2
GAATAGCCCTGCGGTC-1_V12D07-335_D1,0,0,0,0,0,0
AATAGCTACCGCGTGC-1_V12D07-335_D1,0,0,0,0,0,0
CCGAGCTGTGCTTGTC-1_V12D07-335_D1,0,0,0,0,0,0
GATGACGATGATCGCG-1_V12D07-335_D1,0,0,1,0,0,1
GCCTATGCTGGGCCTT-1_V12D07-335_D1,0,0,0,0,0,0
TTACTGTCTAGAGCTC-1_V12D07-335_D1,0,2,0,0,2,4
AGCGGTTGCCGCTCTG-1_V12D07-335_D1,1,4,0,0,0,5
GCTTGCAGCACAATTG-1_V12D07-335_D1,0,0,1,3,0,4
CCGGAGGTCTTATGGT-1_V12D07-335_D1,0,0,2,0,0,2
ACAGTATACCGTGGGA-1_V12D07-335_D1,0,4,1,0,0,5
GGGATCCCAATACAAA-1_V12D07-335_D1,0,1,3,1,0,5
ATTACGACTCCACAGT-1_V12D07-335_D1,0,1,1,1,0,3
CTCACACGCAAGCCTA-1_V12D07-335_D1,0,1,0,0,0,1
CCAGATGTAAATGGGT-1_V12D07-335_D1,0,0,4,1,0,5
GAACTTGTGCACGGGA-1_V12D07-335_D1,0,1,3,1,1,6
AAGCCGCTTTACCTTG-1_V12D07-335_D1,0,0,3,0,0,3
TCCATTCCCACTAGAG-1_V12D07-335_D1,0,0,2,0,0,2
AGAGCGCTTGTAACGG-1_V12D07-335_D1,0,0,1,0,0,1
TGGGTTCCCGGACGGA-1_V12D07-335_D1,1,1,1,0,0,3
GCTGCGCCTCCCACGT-1_V12D07-335_D1,1,3,0,0,0,4
CTGTTGGCTCTTCTGA-1_V12D07-335_D1,0,1,1,1,0,3
TTGTTCTAGATACGCT-1_V12D07-335_D1,0,1,1,1,0,3
CCCTCAAGCTCTTAGT-1_V12D07-335_D1,1,1,0,0,0,2
TGGTCTAGCTTACATG-1_V12D07-335_D1,0,1,1,0,0,2
ATGCACCTTCCTTAAT-1_V12D07-335_D1,0,0,0,0,0,0
GGGATACGGTAATAAT-1_V12D07-335_D1,0,0,0,1,0,1
AGTTCACCGGTTGGAC-1_V12D07-335_D1,0,0,1,0,0,1
GACATACTGTCGCAGA-1_V12D07-335_D1,0,1,0,0,0,1
TGGACACCGTTGCTTG-1_V12D07-335_D1,0,1,0,0,0,1
TGCGATGCTAATGGCT-1_V12D07-335_D1,1,0,0,0,0,1
TTCTGTTTCCTGTCGC-1_V12D07-335_D1,1,2,0,0,0,3
CGTTGTAAACGTCAGG-1_V12D07-335_D1,0,1,0,0,0,1
GATCGGCGATAAGTCG-1_V12D07-335_D1,0,1,0,0,0,1
AGCCTTAAAGCGGAAG-1_V12D07-335_D1,0,0,1,0,0,1
TCCGTAACCACAATCC-1_V12D07-335_D1,0,2,1,0,0,3
GAATGCCGAAATGACC-1_V12D07-335_D1,0,2,0,0,0,2
TATACTCATGCGGCAA-1_V12D07-335_D1,2,1,2,0,0,5
TAGTGTCAGAAACGGC-1_V12D07-335_D1,0,1,0,0,0,1
CGTCATACCATATCCA-1_V12D07-335_D1,0,0,0,0,0,0
TAGTACCTTAGTGGTC-1_V12D07-335_D1,0,0,0,0,0,0
CTGGCGGGAATAAGTA-1_V12D07-335_D1,0,0,0,0,0,0
AGTGTGGTCTATTGTG-1_V12D07-335_D1,1,4,1,0,0,6
GCTATCGCGGCGCAAC-1_V12D07-335_D1,0,1,0,0,0,1
CAGTAATCCCTCCCAG-1_V12D07-335_D1,0,1,2,0,0,3
GTATTAAGGCGTCTAA-1_V12D07-335_D1,0,1,0,0,0,1
CTAATTTCAACAACAC-1_V12D07-335_D1,2,0,0,0,0,2
TTAGCAACATGGATGT-1_V12D07-335_D1,0,2,0,0,0,2
ATGCTCAGTGTTGCAT-1_V12D07-335_D1,1,1,0,0,0,2
GATGTTTGTGCGAGAT-1_V12D07-335_D1,0,2,1,0,0,3
CACTTCGCCACAGGCT-1_V12D07-335_D1,1,2,0,0,0,3
CTGTATGGTGTAGAAA-1_V12D07-335_D1,0,1,3,0,0,4
TACGTGCACTATGCTG-1_V12D07-335_D1,0,1,0,0,0,1
GTATCAGCTTGGGTTC-1_V12D07-335_D1,0,1,0,0,0,1
TAACAAAGGGAGAAGC-1_V12D07-335_D1,0,4,1,1,0,6
TTACATCGTGGCCTGG-1_V12D07-335_D1,0,2,1,1,0,4
TCTGAACCGGTCGGCT-1_V12D07-335_D1,0,2,0,0,0,2
GGCTCGTGCCACCAGC-1_V12D07-335_D1,0,3,0,0,0,3
TATAAGTGAGGATAGC-1_V12D07-335_D1,1,1,1,0,0,3
GCCCGCGCGTTTGACA-1_V12D07-335_D1,0,1,0,1,0,2
TGCTGGTTGGACAATT-1_V12D07-335_D1,0,2,1,0,0,3
GCCTAGCGATCTGACC-1_V12D07-335_D1,0,2,0,0,0,2
CCATGCTCTGCAGGAA-1_V12D07-335_D1,0,0,0,1,0,1
TATAAATCCACAAGCT-1_V12D07-335_D1,0,3,3,0,0,6
CGCTCGACATAATGAT-1_V12D07-335_D1,0,3,0,0,0,3
CCAATTGAATGTTAAT-1_V12D07-335_D1,0,3,1,0,0,4
GCTAATACCGAATGCC-1_V12D07-335_D1,0,6,0,0,0,6
TTCAACGACCCGACCG-1_V12D07-335_D1,6,7,2,0,0,15
TTCCTCGAGGGTGTCT-1_V12D07-335_D1,8,5,0,1,0,14
CAACGACCCGTTTACA-1_V12D07-335_D1,5,6,0,0,0,11
CTTGTACTTGTTGACT-1_V12D07-335_D1,9,1,0,0,0,10
TCTCTAATAGCTGGTA-1_V12D07-335_D1,0,0,0,0,0,0
ATTATGCCATAGGGAG-1_V12D07-335_D1,2,4,1,0,0,7
GACAACGCAGCTTACG-1_V12D07-335_D1,0,2,1,0,0,3
AGATGACTCGCCCACG-1_V12D07-335_D1,0,0,0,0,0,0
GTGCGGGTCTCCAAAT-1_V12D07-335_D1,0,0,0,0,0,0
GTACGAGATTGCGACA-1_V12D07-335_D1,0,1,0,0,0,1
GTATAGGACTCAGTAG-1_V12D07-335_D1,0,1,0,0,0,1
TTGCACGGAGCAGCAC-1_V12D07-335_D1,0,0,1,0,0,1
CACAGCTAGGGAGTGA-1_V12D07-335_D1,0,3,1,0,0,4
ATACTAGCATGACCCT-1_V12D07-335_D1,0,0,1,0,0,1
CCAAGACTTCTGCGAA-1_V12D07-335_D1,0,1,0,0,0,1
ACATAATAAGGCGGTG-1_V12D07-335_D1,0,6,1,1,0,8
TAATACACAGTAGTAT-1_V12D07-335_D1,0,3,1,0,0,4
TCTTGGTAACACCAAA-1_V12D07-335_D1,0,4,7,3,1,15
AACTGGGTCCCGACGT-1_V12D07-335_D1,0,4,1,0,0,5
ATCACTTCATCCTCGC-1_V12D07-335_D1,0,5,2,0,0,7
TGGAAGGATAAAGATG-1_V12D07-335_D1,0,2,4,0,0,6
CATGATGCACAATTCT-1_V12D07-335_D1,0,2,3,1,0,6
TGCCTGATCAAACGAT-1_V12D07-335_D1,0,6,2,0,0,8
ATAGGGATATCCTTGA-1_V12D07-335_D1,0,0,5,0,0,5
CACCTAATCAGTTTAC-1_V12D07-335_D1,0,1,2,0,0,3
TGTGACTACGCCAGTC-1_V12D07-335_D1,0,1,0,0,0,1
CCCGACCATAGTCCGC-1_V12D07-335_D1,1,0,4,0,0,5
CGCGCCCGACTTAATA-1_V12D07-335_D1,0,1,0,0,0,1
TGCCACCTGGCGAAAC-1_V12D07-335_D1,0,2,1,0,0,3
CTGCCAAGGTTGGAAG-1_V12D07-335_D1,1,1,0,0,0,2
TCTCCAACGTAGGTTA-1_V12D07-335_D1,1,0,0,0,0,1
TTCTTGGAGTAATGAG-1_V12D07-335_D1,0,0,0,0,0,0
GTCTCGATCTGCTTTC-1_V12D07-335_D1,0,0,0,0,0,0
TACTCTCCGAACAAAT-1_V12D07-335_D1,0,2,0,0,0,2
ATCACATTAGAATATC-1_V12D07-335_D1,0,3,0,1,0,4
TACGGGATGCTAGCAG-1_V12D07-335_D1,0,1,1,0,0,2
AGCTGAAGTAAACCAA-1_V12D07-335_D1,0,0,0,0,0,0
CATGGGTCGGGTGTGG-1_V12D07-335_D1,0,0,0,0,0,0
CACCCACGAGGCAATT-1_V12D07-335_D1,0,1,0,0,0,1
TGCCATTACTAAAGAA-1_V12D07-335_D1,1,2,0,0,0,3
CCGTTACGTTAGAACA-1_V12D07-335_D1,0,0,1,0,0,1
GCCAGGAGTAACCGAT-1_V12D07-335_D1,0,0,0,0,0,0
GGAAAGTGCCCATGCC-1_V12D07-335_D1,0,0,0,0,0,0
TCTTACCGGAACTCGT-1_V12D07-335_D1,0,0,0,0,0,0
TATGTCAAGACCGACT-1_V12D07-335_D1,0,1,1,0,0,2
CCTAACTAAGGCTCTA-1_V12D07-335_D1,0,0,0,0,0,0
GCGGTGAACTGCGCTC-1_V12D07-335_D1,0,1,0,0,0,1
CCTCGCGCGATATAGG-1_V12D07-335_D1,0,1,0,0,0,1
ATCGGCAAGCAGTCCA-1_V12D07-335_D1,0,1,0,0,0,1
AGATCGTGCATAAGAT-1_V12D07-335_D1,0,1,0,0,0,1
ATTCAGGACCTATTTC-1_V12D07-335_D1,0,2,1,0,0,3
AGCTAGAAGCAGAAGT-1_V12D07-335_D1,0,1,0,0,0,1
TTCGCTATCTGACGTG-1_V12D07-335_D1,0,0,0,0,0,0
TTCCGCAGAGAAATAT-1_V12D07-335_D1,0,1,2,0,0,3
CAGTACATTCTCTAAA-1_V12D07-335_D1,0,2,0,0,0,2
GTGAAGATTTCAAGTG-1_V12D07-335_D1,0,1,0,0,0,1
AACGCATGATCTGGGT-1_V12D07-335_D1,0,1,0,0,0,1
CCCAGAGGAGGGCGTA-1_V12D07-335_D1,0,1,0,0,0,1
GGAAACCTTGTTGAAT-1_V12D07-335_D1,0,0,0,0,0,0
GTGAAGCCGTATAGTC-1_V12D07-335_D1,0,0,0,0,0,0
GAGCTGTCGTCTCGGA-1_V12D07-335_D1,1,0,0,0,0,1
TGTCATTTGTTGGGAA-1_V12D07-335_D1,0,0,0,0,0,0
ACCAACACCACACACT-1_V12D07-335_D1,0,0,0,0,0,0
AAATGATTCGATCAGC-1_V12D07-335_D1,0,0,0,0,0,0
CTGCTTTATGTCCGCG-1_V12D07-335_D1,0,0,0,0,0,0
GCGAGAGGCCATGTAA-1_V12D07-335_D1,0,0,0,0,0,0
ATTGACCGGCGATGAC-1_V12D07-335_D1,1,1,1,0,1,4
ACCCTGGTAACGCCCT-1_V12D07-335_D1,0,1,1,0,0,2
GTTGGACCGCATCAGG-1_V12D07-335_D1,1,0,0,0,0,1
CGTTTACAAGGCAGCT-1_V12D07-335_D1,0,0,0,0,0,0
CGGTCCATGAGACTCC-1_V12D07-335_D1,0,0,0,0,0,0
GTTCGTCTGGGTCCCT-1_V12D07-335_D1,0,0,1,0,1,2
TGTACTACTCTCACGG-1_V12D07-335_D1,0,0,0,0,1,1
AGTGAAGATGGTGTCC-1_V12D07-335_D1,0,1,2,0,0,3
GAGGGCCATAATATTA-1_V12D07-335_D1,2,0,2,1,0,5
ACTCCCGTAGACTAGG-1_V12D07-335_D1,0,0,2,1,0,3
CGTCAAATGGTCGCAG-1_V12D07-335_D1,0,2,1,0,0,3
AAGTCTAGTAGCTGCC-1_V12D07-335_D1,0,0,3,1,0,4
AAGAAATCACCAGATT-1_V12D07-335_D1,0,2,4,1,0,7
GAGTGCACGGACAACA-1_V12D07-335_D1,0,0,0,1,0,1
GTTCAAATCAGATGTC-1_V12D07-335_D1,0,0,0,1,0,1
CATGGCTCCCTATGTC-1_V12D07-335_D1,0,2,0,0,0,2
GGCCACACGAAAGCCT-1_V12D07-335_D1,1,1,0,0,0,2
GAAGCCGGGTAAGCTC-1_V12D07-335_D1,0,2,0,0,0,2
TTGCGCTCTCTCGCTT-1_V12D07-335_D1,0,1,0,0,0,1
TACATGACCTTATCCG-1_V12D07-335_D1,0,0,0,0,0,0
GTCCTTCTACAACCCA-1_V12D07-335_D1,0,2,0,0,0,2
TATATGCTGGGTTGCC-1_V12D07-335_D1,0,1,0,0,0,1
GTTTATGGGATTTAGA-1_V12D07-335_D1,0,0,0,0,0,0
GGAACCCGAACAAGAA-1_V12D07-335_D1,0,2,0,0,0,2
AACGTTATCAGCACCT-1_V12D07-335_D1,1,0,1,0,0,2
CATCGTCCGGTTACTA-1_V12D07-335_D1,0,0,0,0,0,0
AGACAGCTCAGAATCC-1_V12D07-335_D1,0,4,0,0,0,4
GCAGATCCTCGCAAAT-1_V12D07-335_D1,0,0,0,0,0,0
GGGTCATGCGTACCAT-1_V12D07-335_D1,1,2,0,0,0,3
CTGGTCATTCCAATCC-1_V12D07-335_D1,0,0,0,0,0,0
TCAGGGCGCAAACTCG-1_V12D07-335_D1,0,0,0,0,0,0
GATGCCAGCAGAAGGC-1_V12D07-335_D1,1,1,1,0,0,3
GTTATTAACGTGGGAG-1_V12D07-335_D1,0,0,0,0,0,0
AATACAATGTTTCAGG-1_V12D07-335_D1,0,0,0,0,0,0
TTGCTGCACCTATCCA-1_V12D07-335_D1,0,2,1,0,0,3
CCAGAGACAAAGCCGG-1_V12D07-335_D1,1,2,0,0,0,3
CCGAAGTATATTGTTC-1_V12D07-335_D1,2,4,1,0,0,7
GCTAAACCTGAGGTGA-1_V12D07-335_D1,0,1,2,0,0,3
TCATACTTACAGATCC-1_V12D07-335_D1,0,2,1,0,0,3
CGAGCACTTCAAGTTT-1_V12D07-335_D1,0,0,0,0,0,0
TAGCAACCTGTCACAA-1_V12D07-335_D1,0,1,0,0,0,1
TGGGAAATGCCTTTCC-1_V12D07-335_D1,0,1,0,0,0,1
AGACCATGGGATACAA-1_V12D07-335_D1,0,0,0,0,0,0
TAAATGAATCCGTTTC-1_V12D07-335_D1,0,3,1,0,0,4
ACAACGGTCCCTGCGA-1_V12D07-335_D1,0,1,0,1,0,2
GTCACTCTCCAAATCT-1_V12D07-335_D1,1,2,0,1,0,4
TTCTACTTGCGAGGGC-1_V12D07-335_D1,0,2,0,0,0,2
CGCAATTACTTTCGGT-1_V12D07-335_D1,0,1,0,0,0,1
CTGTTCATCTCACGGG-1_V12D07-335_D1,0,1,0,0,0,1
TTCTTGTAACCTAATG-1_V12D07-335_D1,0,5,0,0,0,5
GCTTGATGATAATCAG-1_V12D07-335_D1,0,5,0,0,0,5
TTGGCTCGCATGAGAC-1_V12D07-335_D1,0,1,1,0,0,2
GCCCAGTTGGTATGCC-1_V12D07-335_D1,1,2,1,0,0,4
ATTCCTCCGCCAGTGC-1_V12D07-335_D1,0,1,0,0,0,1
TCGTCCGCTGGCGTCT-1_V12D07-335_D1,0,1,0,0,0,1
GGAGAAGTCATTGGCA-1_V12D07-335_D1,0,3,0,0,0,3
TTGTTAGCAAATTCGA-1_V12D07-335_D1,0,3,0,0,0,3
TCTAGCATCTTCGATG-1_V12D07-335_D1,0,2,1,0,0,3
TTCTAGGCCAATTGTG-1_V12D07-335_D1,0,3,1,0,0,4
TCACGGTCATCGCACA-1_V12D07-335_D1,0,4,0,0,0,4
ATGAAGCCAAGGAGCC-1_V12D07-335_D1,0,5,1,0,0,6
AATGACTGTCAGCCGG-1_V12D07-335_D1,0,0,0,0,0,0
CCAAACAGAACCCTCG-1_V12D07-335_D1,0,2,0,0,0,2
TATCGATGATTAAACG-1_V12D07-335_D1,1,1,1,0,0,3
GAACACACATCAACCA-1_V12D07-335_D1,3,2,0,4,0,9
CCCGTCAGCGTCTGAC-1_V12D07-335_D1,4,2,0,0,0,6
AGCATCGTCGATAATT-1_V12D07-335_D1,14,3,0,0,0,17
GACTAAGATCATGCAC-1_V12D07-335_D1,14,6,0,0,0,20
TAGGGTGTTTCAAGAG-1_V12D07-335_D1,3,2,0,0,0,5
TGGTTCGTAGCAAAGG-1_V12D07-335_D1,7,5,0,1,0,13
CTGTTCACTGCCTGTG-1_V12D07-335_D1,0,2,0,0,0,2
ATGTGCATCCGACGCA-1_V12D07-335_D1,0,0,0,0,0,0
TTGTCGTTCAGTTACC-1_V12D07-335_D1,0,2,0,0,0,2
CGGGATCAATGTAAGA-1_V12D07-335_D1,0,1,0,0,0,1
TTATCTGTATCATAAC-1_V12D07-335_D1,0,1,0,0,0,1
ATCGACTCTTTCCGTT-1_V12D07-335_D1,0,3,0,0,0,3
CTCATTTGATGGGCGG-1_V12D07-335_D1,0,0,1,0,0,1
GTAAGCGGGCAGTCAG-1_V12D07-335_D1,0,4,2,1,0,7
TCTATCGGTCGCAACA-1_V12D07-335_D1,0,1,5,0,0,6
AACGCGGTCTCCAGCC-1_V12D07-335_D1,1,2,4,0,0,7
ATTAATACTACGCGGG-1_V12D07-335_D1,0,2,0,0,0,2
CTTTAACTTTCAAAGG-1_V12D07-335_D1,0,3,3,1,0,7
CGTACCTGATAGGCCT-1_V12D07-335_D1,1,3,4,0,0,8
GAATGTTGGGTAATCT-1_V12D07-335_D1,1,2,4,1,0,8
TGCGGAGTAAAGGTGC-1_V12D07-335_D1,0,0,3,0,0,3
CCTGAATATTTACATA-1_V12D07-335_D1,1,4,3,0,0,8
TTGCTCCCATACCGGA-1_V12D07-335_D1,0,2,1,0,0,3
CCTCTAATCTGCCAAG-1_V12D07-335_D1,0,0,1,2,0,3
AGGTTGAGGCACGCTT-1_V12D07-335_D1,0,1,1,0,0,2
TCCCGTCAGTCCCGCA-1_V12D07-335_D1,0,2,3,0,0,5
TCCGATGACTGAGCTC-1_V12D07-335_D1,0,5,0,0,0,5
CAGCCTCCTGCAGAGG-1_V12D07-335_D1,0,4,0,0,0,4
CTTAGCCTTCCACATG-1_V12D07-335_D1,0,2,2,0,0,4
ATTAATGAACCAGTCG-1_V12D07-335_D1,0,0,0,0,0,0
ACGATACATAGAACTA-1_V12D07-335_D1,0,0,2,0,0,2
AGCCACTCCCGTGCTT-1_V12D07-335_D1,0,1,1,0,0,2
ATACGGGTTTCGATTG-1_V12D07-335_D1,0,3,3,2,0,8
CTGTCAAATGGCTCGG-1_V12D07-335_D1,0,1,1,0,0,2
GCTCGGAATTTAAAGC-1_V12D07-335_D1,0,0,0,0,0,0
TAGGCATGTTACGCCA-1_V12D07-335_D1,0,0,0,0,0,0
TGGCAACTCGCGCGCC-1_V12D07-335_D1,0,2,1,0,0,3
ATCAGTAGGCAGGGAT-1_V12D07-335_D1,1,1,1,0,0,3
TATCGATCTATGCATA-1_V12D07-335_D1,0,0,0,0,0,0
CGACTCAGGATGTTAT-1_V12D07-335_D1,0,1,0,0,0,1
GCCATATTGCACACAG-1_V12D07-335_D1,0,0,0,0,0,0
AATTCATAAGGGATCT-1_V12D07-335_D1,0,0,0,0,0,0
CGGTAGAGGTGCAGGT-1_V12D07-335_D1,0,0,1,0,0,1
AATGATGATACGCTAT-1_V12D07-335_D1,0,0,0,0,0,0
CTTGTGCTCACCGATT-1_V12D07-335_D1,0,1,0,0,0,1
TTCCAATCAGAGCTAG-1_V12D07-335_D1,0,0,1,0,0,1
CGATGGACCCTACGCC-1_V12D07-335_D1,0,0,0,0,0,0
GGTCGGATAAACGGCG-1_V12D07-335_D1,0,2,2,2,3,9
TTAGCTAATACGATCT-1_V12D07-335_D1,0,1,0,0,0,1
CTCGATATTTGCGAGC-1_V12D07-335_D1,0,0,0,0,0,0
ATTACTTACTGGGCAT-1_V12D07-335_D1,1,1,0,0,0,2
CTAGCCGATGTTATGA-1_V12D07-335_D1,0,4,0,0,0,4
TACTGCAATCAATTAC-1_V12D07-335_D1,0,3,0,0,0,3
TAGTCTGTGACGTTGC-1_V12D07-335_D1,1,1,1,0,0,3
CTCGTTTCTAATGTTT-1_V12D07-335_D1,0,0,0,0,0,0
TTCGTTCAACGAAGTT-1_V12D07-335_D1,0,2,0,0,0,2
CTGAATTTATTGCCAG-1_V12D07-335_D1,0,3,0,0,0,3
TGGAATATCCTTGACC-1_V12D07-335_D1,2,3,0,0,0,5
CAGATCATTTAAAGTC-1_V12D07-335_D1,0,2,0,0,0,2
CTCCTTTACGCAAGTC-1_V12D07-335_D1,0,0,0,0,0,0
TCCCAAACAGACAACG-1_V12D07-335_D1,0,0,0,0,0,0
ATCGCTGCGTGCAGCA-1_V12D07-335_D1,0,0,0,0,0,0
TTAGTTCAAGTGTTCG-1_V12D07-335_D1,0,0,0,0,0,0
AAACTCGTGATATAAG-1_V12D07-335_D1,1,2,1,0,0,4
TTAACGAACAAGCAGT-1_V12D07-335_D1,1,0,1,0,0,2
GTTATATCAGGAGCCA-1_V12D07-335_D1,0,0,0,0,0,0
CAAATTGGATTATGCC-1_V12D07-335_D1,0,0,0,0,1,1
CGAGGAGCTTCCATAT-1_V12D07-335_D1,0,1,0,0,0,1
GGAGACCAATGTGCTT-1_V12D07-335_D1,0,0,1,0,1,2
CATTGATGAACACGCC-1_V12D07-335_D1,0,1,1,0,0,2
GTCAATGCTATAATTT-1_V12D07-335_D1,0,0,3,1,1,5
ACCACCCTCTCTTCTA-1_V12D07-335_D1,0,0,2,0,0,2
TGGAGGGAAACACCTC-1_V12D07-335_D1,0,1,7,1,0,9
CACGGACGTGGATGGC-1_V12D07-335_D1,0,0,1,0,0,1
AACTTTCTCGATCATG-1_V12D07-335_D1,0,1,3,0,0,4
CGTATTGTTTCCTAAT-1_V12D07-335_D1,0,1,1,0,0,2
CCTACTGCGGCGGCCA-1_V12D07-335_D1,0,1,1,1,0,3
CTTAGGTCCCAATCGT-1_V12D07-335_D1,0,1,1,1,0,3
CGCAATCGATCATTAG-1_V12D07-335_D1,0,1,0,0,0,1
TGGTTATGCTTGCGGT-1_V12D07-335_D1,1,0,0,0,0,1
GGCTTGGCTCTCACCT-1_V12D07-335_D1,0,0,0,0,0,0
ATTGGTAGGATCCGCT-1_V12D07-335_D1,1,0,0,0,0,1
TCAGGGCGACTTCCTT-1_V12D07-335_D1,0,1,0,0,0,1
TCTGCAGATTCGAGTC-1_V12D07-335_D1,0,0,1,0,0,1
CTCTCGCTGTACTATG-1_V12D07-335_D1,1,0,0,0,0,1
AATAGTCGCGAGTCGG-1_V12D07-335_D1,0,3,0,0,0,3
AGTTACCCTTAAGACT-1_V12D07-335_D1,0,1,1,0,0,2
CTTAAATAAGACCCAT-1_V12D07-335_D1,1,1,1,0,0,3
GGTTGTGCTCTTGTCC-1_V12D07-335_D1,0,6,0,0,0,6
GTGAGTCTAAGACGGA-1_V12D07-335_D1,2,1,0,0,0,3
CGCGACACTGCGCAGC-1_V12D07-335_D1,0,1,0,0,0,1
GCTCGCGGTTCCGCTC-1_V12D07-335_D1,1,4,0,0,0,5
TTAACTCACGCGTGGA-1_V12D07-335_D1,0,0,0,0,0,0
GGAACGGCCTGCAGCC-1_V12D07-335_D1,1,1,0,0,0,2
GTAGAAACGGGTGGAG-1_V12D07-335_D1,0,2,2,0,0,4
TAATGAAAGACCCTTG-1_V12D07-335_D1,0,1,0,0,0,1
AGGCTTGCTAGACACC-1_V12D07-335_D1,0,1,1,0,0,2
TTGCGTAGTTTGAGGA-1_V12D07-335_D1,0,2,0,0,0,2
CGCCCTTGAAGGCTGA-1_V12D07-335_D1,0,5,0,0,0,5
CCCGGTGGAAGAACCT-1_V12D07-335_D1,0,1,2,0,0,3
TTAACACCTCGAACAT-1_V12D07-335_D1,1,1,0,0,0,2
GATTCCTATACGGCGC-1_V12D07-335_D1,0,1,0,0,0,1
TTACCCTAACAGTCCT-1_V12D07-335_D1,0,2,1,1,0,4
ACCCACCTACATGCTC-1_V12D07-335_D1,0,1,1,0,0,2
AAAGGGCAGCTTGAAT-1_V12D07-335_D1,0,5,0,0,0,5
CACACAGGGATAGATT-1_V12D07-335_D1,1,2,1,0,0,4
AGAGCGTACAAGCTCG-1_V12D07-335_D1,0,2,1,0,0,3
TCTTACGGCATCCGAC-1_V12D07-335_D1,0,3,1,1,0,5
GCCTATTCCGATATAG-1_V12D07-335_D1,0,1,1,0,0,2
GAAAGTGACTAACTGC-1_V12D07-335_D1,0,1,0,0,0,1
CCGGAATGGTTTCAGT-1_V12D07-335_D1,0,3,0,0,0,3
AGTATAATACTAGGCA-1_V12D07-335_D1,0,1,0,0,0,1
TAACTATCGAAGGTCC-1_V12D07-335_D1,0,3,0,0,0,3
ATGAGGAGTGTTAATC-1_V12D07-335_D1,0,1,0,0,0,1
TGTGTCGCGAGTTGCA-1_V12D07-335_D1,2,3,1,0,0,6
ATCCAACGCAGTCATA-1_V12D07-335_D1,0,1,0,0,0,1
AAGGCGCGTAAAGCTT-1_V12D07-335_D1,2,2,0,0,0,4
AGTCGGCCCAAACGAC-1_V12D07-335_D1,0,1,0,0,0,1
AACGTCAGACTAGTGG-1_V12D07-335_D1,0,1,0,0,0,1
ACTACCAGCTCTCTGG-1_V12D07-335_D1,2,0,1,0,0,3
GCAAGTGCACAGAGAA-1_V12D07-335_D1,0,2,1,0,0,3
ACACCTTAAGTAGGGC-1_V12D07-335_D1,0,1,1,0,1,3
TTCGACGGGAAGGGCG-1_V12D07-335_D1,0,1,1,0,0,2
TTCGCACTCGCGTGCT-1_V12D07-335_D1,0,1,0,0,0,1
TATTTGTTACCCTTTA-1_V12D07-335_D1,0,0,0,0,0,0
CGCTGTGACGCCGCAC-1_V12D07-335_D1,0,1,2,0,0,3
GTTGCACGGAGTTTCG-1_V12D07-335_D1,0,1,2,1,0,4
GTTTCCTGGAGGGTGA-1_V12D07-335_D1,0,1,0,0,0,1
ACACCCAGCATGCAGC-1_V12D07-335_D1,0,4,0,0,0,4
TCAACCATGTTCGGGC-1_V12D07-335_D1,1,0,0,0,1,2
TTACAACTACGCATCC-1_V12D07-335_D1,4,2,0,0,0,6
TCCGATGGTGCGACAT-1_V12D07-335_D1,8,0,0,0,1,9
GGGCGTACATTTATAT-1_V12D07-335_D1,17,3,0,0,0,20
AGCGACCAACGATATT-1_V12D07-335_D1,9,2,0,0,0,11
ACACAAAGACGGGTGG-1_V12D07-335_D1,16,2,0,1,0,19
ATCGCACGCCGGGAGA-1_V12D07-335_D1,12,2,0,0,0,14
GCTCTAAACCCTGACG-1_V12D07-335_D1,0,0,2,0,0,2
AATGCAACCGGGTACC-1_V12D07-335_D1,0,2,0,0,0,2
TCAAACAACCGCGTCG-1_V12D07-335_D1,0,0,0,0,0,0
TATGCTCCCTACTTAC-1_V12D07-335_D1,0,2,0,0,0,2
AAAGGGATGTAGCAAG-1_V12D07-335_D1,0,0,1,1,0,2
ACGATCATACATAGAG-1_V12D07-335_D1,0,1,1,0,0,2
TTGTTCAGTGTGCTAC-1_V12D07-335_D1,0,2,1,0,0,3
ATGCATGATCCAGGAT-1_V12D07-335_D1,0,0,1,0,0,1
AGTCTTCTCCTCAAAT-1_V12D07-335_D1,1,0,2,0,0,3
GATTCCCTTGTCGCAG-1_V12D07-335_D1,0,6,2,0,0,8
CTCGCACCTATATAGT-1_V12D07-335_D1,0,3,1,0,0,4
ACTCAATAAAGGCACG-1_V12D07-335_D1,0,2,3,0,0,5
AACCGAGCTTGGTCAT-1_V12D07-335_D1,0,3,4,1,0,8
TAAGGCAACATAAGAT-1_V12D07-335_D1,0,2,3,0,0,5
CACGCACAGCGCAGCT-1_V12D07-335_D1,0,3,4,0,0,7
GGTTTACAATCTCAAT-1_V12D07-335_D1,0,2,6,0,0,8
TGCAGGATCGGCAAAG-1_V12D07-335_D1,0,3,2,0,0,5
ATAACGGAGTCCAACG-1_V12D07-335_D1,0,0,0,0,0,0
AACGATATGTCAACTG-1_V12D07-335_D1,0,1,2,0,0,3
GACAACGACCATTGAA-1_V12D07-335_D1,0,1,2,1,0,4
TTGACCATGTTCTCCG-1_V12D07-335_D1,0,9,0,0,0,9
AGTACGGGCACCTGGC-1_V12D07-335_D1,0,2,0,0,0,2
CGCCATCCGATTATGA-1_V12D07-335_D1,1,3,2,2,0,8
AAGGTATCCTAATATA-1_V12D07-335_D1,0,1,1,0,0,2
TGTTGTCAAGAAGTCT-1_V12D07-335_D1,0,0,1,0,0,1
CAGTGAATAAATGACT-1_V12D07-335_D1,0,0,0,0,0,0
CACCTTGCGAAACTCG-1_V12D07-335_D1,0,0,0,0,0,0
CATTTAGCGGACCATG-1_V12D07-335_D1,0,0,0,0,0,0
CCAGTCTAGACGGCGC-1_V12D07-335_D1,0,1,0,0,0,1
TCGCTTTAAACGTTTG-1_V12D07-335_D1,0,1,0,0,0,1
GTGAAACGGCGCCACC-1_V12D07-335_D1,0,0,0,0,0,0
GGGCTCATCGAACCCA-1_V12D07-335_D1,0,0,0,0,0,0
TTGATGTGTAGTCCCG-1_V12D07-335_D1,0,0,0,0,0,0
CAGTAGCCCACGCGGT-1_V12D07-335_D1,0,2,0,0,0,2
AGCGCGGGTGCCAATG-1_V12D07-335_D1,0,1,0,1,0,2
TAATCGATCCGTACGT-1_V12D07-335_D1,0,1,0,0,0,1
AGTGGCGGCAATTTGA-1_V12D07-335_D1,0,0,1,0,0,1
CCTTTCAATGAAGAAA-1_V12D07-335_D1,0,0,0,0,0,0
CTCAGTCACGACAAAT-1_V12D07-335_D1,0,0,0,0,0,0
ATAGGCTAGCTTCGCA-1_V12D07-335_D1,0,1,0,0,0,1
CGGTTCAAGTAGGTGT-1_V12D07-335_D1,0,1,0,0,0,1
CAGTCGAGGATGCAAT-1_V12D07-335_D1,1,3,0,0,0,4
TATCACCCAACCGACC-1_V12D07-335_D1,0,0,0,0,0,0
AATGATGCGACTCCTG-1_V12D07-335_D1,0,0,0,0,0,0
TGGAACCACTGACACA-1_V12D07-335_D1,0,1,0,0,0,1
GCCAATAGGGCATCTC-1_V12D07-335_D1,0,2,0,0,0,2
TTCTTTGGTCGCGACG-1_V12D07-335_D1,0,1,0,0,0,1
ATTAGATTCCTCAGCA-1_V12D07-335_D1,1,1,1,0,0,3
CCGTGGAACGATCCAA-1_V12D07-335_D1,1,2,0,0,0,3
GGGTCGTGGCAAGTGT-1_V12D07-335_D1,0,1,0,0,0,1
TCGCTCGGCACCAGCG-1_V12D07-335_D1,0,0,0,0,0,0
ACGCAATCACTACAGC-1_V12D07-335_D1,0,0,0,0,0,0
CTCTAATGCATTGATC-1_V12D07-335_D1,0,0,0,0,0,0
GTCTCGACTAAGTTTG-1_V12D07-335_D1,0,0,0,0,0,0
TGGTTTAAACGTGGGT-1_V12D07-335_D1,0,3,1,0,0,4
CGCAGATCTTCACCCG-1_V12D07-335_D1,0,0,1,1,0,2
TCCAGATGTACGCCAA-1_V12D07-335_D1,0,0,1,1,0,2
CATTGCGGGTCAATTC-1_V12D07-335_D1,0,0,0,0,2,2
GACGTTCGTAAATACA-1_V12D07-335_D1,0,1,0,0,0,1
TACACCGTCGTTAGTC-1_V12D07-335_D1,0,1,0,0,0,1
ACGGGCGTATGCGACA-1_V12D07-335_D1,0,0,1,0,0,1
GAAGGCTACCATTGTT-1_V12D07-335_D1,1,0,1,0,0,2
TAAATCTTTACACCTC-1_V12D07-335_D1,0,1,2,2,1,6
AGTTTATGTAAAGACA-1_V12D07-335_D1,0,0,0,0,0,0
AGGAGACATCCACAGT-1_V12D07-335_D1,0,0,2,0,0,2
CAACCTGAACCTGCCA-1_V12D07-335_D1,0,0,2,0,1,3
AGTCCCTCGCAGAAAG-1_V12D07-335_D1,0,1,4,2,0,7
TGTATACGGATGATGA-1_V12D07-335_D1,0,0,6,0,0,6
TTGTGGTATAGGTATG-1_V12D07-335_D1,0,1,3,0,0,4
TCTGCACCATTAGTAA-1_V12D07-335_D1,0,1,1,0,0,2
AAATGTATCTTATCCC-1_V12D07-335_D1,0,0,1,0,0,1
ACTCTAAACCTGGGAT-1_V12D07-335_D1,0,1,0,1,0,2
GCTGGCAGGTGCCGTG-1_V12D07-335_D1,0,0,0,0,0,0
CTCATTCGTGAACATC-1_V12D07-335_D1,0,1,0,1,0,2
TCGCCGGATGGGCAAG-1_V12D07-335_D1,0,3,0,0,0,3
GGACTAAGTCAGGAGT-1_V12D07-335_D1,1,0,0,0,0,1
TATCAAAGGTCTGTAA-1_V12D07-335_D1,0,1,0,1,0,2
TTCAGTTTGTGGCAGC-1_V12D07-335_D1,0,1,0,0,0,1
TGTTCATAAATGTGCT-1_V12D07-335_D1,2,0,0,1,0,3
CTTAGCCCGGATAGTG-1_V12D07-335_D1,1,1,0,0,0,2
GATGCGAATGGTATTA-1_V12D07-335_D1,1,0,0,0,0,1
TCTAACTGTATGTAAA-1_V12D07-335_D1,2,1,0,0,0,3
TTAAACCTGGTTCCTT-1_V12D07-335_D1,0,1,0,0,0,1
GCTAAGTAAAGGCGAT-1_V12D07-335_D1,0,1,1,0,0,2
AGTTACCGCACATGGT-1_V12D07-335_D1,1,2,0,0,0,3
GACTGCGGCACGTGTA-1_V12D07-335_D1,0,3,2,0,0,5
TGGTGATCGTATTTGT-1_V12D07-335_D1,0,3,0,0,0,3
TTATCGCCTGCGAAGC-1_V12D07-335_D1,0,0,1,0,0,1
TGGAATTAGACGCTTT-1_V12D07-335_D1,0,1,0,0,0,1
TCGTCACACTGTTAGC-1_V12D07-335_D1,1,0,0,0,0,1
TTATGTTTGCGATAGA-1_V12D07-335_D1,0,2,1,0,0,3
GGTGCTGATCACAAAG-1_V12D07-335_D1,0,0,0,0,0,0
CATAGCCGCCCGGGAT-1_V12D07-335_D1,0,1,0,0,0,1
GGTTAGTTACGGCGCC-1_V12D07-335_D1,0,3,0,0,0,3
ATTCCCACATAAACAA-1_V12D07-335_D1,1,0,1,0,0,2
ATTCAGTAGCAGGGTC-1_V12D07-335_D1,1,1,3,0,0,5
CAGTTCCGCGGGTCGA-1_V12D07-335_D1,0,2,0,0,0,2
AAGAGATGAATCGGTA-1_V12D07-335_D1,0,0,0,0,0,0
CGCAATTCTACAATAA-1_V12D07-335_D1,1,1,0,0,0,2
TAACGCTTTGAGAGCG-1_V12D07-335_D1,0,1,2,0,0,3
AGGCTATGGTTAGCTT-1_V12D07-335_D1,0,1,0,1,0,2
GAGGAATGGAGAGGTT-1_V12D07-335_D1,0,0,1,0,0,1
TCCTCTACGAGATGGC-1_V12D07-335_D1,0,0,0,0,0,0
TTGATTATGCAGATGA-1_V12D07-335_D1,0,2,0,0,0,2
TCAGTACTGACCCGCG-1_V12D07-335_D1,0,1,0,0,0,1
TTATGACAAACTGGAT-1_V12D07-335_D1,0,0,0,0,0,0
GTAAGTAGGGTATACC-1_V12D07-335_D1,1,5,0,0,0,6
CGCAAACACGAGTTAC-1_V12D07-335_D1,0,3,0,0,0,3
TGGCCGTATATTGACC-1_V12D07-335_D1,0,2,0,0,0,2
ACTGTAGCACTTTGGA-1_V12D07-335_D1,0,1,1,0,0,2
GCTCTATGTTACGTGC-1_V12D07-335_D1,0,4,0,1,0,5
TGCGCGATTAACGGAG-1_V12D07-335_D1,0,2,0,0,0,2
GAATCGACATGGTCAC-1_V12D07-335_D1,1,1,1,0,0,3
GACTAAGTAGGCTCAC-1_V12D07-335_D1,0,2,0,0,0,2
ATCTTGACCTGCAACG-1_V12D07-335_D1,1,2,1,0,0,4
ATGCACTACCGCATTG-1_V12D07-335_D1,0,0,1,0,0,1
CAGATACTAACATAGT-1_V12D07-335_D1,1,4,0,1,0,6
GATCGACACTATCTGA-1_V12D07-335_D1,0,2,1,0,0,3
ATAGAGTACTGGGACA-1_V12D07-335_D1,0,3,0,0,0,3
CCTACTGCTTACACTT-1_V12D07-335_D1,0,1,0,0,0,1
CCTGCTATTTGAGAAG-1_V12D07-335_D1,0,1,1,0,0,2
CGCGTTCATGAAATAC-1_V12D07-335_D1,0,0,0,0,0,0
CATTATGCTTGTTGTG-1_V12D07-335_D1,1,1,0,0,0,2
CCAGGGACGTGGCCTC-1_V12D07-335_D1,1,2,0,0,0,3
TATGGATGTGCTACGC-1_V12D07-335_D1,3,9,0,0,0,12
GTACTAAGATTTGGAG-1_V12D07-335_D1,9,6,0,0,0,15
AGACCCGCCCTCCTCG-1_V12D07-335_D1,12,3,0,0,0,15
CGCATTAGCTAATAGG-1_V12D07-335_D1,15,2,0,0,0,17
GCTCTCGGGTACCGAA-1_V12D07-335_D1,14,1,0,1,0,16
CACCGCCAGAAGGTTT-1_V12D07-335_D1,3,3,0,0,0,6
TCCCAAAGACGAAGGA-1_V12D07-335_D1,0,3,0,0,0,3
ATGGATTGACCAAACG-1_V12D07-335_D1,0,1,1,0,0,2
GTCATGGACATGACTA-1_V12D07-335_D1,0,3,0,0,1,4
CTACTGCCACCTGACC-1_V12D07-335_D1,0,0,1,0,0,1
TTATATTTGGCAATCC-1_V12D07-335_D1,0,1,2,0,0,3
AGCACCAGTACTCACG-1_V12D07-335_D1,3,2,1,0,0,6
CATGGTCTAGATACCG-1_V12D07-335_D1,0,2,2,0,0,4
TCTACCGTCCACAAGC-1_V12D07-335_D1,0,4,4,0,0,8
CTAGTTGGGCCCGGTA-1_V12D07-335_D1,0,2,5,0,0,7
TCCCGCGTACTCCTGG-1_V12D07-335_D1,0,1,4,0,1,6
CAGAGCATGAGCTTGC-1_V12D07-335_D1,0,3,6,0,1,10
ACACGGGAACTTAGGG-1_V12D07-335_D1,0,0,6,0,0,6
GGCTCTGCTCCAACGC-1_V12D07-335_D1,0,0,3,0,0,3
AGAACGTGGTACATTC-1_V12D07-335_D1,0,4,2,0,1,7
CAATAAACCTTGGCCC-1_V12D07-335_D1,0,2,2,0,0,4
ACTTCGCCATACGCAC-1_V12D07-335_D1,0,0,4,0,0,4
ATCTGGTTAAGACTGT-1_V12D07-335_D1,1,3,1,0,0,5
TCGTAAGACGACATTG-1_V12D07-335_D1,0,1,3,0,0,4
GTGTACCTTGGCTACG-1_V12D07-335_D1,0,1,2,0,0,3
GCCCGTAATACCTTCT-1_V12D07-335_D1,0,3,1,0,0,4
CGGTCAAGTGGGAACC-1_V12D07-335_D1,0,2,2,1,0,5
TTGTAAGGCCAGTTGG-1_V12D07-335_D1,0,0,0,0,0,0
GGAGCACCAAGAACTA-1_V12D07-335_D1,0,0,0,0,0,0
TAATAGTGACGACCAG-1_V12D07-335_D1,0,1,1,0,0,2
CTAAATCCTATTCCGG-1_V12D07-335_D1,0,0,0,0,0,0
CGAGTTCTGTCCCACC-1_V12D07-335_D1,0,0,0,0,0,0
AGGCAGATGCGTAAAC-1_V12D07-335_D1,0,0,0,0,0,0
AAGGATGAGGGACCTC-1_V12D07-335_D1,0,0,0,0,0,0
AGAGAACCGTCTAGGA-1_V12D07-335_D1,0,0,0,0,0,0
GAGGGCGCAGCTCTGC-1_V12D07-335_D1,0,1,1,0,0,2
AAGATTGGCGGAACGT-1_V12D07-335_D1,0,0,0,0,0,0
CCAGTAGTCTGATCCA-1_V12D07-335_D1,0,0,0,0,0,0
AAGGGACAGATTCTGT-1_V12D07-335_D1,0,2,1,0,0,3
ATAGAGTTATCAACTT-1_V12D07-335_D1,0,0,2,0,0,2
AAATTACCTATCGATG-1_V12D07-335_D1,0,2,0,0,0,2
GATCCTAAATCGGGAC-1_V12D07-335_D1,0,0,0,0,0,0
TTACAGACCTAAATGA-1_V12D07-335_D1,0,1,0,0,0,1
CCTCACCTTAGCATCG-1_V12D07-335_D1,1,1,3,0,0,5
CATGCGACCAGTTTAA-1_V12D07-335_D1,0,0,0,0,0,0
AACATATCAACTGGTG-1_V12D07-335_D1,0,0,0,0,0,0
CTATAAGAGCCAATCG-1_V12D07-335_D1,0,1,0,0,0,1
AATATCGAGGGTTCTC-1_V12D07-335_D1,1,3,0,1,0,5
GTACTCCTGGGTATGC-1_V12D07-335_D1,0,1,0,0,0,1
ATAAGTAGGATTCAGA-1_V12D07-335_D1,0,0,0,1,0,1
AGGTCGCGGAGTTACT-1_V12D07-335_D1,0,1,0,0,0,1
CTAATTCTCAGATATT-1_V12D07-335_D1,0,3,0,0,0,3
GCCAACCATTTCCGGA-1_V12D07-335_D1,0,1,0,0,0,1
TGATCCCAGCATTAGT-1_V12D07-335_D1,0,0,0,0,0,0
CGTTGTAAGATTGATT-1_V12D07-335_D1,0,0,0,0,0,0
GAAACCATGGTGCGCT-1_V12D07-335_D1,0,0,0,0,0,0
AATCTATGCCGGAGCC-1_V12D07-335_D1,0,0,0,0,0,0
GACTCCCAGAATAAGG-1_V12D07-335_D1,0,0,0,0,0,0
TATGATCCGGCACGCC-1_V12D07-335_D1,1,1,0,1,0,3
CCGCTTGCTGACATGG-1_V12D07-335_D1,0,0,1,0,1,2
TGGTTAAGGGCGCTGG-1_V12D07-335_D1,0,1,0,0,0,1
TTGATAGTCAATACAT-1_V12D07-335_D1,0,0,0,0,0,0
GGTTTAATTGAGCAGG-1_V12D07-335_D1,1,0,1,2,4,8
CATTACATAGATTGTG-1_V12D07-335_D1,1,1,0,0,1,3
GGTACACCAGATTTAT-1_V12D07-335_D1,0,3,2,0,1,6
GGCCCGTATACCATGC-1_V12D07-335_D1,0,0,2,0,3,5
ATCTTTCGTATAACCA-1_V12D07-335_D1,0,0,4,0,1,5
GAGATGACAATCCTTA-1_V12D07-335_D1,0,1,0,0,1,2
AAAGCTTGCCTACATA-1_V12D07-335_D1,0,0,2,0,0,2
GAACGATAAGTTAAAG-1_V12D07-335_D1,0,1,5,0,1,7
TAATAGCTAAATGATG-1_V12D07-335_D1,0,1,2,0,0,3
TATGGCTAGGCTAATT-1_V12D07-335_D1,0,0,3,0,0,3
AGGAGAGTCTGGCTAC-1_V12D07-335_D1,0,3,1,0,0,4
TGCTCTGCCGGTTCAC-1_V12D07-335_D1,0,3,4,0,0,7
CCAATAGATTTCATCT-1_V12D07-335_D1,0,1,0,0,0,1
GGGCACGAATTGGCCG-1_V12D07-335_D1,1,0,1,0,0,2
TCGTTGACAGGGTCCC-1_V12D07-335_D1,0,0,0,1,0,1
ATCGTATTCCGAGAAC-1_V12D07-335_D1,2,0,0,0,0,2
GGGAATTCTGTCCAGT-1_V12D07-335_D1,1,1,0,0,0,2
ACGCGTTTCTTAAGAG-1_V12D07-335_D1,0,0,0,0,0,0
GAGAGCGCAGTCCCTG-1_V12D07-335_D1,0,1,0,0,0,1
GTCCTATTGTTGTGGT-1_V12D07-335_D1,0,0,0,0,0,0
CATCTGCAGGATCATT-1_V12D07-335_D1,1,2,0,0,0,3
GAGTCGACAGACCCTC-1_V12D07-335_D1,3,2,2,0,0,7
AAGTGCAAAGGTAGAC-1_V12D07-335_D1,0,1,1,0,0,2
AGGGTGGATAGTGCAT-1_V12D07-335_D1,0,0,0,0,0,0
TGATAGCGGGATTCTA-1_V12D07-335_D1,0,1,0,1,0,2
GTCAGTTTGGTAGTCG-1_V12D07-335_D1,1,4,2,0,0,7
GCATTCGAAATGAACA-1_V12D07-335_D1,0,2,0,0,0,2
AAAGACTGGGCGCTTT-1_V12D07-335_D1,0,1,0,0,0,1
TAACAATATTTGTTGC-1_V12D07-335_D1,0,0,0,0,0,0
CCAGCTTCCGCCCGCA-1_V12D07-335_D1,0,1,1,0,0,2
GATATGGATTACGCGG-1_V12D07-335_D1,0,2,0,0,0,2
AGAGCAGTTATGAGAC-1_V12D07-335_D1,0,0,0,0,0,0
TCACATCTTATCTGAT-1_V12D07-335_D1,0,0,0,0,0,0
TATGAAGACAGGTGCG-1_V12D07-335_D1,0,0,0,0,0,0
TACCTGCTGCACTGTG-1_V12D07-335_D1,0,1,0,0,0,1
TAGGTCCAAGTAAGGA-1_V12D07-335_D1,0,3,1,0,0,4
GAAACTCGTGCGATGC-1_V12D07-335_D1,0,1,0,0,0,1
AACAATTACTCTACGC-1_V12D07-335_D1,0,1,0,0,0,1
CCGCACGTGACCTCGG-1_V12D07-335_D1,1,3,2,0,0,6
AACTTGCCCGTATGCA-1_V12D07-335_D1,0,0,1,0,0,1
GGGTATGTATGCACTT-1_V12D07-335_D1,0,2,0,0,0,2
TTCGTACTCCAGAACG-1_V12D07-335_D1,1,3,0,0,0,4
GAATTTCTCGCTGCAG-1_V12D07-335_D1,0,1,1,0,0,2
AACAGGATGGGCCGCG-1_V12D07-335_D1,0,2,0,0,0,2
GACGTGTAGGGATTAT-1_V12D07-335_D1,0,2,0,1,0,3
TAGGTGAGCCCTACTC-1_V12D07-335_D1,0,3,0,0,0,3
CTAATTCGCACGCGCT-1_V12D07-335_D1,0,3,2,0,0,5
GAAGCTTGCTGACCGC-1_V12D07-335_D1,0,5,1,0,0,6
GGTTAGGCTTGGAGAA-1_V12D07-335_D1,0,4,0,0,0,4
ACAAGGACAAGAGGTT-1_V12D07-335_D1,0,4,0,0,0,4
AGGCCACCCGTTATGA-1_V12D07-335_D1,0,1,0,0,0,1
GTGGGCTTAGACACAC-1_V12D07-335_D1,0,1,0,0,0,1
CGTGTCCCATTCGCGA-1_V12D07-335_D1,0,0,0,0,0,0
TGGAGTGATGCGATGA-1_V12D07-335_D1,0,2,0,1,0,3
AACAACTGGTAGTTGC-1_V12D07-335_D1,0,1,3,0,0,4
CCTGGCTAGACCCGCC-1_V12D07-335_D1,0,1,0,0,0,1
CGCAATTAGGGTAATA-1_V12D07-335_D1,1,1,0,0,0,2
TCGAAATTTAGGACCA-1_V12D07-335_D1,0,1,0,0,0,1
AGACTAGCCTTCCAGA-1_V12D07-335_D1,0,1,0,0,0,1
TTGATCTAACTTTGTC-1_V12D07-335_D1,0,6,0,0,0,6
AAGGAGCGGTTGGTGC-1_V12D07-335_D1,0,0,1,0,0,1
ACTTGGGACCCGGTGG-1_V12D07-335_D1,0,3,1,0,0,4
TGATCTCCGGCGCCAG-1_V12D07-335_D1,0,3,1,3,0,7
CAGTTCAAATTGACAC-1_V12D07-335_D1,4,2,0,0,0,6
GTCCGGCTGAATTGCG-1_V12D07-335_D1,1,1,1,1,0,4
CTGGAAATGGATGCTT-1_V12D07-335_D1,2,3,0,0,0,5
TGATCGGTTTGACCCT-1_V12D07-335_D1,2,7,0,0,0,9
TAGAGTCTAAGCGAAC-1_V12D07-335_D1,2,4,0,0,1,7
GAGACTGATGGGTAGA-1_V12D07-335_D1,11,0,1,1,0,13
TAGCTAAGTCCGGGAG-1_V12D07-335_D1,18,1,0,0,0,19
GGGCGATATGTGTGAA-1_V12D07-335_D1,10,1,0,0,0,11
CTCGAGGTCGAACAGT-1_V12D07-335_D1,14,1,0,0,0,15
GATCCCTTTATACTGC-1_V12D07-335_D1,0,4,0,0,0,4
GTCATGCACCTCCGTT-1_V12D07-335_D1,0,2,0,0,0,2
ACTTTCCTATAGCTTC-1_V12D07-335_D1,0,2,0,0,0,2
TCGCTCGATATATTCC-1_V12D07-335_D1,0,0,0,0,0,0
ATAGGTTGGGCAGATG-1_V12D07-335_D1,0,2,0,0,0,2
CAATTAAGGGTGATGA-1_V12D07-335_D1,0,1,3,0,0,4
ACCGACTGAGTCCCAC-1_V12D07-335_D1,0,1,0,0,0,1
CCTGTCACCCGGGCTC-1_V12D07-335_D1,1,3,5,0,0,9
GATCGGTGGCCATAAC-1_V12D07-335_D1,0,2,4,0,0,6
CCTATGGGTTACCGTC-1_V12D07-335_D1,0,4,3,0,0,7
TTGGGACACTGCCCGC-1_V12D07-335_D1,0,3,3,1,0,7
CGAGGCTAAATATGGC-1_V12D07-335_D1,0,5,8,1,0,14
TCAGGGTGTAACGTAA-1_V12D07-335_D1,0,2,5,0,0,7
CGAGAGATGTGAACCT-1_V12D07-335_D1,0,1,3,0,0,4
TCGCTGGGCGGATTGT-1_V12D07-335_D1,0,3,3,0,0,6
AGATCTCAGGTGTGAT-1_V12D07-335_D1,0,5,3,0,0,8
TGGCCAAACTGAAGTA-1_V12D07-335_D1,0,3,2,0,0,5
GCTTCCGTCCCTAGAC-1_V12D07-335_D1,0,3,0,0,0,3
CAGCAGCCCGTTCCTT-1_V12D07-335_D1,0,3,1,0,0,4
TGTATAACAGATCCTG-1_V12D07-335_D1,0,2,0,0,0,2
CGCGGGAATTAGGCAG-1_V12D07-335_D1,0,0,1,0,0,1
TGCATGTGGTAATCTA-1_V12D07-335_D1,0,0,0,0,0,0
ACAATTTGAGCAGTGG-1_V12D07-335_D1,0,0,1,0,0,1
GAGCTAAGGGCATATC-1_V12D07-335_D1,1,0,1,1,0,3
CCAGATAGTTGAGTGA-1_V12D07-335_D1,0,1,0,0,0,1
CCACAATGTACGTCTT-1_V12D07-335_D1,0,0,1,0,0,1
CAATGGATCTCTACCA-1_V12D07-335_D1,0,0,0,0,0,0
TGTGGCAAAGCGTATG-1_V12D07-335_D1,0,0,1,0,0,1
TAAAGCGTTAGGAGAA-1_V12D07-335_D1,0,0,0,0,0,0
TCCGTTTAGCCTTGAA-1_V12D07-335_D1,0,0,1,0,0,1
CAGCTCGACAAGTTAA-1_V12D07-335_D1,0,1,0,0,0,1
GCCTATAGTGTCAGGG-1_V12D07-335_D1,0,0,0,0,0,0
ATAGACAACGGGACCT-1_V12D07-335_D1,0,0,0,0,0,0
CTACTATCTTTCAGAG-1_V12D07-335_D1,0,2,0,0,0,2
GCGCTGCTTTGCATTT-1_V12D07-335_D1,0,2,0,0,0,2
GCGCATCCAGTCAGCA-1_V12D07-335_D1,0,2,0,0,0,2
GACTCGCGGGAATGAC-1_V12D07-335_D1,0,0,0,0,0,0
CTGGTAACGAGCTCTT-1_V12D07-335_D1,0,0,0,0,0,0
TCCGGCCTAGCGTACA-1_V12D07-335_D1,0,1,0,0,0,1
TCTAGGTGGCGACGCT-1_V12D07-335_D1,0,0,0,0,0,0
ACGCTAGTGATACACT-1_V12D07-335_D1,1,1,0,1,0,3
ATCTGCACCTCTGCGA-1_V12D07-335_D1,0,1,0,0,0,1
CCTCACCTGAGGGAGC-1_V12D07-335_D1,0,0,0,0,0,0
AGTGAGCCTCGCCGCC-1_V12D07-335_D1,0,3,0,0,0,3
ACGAGTACGGATGCCC-1_V12D07-335_D1,0,0,0,0,0,0
GGTACCATTAAGACGG-1_V12D07-335_D1,0,0,0,0,0,0
TTCTGCTAGACTCCAA-1_V12D07-335_D1,0,0,0,0,0,0
TAACTATTACGCCAAA-1_V12D07-335_D1,0,0,0,2,0,2
GCATTCAAGGCAACGC-1_V12D07-335_D1,0,0,0,0,0,0
AGTACATCATTTATCA-1_V12D07-335_D1,0,0,0,0,0,0
GTCGTGTCTGGTCATC-1_V12D07-335_D1,0,0,0,0,0,0
AGTCTAAAGTATACTC-1_V12D07-335_D1,0,1,0,0,0,1
CGGCCCAACCTGTAGT-1_V12D07-335_D1,1,2,0,0,0,3
AGGGAGACATACTTCG-1_V12D07-335_D1,1,0,0,2,2,5
TCCCTAGATCAATAGG-1_V12D07-335_D1,0,2,1,0,1,4
TCCCGTCGCGTCATAG-1_V12D07-335_D1,0,2,1,1,0,4
CGCATCCATCAGCCAG-1_V12D07-335_D1,0,1,0,0,0,1
CTGCACCTAGTCCACA-1_V12D07-335_D1,0,0,2,0,1,3
CGAGGATCGGGAACGA-1_V12D07-335_D1,0,0,3,0,1,4
CAATGAGGTTCGACTA-1_V12D07-335_D1,0,0,2,0,1,3
TCTGACGGGCTAACCC-1_V12D07-335_D1,0,1,1,0,0,2
TTCTATGCCTTTCGCA-1_V12D07-335_D1,0,0,6,0,0,6
AGAGTATAGTGTTACG-1_V12D07-335_D1,0,4,3,0,0,7
CCATTGTTTCCTCCAT-1_V12D07-335_D1,0,1,2,0,0,3
CTCATCACTTAGTGAT-1_V12D07-335_D1,0,0,2,1,0,3
CCGAAGGGCGTACCGC-1_V12D07-335_D1,0,1,2,0,0,3
TCAAGCTGCCTTGAAA-1_V12D07-335_D1,0,1,3,1,0,5
CTCATTAACGTTGCCC-1_V12D07-335_D1,0,5,3,0,0,8
GTCTTCCTCACCTAAG-1_V12D07-335_D1,1,0,0,0,0,1
GGTGATGAAGGAAGTG-1_V12D07-335_D1,0,2,1,0,0,3
TCAATACAATTGCTGC-1_V12D07-335_D1,0,1,0,0,0,1
GCAACCCAAGTTGTTT-1_V12D07-335_D1,1,2,1,0,0,4
ATGAAGTGGACCCAGC-1_V12D07-335_D1,3,1,0,0,0,4
GAGAATCTCACGATCA-1_V12D07-335_D1,0,0,1,0,0,1
TATATCATTGATCAGT-1_V12D07-335_D1,0,1,1,0,0,2
AACTTTACGGGAGCTT-1_V12D07-335_D1,1,0,0,0,0,1
TTCTTGTGTCCATCAG-1_V12D07-335_D1,0,2,1,0,0,3
ACAATTTAGGAGGCTC-1_V12D07-335_D1,1,3,0,0,0,4
ATACTTGTTCTCGAGC-1_V12D07-335_D1,0,1,0,0,0,1
CACGGGATTGAGGGTT-1_V12D07-335_D1,0,3,0,0,0,3
GTTAATGTCTATCTTA-1_V12D07-335_D1,1,0,1,0,0,2
GCGTTATATTTGGAAC-1_V12D07-335_D1,0,1,0,0,0,1
CGTCAAGGCTATAAAT-1_V12D07-335_D1,0,0,0,0,0,0
TTAGCTCTGTAATCCG-1_V12D07-335_D1,0,0,0,0,0,0
AATGGTCCACCGTTCA-1_V12D07-335_D1,0,3,0,0,0,3
GTCATTGCATTGACCC-1_V12D07-335_D1,0,2,0,0,0,2
TGTCCGTGGCGCCTTT-1_V12D07-335_D1,0,0,0,0,0,0
TCAACTAACGTATAAC-1_V12D07-335_D1,0,0,0,0,0,0
TCCTCTCCAGTTGTCC-1_V12D07-335_D1,0,0,1,0,0,1
TGTGTTCGTATCCAAG-1_V12D07-335_D1,0,1,1,0,0,2
CCGCGTAGGTAAGGGC-1_V12D07-335_D1,0,2,0,0,0,2
CTGCGGGTGAAATGTT-1_V12D07-335_D1,0,0,1,0,0,1
TATCTACAGAGGTAAT-1_V12D07-335_D1,0,1,0,0,0,1
CTACTCTAGGCCCGGC-1_V12D07-335_D1,0,1,0,0,0,1
ACAAGCAGTGCCTAGC-1_V12D07-335_D1,0,1,2,0,0,3
TACAAGTCTCGTGCAT-1_V12D07-335_D1,2,1,0,0,0,3
TCGGAATGCGCTCTGA-1_V12D07-335_D1,0,1,0,0,0,1
TCGCGTCCAGAAGGTC-1_V12D07-335_D1,0,2,0,0,0,2
TATGGCCCGGCCTCGC-1_V12D07-335_D1,0,2,0,0,0,2
GCTGGCATATTCACCT-1_V12D07-335_D1,0,2,2,0,0,4
GTCAGAATAGTCTATG-1_V12D07-335_D1,0,1,0,0,0,1
GGCGTCCTATCCGCTG-1_V12D07-335_D1,1,3,0,0,0,4
CGGAGTTTGAGAGACA-1_V12D07-335_D1,0,2,0,0,0,2
AGCACTTAAGGACGCC-1_V12D07-335_D1,0,4,0,0,0,4
TCCACAATGGTTTACG-1_V12D07-335_D1,0,0,0,0,0,0
CCAACGATGCACTGAT-1_V12D07-335_D1,1,1,1,0,0,3
ATTTACAGTTTACTGG-1_V12D07-335_D1,0,6,0,0,0,6
CCCTGAAATGAGTTGA-1_V12D07-335_D1,1,1,0,0,0,2
CAAACGGTCGCACTTT-1_V12D07-335_D1,1,2,1,0,0,4
TGATTCGTCTATCACT-1_V12D07-335_D1,0,1,1,0,0,2
TCAGGTTCTTTGAGAA-1_V12D07-335_D1,1,1,0,0,0,2
CACGCAGCGAGGCTTT-1_V12D07-335_D1,2,1,0,0,0,3
TTAAGCGCCTGACCCA-1_V12D07-335_D1,0,0,0,0,0,0
CTTACACGGTATTCCA-1_V12D07-335_D1,4,1,0,1,0,6
AAGGCTGTGCTCATCG-1_V12D07-335_D1,1,2,1,0,0,4
GACCAGAGCCCTGTAG-1_V12D07-335_D1,6,1,0,1,0,8
TCCCAGGCTTAGCTAA-1_V12D07-335_D1,0,2,0,0,0,2
ATTGAAGATCTTAGTG-1_V12D07-335_D1,6,3,0,0,0,9
AGTTCCTACAGAATTA-1_V12D07-335_D1,0,2,0,0,1,3
GGGCTGGTTAGTCGCG-1_V12D07-335_D1,5,1,1,0,0,7
GAAATGGCGGTGTTAG-1_V12D07-335_D1,6,4,0,0,0,10
TACGAACACGACTTCA-1_V12D07-335_D1,7,1,0,0,0,8
ACCACAAGTTTCTATC-1_V12D07-335_D1,7,5,0,0,0,12
ATATTTAACCCTCAAG-1_V12D07-335_D1,9,2,0,0,0,11
GATCATTCCAAACATT-1_V12D07-335_D1,2,3,0,0,0,5
TCCAGGCGAGTACGGT-1_V12D07-335_D1,8,1,0,0,1,10
GTTTGACCAAATCCTA-1_V12D07-335_D1,17,0,0,0,0,17
CACAGCACCCACGGCA-1_V12D07-335_D1,18,0,0,0,1,19
TGCAAGAATGACGTAA-1_V12D07-335_D1,6,2,1,0,0,9
GCGAAGCCATACCCGT-1_V12D07-335_D1,1,3,0,0,0,4
TCCTTTCTTACGCTTA-1_V12D07-335_D1,0,1,0,0,0,1
GCTGCTCTCCGGACAC-1_V12D07-335_D1,0,1,1,0,0,2
ACTGTCTTCTTTAGAA-1_V12D07-335_D1,0,1,1,0,0,2
TCAAACTTAGATTGTT-1_V12D07-335_D1,0,1,1,0,0,2
CTATGTCACTAGCCCA-1_V12D07-335_D1,0,0,0,0,0,0
TGCGCAAAGCATTTGG-1_V12D07-335_D1,0,3,1,0,0,4
TTAATGTAGACCAGGT-1_V12D07-335_D1,0,4,3,0,0,7
GGCGGTAGGATCATTG-1_V12D07-335_D1,2,2,0,0,0,4
GGCAATAGTCAATGAG-1_V12D07-335_D1,1,2,5,0,0,8
ACACGAGACTCCTTCT-1_V12D07-335_D1,0,2,6,0,0,8
GACACAAGGGAAGAAA-1_V12D07-335_D1,0,3,3,0,0,6
TCAGCAAATGCATCTC-1_V12D07-335_D1,0,0,4,0,0,4
GAGATCTGTCACTCCG-1_V12D07-335_D1,0,1,3,0,0,4
ATGCCGGTCTTGCATA-1_V12D07-335_D1,0,1,5,0,0,6
TTGGGCGGCGGTTGCC-1_V12D07-335_D1,0,2,2,0,0,4
TTGTTGTGTGTCAAGA-1_V12D07-335_D1,0,2,2,0,0,4
ACTGTACGATACACAT-1_V12D07-335_D1,0,2,2,0,0,4
TCCACTTTATCTAGGT-1_V12D07-335_D1,0,0,0,0,0,0
GGTCTGAGAATCTGGA-1_V12D07-335_D1,0,0,1,0,0,1
TAGAAAGGTGGCGCTA-1_V12D07-335_D1,0,2,0,0,0,2
TATGTCTCATTGTGCC-1_V12D07-335_D1,0,3,0,0,0,3
GGATTTCACTTCTATA-1_V12D07-335_D1,0,1,1,0,0,2
TGAGTGGTCCGTGACG-1_V12D07-335_D1,1,0,0,0,0,1
CGCTTTCTTGCATTCG-1_V12D07-335_D1,0,0,2,0,0,2
ACCCAACGCCCGTGGC-1_V12D07-335_D1,0,1,0,0,0,1
GAACGTCTCATGGTCG-1_V12D07-335_D1,0,0,0,0,0,0
AGGGTTCCCTTTGGTT-1_V12D07-335_D1,0,0,0,0,2,2
GTAGCTTCCTCTTGTT-1_V12D07-335_D1,0,0,0,0,0,0
GCATGAGGGACGCGGC-1_V12D07-335_D1,0,0,0,0,0,0
CTACCCTAAGGTCATA-1_V12D07-335_D1,0,0,0,0,0,0
TCACCGCTCGGCACTC-1_V12D07-335_D1,0,0,0,0,0,0
GGCTCGCGTTGAGGTA-1_V12D07-335_D1,0,0,1,0,0,1
CTAACGAAACTTGCTG-1_V12D07-335_D1,0,0,0,0,0,0
TTAAACTCGAATTCAT-1_V12D07-335_D1,0,1,0,0,0,1
TACTTTACTGAGCCGG-1_V12D07-335_D1,0,3,0,0,0,3
GCTTGGATCGATTAGG-1_V12D07-335_D1,0,1,0,0,0,1
CGGTTATCCAACAGTG-1_V12D07-335_D1,0,1,0,0,0,1
CAGACCTGTAAGTGTT-1_V12D07-335_D1,1,2,2,0,0,5
GACGGTCAATAGAAGC-1_V12D07-335_D1,0,1,0,0,0,1
CTGACTGCGCAGCTCG-1_V12D07-335_D1,0,0,0,1,0,1
CCATACCTTTACTTGT-1_V12D07-335_D1,0,2,0,0,0,2
GTAATAAAGGGCTCCC-1_V12D07-335_D1,0,1,0,0,0,1
GTGAACTCCCATTCGA-1_V12D07-335_D1,0,0,0,0,0,0
GTGGTTACTTCTTTCG-1_V12D07-335_D1,0,0,0,0,0,0
TCAGAACCTCCACAGG-1_V12D07-335_D1,0,0,0,0,0,0
TCCCACTCTCTTCCGG-1_V12D07-335_D1,0,0,0,0,0,0
ATCTTGACTTGTCCAA-1_V12D07-335_D1,0,0,0,0,0,0
TCGGGAACGTGCCTAG-1_V12D07-335_D1,0,0,0,0,0,0
GTTAGCCGTAAATCAA-1_V12D07-335_D1,0,0,0,0,0,0
ATTTACTAAGTCCATT-1_V12D07-335_D1,0,1,0,1,0,2
GGGTGCATATGAAAGC-1_V12D07-335_D1,1,0,0,0,0,1
TCCGAATGGTCCTGAG-1_V12D07-335_D1,1,4,0,0,0,5
TGATGGCTGTTTCTGA-1_V12D07-335_D1,0,0,0,0,0,0
AAATAAGGTAGTGCCC-1_V12D07-335_D1,0,0,0,0,0,0
CCACTATCCGGGTCAC-1_V12D07-335_D1,0,1,0,0,1,2
ACACCACATAATTAGC-1_V12D07-335_D1,0,0,2,0,0,2
CGCGGTAAGTCTAGCT-1_V12D07-335_D1,2,0,2,1,2,7
GCGGGCATTACGATGC-1_V12D07-335_D1,0,2,0,0,1,3
AGGATTGCTTACGACA-1_V12D07-335_D1,0,2,3,0,0,5
CTCGGGATAACACCTA-1_V12D07-335_D1,0,0,1,0,2,3
GTCGTCTGGTTGGCTA-1_V12D07-335_D1,0,1,2,1,0,4
GCAATTAGTCGCACCG-1_V12D07-335_D1,0,1,5,0,0,6
GTGACCTAAAGAATAA-1_V12D07-335_D1,0,4,1,0,0,5
CTGAGCGAGACTTATT-1_V12D07-335_D1,0,2,2,0,0,4
CAAGACTCAGAAGCGC-1_V12D07-335_D1,0,1,0,1,0,2
ACTTCGCTAGCGAGTG-1_V12D07-335_D1,0,5,0,0,0,5
CCATACTCGCCTCTCC-1_V12D07-335_D1,0,1,0,0,0,1
ACGATACCTATCCTGA-1_V12D07-335_D1,0,1,0,0,0,1
CTCACCAGTACAAGTG-1_V12D07-335_D1,0,1,0,0,0,1
CGAAGACGGTGAGTGC-1_V12D07-335_D1,1,1,1,0,0,3
AAATTAATAAGCGCGA-1_V12D07-335_D1,0,0,0,0,0,0
GGGCCCTTATCTATAC-1_V12D07-335_D1,0,0,0,0,0,0
CTGCCCACGAAGCGTT-1_V12D07-335_D1,0,0,1,0,0,1
GGACAAGTTGCAGTGA-1_V12D07-335_D1,0,2,0,0,0,2
GTCCGAGAGCAATCAT-1_V12D07-335_D1,0,1,0,0,0,1
ATGGCAGCCGAGAAAC-1_V12D07-335_D1,0,1,0,0,0,1
CCTCGGATGCTACCTG-1_V12D07-335_D1,0,2,0,0,0,2
ATACGGTGAAGATGCA-1_V12D07-335_D1,0,1,0,0,0,1
ACATCAGCTGGGACGC-1_V12D07-335_D1,0,1,1,0,0,2
GGTTGTGTAGCCTGGC-1_V12D07-335_D1,0,2,2,0,0,4
CCTGCGTTCTACGCTT-1_V12D07-335_D1,0,4,1,0,0,5
GAACGTTAGGAAGACG-1_V12D07-335_D1,0,0,1,0,0,1
CTGATAGTGTATCTCA-1_V12D07-335_D1,0,1,0,0,0,1
TTCTGCGAGCGCCCTT-1_V12D07-335_D1,0,1,1,0,0,2
CTTTGGCGCTTTATAC-1_V12D07-335_D1,0,3,2,0,0,5
TCCGAACTTGGCTTAC-1_V12D07-335_D1,0,1,1,0,0,2
TAGATTCCTGGTTATT-1_V12D07-335_D1,0,1,0,0,0,1
CCGACAAAGGGAGTGC-1_V12D07-335_D1,1,3,1,0,0,5
CCATGGCCCTTGTACC-1_V12D07-335_D1,0,3,0,0,0,3
GAAATATCACCATCAG-1_V12D07-335_D1,5,2,0,0,0,7
ACGAAATGGGCGGCAC-1_V12D07-335_D1,20,1,0,0,0,21
GTGAGCGTGCTGCACT-1_V12D07-335_D1,21,0,0,0,0,21
CCGCGGGTACGAAGAA-1_V12D07-335_D1,4,4,0,2,0,10
TCCCTGGCTCGCTGGA-1_V12D07-335_D1,6,4,0,0,0,10
CAGCTTAGTAGGTAGC-1_V12D07-335_D1,1,3,0,2,0,6
CACGAAAGTTAGTCCC-1_V12D07-335_D1,0,2,1,0,0,3
ACCTAATCGACTTCCT-1_V12D07-335_D1,0,2,1,0,0,3
AAGTAGTGACGCGAGG-1_V12D07-335_D1,0,0,1,0,0,1
TCCGATTACATTGCCG-1_V12D07-335_D1,0,3,0,0,0,3
CCTCCGACAATTCAAG-1_V12D07-335_D1,2,1,0,0,0,3
GTTCACAGGAGTCTAG-1_V12D07-335_D1,0,3,0,0,0,3
CGAAGTTGCTCTGTGT-1_V12D07-335_D1,8,3,0,1,0,12
GTCGGATATCTCAGAC-1_V12D07-335_D1,0,4,0,0,0,4
CGCTCTCCGTAGATTA-1_V12D07-335_D1,10,1,0,0,0,11
CAAGCAACGTCGGAGT-1_V12D07-335_D1,0,5,2,0,1,8
CCATTCCCTGCCCACA-1_V12D07-335_D1,12,4,0,0,0,16
CTTTGGCTTTAGTAAA-1_V12D07-335_D1,7,2,0,0,0,9
GGCTATTAAGTTGTAT-1_V12D07-335_D1,17,0,0,0,0,17
CCATTAGCGATAATCC-1_V12D07-335_D1,13,1,0,0,0,14
TGTTCTTCCATTGACT-1_V12D07-335_D1,6,3,1,0,0,10
AGATAACTTCAGGGCC-1_V12D07-335_D1,12,2,0,0,0,14
ATAGACGAAGAGAAAG-1_V12D07-335_D1,2,3,0,0,0,5
GGCGGAGTAATATTAG-1_V12D07-335_D1,8,1,0,0,0,9
TGACCCACGTTAGACA-1_V12D07-335_D1,4,3,0,0,0,7
TCACAGGTTATTGGGC-1_V12D07-335_D1,13,2,1,0,0,16
TCACGCATTGTAGATC-1_V12D07-335_D1,8,3,0,0,0,11
TTGAAGAATTCCCAGG-1_V12D07-335_D1,10,2,0,0,0,12
AAATGGTCAATGTGCC-1_V12D07-335_D1,4,1,0,0,0,5
TAGTGCCCTCCAGAGT-1_V12D07-335_D1,3,3,0,0,0,6
GGTATTGCCGAGTTTA-1_V12D07-335_D1,1,3,1,0,0,5
CGTATTAAGAGATCTA-1_V12D07-335_D1,15,3,0,0,0,18
ACTGTCCAGGATTATA-1_V12D07-335_D1,4,7,0,0,0,11
CGGGCAGCTAAACCGC-1_V12D07-335_D1,8,1,1,0,0,10
TTGCTGATCATGTTCG-1_V12D07-335_D1,3,4,0,0,0,7
TATGGGTACGTATCGT-1_V12D07-335_D1,10,4,0,0,0,14
CAGCTCACTGAGACAT-1_V12D07-335_D1,3,3,0,1,0,7
GGGACTGCATAGATAG-1_V12D07-335_D1,2,8,1,0,2,13
ACGCATTCGTGAGTAC-1_V12D07-335_D1,0,2,0,0,0,2
CTCTGGACGCCTGGTG-1_V12D07-335_D1,0,2,1,0,0,3
AGGGTTTAGTTCGGGA-1_V12D07-335_D1,0,0,0,0,0,0
GGGAGAACTCACAGTA-1_V12D07-335_D1,0,2,1,0,0,3
ATCAATCTGGGCTGCA-1_V12D07-335_D1,0,0,0,0,0,0
TCTTCGATACCAATAA-1_V12D07-335_D1,0,1,1,0,0,2
ACGTAGATTGCTGATG-1_V12D07-335_D1,0,0,7,0,0,7
TCTTGATGCGTAGCGA-1_V12D07-335_D1,0,1,5,0,0,6
GGGCTGCCTAGGGCGA-1_V12D07-335_D1,0,3,3,0,0,6
CTCTCACAATCGATGA-1_V12D07-335_D1,0,4,6,0,0,10
CCAAGCGTAACTCGTA-1_V12D07-335_D1,0,3,1,0,0,4
ACAACAGCATGAGCTA-1_V12D07-335_D1,0,7,2,0,0,9
GTCCCAACGTAAAGTA-1_V12D07-335_D1,0,3,2,0,0,5
TCGGAGTACATGAGTA-1_V12D07-335_D1,0,0,1,0,0,1
GGGAGTTAATGAGGCG-1_V12D07-335_D1,0,2,8,0,0,10
CCGGGCGGTCTCGTCA-1_V12D07-335_D1,0,1,1,0,0,2
CCGTAAGTTGGTCCCA-1_V12D07-335_D1,0,1,2,0,1,4
GGAGGGCTTGGTTGGC-1_V12D07-335_D1,0,2,1,0,0,3
TCGGACGCCCAGCCCA-1_V12D07-335_D1,0,4,3,0,2,9
TCTGTGCCATCATAGT-1_V12D07-335_D1,0,2,0,0,0,2
GTACTGGAGTTAGACC-1_V12D07-335_D1,0,1,0,0,0,1
GGAATGCGCTAGCGTG-1_V12D07-335_D1,0,2,3,0,0,5
GTGTGAATAACTTAGG-1_V12D07-335_D1,1,4,0,0,0,5
GGTCGGCCAGGAGCTT-1_V12D07-335_D1,0,2,1,0,0,3
TAGCCGGCGGTCAGCG-1_V12D07-335_D1,0,2,1,0,0,3
CGGGTGTACCCATTTA-1_V12D07-335_D1,0,1,0,0,0,1
AGTGATTCAAGCAGGA-1_V12D07-335_D1,0,1,0,0,0,1
GTTGGATTGAGAACAC-1_V12D07-335_D1,0,1,0,0,0,1
CACACGCGCTGTCTTA-1_V12D07-335_D1,0,1,0,0,0,1
TAGACGCCCGTACCGG-1_V12D07-335_D1,0,0,0,0,0,0
GGTTTCAATCGGTCAG-1_V12D07-335_D1,0,0,0,0,0,0
AATCTGCGTTGGGACG-1_V12D07-335_D1,0,0,0,0,0,0
TTACGGATGGTTCGAG-1_V12D07-335_D1,0,1,3,1,0,5
CGGCAGGGTCGGGTTG-1_V12D07-335_D1,0,1,1,0,0,2
GCTTTCAGAGGAGGTG-1_V12D07-335_D1,0,0,0,0,0,0
TCTTCCCATGGGCACA-1_V12D07-335_D1,0,1,0,0,0,1
TACCGCGGACTTGCAG-1_V12D07-335_D1,0,1,0,0,0,1
AGAATTATGGATTCGA-1_V12D07-335_D1,0,2,0,1,0,3
ATTGATGAGTCCTAAC-1_V12D07-335_D1,0,0,0,0,0,0
TAGGTCGCCGGAACTG-1_V12D07-335_D1,0,3,1,0,0,4
TAACCTACCGTCCGAG-1_V12D07-335_D1,0,0,0,1,0,1
CTTAGTAGGCCTACAG-1_V12D07-335_D1,0,1,0,0,0,1
CTAGATGTGAGTGTAA-1_V12D07-335_D1,0,0,0,0,0,0
ACTCCCGAATTCGTTT-1_V12D07-335_D1,0,0,0,0,0,0
GTTCATCGTTTGGCTG-1_V12D07-335_D1,0,0,0,0,0,0
ACTTTACCCTCATGAA-1_V12D07-335_D1,0,0,0,0,0,0
GCGAGAGTTGCGTCCA-1_V12D07-335_D1,0,0,0,0,0,0
GTTCGGGCGTACCATT-1_V12D07-335_D1,0,0,0,0,0,0
CGACTTTGTATAGCCT-1_V12D07-335_D1,0,0,0,0,0,0
GCCATCGATGCTGCAT-1_V12D07-335_D1,0,2,0,2,0,4
GCATTTCCAAGGCTCC-1_V12D07-335_D1,0,1,0,2,0,3
ATGTAAGGCTGCTCTT-1_V12D07-335_D1,3,1,0,0,0,4
ACGTTCGCAATCAATT-1_V12D07-335_D1,2,1,0,1,0,4
GTGACGAGGGTGACCC-1_V12D07-335_D1,1,2,0,0,0,3
ATTATAGCTACTTTAC-1_V12D07-335_D1,0,2,0,0,0,2
CGTGTGTTAAACCCTG-1_V12D07-335_D1,0,0,0,0,1,1
TTGGTATGGCTTGTGT-1_V12D07-335_D1,0,1,0,0,0,1
CATTCCCATTCCGTCG-1_V12D07-335_D1,0,0,1,0,1,2
TGCCGAAAGCGTATTC-1_V12D07-335_D1,0,0,0,0,2,2
CAACACATCTCCTGCC-1_V12D07-335_D1,0,0,3,0,0,3
CTGCCTCATATGCAAC-1_V12D07-335_D1,0,1,1,0,0,2
TCCCGCCTATGTGCGT-1_V12D07-335_D1,0,1,3,0,0,4
GGTTACCCGACACTTT-1_V12D07-335_D1,0,1,3,0,0,4
CCAGCGGGATCACCAG-1_V12D07-335_D1,2,1,3,1,0,7
ATGTTTCGGCCCGGAG-1_V12D07-335_D1,0,0,1,0,0,1
GCGTCTAACCTCCTAA-1_V12D07-335_D1,0,0,0,0,0,0
ATCAGGTAGCTGACAG-1_V12D07-335_D1,0,0,4,0,0,4
GGTATGAAAGAACTGA-1_V12D07-335_D1,0,1,0,0,0,1
GTGGCCTAATATCATT-1_V12D07-335_D1,0,1,0,0,0,1
CCTGTGAAACCGTAAC-1_V12D07-335_D1,1,2,1,0,0,4
GGCAGAGAGATCGGGA-1_V12D07-335_D1,0,2,0,0,0,2
TAGCGTCGAATATTGA-1_V12D07-335_D1,0,3,0,0,0,3
CGCCGACTATTCGCTA-1_V12D07-335_D1,1,0,1,0,0,2
TCTGGCGCAAGCCGGG-1_V12D07-335_D1,0,3,1,0,0,4
AGTGGTTGCGTATAGG-1_V12D07-335_D1,0,2,0,0,0,2
ATCGGTTACCTAGTAA-1_V12D07-335_D1,0,0,1,0,0,1
CCTGCCCGTTGTCTAG-1_V12D07-335_D1,0,1,0,0,0,1
GCACACGCCCATGGTC-1_V12D07-335_D1,0,1,2,0,1,4
AGTACGGCCCGTATCG-1_V12D07-335_D1,0,1,1,0,0,2
TATCTAGCCTAAAGGA-1_V12D07-335_D1,0,0,0,0,0,0
CACTCGGTTAGGAGGA-1_V12D07-335_D1,0,0,3,0,0,3
ATGTTCGTCGACCCAC-1_V12D07-335_D1,0,1,2,0,0,3
TTCCTCTGCCCGAATA-1_V12D07-335_D1,0,3,1,0,0,4
TTACTATCGGCTTCTC-1_V12D07-335_D1,0,1,2,0,0,3
GCCGCATTAGTCCGGC-1_V12D07-335_D1,0,1,3,0,0,4
TAAGGGCTGGGAGAGG-1_V12D07-335_D1,0,0,0,0,0,0
TAAGCAGGCGACACGC-1_V12D07-335_D1,0,1,0,0,0,1
AGCACTACCGGCCTGT-1_V12D07-335_D1,0,0,0,0,0,0
GAAAGCCCTTTGGACC-1_V12D07-335_D1,0,1,1,0,0,2
GACCGACTGAAGCGTC-1_V12D07-335_D1,0,2,0,0,0,2
CGGTGAAGACTAAAGT-1_V12D07-335_D1,0,2,0,0,0,2
CCCTGCGCTACGCATA-1_V12D07-335_D1,1,4,1,0,0,6
TACTGGACAGCTCGGC-1_V12D07-335_D1,0,0,0,0,0,0
TTAGTAGGGCGGCGGG-1_V12D07-335_D1,3,1,1,0,0,5
GAGGCTATCAAAGTCG-1_V12D07-335_D1,3,2,0,0,0,5
TTACCATTGATTACCC-1_V12D07-335_D1,15,1,0,0,0,16
ATACCACGGGCAACTT-1_V12D07-335_D1,2,0,1,0,0,3
TGTCCTAAGTCACCGC-1_V12D07-335_D1,18,0,0,0,0,18
AGGTAGGTACAAAGCT-1_V12D07-335_D1,2,1,0,0,0,3
GGCATACAGGTAGCGG-1_V12D07-335_D1,16,1,0,0,0,17
TGTAGTGATCTATAAT-1_V12D07-335_D1,2,1,0,0,0,3
TCCCGGGTGTGCTGCT-1_V12D07-335_D1,16,1,0,0,0,17
TACGATGTTGATCATC-1_V12D07-335_D1,0,1,0,0,0,1
CCTCTCTCCCATCTAG-1_V12D07-335_D1,7,3,1,0,0,11
GCAGGACTATAGAATA-1_V12D07-335_D1,0,2,0,0,0,2
CTAGTGAAGGACAGGA-1_V12D07-335_D1,18,1,0,0,0,19
TACGAGAACTTCACGT-1_V12D07-335_D1,0,0,0,0,0,0
CGTTGTTTCAATTCCC-1_V12D07-335_D1,2,1,0,0,0,3
GCAAATATTACGCTTT-1_V12D07-335_D1,0,3,0,0,0,3
CCAATAGTGCCGTCGA-1_V12D07-335_D1,0,0,0,0,0,0
ATTGCTGCTCCTCCAT-1_V12D07-335_D1,0,1,0,0,0,1
GAGATCTGCTTGGCAT-1_V12D07-335_D1,0,0,0,0,0,0
GCCGAAATTCCTACGT-1_V12D07-335_D1,0,0,1,0,0,1
GGCACTCCACTGGGCA-1_V12D07-335_D1,0,2,0,0,2,4
GGGTCACCGTGACGGT-1_V12D07-335_D1,0,0,0,0,0,0
CACTTAATCAGACGGA-1_V12D07-335_D1,0,1,0,0,0,1
CGTTTCGCTCATTACA-1_V12D07-335_D1,0,5,0,0,0,5
ATAAAGGCTCGGTCGT-1_V12D07-335_D1,0,2,0,0,0,2
CACTAAAGTTGCCTAT-1_V12D07-335_D1,0,1,0,0,0,1
GTGCTCAAGTACTGTC-1_V12D07-335_D1,0,4,0,0,0,4
CCATGCCTGTTTAGTA-1_V12D07-335_D1,0,1,0,0,0,1
TCTAGTTATCAGAAGA-1_V12D07-335_D1,0,1,0,0,0,1
TTGTAATCCGTACTCG-1_V12D07-335_D1,0,3,0,0,0,3
TCCCAGCTTTAGTCTG-1_V12D07-335_D1,0,1,0,0,0,1
CTACGCACGGAGTACC-1_V12D07-335_D1,0,1,0,0,0,1
AAATTAACGGGTAGCT-1_V12D07-335_D1,1,3,0,0,0,4
CGGCCACGCACAAAGT-1_V12D07-335_D1,0,0,0,0,0,0
GAAGCGTGAGGAATTT-1_V12D07-335_D1,0,2,0,0,0,2
ATATCTTAGGGCCTTC-1_V12D07-335_D1,0,1,0,0,0,1
ACGCGGGCCAAGGACA-1_V12D07-335_D1,0,0,1,0,0,1
GCGAGTTCTGCAAAGA-1_V12D07-335_D1,0,5,3,0,0,8
TATTCGTGCCAGAATA-1_V12D07-335_D1,0,0,1,0,0,1
AGGGCTGCAGTTACAG-1_V12D07-335_D1,0,2,4,0,0,6
CTAGCATAGTATAATG-1_V12D07-335_D1,0,1,4,0,1,6
TAGGTTCGAGTTCGTC-1_V12D07-335_D1,0,1,1,0,0,2
GAATTATAGTGAAAGG-1_V12D07-335_D1,0,0,5,0,0,5
CTATCGGGTCTCAACA-1_V12D07-335_D1,0,4,3,0,0,7
GCGCTAATTGAATAGA-1_V12D07-335_D1,0,1,3,0,0,4
ATGCGACAGTCCCATT-1_V12D07-335_D1,0,2,4,0,0,6
GGTAGTGCTCGCACCA-1_V12D07-335_D1,0,7,4,2,0,13
AAGCTCGTGCCAAGTC-1_V12D07-335_D1,0,2,4,0,0,6
TATTCAATTCTAATCC-1_V12D07-335_D1,0,4,3,0,0,7
TTCAAAGTCTCTAGCC-1_V12D07-335_D1,0,2,1,0,0,3
TTGAATATGGACTTTC-1_V12D07-335_D1,0,4,1,0,0,5
AAGAGCTCTTTATCGG-1_V12D07-335_D1,0,0,0,0,0,0
TTACTCCGGCCGGGAA-1_V12D07-335_D1,0,5,1,0,1,7
AAACGAGACGGTTGAT-1_V12D07-335_D1,0,0,0,0,0,0
GCTAAGTAGTTTCTCT-1_V12D07-335_D1,0,1,0,0,0,1
ATAACGCCGGAGGGTC-1_V12D07-335_D1,0,2,2,0,1,5
GGATCCGGAATATACT-1_V12D07-335_D1,1,0,3,0,1,5
TGAAAGGACCTGACTC-1_V12D07-335_D1,0,1,0,0,0,1
TCCGCGGCAGCATCTG-1_V12D07-335_D1,0,0,0,0,0,0
TGCATATGTCTGTCAC-1_V12D07-335_D1,0,2,0,0,0,2
TGTAGGAGAAATTTCC-1_V12D07-335_D1,0,2,1,0,1,4
AGTGAGACTTCCAGTA-1_V12D07-335_D1,1,0,1,0,0,2
CCCAAACATGCTGCTC-1_V12D07-335_D1,0,0,0,0,0,0
GCTTATGAAGCAGGAA-1_V12D07-335_D1,0,0,0,0,0,0
TTCTAACCGAAGCTTA-1_V12D07-335_D1,0,0,1,0,0,1
GGATGTCCTTACCGCA-1_V12D07-335_D1,0,2,1,0,0,3
AGGGTGCTCTCGAGGG-1_V12D07-335_D1,0,0,0,0,0,0
AACTCTCAATAGAGCG-1_V12D07-335_D1,0,2,0,0,0,2
TCTGAATTCCGTACAA-1_V12D07-335_D1,0,0,0,0,0,0
GCGTGGTACTGGGTTA-1_V12D07-335_D1,0,3,0,0,0,3
CGTCGGATAGTGTTGA-1_V12D07-335_D1,0,2,0,0,0,2
ATATGTCTCCCTAGCC-1_V12D07-335_D1,0,0,0,0,0,0
TCTTTAAGACTATGAA-1_V12D07-335_D1,0,1,0,0,0,1
TCATTTAAGTCTCCGA-1_V12D07-335_D1,0,0,0,0,0,0
GATATTGAGATTGGCG-1_V12D07-335_D1,1,1,0,0,0,2
TGACATCGAGCGGACC-1_V12D07-335_D1,0,0,0,0,0,0
GCGTAAATGGCCATAA-1_V12D07-335_D1,0,3,0,0,0,3
ATTGTACAACTCGGCT-1_V12D07-335_D1,2,1,0,0,0,3
TACGCTATAGAAACCT-1_V12D07-335_D1,0,1,0,0,0,1
CACCCAAATCTTATGT-1_V12D07-335_D1,0,0,1,0,0,1
AGATGATGGAGTCTGG-1_V12D07-335_D1,0,0,0,0,0,0
CCACGGTGCCCGGTAG-1_V12D07-335_D1,0,0,0,0,0,0
TCAAGAAATACTAGCT-1_V12D07-335_D1,0,0,0,0,0,0
AGGTATAATTGATAGT-1_V12D07-335_D1,0,0,0,0,0,0
CAAGGTCCTATAGGCT-1_V12D07-335_D1,0,0,0,0,0,0
CCGGCACGACCGTTTC-1_V12D07-335_D1,0,0,0,0,0,0
ACCTCCGTTATTCACC-1_V12D07-335_D1,0,2,2,0,0,4
GCAGCCTATATCACAT-1_V12D07-335_D1,0,1,0,0,0,1
GGTATAGTGACACATA-1_V12D07-335_D1,1,2,0,0,0,3
AAATTCCAGGTCCAAA-1_V12D07-335_D1,0,0,0,0,1,1
TCTTTAGCAGGCGAAC-1_V12D07-335_D1,0,2,0,1,1,4
TATTGACATTTCTGCC-1_V12D07-335_D1,0,1,0,0,0,1
TCTGATCGGGTGCTAG-1_V12D07-335_D1,0,0,1,0,1,2
GGCCCGGAGCATGTCT-1_V12D07-335_D1,0,2,3,0,0,5
GGGCGCAGCGTTACTC-1_V12D07-335_D1,0,1,0,0,0,1
TTGGCGATCCGAATAT-1_V12D07-335_D1,0,5,6,0,0,11
CCACGTAAATTAGACT-1_V12D07-335_D1,0,0,2,0,1,3
TCTGATTGGAAATGGA-1_V12D07-335_D1,0,1,2,0,0,3
ATGGCGGAATAGTCGC-1_V12D07-335_D1,0,1,0,2,0,3
ATCGCTTTACGTCTCA-1_V12D07-335_D1,0,2,2,0,0,4
TACGTGCAAGGTTCCT-1_V12D07-335_D1,0,2,0,1,0,3
CAGGACAGCTGCCCTT-1_V12D07-335_D1,0,0,3,0,0,3
CAAACCAGGTCTGCAT-1_V12D07-335_D1,0,0,0,0,0,0
ACAAGCTATATGGAAG-1_V12D07-335_D1,0,1,0,0,0,1
TCGCCCACTGCGAGAG-1_V12D07-335_D1,0,2,0,0,0,2
AGCCGCAAATTCAAAT-1_V12D07-335_D1,0,6,0,0,0,6
TTAACGTTAAAGCCTG-1_V12D07-335_D1,0,1,2,0,0,3
CAGCGCCAACACGATA-1_V12D07-335_D1,0,1,0,0,0,1
ATCCAATGGTACCGAA-1_V12D07-335_D1,0,1,0,0,0,1
GTGCTGCAGATAAGGA-1_V12D07-335_D1,0,0,4,0,0,4
GGCCTTTGCAACTGGC-1_V12D07-335_D1,0,0,0,0,0,0
GTCGTACCTACGATTG-1_V12D07-335_D1,0,2,3,0,0,5
TAGAAATTCACGTATA-1_V12D07-335_D1,0,3,1,0,0,4
AGAATAAATCTTCAGG-1_V12D07-335_D1,0,3,2,0,0,5
CATTGCGAAATGGGCG-1_V12D07-335_D1,0,1,2,0,0,3
GTCTACTCAATTACAA-1_V12D07-335_D1,0,2,2,0,0,4
TGTAATGACCACAATA-1_V12D07-335_D1,0,0,3,0,0,3
AAAGTCGACCCTCAGT-1_V12D07-335_D1,0,0,5,1,0,6
TACTCGGCACGCCGGG-1_V12D07-335_D1,0,2,8,0,0,10
AGGTGTATCGCCATGA-1_V12D07-335_D1,0,1,3,0,0,4
TGTGCTTTACGTAAGA-1_V12D07-335_D1,0,0,1,0,0,1
AAACCTCATGAAGTTG-1_V12D07-335_D1,0,1,3,0,0,4
TATAGGGTACTCATGA-1_V12D07-335_D1,0,3,2,0,0,5
CCAGCTGATGGTACTT-1_V12D07-335_D1,0,1,3,0,0,4
AATATTGGAGTATTGA-1_V12D07-335_D1,0,3,1,0,0,4
GGCCCTCACCCACTTA-1_V12D07-335_D1,0,1,0,0,0,1
AACCAAGACTTCTCTG-1_V12D07-335_D1,0,1,0,0,0,1
TCGTATTACCCATTGC-1_V12D07-335_D1,0,1,0,0,0,1
ATTCGACGCCGGGCCT-1_V12D07-335_D1,0,2,1,0,0,3
GGCGCAGGACATCTTC-1_V12D07-335_D1,0,2,0,0,0,2
GTACTCCCTTATCGCT-1_V12D07-335_D1,0,1,0,0,0,1
TGGTCTGTTGGGCGTA-1_V12D07-335_D1,0,1,0,0,0,1
AATAACAACGCTCGGC-1_V12D07-335_D1,0,3,0,0,0,3
CATACCCGTACCCAGT-1_V12D07-335_D1,0,1,0,0,0,1
ACAATCCATTTAAACC-1_V12D07-335_D1,0,2,0,0,0,2
GTTACAATTGGTGACG-1_V12D07-335_D1,0,2,2,0,0,4
TTGCCCTGATCACGGG-1_V12D07-335_D1,0,2,0,0,0,2
CTAACCGCGCGCCCGT-1_V12D07-335_D1,0,0,0,0,0,0
CTAAAGAATGCCTACT-1_V12D07-335_D1,0,0,0,0,0,0
ACCCATCTTGAGGGTA-1_V12D07-335_D1,0,1,0,0,0,1
GATCTTTGCAGGGTAT-1_V12D07-335_D1,0,0,0,0,0,0
GGGTACTTCATGAACT-1_V12D07-335_D1,0,1,0,0,0,1
GCCGCTTGTGAGAAAC-1_V12D07-335_D1,0,1,0,0,0,1
CCTGTAAGACATGATA-1_V12D07-335_D1,0,3,0,0,0,3
CGACAGTTCGCGTTAT-1_V12D07-335_D1,0,1,0,0,0,1
ACGATGCATATGTTAT-1_V12D07-335_D1,0,0,0,0,0,0
TGTTCCGCTTCCATGA-1_V12D07-335_D1,0,0,0,0,0,0
GGATGACGCGAGTTTA-1_V12D07-335_D1,0,2,0,0,0,2
GAAGTTTCCACTCAAT-1_V12D07-335_D1,0,2,0,0,0,2
GCGAGGCCCGAGCAGA-1_V12D07-335_D1,0,4,1,0,1,6
CATACTATGTAATTGT-1_V12D07-335_D1,0,0,0,0,0,0
CCAATGTCACAGCAAG-1_V12D07-335_D1,0,1,0,0,0,1
GTTGGATTTGCGTTGG-1_V12D07-335_D1,0,0,0,0,0,0
GGGAGGATGCCCGAAA-1_V12D07-335_D1,0,4,2,0,0,6
GATCGCGGGCTCTCCA-1_V12D07-335_D1,0,1,2,0,0,3
GTTCGCCATAAGTGCC-1_V12D07-335_D1,0,2,0,0,0,2
AGATTATAGGACGTTT-1_V12D07-335_D1,0,2,1,0,0,3
TCGAGACCAACACCGT-1_V12D07-335_D1,0,0,0,0,0,0
TATGGGACCGAGCAGG-1_V12D07-335_D1,0,0,0,0,0,0
GATGCGTCCTGCATTC-1_V12D07-335_D1,0,1,0,0,0,1
TATGGTCTGAGTAACA-1_V12D07-335_D1,0,0,0,0,1,1
GCATAGAGCACTCAGG-1_V12D07-335_D1,0,2,2,0,0,4
CTTCATTGTCAGTGGA-1_V12D07-335_D1,0,0,0,0,0,0
GCAGATTAGGGATATC-1_V12D07-335_D1,0,3,3,0,0,6
CCTGTCGCCCGTAAAT-1_V12D07-335_D1,0,3,2,0,1,6
CAATTTCGTATAAGGG-1_V12D07-335_D1,1,3,2,0,0,6
GTACACTTACCTGAAG-1_V12D07-335_D1,0,4,4,0,0,8
CCAGCCTGGACCAATA-1_V12D07-335_D1,0,1,2,3,1,7
ATGGAGCAGGCCGTGA-1_V12D07-335_D1,0,2,1,0,0,3
GTCATTAGAGCGAACG-1_V12D07-335_D1,0,2,1,1,1,5
AAGACTGCAAGCTACT-1_V12D07-335_D1,0,3,8,0,0,11
CTAGTCACGTCTTAAG-1_V12D07-335_D1,0,4,2,1,0,7
ACTCTTGTATAGTAAC-1_V12D07-335_D1,1,1,6,1,0,9
ATTAGGCGATGCTTTC-1_V12D07-335_D1,0,4,2,0,0,6
TTCGGGACTAATCGCG-1_V12D07-335_D1,0,2,4,0,0,6
TGGACTGTTCGCTCAA-1_V12D07-335_D1,0,2,2,1,1,6
AACGTGCGAAAGTCTC-1_V12D07-335_D1,0,2,2,0,2,6
CCACCCAAGGAAAGTG-1_V12D07-335_D1,1,2,0,0,0,3
CCGCACAAAGACCAAC-1_V12D07-335_D1,0,0,4,0,0,4
GCGATTGTTAACGTTA-1_V12D07-335_D1,0,1,1,0,1,3
ACTCGTCAGTAATCCC-1_V12D07-335_D1,0,0,0,0,1,1
GGTGATAAGGAGCAGT-1_V12D07-335_D1,0,1,3,0,0,4
AAGAGGCATGGATCGC-1_V12D07-335_D1,0,0,0,1,0,1
CACGTTCGTGCTCTAG-1_V12D07-335_D1,0,3,2,0,0,5
CTATTTGGTTACGGAT-1_V12D07-335_D1,0,1,0,0,0,1
GTACAGAGGCAAGGGT-1_V12D07-335_D1,0,1,0,0,0,1
GGGCCGGCCGAAGTAC-1_V12D07-335_D1,0,1,1,0,0,2
CCTGAACGATATATTC-1_V12D07-335_D1,0,0,0,0,0,0
CCGGGCTGCTCCATAC-1_V12D07-335_D1,0,0,0,0,0,0
TACTTGTTAGTAGTCC-1_V12D07-335_D1,1,0,0,0,0,1
CCTAGGCGTAGCGATC-1_V12D07-335_D1,0,1,0,0,0,1
CTGGCGCACAGGTCTG-1_V12D07-335_D1,0,0,0,0,0,0
ACTTATACTTACCCGG-1_V12D07-335_D1,0,2,0,0,0,2
GAAGTCTCCCTAGCGA-1_V12D07-335_D1,0,0,0,0,0,0
ACCGATGGTAGCATCG-1_V12D07-335_D1,0,0,0,0,0,0
CGAGTTTATCGGACTG-1_V12D07-335_D1,0,0,1,0,0,1
CATAACGGACAGTCGT-1_V12D07-335_D1,0,1,0,0,0,1
TGACGATGCACTAGAA-1_V12D07-335_D1,0,0,1,0,0,1
TAGGGAGCTTGGGATG-1_V12D07-335_D1,0,0,0,0,0,0
AGGGTCGATGCGAACT-1_V12D07-335_D1,0,1,0,0,0,1
TATATCCCTGGGAGGA-1_V12D07-335_D1,0,1,0,1,0,2
CATCTTACACCACCTC-1_V12D07-335_D1,0,0,0,1,0,1
GTGCGACAGGGAGTGT-1_V12D07-335_D1,0,1,0,0,0,1
CCGATCTCAACCTTAT-1_V12D07-335_D1,0,0,0,0,0,0
ACGATCATCTTGTAAA-1_V12D07-335_D1,0,0,0,0,0,0
GAAAGAACAGCGTTAT-1_V12D07-335_D1,0,1,0,0,0,1
CTAGGTCTGAAGGAAT-1_V12D07-335_D1,0,1,0,0,0,1
ATATCAACCTACAGAG-1_V12D07-335_D1,0,1,0,0,0,1
AAATAGCTTAGACTTT-1_V12D07-335_D1,0,0,0,0,0,0
GCGACATGTAAACATC-1_V12D07-335_D1,0,0,0,0,0,0
ATAAGTAGGGCGACTC-1_V12D07-335_D1,0,0,0,0,0,0
GCGAGCGCATGCTCCC-1_V12D07-335_D1,0,0,0,0,0,0
AGGGACCGGCTGCGTT-1_V12D07-335_D1,0,1,0,0,1,2
CCTATGAAGTGGTGCC-1_V12D07-335_D1,2,1,0,0,0,3
GCTTACGTAGTTAGTA-1_V12D07-335_D1,0,1,0,0,0,1
CATACTTAGGCAATAC-1_V12D07-335_D1,0,1,0,0,0,1
CCTGTCCCTCACGTTA-1_V12D07-335_D1,0,2,1,1,0,4
CAATGTGCCAACCCTT-1_V12D07-335_D1,0,3,0,0,0,3
GTTAAGTTAGAGTGGG-1_V12D07-335_D1,1,0,1,0,1,3
CTGGGATACGCTACCC-1_V12D07-335_D1,0,0,1,0,0,1
AACCTGTCACGGAATT-1_V12D07-335_D1,1,2,1,0,0,4
ACTGCGGACACACCGT-1_V12D07-335_D1,0,1,1,0,0,2
CCGTGAGGCATTCATG-1_V12D07-335_D1,0,3,3,0,0,6
GCCCAGATGCTGGAGA-1_V12D07-335_D1,0,3,0,2,0,5
TCTGGCCGTTCAAGTT-1_V12D07-335_D1,0,1,3,1,0,5
ATACGAAGGCTTTCCA-1_V12D07-335_D1,0,1,3,0,0,4
GATCCGAATATAAGTG-1_V12D07-335_D1,0,0,1,0,0,1
GTGGAGCATGTCGGCC-1_V12D07-335_D1,0,1,2,0,0,3
ACTCTTCAGCTCCCGC-1_V12D07-335_D1,0,1,1,0,0,2
CCCGATAGCCTCGCCT-1_V12D07-335_D1,0,1,3,0,0,4
ACAGGTGTGTTGTTGC-1_V12D07-335_D1,1,0,1,0,0,2
TGAACTGCTATGACTT-1_V12D07-335_D1,0,1,0,0,0,1
TGACATATATGACGAT-1_V12D07-335_D1,0,1,0,0,0,1
AAGTCTTCTGTGGCCT-1_V12D07-335_D1,0,0,0,0,0,0
ACCAGACCATAACAAC-1_V12D07-335_D1,0,1,2,0,0,3
TGAGACGTACCTCTCA-1_V12D07-335_D1,0,0,2,0,0,2
GACCGTTACATGCGAC-1_V12D07-335_D1,0,0,1,0,0,1
GGTTCGGATTATACTA-1_V12D07-335_D1,0,1,0,0,0,1
CCTCCTGAGCCCACAT-1_V12D07-335_D1,0,1,0,0,0,1
CCGCGATTTGGTAGGT-1_V12D07-335_D1,0,0,2,0,0,2
AATCTCTACTGTGGTT-1_V12D07-335_D1,0,2,2,0,0,4
ACTTTGACTGCATCCT-1_V12D07-335_D1,0,0,0,0,0,0
CCCTGACTAACAAATT-1_V12D07-335_D1,0,0,1,0,0,1
ACGCTGTGAGGCGTAG-1_V12D07-335_D1,0,1,4,0,0,5
GCATACGAGGTCTTTA-1_V12D07-335_D1,0,2,3,0,0,5
TCGGGATTCAAACATA-1_V12D07-335_D1,0,1,3,0,0,4
GGGCCCTACGAAAGGG-1_V12D07-335_D1,0,1,3,0,0,4
CGCCAAGAAGCCGAGT-1_V12D07-335_D1,0,2,1,0,0,3
GGTACATCTGGGACGA-1_V12D07-335_D1,0,2,0,0,0,2
GGATGCTGGCGTTCCT-1_V12D07-335_D1,0,2,0,0,0,2
CCGATTCGAGGGACCC-1_V12D07-335_D1,0,2,1,0,0,3
CCACTGGTGGCTGGTT-1_V12D07-335_D1,0,1,0,0,0,1
GACAGGCACACACTAT-1_V12D07-335_D1,0,0,2,1,0,3
TCAACGCGACCGGCAG-1_V12D07-335_D1,0,4,1,1,0,6
CTACGACTAGCTATAA-1_V12D07-335_D1,0,1,0,1,0,2
CGGTTGACCTGGCATA-1_V12D07-335_D1,0,1,0,0,0,1
ATCCTGAATCGCTGCG-1_V12D07-335_D1,1,2,1,0,0,4
GTTTCATATCGTCGCT-1_V12D07-335_D1,0,6,0,2,0,8
ATAAATATTAGCAGCT-1_V12D07-335_D1,0,1,0,0,0,1
AAGAGGATGTACGCGA-1_V12D07-335_D1,0,1,0,0,0,1
TCCTGCGTTGATACTC-1_V12D07-335_D1,0,0,0,0,0,0
CGTGCATTGTCGACGC-1_V12D07-335_D1,0,1,1,0,0,2
CCGGGTTCGAGGTTAC-1_V12D07-335_D1,0,0,0,0,0,0
CCCAATTTCACAACTT-1_V12D07-335_D1,0,0,1,1,1,3
TGATTTATTAGCTGTG-1_V12D07-335_D1,1,0,1,0,0,2
TGGAAGAAGGGAACGT-1_V12D07-335_D1,0,1,0,0,0,1
GACGCTTGCTTCTAAA-1_V12D07-335_D1,0,0,0,0,0,0
GGGAACGGGAGGTTAG-1_V12D07-335_D1,0,1,1,0,0,2
GCGGCTCTGACGTACC-1_V12D07-335_D1,0,2,0,0,0,2
ACGTTAGATTTGCCCG-1_V12D07-335_D1,0,0,2,0,0,2
GAGAGGGCGCGAGGTT-1_V12D07-335_D1,0,1,0,0,0,1
GCGTCTCTGCATTGGG-1_V12D07-335_D1,0,1,1,0,0,2
GCAGCACACAGCCCAG-1_V12D07-335_D1,0,2,1,0,0,3
CAGGCCGTTTGGGTGT-1_V12D07-335_D1,0,3,1,0,0,4
AACTCAAGTTAATTGC-1_V12D07-335_D1,0,0,0,0,0,0
CTTCGTAGATAGGTGA-1_V12D07-335_D1,0,3,2,0,1,6
TGCAGAGTACCGAGCA-1_V12D07-335_D1,0,0,0,0,0,0
GAAGTGATTTATCGTG-1_V12D07-335_D1,0,1,1,0,1,3
CGCTACGGGACATTTA-1_V12D07-335_D1,0,1,5,0,1,7
CCACACTGAGATATTA-1_V12D07-335_D1,0,1,3,0,0,4
CGATCCGACCCAGTGC-1_V12D07-335_D1,0,1,2,0,1,4
CTGTACTTCTTAGCAT-1_V12D07-335_D1,0,3,1,0,0,4
ACTTATTAGGATCGGT-1_V12D07-335_D1,0,1,0,0,0,1
TAGTCCGCAGAGAATG-1_V12D07-335_D1,0,2,3,0,2,7
TTCACGAAAGGATCAC-1_V12D07-335_D1,0,1,1,0,0,2
TACATTTCTAACGTGC-1_V12D07-335_D1,0,2,2,0,0,4
ACCATATCCGCAATAA-1_V12D07-335_D1,0,2,2,0,0,4
CACTCAAGAGCTATGG-1_V12D07-335_D1,0,2,2,0,0,4
TGTACGAACAAATCCG-1_V12D07-335_D1,0,1,1,0,0,2
ATCATCCAATATTTGT-1_V12D07-335_D1,1,5,2,0,1,9
CGCTATTCTTAGGCTC-1_V12D07-335_D1,0,1,3,0,0,4
TGGCAGCAGTAATAGT-1_V12D07-335_D1,1,2,5,1,1,10
TCACGTGCCCGATTCA-1_V12D07-335_D1,1,4,3,0,0,8
CATACGGCGTCTGGGC-1_V12D07-335_D1,0,1,4,1,0,6
CACATGATTCAGCAAC-1_V12D07-335_D1,1,6,8,0,0,15
GCTAGTAGAGCTTGTA-1_V12D07-335_D1,0,2,3,1,0,6
TGCTGTTGAAGAACTC-1_V12D07-335_D1,1,5,2,0,0,8
CGGAGCATGGCGATCC-1_V12D07-335_D1,0,1,0,0,0,1
TAGCGTTGGGTCTTAC-1_V12D07-335_D1,1,3,5,1,0,10
GTAGCGGCTATACACT-1_V12D07-335_D1,0,2,3,1,0,6
TAACATACAATGTGGG-1_V12D07-335_D1,1,5,4,0,0,10
TCTTCGAATAGACGTT-1_V12D07-335_D1,0,3,1,0,2,6
GATCGTGACTGATATC-1_V12D07-335_D1,1,2,4,0,0,7
GATCCGGGAATTAACA-1_V12D07-335_D1,0,6,6,0,0,12
TTATATACGCTGTCAC-1_V12D07-335_D1,0,3,2,0,0,5
GTCGCGTAACCCGTTG-1_V12D07-335_D1,0,2,3,1,0,6
AGCTCTAGACGTTCCA-1_V12D07-335_D1,0,2,2,0,0,4
GTCAAGCGGACTCGGG-1_V12D07-335_D1,0,3,1,0,0,4
CGAGGGACTGCGGTCG-1_V12D07-335_D1,0,3,2,0,0,5
AATCGCCTCAGCGCCA-1_V12D07-335_D1,1,0,0,0,1,2
CTTGTTGCTGAGTCAA-1_V12D07-335_D1,0,1,1,0,0,2
GATATGAGACACTAAC-1_V12D07-335_D1,1,2,0,0,0,3
TTATGATCTTAACGAA-1_V12D07-335_D1,1,1,2,0,0,4
CGCCGCCCATGCCTGT-1_V12D07-335_D1,0,2,2,1,0,5
CTGGGATAAATAATGG-1_V12D07-335_D1,0,0,1,0,0,1
GTGCCCGTTCGGATTC-1_V12D07-335_D1,0,0,3,0,0,3
TTCAATACTCTGAATC-1_V12D07-335_D1,0,1,0,0,0,1
CGCACATGTCCACTAC-1_V12D07-335_D1,0,0,0,0,0,0
AGAAGAGCGCCGTTCC-1_V12D07-335_D1,0,0,0,0,0,0
GATAACTCGCACTGTG-1_V12D07-335_D1,0,1,0,0,0,1
AGTCGACGGTCTCAAG-1_V12D07-335_D1,0,0,0,0,0,0
GTGACCGCACACTACG-1_V12D07-335_D1,0,3,0,0,0,3
GTATGTGGGTCTAGTT-1_V12D07-335_D1,1,3,0,0,0,4
CTTGAGTTAGGGTAAT-1_V12D07-335_D1,0,2,0,0,0,2
TTAGCTGATTTGCCGT-1_V12D07-335_D1,0,3,0,0,0,3
GCTGTTGCTACCGAAC-1_V12D07-335_D1,0,0,0,0,0,0
TATTACCATCCTGCTT-1_V12D07-335_D1,1,0,0,0,0,1
TTGAATTCACGTGAGG-1_V12D07-335_D1,0,1,0,0,0,1
CCATCTCACCAGTGAA-1_V12D07-335_D1,0,3,0,0,0,3
CGCACGTGCGCTATCA-1_V12D07-335_D1,0,2,0,0,0,2
ACCCGGATGACGCATC-1_V12D07-335_D1,0,1,0,0,0,1
CGCTAGAGACCGCTGC-1_V12D07-335_D1,0,1,1,0,0,2
ATAGTTCCACCCACTC-1_V12D07-335_D1,0,0,0,0,0,0
GCAGACCCAGCACGTA-1_V12D07-335_D1,0,0,0,0,0,0
TAGACTACCTAGCGTT-1_V12D07-335_D1,0,2,0,0,0,2
GGTTCTACTCGTCTGA-1_V12D07-335_D1,1,0,0,0,0,1
GACTCACCCACGTGAG-1_V12D07-335_D1,0,0,0,0,0,0
AGCTCTTCGTAACCTT-1_V12D07-335_D1,0,0,0,0,0,0
ACTATCCAGGGCATGG-1_V12D07-335_D1,0,0,0,0,0,0
AAGGATCGATCGCTTG-1_V12D07-335_D1,0,0,0,0,0,0
ATATCGGTAGGGAGAT-1_V12D07-335_D1,1,0,0,1,0,2
TTCCAGACGAGATTTA-1_V12D07-335_D1,1,0,0,0,0,1
GACCGACGTGAAAGCA-1_V12D07-335_D1,0,2,0,1,0,3
CCTGGAAACGTTCTGC-1_V12D07-335_D1,0,2,0,1,1,4
CCGGTAATGGCTAGTC-1_V12D07-335_D1,0,0,0,1,0,1
GCCGTGGAAGAAATGT-1_V12D07-335_D1,0,1,0,2,0,3
GTCTTGAGGAGCAGTG-1_V12D07-335_D1,0,0,0,0,0,0
TCCCAAAGCCCTAAAT-1_V12D07-335_D1,0,1,0,0,0,1
TTGAGCGCCACGTGAT-1_V12D07-335_D1,0,0,0,1,1,2
TTGAGTCCCGCTGCTG-1_V12D07-335_D1,0,3,2,0,2,7
ATGGAACCTTTGCACA-1_V12D07-335_D1,0,0,0,0,0,0
GCTAGCACCTGGGCCA-1_V12D07-335_D1,0,2,3,0,0,5
CGCCGTCTACCCATCG-1_V12D07-335_D1,0,1,3,0,1,5
GATAGGTGTCCCGGGC-1_V12D07-335_D1,0,1,2,1,0,4
AGGTATGCGGACATTA-1_V12D07-335_D1,0,1,1,0,0,2
TTGGTTCGCTCAAAGG-1_V12D07-335_D1,0,1,2,0,0,3
TCTGGAGCGTAAGAGT-1_V12D07-335_D1,0,5,3,1,0,9
TGCCTAAATTTAATAG-1_V12D07-335_D1,0,1,1,0,0,2
TAATTTCCGTCCAGTA-1_V12D07-335_D1,0,0,0,0,0,0
TCCTTCAATCCCTACG-1_V12D07-335_D1,0,0,0,0,0,0
TACCTATCCCTAGAGG-1_V12D07-335_D1,0,1,1,0,0,2
GCATGGGTACTGACGC-1_V12D07-335_D1,1,1,0,0,0,2
GTCGGGAACATGGTAG-1_V12D07-335_D1,0,1,1,0,0,2
GCAAATGAGGACACTT-1_V12D07-335_D1,0,0,0,0,0,0
GAATGGGCTTATCGAC-1_V12D07-335_D1,0,3,0,0,1,4
TGGTCGTGCAAGGCAA-1_V12D07-335_D1,0,2,3,0,0,5
CACCACGCCACACAGA-1_V12D07-335_D1,0,1,2,0,0,3
GAACCTCGACCTACAC-1_V12D07-335_D1,0,0,3,0,0,3
CAATACGCTCTGAGGC-1_V12D07-335_D1,0,0,6,0,0,6
TGGTAAGCAGGATTGA-1_V12D07-335_D1,0,0,1,0,0,1
AGTGGCTCCGTCGGCC-1_V12D07-335_D1,0,4,3,0,0,7
GATCGGATAGAACCAT-1_V12D07-335_D1,0,1,1,0,0,2
GCTACAGTACGGACCG-1_V12D07-335_D1,0,1,3,0,0,4
TCTATTACTAGAGGAT-1_V12D07-335_D1,0,1,2,1,0,4
TTCAGGCGTCAAAGCC-1_V12D07-335_D1,0,1,4,0,0,5
AGACCGGGAAACCCTG-1_V12D07-335_D1,0,1,1,1,0,3
AGAGATCTCTAAAGCG-1_V12D07-335_D1,0,0,1,0,0,1
CCCTGCCCAATCCGCT-1_V12D07-335_D1,0,0,1,0,0,1
GTGGCGGTCCCAGCGT-1_V12D07-335_D1,0,0,1,0,0,1
GCATTGTAATTCATAT-1_V12D07-335_D1,0,0,0,0,0,0
CCGTTCCGAATCTCGG-1_V12D07-335_D1,0,1,0,0,0,1
AGCTTGATCTTAACTT-1_V12D07-335_D1,0,1,1,1,0,3
CCTGTACTCACGCCCA-1_V12D07-335_D1,0,2,3,1,0,6
AAGTGACGACCGAATT-1_V12D07-335_D1,0,2,1,0,0,3
CTCACTTGGCTGGTAA-1_V12D07-335_D1,0,0,3,0,0,3
CGCCTGGCCTACGTAA-1_V12D07-335_D1,0,2,3,0,0,5
CCCGTAAGTCTAGGCC-1_V12D07-335_D1,0,3,2,1,0,6
TTGGACATGTGGCTTA-1_V12D07-335_D1,0,2,2,0,0,4
ATTACGCGCTGGCAGG-1_V12D07-335_D1,0,1,1,0,0,2
ACGCGCTACACAGGGT-1_V12D07-335_D1,0,3,2,0,0,5
TACGTTTACCGGCAAT-1_V12D07-335_D1,0,0,2,0,0,2
CGAAACGCAATTCATG-1_V12D07-335_D1,1,3,2,0,0,6
TAGTCTAACAACGAGA-1_V12D07-335_D1,0,3,0,1,0,4
TTGCATGCTGATCACG-1_V12D07-335_D1,0,0,2,0,0,2
TCTGGGTAGCGCTCAT-1_V12D07-335_D1,0,0,0,0,0,0
ACATCGGTCAGCCGCG-1_V12D07-335_D1,0,3,0,0,1,4
AGATACCGGTGTTCAC-1_V12D07-335_D1,0,4,2,0,0,6
GATTACTGAATTTGGG-1_V12D07-335_D1,0,2,1,0,0,3
TCCAACTTTAAATTCT-1_V12D07-335_D1,0,0,0,0,0,0
TCCTAGCAAAGAAGCT-1_V12D07-335_D1,1,1,0,0,0,2
GTCTATCTGAGTTTCT-1_V12D07-335_D1,1,0,3,0,0,4
GATGTTCAATCCACGA-1_V12D07-335_D1,0,0,3,0,0,3
AGTTAAACACTTGCGA-1_V12D07-335_D1,0,4,2,1,0,7
AGCTCTTTACTCAGTT-1_V12D07-335_D1,0,2,2,0,0,4
ATCCAGGATTCGTGAA-1_V12D07-335_D1,0,2,0,0,0,2
AGTCAACACCACCATC-1_V12D07-335_D1,0,2,4,0,1,7
CGATACCTCGCGGACA-1_V12D07-335_D1,0,4,1,0,2,7
TACAACGCACAACTCA-1_V12D07-335_D1,1,1,1,0,0,3
AATTAAAGGTCGGCGT-1_V12D07-335_D1,0,2,2,0,0,4
TACGCAGTTCTTTCCT-1_V12D07-335_D1,0,1,2,0,1,4
GACCGTGCTGACGGTG-1_V12D07-335_D1,0,1,2,0,0,3
GGCAAATTACTTTACT-1_V12D07-335_D1,0,3,6,0,0,9
GGTACAAACATGCTAT-1_V12D07-335_D1,0,1,1,0,1,3
CGGGCCTTCTTTGTAA-1_V12D07-335_D1,1,1,0,1,0,3
CGTGAAGTTAATTCAC-1_V12D07-335_D1,0,2,5,0,0,7
ATAGTGAAGCGTTCTC-1_V12D07-335_D1,0,4,3,0,0,7
TACGCCATATTCTAAT-1_V12D07-335_D1,0,3,3,1,0,7
GCCGGGTTAGGGTCGC-1_V12D07-335_D1,0,3,2,0,0,5
TACATAGGCATACACC-1_V12D07-335_D1,0,2,0,0,0,2
GCCGATTGGCCAAGCT-1_V12D07-335_D1,0,1,4,0,0,5
CTGCCATGCATCACAT-1_V12D07-335_D1,0,2,2,0,0,4
TTATGAATGAAAGGGA-1_V12D07-335_D1,0,1,9,0,0,10
GCTGAGGCGTGAGTAT-1_V12D07-335_D1,0,0,2,0,0,2
GCGCCGTTCCACGATA-1_V12D07-335_D1,1,3,2,0,0,6
CGCATGGTGCGATGCT-1_V12D07-335_D1,0,5,2,2,0,9
AGGTTTCACACACCTT-1_V12D07-335_D1,0,1,5,0,0,6
CAAGGATCGCATGTTC-1_V12D07-335_D1,0,2,5,0,0,7
ACGTTAATGTCGAAGA-1_V12D07-335_D1,0,4,4,0,0,8
TCCAGAGCACCGGTTC-1_V12D07-335_D1,0,0,5,0,0,5
GATTCGACGGTTCACG-1_V12D07-335_D1,0,3,1,0,1,5
GTTTCTGCAGTCTCCC-1_V12D07-335_D1,0,4,4,0,0,8
GCTGCACGGTTTCTTA-1_V12D07-335_D1,0,0,0,0,0,0
CGTGCAGACTGGGACA-1_V12D07-335_D1,0,1,6,0,2,9
GTGTTACTATGCGTCC-1_V12D07-335_D1,0,2,2,0,0,4
TCCTCGGGCTGGGCTT-1_V12D07-335_D1,0,2,1,0,1,4
GTGAGGACACTTAAGG-1_V12D07-335_D1,0,1,1,1,0,3
ATACGCCGGCGAAACC-1_V12D07-335_D1,0,1,1,0,0,2
TCTGCCAGAAACTGCA-1_V12D07-335_D1,0,0,1,0,0,1
TTCTGCGGGTTAGCGG-1_V12D07-335_D1,0,5,0,0,0,5
CTCGGTACCACTGCTC-1_V12D07-335_D1,0,2,3,0,0,5
GTAAGTAACAGTCTGG-1_V12D07-335_D1,0,0,0,0,0,0
GTGCGTGTATATGAGC-1_V12D07-335_D1,1,1,0,0,0,2
ATTTGTCTTGGGAGCT-1_V12D07-335_D1,0,1,1,0,0,2
CCTCGGACCGGGATAG-1_V12D07-335_D1,0,1,0,0,0,1
TAGGTGCTCGCCTAGC-1_V12D07-335_D1,0,0,0,0,0,0
CTTTAGGAACACTGTT-1_V12D07-335_D1,0,0,0,0,0,0
TCGGGCCGTCGTGGTA-1_V12D07-335_D1,0,0,0,0,0,0
AGTGCTTGCACGAATA-1_V12D07-335_D1,0,0,0,0,0,0
TGCAGTTTCCTCCCAT-1_V12D07-335_D1,0,0,0,0,0,0
TGAGAGATTTACCACG-1_V12D07-335_D1,0,1,0,0,0,1
GAAACAGATGACCACC-1_V12D07-335_D1,0,0,0,0,0,0
AGCAACATATCTTATT-1_V12D07-335_D1,1,0,0,1,0,2
CAAGTGTGGTTGCAAA-1_V12D07-335_D1,0,0,0,0,0,0
GCCTCATCTGGAAATA-1_V12D07-335_D1,0,1,0,0,0,1
AACCCTACTGTCAATA-1_V12D07-335_D1,0,2,0,0,0,2
ACGTATTACTCCGATC-1_V12D07-335_D1,0,2,0,0,0,2
TCTGGGAACCTTTGAA-1_V12D07-335_D1,0,2,1,0,0,3
GCTCGCTCATGTCCAA-1_V12D07-335_D1,0,0,0,0,0,0
GCGCAAGAGCGCGCTG-1_V12D07-335_D1,0,2,0,0,0,2
TTGACGCTCCATGAGC-1_V12D07-335_D1,0,0,0,0,0,0
TATAGATGGTCGCAGT-1_V12D07-335_D1,0,1,0,0,0,1
TTACATGCCACAACTA-1_V12D07-335_D1,0,2,0,0,0,2
ACATGGCGCCAAAGTA-1_V12D07-335_D1,0,0,0,0,0,0
TATGGTTAGTGGGAGA-1_V12D07-335_D1,0,0,0,0,0,0
CATGACTTCGCTGAAT-1_V12D07-335_D1,0,0,0,0,0,0
ACCACCAATGTAACAA-1_V12D07-335_D1,0,0,0,0,0,0
TCTTAGAGCTCCAATT-1_V12D07-335_D1,0,0,0,0,0,0
CCACGAATTTAACCTC-1_V12D07-335_D1,0,0,2,0,0,2
TTCTTGCTAGCATCTC-1_V12D07-335_D1,0,1,1,0,0,2
ACACCTTACTACTTGC-1_V12D07-335_D1,0,3,0,2,0,5
AGTCGGTTGCGTGAGA-1_V12D07-335_D1,1,3,2,2,1,9
ACCTACAGTATGTGGT-1_V12D07-335_D1,0,4,1,0,0,5
GAGGATAAACAGTGCT-1_V12D07-335_D1,0,3,2,0,0,5
TTCCGGTATCTGTGTC-1_V12D07-335_D1,0,1,0,1,0,2
GGAGGCCGAAGTCGTC-1_V12D07-335_D1,0,1,0,0,0,1
TTCGCTAGGAAGTTGT-1_V12D07-335_D1,0,2,1,0,0,3
TAAAGACAACCCTTTA-1_V12D07-335_D1,0,0,1,0,1,2
GTTGCGCTAACATTAC-1_V12D07-335_D1,2,0,1,0,0,3
GCTGAACTCTCCAGGG-1_V12D07-335_D1,0,0,1,1,1,3
AGCCCTGTCGCACCGT-1_V12D07-335_D1,0,1,3,0,0,4
AGCGCTAGAGCGATGT-1_V12D07-335_D1,0,1,4,0,2,7
TGCGCCGTTAATAACG-1_V12D07-335_D1,0,1,0,0,1,2
TGACAACGCATGTCGC-1_V12D07-335_D1,0,0,1,1,0,2
CGTCTTGAGTGTGACG-1_V12D07-335_D1,0,2,1,1,1,5
GATAGGATTAATTACA-1_V12D07-335_D1,0,0,9,1,0,10
GATACCGTGTCGGAGT-1_V12D07-335_D1,0,2,3,0,0,5
TGTGTCGAAGTCGAGG-1_V12D07-335_D1,0,0,0,0,0,0
GGATCAGAGCCATCAG-1_V12D07-335_D1,0,0,0,0,0,0
GTCCCAATCATCCCGC-1_V12D07-335_D1,2,1,2,0,0,5
TGCCACACTAGAGGAA-1_V12D07-335_D1,0,0,2,0,0,2
TGAATTTCACTTGCCT-1_V12D07-335_D1,0,0,0,0,0,0
CTCAGATTGTGATAAG-1_V12D07-335_D1,0,1,1,0,0,2
CGGACGTTACTTGAAG-1_V12D07-335_D1,0,0,1,0,0,1
CCGCCTTGCGATGTCG-1_V12D07-335_D1,0,2,2,0,0,4
CCAGTCAAATCTCTTA-1_V12D07-335_D1,0,1,0,0,0,1
AAACAGCTTTCAGAAG-1_V12D07-335_D1,0,0,3,2,0,5
TAGCTGATGTGAAGCG-1_V12D07-335_D1,0,0,2,0,0,2
CTTATGCGCTCAGGGC-1_V12D07-335_D1,0,3,1,0,0,4
TGGCTCTTGTCGCGTA-1_V12D07-335_D1,0,1,0,0,0,1
TTGTGAGGCATGACGC-1_V12D07-335_D1,0,2,1,0,0,3
CATAAGCTCTCCGTCT-1_V12D07-335_D1,0,0,3,0,0,3
CCTTCTCAGCGTTCCT-1_V12D07-335_D1,0,3,1,0,0,4
TGCAGCTACGTACTTC-1_V12D07-335_D1,0,2,1,0,0,3
CTCTACACTGGCGATT-1_V12D07-335_D1,0,3,1,0,0,4
TGCAGATCGTCCTAGG-1_V12D07-335_D1,0,0,1,0,0,1
TGCCAAAGTCAGACTT-1_V12D07-335_D1,0,1,3,0,0,4
ACAATAGTCGTACGTT-1_V12D07-335_D1,0,1,0,0,0,1
CATGCCAACTCGCAAA-1_V12D07-335_D1,0,0,4,1,0,5
TGCAGAACTATATCGT-1_V12D07-335_D1,0,5,2,0,0,7
TCGTGTCACGCTGACA-1_V12D07-335_D1,0,0,0,0,0,0
TGATCAGGGAACTGCT-1_V12D07-335_D1,0,1,2,0,0,3
CTTGCAACCGCCTCCT-1_V12D07-335_D1,0,1,0,0,0,1
AGCCCATACATGTAAG-1_V12D07-335_D1,0,1,1,0,0,2
ATCCAATGGAGGGTCC-1_V12D07-335_D1,0,1,0,0,0,1
AAACCGGGTAGGTACC-1_V12D07-335_D1,0,0,3,0,0,3
GCAACCACGGCCGCGT-1_V12D07-335_D1,0,1,0,0,0,1
CGCTTATTCCCGGTCG-1_V12D07-335_D1,0,3,2,0,0,5
TTACTCTGGTACGTAC-1_V12D07-335_D1,1,3,1,2,0,7
GTGGTTTCCGCCTTTC-1_V12D07-335_D1,0,1,3,0,0,4
ATAGGCGGCTATAGAA-1_V12D07-335_D1,0,1,1,0,0,2
GTGCCATCACACGGTG-1_V12D07-335_D1,0,1,1,0,0,2
CCCAACATACGTCGCG-1_V12D07-335_D1,0,1,1,0,0,2
CGGTGCAGATAGAACG-1_V12D07-335_D1,0,1,2,1,0,4
GGGCGGGTTCCCTACG-1_V12D07-335_D1,0,1,5,0,0,6
TGAGCCATACAGTCTC-1_V12D07-335_D1,0,2,1,0,0,3
CTCCGCCCACATGAGG-1_V12D07-335_D1,0,2,3,0,0,5
GTTGAACCGGTTCCAT-1_V12D07-335_D1,0,2,1,0,0,3
TTGACTACCATATGGT-1_V12D07-335_D1,0,0,0,0,0,0
ACCATCGTATATGGTA-1_V12D07-335_D1,0,6,0,0,1,7
TGCGTAAGAACCTGAT-1_V12D07-335_D1,0,3,1,1,0,5
AGAAGGTTGCCGAATT-1_V12D07-335_D1,0,1,4,0,0,5
AGGACGACCCATTAGA-1_V12D07-335_D1,0,2,3,0,0,5
GGTGCTGGTACACATT-1_V12D07-335_D1,0,0,2,0,0,2
GCGCTATGCCGAGGCA-1_V12D07-335_D1,0,2,6,0,0,8
ACCCGGTTACACTTCC-1_V12D07-335_D1,1,5,1,0,0,7
TAACTCATCCGCGCGG-1_V12D07-335_D1,1,3,4,0,0,8
CACAATGAGCTGCTAT-1_V12D07-335_D1,0,3,3,0,0,6
GTTACTTTGGGCCTAG-1_V12D07-335_D1,0,0,1,0,0,1
GGGCCCGTCTTAAACA-1_V12D07-335_D1,0,2,3,0,0,5
GAAATTGTCTCTATAA-1_V12D07-335_D1,0,4,2,0,0,6
GGCGCATGAATTGATG-1_V12D07-335_D1,0,1,3,0,0,4
CATATAGGTACAGTCA-1_V12D07-335_D1,0,2,2,0,0,4
TCAACGAGGAGACAAA-1_V12D07-335_D1,0,1,2,1,0,4
TTGCACAATTCAGAAA-1_V12D07-335_D1,0,1,0,1,0,2
CATCGGACGGGTTAAT-1_V12D07-335_D1,0,2,5,0,0,7
ATTAAACATGCGGACC-1_V12D07-335_D1,0,6,5,2,0,13
TATCTACCACAGCGGG-1_V12D07-335_D1,0,4,5,2,0,11
CGAGACCCTAGAGTGT-1_V12D07-335_D1,0,4,2,0,0,6
ACATCGATCGTTTACC-1_V12D07-335_D1,0,2,3,0,0,5
ATCGACCCAATACAGA-1_V12D07-335_D1,0,2,5,0,0,7
GAATCTGAACATTCTC-1_V12D07-335_D1,0,2,3,0,0,5
AGTTCCTATTTATGTT-1_V12D07-335_D1,0,1,4,0,0,5
CAGTCTGTATACTGGG-1_V12D07-335_D1,0,3,3,0,1,7
GGAGACGACACCTTTG-1_V12D07-335_D1,0,1,3,0,0,4
CCTAAATTAACGGTTC-1_V12D07-335_D1,0,2,3,0,0,5
GCTACGACTTATTGGG-1_V12D07-335_D1,0,1,2,0,0,3
CTGTGCAGGGTAGGTC-1_V12D07-335_D1,1,0,6,1,0,8
ACGCCGCTAGACGACC-1_V12D07-335_D1,0,1,0,0,0,1
ACTTGACTCCCTCTTT-1_V12D07-335_D1,0,0,3,0,0,3
CGCCTCCCTCCTCTAT-1_V12D07-335_D1,0,2,5,0,1,8
CTAGATTTACGACGGC-1_V12D07-335_D1,0,1,2,0,1,4
GATGCTGTATTTCATC-1_V12D07-335_D1,0,2,0,0,0,2
TGCGTTTGTTGACACT-1_V12D07-335_D1,0,2,1,1,0,4
CGTGCCCTCCCGAAGA-1_V12D07-335_D1,1,2,1,0,0,4
ACTCTCTGACTTAGGT-1_V12D07-335_D1,0,3,5,0,1,9
CTGGGTAGGCAGTTAA-1_V12D07-335_D1,2,2,4,0,0,8
GTTTGGCCCAAGTTAT-1_V12D07-335_D1,0,0,0,0,0,0
GAATGTGGTCCGGATT-1_V12D07-335_D1,0,1,0,0,1,2
CCCAGTTAAGGCGCCG-1_V12D07-335_D1,0,3,2,0,0,5
CGGTACTAGAATCAAA-1_V12D07-335_D1,0,1,2,0,0,3
GCTTAATGTAACTAAC-1_V12D07-335_D1,1,0,0,0,0,1
AGGACAGTCGAATCCC-1_V12D07-335_D1,0,2,1,0,0,3
GACAGCCAGACCTGAC-1_V12D07-335_D1,0,0,1,0,0,1
GGCGAAATCTAACTTG-1_V12D07-335_D1,1,0,3,0,0,4
CTGGTAACACATAGAA-1_V12D07-335_D1,0,2,1,0,0,3
TAGCCATTTCAAAGTC-1_V12D07-335_D1,0,1,0,0,0,1
GGGATTTACCGCACCT-1_V12D07-335_D1,0,1,0,0,0,1
ATGCCATTTGCGACCA-1_V12D07-335_D1,0,1,0,0,0,1
GAATAGACGCGACCCA-1_V12D07-335_D1,0,0,0,0,0,0
TGTATGGCGCAGACAG-1_V12D07-335_D1,0,1,0,0,0,1
GGATGAAGATCGCTGA-1_V12D07-335_D1,0,0,0,0,0,0
CGACAATTTGATCTAA-1_V12D07-335_D1,0,1,0,0,0,1
AAAGTTGACTCCCGTA-1_V12D07-335_D1,0,4,1,0,0,5
CGCGGCTCAACTTGAA-1_V12D07-335_D1,0,1,0,0,0,1
CACGCGGAACTGTTGC-1_V12D07-335_D1,0,0,0,0,0,0
TCTTAGAGTGAACTCT-1_V12D07-335_D1,0,1,0,0,0,1
AGTCCATTGGCTGATG-1_V12D07-335_D1,0,1,1,0,0,2
TTAAGATAGGATTGAC-1_V12D07-335_D1,0,0,0,0,0,0
ACATCCTGGTAACTGT-1_V12D07-335_D1,0,2,0,0,0,2
CACCTTGGCGCCTTTG-1_V12D07-335_D1,0,0,0,0,0,0
GCTAGACCGTCTACTG-1_V12D07-335_D1,0,0,0,0,0,0
CGGCCCAGGTATATCC-1_V12D07-335_D1,0,0,0,0,0,0
GTCCATTACTGCTACG-1_V12D07-335_D1,0,0,0,0,0,0
GGGTTTAGGATAGGAT-1_V12D07-335_D1,0,0,0,0,0,0
TAATTAGGACATCCGT-1_V12D07-335_D1,0,1,0,0,0,1
GCTCCCAGTCGGTCCA-1_V12D07-335_D1,0,4,0,2,0,6
ATTCGTGCTATCTCTT-1_V12D07-335_D1,4,1,2,0,0,7
GTTAACTATGTTGTCA-1_V12D07-335_D1,1,0,0,2,0,3
GCTCCGCTCGCTTCAG-1_V12D07-335_D1,0,1,0,1,0,2
GCAACGGCTAGTTATG-1_V12D07-335_D1,0,2,1,1,0,4
AATCGCGCAGAGGACT-1_V12D07-335_D1,0,1,0,0,0,1
AGGTTACACCATGCCG-1_V12D07-335_D1,0,0,0,0,0,0
CGAGATTTCGCTCGGG-1_V12D07-335_D1,0,0,0,0,0,0
CGATAATACTCAGGTT-1_V12D07-335_D1,0,1,0,0,0,1
AAGGCAGGCTGTCTCC-1_V12D07-335_D1,0,2,1,0,0,3
GTAAGTCCACACTCTA-1_V12D07-335_D1,0,1,0,0,1,2
ATGAGGGCAGCGGCTA-1_V12D07-335_D1,0,2,0,0,0,2
GCCGCACTCCGTTTCA-1_V12D07-335_D1,1,3,6,0,0,10
GAGCACGGCGCCTCTT-1_V12D07-335_D1,0,0,11,0,0,11
ACAATTTGGCCATATT-1_V12D07-335_D1,0,0,3,0,0,3
CTGGTTCGCGAGCTAC-1_V12D07-335_D1,0,1,1,0,0,2
GACGGTCCTAGGGTGT-1_V12D07-335_D1,0,0,1,0,1,2
ACTCGCGATCTGACGC-1_V12D07-335_D1,0,1,2,1,0,4
GTGTACGAACCGTTCC-1_V12D07-335_D1,0,0,2,0,0,2
CTTTGACGTCGCTTCT-1_V12D07-335_D1,0,1,0,0,0,1
CGTTATCATACTTCCA-1_V12D07-335_D1,0,2,0,0,0,2
GCTATGCCAGCTTATG-1_V12D07-335_D1,0,0,1,0,0,1
CAGTCGGCCTAGATAT-1_V12D07-335_D1,0,2,2,0,0,4
CCCGTGAGGGCGGTGA-1_V12D07-335_D1,1,0,3,0,0,4
TCTCGTGTTACGAGGA-1_V12D07-335_D1,0,0,0,0,0,0
ACGTCTCGTTCCGGGA-1_V12D07-335_D1,0,0,1,0,0,1
CGAGAGCGCGTAGATA-1_V12D07-335_D1,0,0,3,0,0,3
GACAGATTTCTGGCTC-1_V12D07-335_D1,0,1,0,0,0,1
GGGCCTAAATGGGCTA-1_V12D07-335_D1,0,0,2,0,0,2
ACTTGTAGTCCCTTCA-1_V12D07-335_D1,0,1,0,0,0,1
CCCGAAGTTTCGCGAA-1_V12D07-335_D1,0,0,3,0,0,3
ACCATCCGCCAACTAG-1_V12D07-335_D1,0,1,3,0,0,4
TGCGAATATGGGATTT-1_V12D07-335_D1,0,3,2,2,0,7
TACATCCCTATCCCTG-1_V12D07-335_D1,0,2,2,1,0,5
GTGGGAAGACTGAATC-1_V12D07-335_D1,0,2,1,0,0,3
TCAACATCGACCGAGA-1_V12D07-335_D1,0,0,0,0,0,0
CTATGTGAGTCACGGC-1_V12D07-335_D1,0,0,1,0,0,1
CCGAACACTGGGCCTC-1_V12D07-335_D1,0,1,3,0,0,4
AAACTTGCAAACGTAT-1_V12D07-335_D1,0,0,2,0,0,2
AGGGCGAGCAGCTGAT-1_V12D07-335_D1,0,0,1,0,0,1
AACACGAGACGCGGCC-1_V12D07-335_D1,0,2,1,0,0,3
TGACGAATATTTCCCT-1_V12D07-335_D1,0,2,1,0,0,3
TCGGAGAGTATCGGGA-1_V12D07-335_D1,0,1,3,0,0,4
CAAATCTCTCACAAGG-1_V12D07-335_D1,0,1,0,0,0,1
AGGCCCTAGAACGCCA-1_V12D07-335_D1,0,1,2,0,0,3
TAGAGATCATGCAACT-1_V12D07-335_D1,0,0,0,0,0,0
TTGTTTCCATACAACT-1_V12D07-335_D1,0,1,0,0,0,1
GAGAGGTGCATTCTGG-1_V12D07-335_D1,0,0,0,0,0,0
GTGGACCAACCCGATT-1_V12D07-335_D1,0,2,1,0,0,3
CTGGGCCTGCTATATC-1_V12D07-335_D1,0,1,1,0,0,2
CATAGTCCACAAGAAC-1_V12D07-335_D1,0,2,1,0,0,3
TTGACATGAACGTGGA-1_V12D07-335_D1,0,2,2,0,0,4
GGTTACCACCCTCGGG-1_V12D07-335_D1,0,4,2,0,0,6
TACCGGTCGTTTCCAT-1_V12D07-335_D1,0,2,1,0,0,3
CGAGTACTAAAGAGGA-1_V12D07-335_D1,0,1,1,0,0,2
GCAAGAATTCCTTGGC-1_V12D07-335_D1,0,0,3,0,0,3
TCGCCGAAGTTGCGTC-1_V12D07-335_D1,0,2,2,0,0,4
TTGAGAGTACTGCTAA-1_V12D07-335_D1,0,3,1,0,0,4
GCCACAATTTAAGGAC-1_V12D07-335_D1,0,2,2,0,0,4
ATATTCAGTTAAACCT-1_V12D07-335_D1,0,2,4,2,0,8
TGAGTGCCTCTTAAAT-1_V12D07-335_D1,0,1,0,0,0,1
ATCAGACGGCACGCCG-1_V12D07-335_D1,1,0,3,0,0,4
GTGCGAAATCGAACAC-1_V12D07-335_D1,0,3,1,0,0,4
GTGCCGCTTCAAAGGT-1_V12D07-335_D1,0,3,5,0,0,8
GATACGATGGGAGTCA-1_V12D07-335_D1,0,4,2,0,0,6
GACACTGAGTTCAGTG-1_V12D07-335_D1,0,0,3,0,0,3
ATCCTGCGTGGAATGG-1_V12D07-335_D1,0,3,1,0,0,4
ATCCTACCTAAGCTCT-1_V12D07-335_D1,0,3,3,0,0,6
AGTGATATGAGTAGTT-1_V12D07-335_D1,0,2,2,0,0,4
ATGATGCAATGGTACA-1_V12D07-335_D1,0,2,4,0,1,7
GAAACCGAATTACCTT-1_V12D07-335_D1,0,0,1,0,0,1
AGTGACCTACTTTACG-1_V12D07-335_D1,0,1,4,1,0,6
CAAATGTCCTTCCGTG-1_V12D07-335_D1,0,2,3,1,1,7
TTACTGGGATATTTCA-1_V12D07-335_D1,0,3,3,0,0,6
CTTGCCCAGGCTCTAC-1_V12D07-335_D1,0,0,2,1,0,3
AAATCGTGTACCACAA-1_V12D07-335_D1,0,3,6,0,0,9
GTGATCATAGATCTGC-1_V12D07-335_D1,0,7,1,0,0,8
TGGCAGATTACGATCA-1_V12D07-335_D1,0,1,2,0,0,3
TCACCCTCTTAAGATT-1_V12D07-335_D1,0,1,5,0,0,6
CAGGATATATCGTTGT-1_V12D07-335_D1,0,3,7,0,0,10
CCTGACCACCGATGGT-1_V12D07-335_D1,0,3,4,0,0,7
CTAAAGGGAAATAGGA-1_V12D07-335_D1,0,2,0,0,0,2
CCGCTATCAGCACCAG-1_V12D07-335_D1,0,0,2,1,0,3
CTTTAGTGCTATTATT-1_V12D07-335_D1,0,1,5,1,0,7
CGGGAATTTATGTAAA-1_V12D07-335_D1,0,2,2,1,0,5
TACGACTGCCTCTTAG-1_V12D07-335_D1,0,2,5,0,0,7
AAACTGCTGGCTCCAA-1_V12D07-335_D1,0,3,0,0,0,3
GTACGTTTGCCCGTCA-1_V12D07-335_D1,0,0,5,0,1,6
GGCAAGGCGAAATAGC-1_V12D07-335_D1,0,0,5,0,0,5
GATCTTGGAGGGCATA-1_V12D07-335_D1,0,1,6,0,3,10
AGCGTGGTATTCTACT-1_V12D07-335_D1,0,3,1,0,2,6
CTAAGGGAATGATTGG-1_V12D07-335_D1,0,4,3,1,1,9
CATGGTAAGTAGCGTT-1_V12D07-335_D1,0,0,3,0,0,3
CGTTGAGCGACCGTCG-1_V12D07-335_D1,0,2,4,0,0,6
TGCCCGTACCGTTAAA-1_V12D07-335_D1,0,0,1,0,0,1
ACAAGGGCAGGCTCTG-1_V12D07-335_D1,0,2,4,0,0,6
GAGATCTTCCATGACA-1_V12D07-335_D1,0,3,0,1,0,4
AATGACGTAGGATGTC-1_V12D07-335_D1,0,1,0,0,0,1
GTGGTGGCCAAGTGAA-1_V12D07-335_D1,1,3,2,0,0,6
TCCCGTGTGCAATTTG-1_V12D07-335_D1,0,2,0,0,0,2
ACATCGTATGCAATGG-1_V12D07-335_D1,0,2,3,0,0,5
GCGAAACTTAACTGGA-1_V12D07-335_D1,0,1,1,0,0,2
AATTGAACGCTCTGGT-1_V12D07-335_D1,0,1,2,0,0,3
ACAAATGGTAGTGTTT-1_V12D07-335_D1,1,3,1,1,0,6
ATGGTCGCGTGGTTTC-1_V12D07-335_D1,1,2,2,0,0,5
TGTTATTGTATGTGGC-1_V12D07-335_D1,0,0,1,0,0,1
TTCCGGTTACCCACTT-1_V12D07-335_D1,0,0,0,0,0,0
GAGTGTGCGGTACCCA-1_V12D07-335_D1,0,0,0,0,0,0
CAAGATATTATAACGT-1_V12D07-335_D1,0,2,1,0,0,3
ACACACCAGGACCAGT-1_V12D07-335_D1,0,0,0,0,0,0
ATGGGCCTCGGCCTCT-1_V12D07-335_D1,0,1,0,0,0,1
AAGGTGATAAACCAGC-1_V12D07-335_D1,0,0,0,0,0,0
TCTTACTTATGCCTCT-1_V12D07-335_D1,0,0,0,0,0,0
AAAGTGTGATTTATCT-1_V12D07-335_D1,0,2,1,0,0,3
TGCTCCACAGTTCTTA-1_V12D07-335_D1,1,1,0,0,0,2
CTGGCTGATTCATCCT-1_V12D07-335_D1,0,1,0,0,0,1
TAAGGCTGAATCCCTC-1_V12D07-335_D1,0,1,0,1,0,2
TCTAGTGATATCGTGG-1_V12D07-335_D1,0,0,0,0,0,0
TCGAAGAACCGAGCAC-1_V12D07-335_D1,0,1,0,0,0,1
GACAAACATATGCAGG-1_V12D07-335_D1,0,1,0,0,0,1
AAGTCAATTGTCGTCA-1_V12D07-335_D1,0,1,0,0,0,1
AGTGAACAAACTTCTC-1_V12D07-335_D1,0,0,0,0,0,0
CATGATGGAAGTTAGC-1_V12D07-335_D1,0,0,0,0,0,0
AAGTGCCTTGACTGTA-1_V12D07-335_D1,0,0,0,0,0,0
ATCGCCAGTCAACATT-1_V12D07-335_D1,0,0,0,0,0,0
ACCGCGGTGGAAGTCG-1_V12D07-335_D1,0,0,0,0,0,0
TCTTCTATAACCCGCC-1_V12D07-335_D1,0,1,0,0,0,1
CACATTTCTTGTCAGA-1_V12D07-335_D1,0,2,0,0,0,2
TAGCGTCCCTCGATTG-1_V12D07-335_D1,0,0,0,0,0,0
GTTCGGATCGGGAACA-1_V12D07-335_D1,0,5,1,0,0,6
CAAACTCGCGACGCCG-1_V12D07-335_D1,0,0,0,0,0,0
GTCTTGTAGCTATTCA-1_V12D07-335_D1,0,2,1,0,0,3
TCTCGACGTATCGCCG-1_V12D07-335_D1,2,0,0,0,0,2
TTGCCAAGCAGAACCC-1_V12D07-335_D1,0,0,1,1,0,2
AAACCCGAACGAAATC-1_V12D07-335_D1,0,1,4,0,0,5
TTGAGCAGCCCACGGT-1_V12D07-335_D1,0,1,0,1,0,2
CGCCTTTAGCATGCTC-1_V12D07-335_D1,0,1,0,1,0,2
TGTGGCTCCCACCAAC-1_V12D07-335_D1,1,2,0,1,0,4
CCGCCGTTGAGGATAA-1_V12D07-335_D1,0,1,2,0,1,4
CAATACGAGAGTCTGA-1_V12D07-335_D1,0,1,4,1,0,6
CATCTAGTGAAGGGAA-1_V12D07-335_D1,0,1,1,0,0,2
GGTGGAGGTTGATACG-1_V12D07-335_D1,0,1,0,0,0,1
CCGCACACGAACGTGT-1_V12D07-335_D1,0,0,3,0,0,3
AGAACCCAGCGTGACA-1_V12D07-335_D1,0,0,4,0,0,4
GCGCTCGATCACCTGT-1_V12D07-335_D1,0,0,2,0,0,2
ATCATGGACTACCGAC-1_V12D07-335_D1,0,4,3,0,0,7
TACGCCGCCTCAGAAG-1_V12D07-335_D1,0,0,2,0,0,2
CGACCTACTAGACAAT-1_V12D07-335_D1,0,0,0,0,0,0
GAGTCTTGTAAAGGAC-1_V12D07-335_D1,0,1,1,0,0,2
AATATCCTAGCAAACT-1_V12D07-335_D1,0,3,1,0,0,4
CCCTAGGCAACAAGAG-1_V12D07-335_D1,0,2,0,0,0,2
ACAAAGAAGGTAGGCC-1_V12D07-335_D1,0,2,0,0,0,2
CCCTGGCTGTTCCTTC-1_V12D07-335_D1,0,2,0,0,0,2
TCGCCGCACCGCGTGA-1_V12D07-335_D1,0,3,0,0,1,4
TATAGCGCACGTTATC-1_V12D07-335_D1,0,1,0,0,0,1
TTATCTGACATTAGGA-1_V12D07-335_D1,1,4,5,0,0,10
AGTGGTGTTACCCGTG-1_V12D07-335_D1,0,1,4,0,0,5
GCCAAGAATACTTCTG-1_V12D07-335_D1,0,1,2,0,0,3
CCGGCGTGAGACTCTG-1_V12D07-335_D1,0,0,1,0,0,1
TTCCCGGCGCCAATAG-1_V12D07-335_D1,0,0,2,0,0,2
AAACAGGGTCTATATT-1_V12D07-335_D1,0,0,3,0,0,3
ACAGTAATACAACTTG-1_V12D07-335_D1,0,1,0,1,0,2
CGAACGGCCGGACAAC-1_V12D07-335_D1,0,1,0,0,0,1
GCAACACACTAGAACT-1_V12D07-335_D1,0,0,1,0,0,1
ACTCCCATTCCTAAAG-1_V12D07-335_D1,0,0,2,0,0,2
ACCTGCGTGTCATGTT-1_V12D07-335_D1,0,1,2,0,0,3
TACTTTCCGCACGCCA-1_V12D07-335_D1,0,1,6,0,0,7
AGGTCAGGTGAGAGTG-1_V12D07-335_D1,0,1,1,0,0,2
TCCTCCTAAGACATTC-1_V12D07-335_D1,0,1,1,1,0,3
ATGTGAAAGCCTAATG-1_V12D07-335_D1,0,5,3,0,0,8
AGTCGGCTCAACTTTA-1_V12D07-335_D1,0,1,0,0,0,1
CGATCTGTTGGAGGAC-1_V12D07-335_D1,0,1,2,0,0,3
ACGGGAGTGTCGGCCC-1_V12D07-335_D1,0,0,2,0,0,2
TTAACTTCAGGTAGGA-1_V12D07-335_D1,0,0,3,0,0,3
CCACGGAGCCATAAGA-1_V12D07-335_D1,0,3,3,0,0,6
CTTCTATGTTGAAGTA-1_V12D07-335_D1,0,1,0,1,0,2
CACCGTTGCGCGATAT-1_V12D07-335_D1,0,2,0,1,0,3
TCTAGCAATCTCCGCC-1_V12D07-335_D1,0,1,1,0,0,2
AGTTTGGCCAGACCTA-1_V12D07-335_D1,0,1,2,0,0,3
TTGTAAGGACCTAAGT-1_V12D07-335_D1,0,0,0,0,0,0
AAATTTGCGGGTGTGG-1_V12D07-335_D1,0,2,2,0,0,4
AAGTTCGGCCAACAGG-1_V12D07-335_D1,0,0,4,0,0,4
CCGCTTACCTCACTCT-1_V12D07-335_D1,0,3,1,0,0,4
ATCACGTGCTAATTAA-1_V12D07-335_D1,0,2,5,0,0,7
GGTGAAGTACAGGGAT-1_V12D07-335_D1,0,0,3,0,0,3
GCTGTATTACTGGCCC-1_V12D07-335_D1,0,1,0,0,0,1
AACGGCCATCTCCGGT-1_V12D07-335_D1,0,2,4,0,0,6
TAAGTAACATCTTGAC-1_V12D07-335_D1,0,2,1,0,0,3
TTCTTGAGCCGCGCTA-1_V12D07-335_D1,0,5,2,0,0,7
AGTGCGTAGCTCGTAA-1_V12D07-335_D1,0,1,3,0,0,4
GGGATGGTCGTAACCG-1_V12D07-335_D1,0,2,0,1,0,3
GTCTGGGCGGTCGAGA-1_V12D07-335_D1,0,1,2,0,0,3
CGGAACGTAAACATAG-1_V12D07-335_D1,0,1,4,0,0,5
TGCGACACCCTAGTGC-1_V12D07-335_D1,0,0,0,0,0,0
CAAACGAGTATCGCAG-1_V12D07-335_D1,0,5,6,1,0,12
TCAGTAGGGACTATAA-1_V12D07-335_D1,0,1,1,0,0,2
GCGGTTCCCTATCATG-1_V12D07-335_D1,0,2,2,0,0,4
GTGACTTCAGTAGTGC-1_V12D07-335_D1,0,3,3,0,0,6
CGTCACGTCCATTGGT-1_V12D07-335_D1,1,12,0,3,0,16
ATAAGTTACCGCGACG-1_V12D07-335_D1,0,1,2,0,0,3
CTGAATCCGAGACCTC-1_V12D07-335_D1,0,1,0,0,0,1
TACGACGCTTGCTGCG-1_V12D07-335_D1,0,2,4,0,0,6
GAATTCACCCGGGTGT-1_V12D07-335_D1,0,1,6,0,0,7
GGGTGACACCTTAACT-1_V12D07-335_D1,0,1,1,0,0,2
TGAGTAAATTAGCGTA-1_V12D07-335_D1,0,1,3,1,0,5
GAGTCCGCTTACCGGA-1_V12D07-335_D1,0,1,7,0,0,8
GGCGCGTTCGAGTTTA-1_V12D07-335_D1,0,3,1,0,0,4
ATTCATATACTGTCCA-1_V12D07-335_D1,1,0,3,0,1,5
ATAAACGGACCCGTAA-1_V12D07-335_D1,0,4,6,1,0,11
GTCGTACCATCTCGGG-1_V12D07-335_D1,1,2,2,0,0,5
ATAATAGCTGTTGAAT-1_V12D07-335_D1,0,2,3,0,0,5
TTCCGCGTGAGGCGAT-1_V12D07-335_D1,0,2,6,0,0,8
TACCGGCTCACTGCCC-1_V12D07-335_D1,0,3,1,1,0,5
GTATCTTTCATAACCA-1_V12D07-335_D1,1,2,3,0,0,6
GTTACCTACAACTTGC-1_V12D07-335_D1,0,0,1,0,0,1
TGACTATAATCCTTTC-1_V12D07-335_D1,0,1,0,0,1,2
AAATACCTATAAGCAT-1_V12D07-335_D1,0,1,2,0,0,3
TTATTAGAGCGTGTTC-1_V12D07-335_D1,0,0,0,0,0,0
ATGTGGACATCTTGAT-1_V12D07-335_D1,0,2,4,0,0,6
GTACGCTTCATTGCAC-1_V12D07-335_D1,0,3,4,0,0,7
CACATATTAGCAGGAT-1_V12D07-335_D1,0,2,3,0,0,5
CAAGAGGGCGGAGTAC-1_V12D07-335_D1,0,4,1,0,2,7
TCGCAAAGATGCATTT-1_V12D07-335_D1,0,2,1,0,0,3
GTCGTTATTCGCTTAT-1_V12D07-335_D1,0,0,1,0,0,1
TCGTGTACTATGGATG-1_V12D07-335_D1,0,1,1,0,0,2
GCGGAGAGGGAGAACG-1_V12D07-335_D1,0,4,0,1,0,5
TCACAGGGAATCGCAA-1_V12D07-335_D1,0,2,0,0,0,2
GACTGCACCAGCCCAG-1_V12D07-335_D1,0,2,1,1,1,5
TCCGCTGTCATCCCGG-1_V12D07-335_D1,0,0,1,0,0,1
AGATACTCAAGATCGA-1_V12D07-335_D1,0,1,1,0,1,3
ACTGAATGGCGAAAGT-1_V12D07-335_D1,0,3,3,0,0,6
TCCTACATCCACGGCC-1_V12D07-335_D1,0,1,0,0,0,1
TTCAGCCCTGGTCCAC-1_V12D07-335_D1,1,1,2,0,0,4
TTAGAGTTTAGAAGGA-1_V12D07-335_D1,0,1,1,0,0,2
GGTTAGCTATATGTCT-1_V12D07-335_D1,0,1,1,0,0,2
CTGGTTTCGAGCAAGA-1_V12D07-335_D1,0,0,0,0,0,0
TGGGCCCATACTAATT-1_V12D07-335_D1,0,0,1,0,0,1
ACTTATTTATGTGCCA-1_V12D07-335_D1,0,0,0,0,0,0
TTAGTTATTCGTGGCA-1_V12D07-335_D1,1,0,1,0,0,2
AACCGCTAAGGGATGC-1_V12D07-335_D1,0,1,0,0,0,1
ATACGTCCACTCCTGT-1_V12D07-335_D1,0,0,0,0,0,0
CGACACGCTCCGACAG-1_V12D07-335_D1,0,0,0,0,0,0
TCTGAACTCGTACCCG-1_V12D07-335_D1,0,3,0,0,0,3
AGGATATAGGGATTTA-1_V12D07-335_D1,0,2,0,0,0,2
GTGATCACTAACGCCT-1_V12D07-335_D1,0,0,0,0,0,0
ACCGGGCCTTTGTTGA-1_V12D07-335_D1,0,2,0,0,0,2
TTGACAGGAGCTCCCG-1_V12D07-335_D1,0,3,0,1,0,4
CTCTTCTATTGACTGG-1_V12D07-335_D1,0,6,0,0,0,6
CGTGGCCGAATATCTA-1_V12D07-335_D1,0,0,0,0,0,0
GGTTTAGCCTTTCTTG-1_V12D07-335_D1,0,0,0,0,0,0
TCAAGGTTACTACACC-1_V12D07-335_D1,0,0,0,0,0,0
TTGACTATTGTCCGGC-1_V12D07-335_D1,0,0,0,0,0,0
CGGGAATATAGTATAC-1_V12D07-335_D1,0,0,0,0,0,0
GCAACAGCAGTATGCG-1_V12D07-335_D1,0,0,0,0,0,0
ATCAAACACTGTTCCA-1_V12D07-335_D1,0,0,0,0,0,0
TGGGCAATAGTTGGGT-1_V12D07-335_D1,0,2,0,1,0,3
TGAATGTCAGCCGGCC-1_V12D07-335_D1,1,2,0,0,0,3
CGGCTCTAAAGCTGCA-1_V12D07-335_D1,0,2,0,0,0,2
GGACACAAGTTTACAC-1_V12D07-335_D1,1,4,0,0,0,5
CCGAGAAGTCGCATAA-1_V12D07-335_D1,0,2,0,0,1,3
AACTACCCGTTTGTCA-1_V12D07-335_D1,0,2,0,0,1,3
GCACAAACGAGGCGTG-1_V12D07-335_D1,0,1,0,0,0,1
CACACAGCTTGCGCTC-1_V12D07-335_D1,0,3,0,0,1,4
GTGCTTACATCAGCGC-1_V12D07-335_D1,0,2,0,0,0,2
GCAAACGTCGCCAGGT-1_V12D07-335_D1,1,2,3,0,0,6
GAATAGCATTTAGGGT-1_V12D07-335_D1,0,0,1,0,0,1
TACTGTTTCTCTGGTA-1_V12D07-335_D1,0,0,1,0,0,1
TCCTATCATAGGTAAC-1_V12D07-335_D1,0,1,1,0,0,2
TTCGGTGGAGACGCCC-1_V12D07-335_D1,0,4,1,1,0,6
TGTTGCCGTCGTCCCA-1_V12D07-335_D1,0,0,1,0,0,1
CCAACTTGATAGATCC-1_V12D07-335_D1,0,2,3,0,0,5
CAAAGGTCATCTGAAA-1_V12D07-335_D1,0,1,5,0,0,6
CTAGCTTAATGGTCCC-1_V12D07-335_D1,0,0,2,0,0,2
AGGCCACATTGGTTAC-1_V12D07-335_D1,0,0,0,0,0,0
TTAGGATGGGAGGGTA-1_V12D07-335_D1,0,1,0,0,0,1
TATGACCTTGCGCTGG-1_V12D07-335_D1,1,1,1,1,0,4
ATATACATGTATGGTA-1_V12D07-335_D1,0,0,0,0,0,0
TGTGTGACCATGAATC-1_V12D07-335_D1,0,1,1,0,0,2
CCCACTCCACGGTATC-1_V12D07-335_D1,1,2,0,0,0,3
GGGCAGACGTCACTGC-1_V12D07-335_D1,0,1,1,1,0,3
TCAAAGAGCTATCTGT-1_V12D07-335_D1,0,2,0,0,0,2
AGATGCATCCTGTGTC-1_V12D07-335_D1,0,1,2,0,0,3
GTGAAGTCACGACTCG-1_V12D07-335_D1,0,1,0,0,0,1
TGATTCAGGTCCCGCG-1_V12D07-335_D1,0,1,0,0,0,1
CGCCACAGGTCGCGAT-1_V12D07-335_D1,0,0,2,0,0,2
TTGAATCGTTGTATAA-1_V12D07-335_D1,0,1,1,0,0,2
TGGCCAATTTGGTACT-1_V12D07-335_D1,0,1,3,0,0,4
CGACCCTTAACGCCGG-1_V12D07-335_D1,0,0,1,0,0,1
TCGGCGTACTGCACAA-1_V12D07-335_D1,0,3,2,0,0,5
GAGTAAGGCCACGGGA-1_V12D07-335_D1,0,4,1,0,0,5
ATCAGCTCGTCCACTA-1_V12D07-335_D1,0,3,3,0,0,6
AGGATCACGCGATCTG-1_V12D07-335_D1,1,3,3,4,0,11
AAATGGCCCGTGCCCT-1_V12D07-335_D1,0,3,3,0,0,6
CAGTACCAGTTTACGT-1_V12D07-335_D1,0,1,2,0,0,3
GGTCGTAAGCTCGCAC-1_V12D07-335_D1,0,0,5,0,0,5
CGTTCATGGTGCGCGT-1_V12D07-335_D1,0,0,2,0,0,2
GACTACAAAGCGGTGG-1_V12D07-335_D1,0,2,3,0,0,5
CAGCTGGCGTAACCGT-1_V12D07-335_D1,0,1,0,0,0,1
ACTCGTAACCCGTCCT-1_V12D07-335_D1,0,2,0,0,0,2
CATATGTCAGGCTACG-1_V12D07-335_D1,0,2,0,0,0,2
GCCCGACTTCTTCCCG-1_V12D07-335_D1,0,5,0,0,0,5
CTGGCATCCGAATGAG-1_V12D07-335_D1,0,0,2,0,0,2
AAGTGCGTTAGAATCT-1_V12D07-335_D1,0,0,0,0,0,0
AGAAGTGATTCGTGAT-1_V12D07-335_D1,0,6,2,0,0,8
TACCTTAAGATTTCCC-1_V12D07-335_D1,0,0,3,0,0,3
AATGACAGCAATGTCT-1_V12D07-335_D1,0,2,3,0,0,5
TCAACGCAGGAAATAA-1_V12D07-335_D1,0,1,7,0,0,8
TATTCCTCCGCCCACT-1_V12D07-335_D1,0,1,6,0,0,7
ATCAAACGAAGGTTTG-1_V12D07-335_D1,0,4,3,0,0,7
TTGATTAGCTGTTTCT-1_V12D07-335_D1,0,1,4,0,0,5
CTGCTGAGGCCACGAA-1_V12D07-335_D1,0,1,1,1,0,3
CCGTGTTAAATTCCAT-1_V12D07-335_D1,0,3,4,1,0,8
CACGTCGGCAACCTCT-1_V12D07-335_D1,0,0,0,0,0,0
GTATTCTGAGAAACGA-1_V12D07-335_D1,0,1,1,0,0,2
CGGTGCGCGTTGGTCC-1_V12D07-335_D1,0,1,0,0,0,1
GTGATTCGCCGCTCAA-1_V12D07-335_D1,0,1,1,0,0,2
GCCCGCGCGTAAACGG-1_V12D07-335_D1,0,2,4,1,0,7
AACGTACTGTGGGTAC-1_V12D07-335_D1,0,2,1,0,0,3
GAGTATGCCCGCCTTG-1_V12D07-335_D1,0,1,0,0,0,1
TGATTCTGTCGCCGGT-1_V12D07-335_D1,0,2,1,0,0,3
GGGCGGCAAATGAATT-1_V12D07-335_D1,0,3,1,0,0,4
TTCCAATCTGGCTATC-1_V12D07-335_D1,0,3,1,0,0,4
GGAACCGTGTAAATTG-1_V12D07-335_D1,0,2,1,0,0,3
TTGGTCACACTCGTAA-1_V12D07-335_D1,0,1,2,0,0,3
CGAACCCGCATGCGTC-1_V12D07-335_D1,0,0,1,0,0,1
GGGCGTCACCACGTAA-1_V12D07-335_D1,0,9,1,0,2,12
TACCAGAAGTAGGTTC-1_V12D07-335_D1,0,1,0,0,0,1
TTGGATATCGTCTACG-1_V12D07-335_D1,0,3,4,0,0,7
TAGATATGGACTGGAA-1_V12D07-335_D1,0,3,0,0,0,3
GCGACGATAGTTGTAC-1_V12D07-335_D1,0,1,2,0,0,3
CTGGATTTACACTTGA-1_V12D07-335_D1,0,3,3,0,0,6
GTTATATTATCTCCCT-1_V12D07-335_D1,0,2,4,0,0,6
TATTCCACTCAGCTCG-1_V12D07-335_D1,0,1,2,0,0,3
CTGTTACCCAATCTAG-1_V12D07-335_D1,0,0,0,0,1,1
ACGCGAAGTCAGACGA-1_V12D07-335_D1,0,0,1,0,0,1
GATAGGTAACGTTGAC-1_V12D07-335_D1,0,2,6,1,1,10
TGTTCGTATTGCGGTG-1_V12D07-335_D1,0,1,2,0,0,3
GGTCAGTGGGTCCCAC-1_V12D07-335_D1,0,1,5,0,1,7
AATTCTAGAGTTAGGC-1_V12D07-335_D1,0,2,2,0,0,4
GTTTACGTTCCATCTG-1_V12D07-335_D1,0,3,5,0,0,8
AGACCCACCGCTGATC-1_V12D07-335_D1,0,2,2,0,1,5
TCTAGCATGCCCAGAA-1_V12D07-335_D1,0,2,2,0,0,4
CCCGCAGCGCGAACTA-1_V12D07-335_D1,0,0,2,0,0,2
CTCTATTTGGCTGCAG-1_V12D07-335_D1,0,1,0,0,1,2
TTCTGCCGCGCCTAGA-1_V12D07-335_D1,0,0,0,0,0,0
ACTCCCTAGAATAGTA-1_V12D07-335_D1,0,2,2,1,1,6
CCGAACCTTCCCGGCC-1_V12D07-335_D1,0,0,2,0,0,2
TCAGACGCTATAGAAG-1_V12D07-335_D1,0,3,1,0,0,4
CAGGCGCCATGCTAGG-1_V12D07-335_D1,0,2,2,0,0,4
CACTCGAGCTGAACAA-1_V12D07-335_D1,0,1,0,0,1,2
ACAAGGAAATCCGCCC-1_V12D07-335_D1,0,2,0,0,0,2
ACCACGTGCAGCTATA-1_V12D07-335_D1,1,1,3,0,0,5
ACGGCGACGATGGGAA-1_V12D07-335_D1,0,1,1,0,0,2
TTACTAAAGGACTTTA-1_V12D07-335_D1,0,1,5,0,0,6
GGCTGAAATAGCAAAG-1_V12D07-335_D1,0,1,3,0,1,5
TTAGACGAGTCACCTC-1_V12D07-335_D1,0,0,0,0,0,0
GTAGTCGCGGGAATCA-1_V12D07-335_D1,0,0,1,0,0,1
GCAAACCCTACATTAT-1_V12D07-335_D1,0,0,1,0,0,1
GTTAAAGTAGGACTGG-1_V12D07-335_D1,0,1,3,0,0,4
ACCCTCCCTTGCTATT-1_V12D07-335_D1,0,2,0,0,0,2
CATGTCTCATTTATGG-1_V12D07-335_D1,0,1,0,0,0,1
AATAGAATCTGTTTCA-1_V12D07-335_D1,0,0,0,0,0,0
TCTCATGAGATAGGGT-1_V12D07-335_D1,0,3,1,0,0,4
ATGACTATGCGACATT-1_V12D07-335_D1,0,0,0,0,0,0
CCTAACCCAAACAAGT-1_V12D07-335_D1,0,2,1,0,0,3
AGTCAAGATGACACTT-1_V12D07-335_D1,0,0,0,0,0,0
CGGGAGCTTCAGTGTA-1_V12D07-335_D1,0,3,0,0,0,3
CCACAGTACCCATCCT-1_V12D07-335_D1,0,0,0,0,0,0
GAGCGCGCACGAGTAG-1_V12D07-335_D1,0,0,0,0,0,0
ACCAGTGCGGGAGACG-1_V12D07-335_D1,0,0,0,0,0,0
TCCTTACGACGGTCCG-1_V12D07-335_D1,0,6,0,4,2,12
TAGTCGATCACGGGTT-1_V12D07-335_D1,0,1,0,1,0,2
AGACGAAGTGCCGGTC-1_V12D07-335_D1,0,1,0,0,0,1
CGCTGGTGACTACCCT-1_V12D07-335_D1,0,1,0,0,0,1
AGGCATTGTCGTAGGG-1_V12D07-335_D1,0,1,0,1,0,2
TGGTAGAATATATGGG-1_V12D07-335_D1,0,2,0,0,0,2
TTCTTATCCGCTGGGT-1_V12D07-335_D1,0,0,0,0,0,0
AGTTTGGCACGGGTTG-1_V12D07-335_D1,0,1,1,0,1,3
GCATCGGCCGTGTAGG-1_V12D07-335_D1,0,1,0,1,0,2
ATGCGAGTCCCACCAC-1_V12D07-335_D1,0,0,0,0,0,0
TCGGCGAACCCAAACC-1_V12D07-335_D1,0,0,0,0,1,1
AGAGTAAACTTCACTA-1_V12D07-335_D1,0,0,0,0,0,0
AAGCCGAAGCGGTTTA-1_V12D07-335_D1,0,0,0,0,0,0
CCCGAGTTTCTCCGTA-1_V12D07-335_D1,0,0,0,0,0,0
AATATCGAATCAATGC-1_V12D07-335_D1,0,1,0,0,0,1
GCGCCTCCCACTCCGA-1_V12D07-335_D1,0,2,0,0,0,2
CGTTAAACTAGTTAGG-1_V12D07-335_D1,1,1,0,1,0,3
TGAGTTAAAGACATTC-1_V12D07-335_D1,0,0,0,0,0,0
AACAGGTAGTATGGAT-1_V12D07-335_D1,0,1,0,1,1,3
GAACGCGGGTCACACG-1_V12D07-335_D1,0,3,1,1,1,6
TGTTTGAGATCGTCAG-1_V12D07-335_D1,0,0,0,2,0,2
ATCTCGTGAGCGAAAC-1_V12D07-335_D1,0,1,3,0,0,4
CTGAGAAAGTTCGGCG-1_V12D07-335_D1,0,0,2,0,1,3
ATTACCACACTGCCTG-1_V12D07-335_D1,0,0,1,0,0,1
CTGCTGTCTAACGAGC-1_V12D07-335_D1,0,0,1,0,1,2
CGTGGAAGCCTCGTAC-1_V12D07-335_D1,0,1,4,1,0,6
GGACTCACAAATTAGG-1_V12D07-335_D1,1,2,5,0,0,8
CTTTGCTGTCATGGAT-1_V12D07-335_D1,0,0,3,0,0,3
GGTGTTGGGCGTCTTA-1_V12D07-335_D1,0,1,3,0,2,6
TACCATGTATTGATTT-1_V12D07-335_D1,0,0,6,1,0,7
GGTCTCCAAGTAGTGC-1_V12D07-335_D1,0,1,1,0,0,2
ATCCTTCTGAAAGAAC-1_V12D07-335_D1,0,0,2,0,0,2
CCGGAAGTTATCAGTC-1_V12D07-335_D1,0,0,0,0,0,0
TTAGAGGGATATACAG-1_V12D07-335_D1,3,0,0,1,0,4
TTGTACACCTCGAACA-1_V12D07-335_D1,2,0,1,0,0,3
GTGGGTACTGAGCGTA-1_V12D07-335_D1,0,2,2,0,0,4
CTTAAGCAGCGAGCCG-1_V12D07-335_D1,0,1,0,0,0,1
GCATTGACTTGCGGAA-1_V12D07-335_D1,0,2,0,1,0,3
CCATAACCTGTGCAGT-1_V12D07-335_D1,0,0,3,0,0,3
GGGCTACTATTTCGTG-1_V12D07-335_D1,0,1,1,0,0,2
GGCGAGCGAAACGGCA-1_V12D07-335_D1,1,2,2,0,0,5
GGAGACCATCTACATA-1_V12D07-335_D1,0,1,2,0,0,3
AGACCAAACCACACCT-1_V12D07-335_D1,0,1,2,0,0,3
CGACGCATCCGTACCT-1_V12D07-335_D1,0,0,0,0,0,0
CCTAGGTAAAGGTAGC-1_V12D07-335_D1,0,0,1,0,0,1
AGCGGCGGTTAGCGGT-1_V12D07-335_D1,0,1,0,0,0,1
CTGGACGCAGTCCGGC-1_V12D07-335_D1,0,3,0,0,0,3
AGCCTAATACCCACGT-1_V12D07-335_D1,0,0,3,0,0,3
AATCTGGCTTTCTAGT-1_V12D07-335_D1,0,2,2,0,0,4
CACCCTTGGTGAGACC-1_V12D07-335_D1,0,0,0,0,1,1
GGATCTTGACTCAACC-1_V12D07-335_D1,0,0,1,0,0,1
ACGAGGATACCACTCT-1_V12D07-335_D1,0,0,3,1,0,4
GAGTTGATGGCAATTT-1_V12D07-335_D1,0,0,3,0,0,3
GTGGCAAACAGCGGCA-1_V12D07-335_D1,0,2,2,0,0,4
GATGTAACGAACCACC-1_V12D07-335_D1,0,2,1,0,0,3
AGCCGTGGCTAAATGT-1_V12D07-335_D1,0,3,0,1,0,4
CTCCCTCCTTTCGATC-1_V12D07-335_D1,0,2,0,0,0,2
TTGGAAGAATACAGTC-1_V12D07-335_D1,0,1,3,0,0,4
AGTTAAGTCAACCGCT-1_V12D07-335_D1,0,0,3,1,0,4
CTCATGGTAATTTGCG-1_V12D07-335_D1,0,1,1,0,0,2
AAAGTAGCATTGCTCA-1_V12D07-335_D1,0,0,1,0,0,1
TTGTGGTAGGAGGGAT-1_V12D07-335_D1,0,0,1,0,0,1
AGTCGTGGGCATTACG-1_V12D07-335_D1,0,1,2,0,0,3
ACCTAAGTACCTTTCA-1_V12D07-335_D1,0,0,2,1,0,3
GTAGAGGGAGACAAGT-1_V12D07-335_D1,0,1,1,0,0,2
GATCCTCGACACTGGC-1_V12D07-335_D1,0,0,3,0,0,3
CCTACATTCACAGACG-1_V12D07-335_D1,0,1,3,0,0,4
TTGACCGTGTTAATGA-1_V12D07-335_D1,0,2,6,0,0,8
TCTGTTACCCAGCATA-1_V12D07-335_D1,0,0,3,1,0,4
CTAACTGGTCCGGTTC-1_V12D07-335_D1,0,0,1,0,0,1
AGCGACAGGAACGGTC-1_V12D07-335_D1,0,2,3,0,0,5
TAATAGAACAGAGTTA-1_V12D07-335_D1,0,4,3,0,0,7
ACAGGTGGAGGTGAGG-1_V12D07-335_D1,0,1,1,0,0,2
TGCGAGAATATTACCC-1_V12D07-335_D1,0,2,5,0,0,7
TTGCGTCGGCCAACCG-1_V12D07-335_D1,0,1,6,0,0,7
AGGCTTCCCGAAGAAG-1_V12D07-335_D1,0,1,2,1,0,4
GCGGACCGCGTTGTGG-1_V12D07-335_D1,0,0,3,0,0,3
GTAATCTGATTCTTCG-1_V12D07-335_D1,0,0,1,0,0,1
CCGCGGAATGCGTCAC-1_V12D07-335_D1,0,1,3,1,0,5
TTCCACACAGATTTGA-1_V12D07-335_D1,0,1,1,0,0,2
CTTCTATTAATGCTAG-1_V12D07-335_D1,0,0,2,0,1,3
CATTTGAGTGGTACGT-1_V12D07-335_D1,0,0,1,0,0,1
TCACAGCAAACTCGAA-1_V12D07-335_D1,0,0,2,0,0,2
CAGACGAACCTGATAC-1_V12D07-335_D1,0,1,1,1,1,4
TAGCTAGAAGGCATGA-1_V12D07-335_D1,0,1,4,1,1,7
ATCCAGAGCAACAACC-1_V12D07-335_D1,1,1,2,0,0,4
TCCGGTTCGTCCGGTC-1_V12D07-335_D1,0,1,0,0,1,2
CGCGCATGTTTGATTG-1_V12D07-335_D1,0,1,2,0,0,3
TGGCGATCAAGTTATG-1_V12D07-335_D1,0,2,0,0,0,2
CCCTTTGACAGGTCTT-1_V12D07-335_D1,0,3,5,0,0,8
CAGAGACGGTCACCCA-1_V12D07-335_D1,0,4,3,0,0,7
TAGCTCGCCTGATAAC-1_V12D07-335_D1,0,0,6,0,0,6
TTGTGTTTCCCGAAAG-1_V12D07-335_D1,0,0,0,0,0,0
TATACACAGACGCCTT-1_V12D07-335_D1,0,1,2,0,0,3
ACATTAGTTTATATCC-1_V12D07-335_D1,0,0,2,1,0,3
CCATCGCAGTTAAACT-1_V12D07-335_D1,0,1,1,0,0,2
AATTAGCGCTGCAGCG-1_V12D07-335_D1,0,3,0,0,0,3
TCCGCTTATCCCATTA-1_V12D07-335_D1,0,1,0,0,0,1
GTTTGGGCTTGTGAGC-1_V12D07-335_D1,0,2,3,0,1,6
CTTGTCAACATTCGAG-1_V12D07-335_D1,0,1,1,0,0,2
GGACCAACAGGATAAC-1_V12D07-335_D1,0,0,2,0,0,2
AAGCTAGATCGAGTAA-1_V12D07-335_D1,0,1,0,0,0,1
TACCGTGCCTCGGACC-1_V12D07-335_D1,0,0,2,0,0,2
GTAGCCAAACATGGGA-1_V12D07-335_D1,0,0,1,0,0,1
TGCCAGTACGTGGAGA-1_V12D07-335_D1,0,2,1,0,0,3
ATAAGGTGGAGAACAT-1_V12D07-335_D1,0,4,1,0,0,5
CTTTAATATTGGTCGA-1_V12D07-335_D1,0,0,2,0,0,2
TGGTTCAACGGGTAAT-1_V12D07-335_D1,0,2,0,0,0,2
GCTGCTACTGCGTAGC-1_V12D07-335_D1,0,0,1,0,0,1
CTGCACAACTACATAT-1_V12D07-335_D1,0,3,0,1,0,4
ATATTCCACATAGTGA-1_V12D07-335_D1,0,0,2,0,0,2
TGGCAAACTAAATTAC-1_V12D07-335_D1,0,0,2,0,0,2
ACCGCAATAACTGCCT-1_V12D07-335_D1,1,2,3,0,1,7
TCGCACCAGGAGGCAG-1_V12D07-335_D1,0,1,3,0,0,4
ACTTCAGGCTGATCCC-1_V12D07-335_D1,0,0,0,0,0,0
ACAAATCGCACCGAAT-1_V12D07-335_D1,0,1,0,0,0,1
TCTGATGTATTCTGTC-1_V12D07-335_D1,0,1,1,1,0,3
CTTTACCGAATAGTAG-1_V12D07-335_D1,0,1,1,0,0,2
GCAGATCCATAAGACT-1_V12D07-335_D1,0,2,1,0,0,3
TTCCTCGGACTAACCA-1_V12D07-335_D1,0,2,1,0,1,4
TTATCCGGGATCTATA-1_V12D07-335_D1,0,1,0,0,0,1
CTGGAAGACACGGTGG-1_V12D07-335_D1,0,1,0,0,0,1
GTTCGTCTAAAGAACT-1_V12D07-335_D1,0,0,0,0,0,0
GTCTATTGGTTCCGGT-1_V12D07-335_D1,0,1,0,0,0,1
CTAGGCGCCCTATCAG-1_V12D07-335_D1,0,0,1,0,0,1
AACGGACGTACGTATA-1_V12D07-335_D1,0,0,0,0,0,0
AACACACGCTCGCCGC-1_V12D07-335_D1,0,0,0,0,0,0
GCTACTATAGTAGAGT-1_V12D07-335_D1,2,16,0,0,1,19
AGCATATCAATATGCT-1_V12D07-335_D1,0,0,1,0,0,1
CGAACAGTATGGGCGT-1_V12D07-335_D1,0,0,0,0,0,0
ACAATTGTGTCTCTTT-1_V12D07-335_D1,0,1,0,0,0,1
GATCGCTACCCGATTT-1_V12D07-335_D1,0,1,0,0,0,1
ATTGCGATCAGTAACT-1_V12D07-335_D1,0,2,0,0,0,2
CAGCAGTCCAGACTAT-1_V12D07-335_D1,0,0,0,0,0,0
AGAGGCTTCGGAAACC-1_V12D07-335_D1,0,1,0,0,0,1
AAACAAGTATCTCCCA-1_V12D07-335_D1,0,3,0,0,0,3
GGCAGCAAACCTATGC-1_V12D07-335_D1,0,0,1,0,0,1
ACTAGTTGCGATCGTC-1_V12D07-335_D1,0,0,0,0,0,0
TTGGACCATCTGGCAA-1_V12D07-335_D1,0,0,0,0,1,1
CCCTCCTCGCTCGTAT-1_V12D07-335_D1,0,2,0,0,0,2
GAGCGCAAATACTCCG-1_V12D07-335_D1,0,0,0,0,0,0
ATTACATGTCAGTCTT-1_V12D07-335_D1,0,0,0,0,0,0
TTGGGACGTAAGAGTT-1_V12D07-335_D1,0,0,0,0,0,0
CTTCGGCCAATTGTTT-1_V12D07-335_D1,0,1,0,0,1,2
AGACCGCTCCGCGGTT-1_V12D07-335_D1,0,1,1,0,0,2
GACCGCGTCTGACGTG-1_V12D07-335_D1,0,1,1,0,0,2
CCAAATAACAAGATTC-1_V12D07-335_D1,0,1,1,0,1,3
TCTTTAGAGTCTAACA-1_V12D07-335_D1,0,0,0,0,1,1
CTCCCAATGAGTCGCG-1_V12D07-335_D1,0,0,0,0,0,0
TAGTCTTTCCGAATTG-1_V12D07-335_D1,0,0,1,0,0,1
GAGTAAACCGGAAAGT-1_V12D07-335_D1,0,0,0,0,1,1
GATCTCGACGCTGTGG-1_V12D07-335_D1,0,2,0,0,2,4
CTGACATAGAAATAGA-1_V12D07-335_D1,0,0,1,0,0,1
TATACCGAGTGCCACA-1_V12D07-335_D1,0,0,8,0,1,9
TCCGAACGTTGCCGCT-1_V12D07-335_D1,1,1,2,0,4,8
GCAGAAGGTAATCTCC-1_V12D07-335_D1,0,0,2,0,1,3
GGTACTAAGTGCTTTG-1_V12D07-335_D1,0,1,1,0,1,3
CAGAATATTCGTTATC-1_V12D07-335_D1,0,0,1,0,2,3
TAATCAACCAAATGGG-1_V12D07-335_D1,0,0,5,1,0,6
TCTGCTTAGAACAAGC-1_V12D07-335_D1,0,2,1,0,0,3
AACTGAGTTATACTGA-1_V12D07-335_D1,0,2,1,1,0,4
CCTCAACGATCGCTGT-1_V12D07-335_D1,1,2,0,0,0,3
CGGTACGGCAAACCCA-1_V12D07-335_D1,0,1,3,0,0,4
CAGATGTTTGTCCCAA-1_V12D07-335_D1,1,1,0,1,0,3
GTTTGTTAGCCAAGTA-1_V12D07-335_D1,2,1,0,0,0,3
ACGTGACAAAGTAAGT-1_V12D07-335_D1,0,2,1,0,0,3
TTGTCACCGCGGTATC-1_V12D07-335_D1,4,1,0,0,0,5
GATCTAACCGTATTCA-1_V12D07-335_D1,1,1,0,0,0,2
ATGGAAATTTAAGGAG-1_V12D07-335_D1,1,3,0,0,0,4
ATTGATCACCACATTT-1_V12D07-335_D1,0,0,0,0,0,0
ACTGCTCGGAAGGATG-1_V12D07-335_D1,1,1,3,1,0,6
TCTAAAGAACAGTCTC-1_V12D07-335_D1,0,2,0,0,0,2
CTGGGTTGAGTTAAAG-1_V12D07-335_D1,0,1,1,0,0,2
CCCAGTAAACTTGGGA-1_V12D07-335_D1,0,2,0,0,0,2
AGATTCACAACCGATA-1_V12D07-335_D1,0,2,1,0,0,3
AGAAGGTACACTTCAC-1_V12D07-335_D1,1,0,0,0,0,1
GCAGGAACTTAGATCT-1_V12D07-335_D1,0,1,0,0,0,1
AATCTAGGTTTACTTG-1_V12D07-335_D1,0,2,2,0,0,4
CCCGGTGTATCGGAAT-1_V12D07-335_D1,0,0,0,0,0,0
TTATCCTCAAGGAATA-1_V12D07-335_D1,0,3,3,0,0,6
AGCATCATTTCGAAAG-1_V12D07-335_D1,0,0,3,0,0,3
CGCGAGTCTGCCGGGT-1_V12D07-335_D1,0,3,2,0,0,5
TGCGTCATGACTGAGC-1_V12D07-335_D1,0,1,1,0,0,2
GTATGAAATTTCACTC-1_V12D07-335_D1,0,1,1,0,0,2
TTGGTTGCGGTGCGCG-1_V12D07-335_D1,0,2,0,0,0,2
ACAGAACTGAGAACAA-1_V12D07-335_D1,0,1,1,0,0,2
CTACTATCATAGGTTT-1_V12D07-335_D1,0,0,6,0,0,6
CCTCTATCGATTAGCA-1_V12D07-335_D1,4,3,4,1,0,12
CCGTATCTCGTCGTAG-1_V12D07-335_D1,0,0,0,0,0,0
TCACGATGTCCGTGGA-1_V12D07-335_D1,0,0,2,0,0,2
TCAACAAAGATAATTC-1_V12D07-335_D1,0,1,0,0,0,1
ATGACGCGTTCTATCC-1_V12D07-335_D1,0,1,4,0,0,5
ATTTGCGCGAGTAGCT-1_V12D07-335_D1,0,1,2,0,0,3
TTCTTGGACGATCTGC-1_V12D07-335_D1,0,0,1,0,0,1
AGACGACGATGCCGCT-1_V12D07-335_D1,0,0,1,0,0,1
GGTCTCTGAATGGACT-1_V12D07-335_D1,0,1,2,0,0,3
GCTCAATCCGTTTATT-1_V12D07-335_D1,0,1,3,0,0,4
CCAGAAAGCAACTCAT-1_V12D07-335_D1,0,1,2,0,0,3
CACCGTTAGGGATCAC-1_V12D07-335_D1,0,3,2,0,0,5
AATAACACTAGAACAA-1_V12D07-335_D1,0,1,8,0,0,9
CACCCGGTTTGTGACT-1_V12D07-335_D1,0,3,4,0,0,7
CCACCAACTTTACTGT-1_V12D07-335_D1,0,1,4,0,0,5
AACTCTCAGTGTGCTC-1_V12D07-335_D1,0,2,1,0,0,3
AAACCGTTCGTCCAGG-1_V12D07-335_D1,0,1,1,0,0,2
CAGCGATTCCCTTCAA-1_V12D07-335_D1,0,3,1,0,0,4
GCTAGCTTGAATAGCT-1_V12D07-335_D1,0,0,1,0,0,1
TTGCGGCATCAGAAAG-1_V12D07-335_D1,0,0,1,0,0,1
AATAGAACAGAGTGGC-1_V12D07-335_D1,0,1,0,0,0,1
GCCATCGAGCTGCGTG-1_V12D07-335_D1,0,1,2,0,0,3
ACACTGATCAAGGTGT-1_V12D07-335_D1,0,1,6,1,0,8
ACCAACGCTTATTTAT-1_V12D07-335_D1,0,0,2,0,0,2
GACATCGATTTATAAC-1_V12D07-335_D1,0,1,4,0,0,5
CAGACACCGATCGCTG-1_V12D07-335_D1,0,2,2,0,0,4
CCAAGAAAGTGGGCGA-1_V12D07-335_D1,0,3,1,0,0,4
GGTAGACCGTTGGGCG-1_V12D07-335_D1,0,4,5,0,0,9
TCGTTAGGAGTCCCTA-1_V12D07-335_D1,0,2,0,0,0,2
ACGGCCAACATGGACT-1_V12D07-335_D1,0,1,3,0,0,4
GTGAGTGGTACAACGC-1_V12D07-335_D1,2,2,5,1,0,10
GAGACTTCGCGACCGA-1_V12D07-335_D1,0,1,3,0,0,4
GAAGTCAGTTGCACTA-1_V12D07-335_D1,0,2,5,0,0,7
GTTTGGTAGGGTCAAC-1_V12D07-335_D1,0,0,0,0,0,0
ACGGCACTTGCTTGGG-1_V12D07-335_D1,0,0,0,0,1,1
CCTCTGTACTATTCTA-1_V12D07-335_D1,0,1,2,0,0,3
CTATTCATGTGTCCCA-1_V12D07-335_D1,0,0,0,0,0,0
GCCCGATCTGTGGTCG-1_V12D07-335_D1,0,0,2,0,0,2
TTAGAAGAACATGACT-1_V12D07-335_D1,0,0,3,1,0,4
AGGATAAAGTCGGGAT-1_V12D07-335_D1,0,0,2,0,0,2
CGGCAAACATCGTGCG-1_V12D07-335_D1,0,1,2,0,0,3
CTAGTTACAACCCGGT-1_V12D07-335_D1,0,0,4,0,0,4
TTCGACAGAGCCCGTG-1_V12D07-335_D1,0,1,3,0,0,4
AAGCATACTCTCCTGA-1_V12D07-335_D1,0,1,1,0,1,3
GACGACGATCCGCGTT-1_V12D07-335_D1,0,0,0,0,0,0
GGTAGAAGACCGCCTG-1_V12D07-335_D1,0,1,0,0,0,1
GAGATGGGAGTCGACA-1_V12D07-335_D1,0,0,0,0,0,0
AACGATAATGCCGTAG-1_V12D07-335_D1,0,1,4,0,0,5
TGGTCCCACGCTACGG-1_V12D07-335_D1,0,0,1,1,0,2
CTGCTTGGCGATAGCT-1_V12D07-335_D1,0,0,0,1,0,1
ATCGGAGACAGACGGC-1_V12D07-335_D1,0,2,2,0,0,4
TAGCGTCCGGTGTGGT-1_V12D07-335_D1,0,1,2,0,0,3
GTTGAGTCCCGCCGGT-1_V12D07-335_D1,1,3,0,0,1,5
AAATAGGGTGCTATTG-1_V12D07-335_D1,1,0,0,0,0,1
AAGTGTTTGGAGACGG-1_V12D07-335_D1,0,0,0,0,0,0
AGCACTACCTCACCAG-1_V12D07-335_D1,0,1,0,0,0,1
TGCCTTGGCCAGGCAA-1_V12D07-335_D1,0,1,4,0,0,5
TCGTCTTAGGCGTTAA-1_V12D07-335_D1,0,0,1,0,0,1
TTCTGACCGGGCTCAA-1_V12D07-335_D1,0,1,2,0,0,3
CAGAACTTAGCCCTCT-1_V12D07-335_D1,0,1,1,0,0,2
AGCTCCTTCGCACATC-1_V12D07-335_D1,0,1,0,0,0,1
ACAGGCTTGCCCGACT-1_V12D07-335_D1,0,4,0,0,0,4
GCTATACGTCTCGGAC-1_V12D07-335_D1,0,0,0,0,0,0
GAGCCAGCTACCTGTG-1_V12D07-335_D1,0,2,0,0,0,2
TGCTAAGTGTCTATTT-1_V12D07-335_D1,0,0,0,0,0,0
GTCCTACGAATAGTCT-1_V12D07-335_D1,0,0,0,0,0,0
CAGTGTCGGCTGGCCC-1_V12D07-335_D1,0,0,1,0,0,1
CTATCGACGAAATACA-1_V12D07-335_D1,0,2,0,0,0,2
CATCATTACCCTGAGG-1_V12D07-335_D1,0,2,2,0,0,4
TAAGTTGCGACGTAGG-1_V12D07-335_D1,0,0,1,0,0,1
AGTGCACGCTTAAGAA-1_V12D07-335_D1,0,0,0,0,0,0
TGTGCCGGTGCCGGAA-1_V12D07-335_D1,1,0,0,0,0,1
AGGAGGCCTTCGCGCG-1_V12D07-335_D1,0,3,0,0,0,3
TCCGCGGCCCAATGAA-1_V12D07-335_D1,0,0,0,0,0,0
TCCGTTAAGCTAATAT-1_V12D07-335_D1,0,0,0,0,0,0
AAATCTAGCCCTGCTA-1_V12D07-335_D1,0,0,0,0,0,0
CGCAGGCGATCCAAAC-1_V12D07-335_D1,0,0,0,0,0,0
CCATATGGAAACTATA-1_V12D07-335_D1,0,0,2,0,0,2
CACCGTATCCCATCCG-1_V12D07-335_D1,0,0,1,0,0,1
GGTCAAGACTACTTCG-1_V12D07-335_D1,0,0,0,0,0,0
CCCGTTTCGCAGATGT-1_V12D07-335_D1,0,1,0,0,0,1
GTTATAATACGGTGAA-1_V12D07-335_D1,0,0,0,0,0,0
ACTTGTGGATGGAACG-1_V12D07-335_D1,0,0,0,0,0,0
GTTCGCTGAGACGTCT-1_V12D07-335_D1,0,1,0,0,0,1
GACACTGGAACCCGAT-1_V12D07-335_D1,0,1,0,0,1,2
CCCAGGTCTGAAGGCT-1_V12D07-335_D1,1,1,1,0,0,3
TCTCGAGGAGGTTCGC-1_V12D07-335_D1,0,3,1,0,0,4
ACTATCTGCCCGCGTA-1_V12D07-335_D1,1,0,0,0,0,1
CCTAAATTGTATCCTA-1_V12D07-335_D1,1,0,1,0,1,3
AGAAATTATGACTCGC-1_V12D07-335_D1,0,0,0,0,0,0
TCCAGCGCTATAAGCG-1_V12D07-335_D1,0,1,1,2,0,4
TCGTGTATTGGTCACG-1_V12D07-335_D1,0,1,0,0,0,1
CCACATACTGCACCCA-1_V12D07-335_D1,0,0,1,0,0,1
GTTGCGGACGGTCAGG-1_V12D07-335_D1,0,2,6,0,0,8
GTATTTAATGGCATAA-1_V12D07-335_D1,0,1,1,1,1,4
GTCGATAGGTGACTTT-1_V12D07-335_D1,0,0,1,0,0,1
AATAATCTTCGTATCG-1_V12D07-335_D1,0,0,2,0,0,2
ATTGTTCAACGATCCG-1_V12D07-335_D1,0,0,1,0,0,1
GTGCAGCGTAGAGTAG-1_V12D07-335_D1,0,1,1,0,0,2
TGTGGTAGGGTGCCTT-1_V12D07-335_D1,0,2,1,1,0,4
TGTGGACTATCTACGT-1_V12D07-335_D1,0,0,1,0,0,1
GGCGGGCTCTAAGAGT-1_V12D07-335_D1,0,0,4,0,0,4
TGTGCCAGAGGCAAAG-1_V12D07-335_D1,0,1,0,0,0,1
TGGCTTATGTATAATG-1_V12D07-335_D1,0,1,0,0,0,1
GCAAGCTGGAAACCGC-1_V12D07-335_D1,1,2,2,0,0,5
GATATCAAGCAGGAGC-1_V12D07-335_D1,0,3,0,0,0,3
CACCAATCATCCGTCT-1_V12D07-335_D1,1,0,3,0,0,4
CCACATGGCTCTTTAT-1_V12D07-335_D1,2,0,2,1,0,5
GTCCTACTCTACGGGC-1_V12D07-335_D1,3,1,0,1,0,5
CTCGAGACATACGATA-1_V12D07-335_D1,3,1,1,0,0,5
TATCAGTGGCGTAGTC-1_V12D07-335_D1,3,0,1,1,0,5
TGACAGGACAAGTCCA-1_V12D07-335_D1,1,0,0,2,0,3
TATTAACACCAAAGCA-1_V12D07-335_D1,0,1,0,0,0,1
TAGGCGATGAGGTCTC-1_V12D07-335_D1,0,3,2,0,0,5
CCGCCGGAACTTCTCG-1_V12D07-335_D1,0,1,0,0,0,1
GCCATTAGCCTCAAAC-1_V12D07-335_D1,0,0,2,0,0,2
GTTAGGCTACCCGTTT-1_V12D07-335_D1,0,1,0,0,0,1
GGGTATTCTAGCAAAC-1_V12D07-335_D1,0,1,2,0,0,3
GCCCTAGCCGTCGCGA-1_V12D07-335_D1,0,0,0,0,0,0
CAGATCCTGGTTTGAA-1_V12D07-335_D1,1,0,0,0,0,1
CTTCAGTGGTCGCCTA-1_V12D07-335_D1,0,1,2,0,0,3
GGGCAACCGCACGTGC-1_V12D07-335_D1,0,0,0,0,0,0
GACCCAATTATGATAC-1_V12D07-335_D1,0,2,2,0,0,4
GAAGCTCGGACCCGTC-1_V12D07-335_D1,0,1,1,0,0,2
CGTCGGGTCTAAGCGC-1_V12D07-335_D1,0,0,3,0,0,3
GAGGCCCGACTCCGCA-1_V12D07-335_D1,0,1,4,0,0,5
TTGCCATAGCCCGCTC-1_V12D07-335_D1,0,1,0,0,0,1
TAACATACACGCGATC-1_V12D07-335_D1,0,0,1,0,0,1
CCGACGGGCATGAGGT-1_V12D07-335_D1,0,0,3,0,0,3
AATGTGCCCGAGGTGT-1_V12D07-335_D1,1,3,0,0,0,4
AGCTGTAACCTCAATC-1_V12D07-335_D1,0,0,6,0,0,6
CGAGTGAAGGTACCAG-1_V12D07-335_D1,0,2,5,0,0,7
AGTCTCACAAGACTAC-1_V12D07-335_D1,0,3,2,0,0,5
AAATTGATAGTCCTTT-1_V12D07-335_D1,0,1,1,0,0,2
TAAGTCGCCGAGTATC-1_V12D07-335_D1,0,1,3,0,0,4
GCGGAGAAACTTCGCA-1_V12D07-335_D1,0,0,1,0,0,1
GGCAAAGGCGCCAATA-1_V12D07-335_D1,0,1,2,0,0,3
ATTTCCGGGTTCTGCG-1_V12D07-335_D1,0,0,2,0,0,2
TAAACCCAGGAGGGCA-1_V12D07-335_D1,0,0,0,0,0,0
TTCGGGCGCTAGTCTT-1_V12D07-335_D1,0,1,5,0,0,6
GTGGAGTCGGCGGTTG-1_V12D07-335_D1,0,2,2,0,0,4
GCACGCCTACTTAGAT-1_V12D07-335_D1,0,1,3,0,0,4
CAATATTCTTGACCTA-1_V12D07-335_D1,0,1,1,0,0,2
CGTTTGTGTAGAGGGT-1_V12D07-335_D1,0,0,1,0,0,1
CATAGCGTTGCCCACC-1_V12D07-335_D1,0,0,5,0,0,5
TGATACATTTAGCCGT-1_V12D07-335_D1,0,1,0,0,0,1
TTCCGGCCTTGAGGCT-1_V12D07-335_D1,0,2,0,0,0,2
CCTATACCGTCCTGTC-1_V12D07-335_D1,0,4,1,0,0,5
TCGTTGCTATCCGGTC-1_V12D07-335_D1,0,1,3,0,0,4
TGGCGACTGCTCCAAA-1_V12D07-335_D1,0,0,1,0,0,1
CAGAGGCGATGCATGA-1_V12D07-335_D1,0,1,3,0,0,4
TCACAGGAGAATAAGA-1_V12D07-335_D1,0,0,1,0,0,1
GGGTTAACATTTGAGT-1_V12D07-335_D1,0,0,0,0,0,0
GCGGGCGAGCCTTACC-1_V12D07-335_D1,0,2,1,0,0,3
TGCCAATGGGTACTCT-1_V12D07-335_D1,0,2,1,0,0,3
AGGGACTCTACGCGAC-1_V12D07-335_D1,0,0,1,0,0,1
GACGCCGTAAAGGCTA-1_V12D07-335_D1,0,1,2,0,0,3
AAAGGCTCTCGCGCCG-1_V12D07-335_D1,0,1,2,0,0,3
CTGGCTGGTTGTCAGT-1_V12D07-335_D1,0,1,2,1,0,4
ACATCCCGGCCATACG-1_V12D07-335_D1,0,1,1,0,0,2
CTCTTGTCCCGCTTGG-1_V12D07-335_D1,0,1,6,0,0,7
TACGCCTCCATTCCGA-1_V12D07-335_D1,0,2,3,0,0,5
CGGAGCAATTTAATCG-1_V12D07-335_D1,0,1,0,0,0,1
AACTAGGCTTGGGTGT-1_V12D07-335_D1,0,0,1,0,0,1
GCGTCGCCAGGGTGAT-1_V12D07-335_D1,0,0,1,0,0,1
GTTGGTCATGCTATCC-1_V12D07-335_D1,1,0,0,0,0,1
GCTGGCGGCGCATGCT-1_V12D07-335_D1,0,0,3,0,0,3
TGAGCGGAAAGTGTTC-1_V12D07-335_D1,0,1,0,1,0,2
CTTTCTGTGCGGGCTT-1_V12D07-335_D1,0,1,5,0,0,6
ATCTAATATCCTACGG-1_V12D07-335_D1,0,0,1,0,0,1
AACCTTTAAATACGGT-1_V12D07-335_D1,0,2,2,0,0,4
TTCACTCGAGCACCTA-1_V12D07-335_D1,0,1,1,0,0,2
CTGCACTCCAGTACAG-1_V12D07-335_D1,0,0,0,0,1,1
CCATTTCTACCTATTA-1_V12D07-335_D1,0,1,4,0,0,5
CAAGCGGCACATAATT-1_V12D07-335_D1,0,2,0,0,0,2
GTTAACATCACTTAAA-1_V12D07-335_D1,0,1,0,0,0,1
ATATAAATGTAGCTGC-1_V12D07-335_D1,0,0,1,0,0,1
GCCTCTATACATAGCA-1_V12D07-335_D1,0,2,2,0,0,4
GTGTCGTATAGCGTTC-1_V12D07-335_D1,0,1,3,0,0,4
ATACGTACTTAGCCAC-1_V12D07-335_D1,0,1,2,0,0,3
GCTATCATACTCATGG-1_V12D07-335_D1,0,1,0,1,0,2
TATCCAATTGGTTATC-1_V12D07-335_D1,0,2,2,0,0,4
TCTCCCTGGGCAGCGT-1_V12D07-335_D1,1,1,3,0,0,5
CCTATAATGAGTGCCC-1_V12D07-335_D1,0,1,1,0,0,2
CAATGCGAGAAGTATC-1_V12D07-335_D1,0,0,0,1,0,1
TACCAATAAAGTACCA-1_V12D07-335_D1,0,1,0,0,0,1
GCTAGGCACCACGGAG-1_V12D07-335_D1,0,5,0,0,0,5
GGTGGACTGCTCTGGC-1_V12D07-335_D1,0,1,0,0,1,2
TATTCCGAGCTGTTAT-1_V12D07-335_D1,0,3,0,1,0,4
TTGAGAAGTTTAGCAT-1_V12D07-335_D1,0,0,0,0,0,0
GTCCGGACCTGAAATT-1_V12D07-335_D1,0,0,0,0,0,0
CTGTGGTCGGGAGATA-1_V12D07-335_D1,0,0,0,0,0,0
CATGTAAGAGACATTT-1_V12D07-335_D1,0,0,1,0,0,1
CACGTTTCGTACACAC-1_V12D07-335_D1,0,0,0,0,0,0
CATCCTCTCAAAGATC-1_V12D07-335_D1,0,0,1,0,0,1
GATTAACCGAAAGCCC-1_V12D07-335_D1,0,0,1,0,0,1
AACGCTGTTGCTGAAA-1_V12D07-335_D1,0,0,0,0,0,0
TTCAGCTGGCGTGCCC-1_V12D07-335_D1,0,2,0,0,0,2
TAGAGGTTCTACTTGT-1_V12D07-335_D1,0,0,0,0,0,0
GTATCAAACGTTAGCT-1_V12D07-335_D1,0,0,0,0,0,0
AATCATGTAAAGACTC-1_V12D07-335_D1,0,3,0,0,0,3
AGTCACTAGCTCTCGA-1_V12D07-335_D1,0,1,0,0,0,1
GCGAAACGATCGGGAG-1_V12D07-335_D1,0,2,0,0,0,2
CATGGATTGTCTTCCG-1_V12D07-335_D1,0,1,0,0,0,1
ATTGGATTACAGCGTA-1_V12D07-335_D1,0,2,0,0,1,3
CACACACGCTAACGAG-1_V12D07-335_D1,0,3,0,0,0,3
CTATGGGAAGCGGAAT-1_V12D07-335_D1,0,1,0,0,0,1
TGCCTAATTGAAGATT-1_V12D07-335_D1,0,0,0,0,0,0
TGGCAATGGGACGGCG-1_V12D07-335_D1,0,0,0,1,0,1
ACCTCCGCCCTCGCTG-1_V12D07-335_D1,0,0,0,0,0,0
CGGCAATAAGATCGCC-1_V12D07-335_D1,0,0,0,0,0,0
CCTTGACCACTTTATT-1_V12D07-335_D1,0,3,2,0,0,5
TCATTTAGAAGTGTGA-1_V12D07-335_D1,0,1,0,0,0,1
CAGAATAACACACGGA-1_V12D07-335_D1,0,0,0,0,0,0
TCTGAGCAATTGACTG-1_V12D07-335_D1,0,1,0,0,0,1
CAACGTGGTGGAGTCT-1_V12D07-335_D1,0,0,0,0,0,0
CACAGTTCGCTTCCCA-1_V12D07-335_D1,0,2,1,0,0,3
TCTCTCGCCGCACATA-1_V12D07-335_D1,0,1,0,1,2,4
TGGGCAGGCCACCGCA-1_V12D07-335_D1,0,0,1,0,1,2
CTCCTGTTCAAGGCAG-1_V12D07-335_D1,0,3,0,0,1,4
TATTTGATTTGCACAG-1_V12D07-335_D1,0,1,3,0,0,4
GCCACTCCTTACGGTA-1_V12D07-335_D1,0,2,0,1,1,4
ACCGATATTTAATCAT-1_V12D07-335_D1,0,0,2,1,0,3
TTATTATCTGGAAGGC-1_V12D07-335_D1,0,1,3,0,0,4
TACATGCCGGAATTGT-1_V12D07-335_D1,0,1,2,0,0,3
GGCACTCAGCCGACCC-1_V12D07-335_D1,0,0,0,0,0,0
AAACCGGAAATGTTAA-1_V12D07-335_D1,0,0,3,1,0,4
AGACAGGCATCTCAGC-1_V12D07-335_D1,0,1,3,0,0,4
GTGGTGATGGTTTGTG-1_V12D07-335_D1,0,0,5,0,0,5
CCGATATGACGTAAGG-1_V12D07-335_D1,0,0,1,0,0,1
CATACACAAAGTCAGC-1_V12D07-335_D1,0,0,1,0,1,2
TGCCGTTCTTAATCGG-1_V12D07-335_D1,0,0,1,0,0,1
TCGAGTCTACGATTCG-1_V12D07-335_D1,0,2,1,0,0,3
ACTTCCAGTGGAAGCT-1_V12D07-335_D1,0,0,2,0,1,3
CAATTGGGCCGCACTC-1_V12D07-335_D1,0,1,0,0,0,1
AAATCGCGGAAGGAGT-1_V12D07-335_D1,1,1,2,1,0,5
ATATCAATTCCAGCCT-1_V12D07-335_D1,0,1,1,0,0,2
CTTTGTCGAATGCTCC-1_V12D07-335_D1,2,0,2,0,0,4
TGAGGCATGTACTGTG-1_V12D07-335_D1,2,1,0,1,0,4
TTCGCCGCTCGCGCTA-1_V12D07-335_D1,1,4,1,0,0,6
GACTCCTTCCAATTGA-1_V12D07-335_D1,0,1,0,0,0,1
ACCGAAGAGTCTGGTT-1_V12D07-335_D1,3,1,0,0,0,4
TGGCATGAAGTTTGGG-1_V12D07-335_D1,0,0,0,0,0,0
ACGAGGTTTACAACGT-1_V12D07-335_D1,1,1,2,0,0,4
AACCCATCCCATGATC-1_V12D07-335_D1,1,0,1,1,0,3
TCGACAACTGAACCCG-1_V12D07-335_D1,1,2,0,0,0,3
TATCTTGCAATACAAC-1_V12D07-335_D1,1,2,0,0,0,3
TATTATGTTTGCCTGC-1_V12D07-335_D1,0,0,1,0,0,1
GTCAAAGAAGTGGTGT-1_V12D07-335_D1,0,4,1,0,0,5
GGGACAGAGTTACTCC-1_V12D07-335_D1,0,3,0,0,0,3
AGCAACCGAAAGTAAT-1_V12D07-335_D1,0,1,0,0,0,1
CTCTCTAACTGCCTAG-1_V12D07-335_D1,0,3,2,0,0,5
ATACGGAACGTCGTTT-1_V12D07-335_D1,0,2,2,0,0,4
TCGGTCCCGACAATAG-1_V12D07-335_D1,0,0,1,0,0,1
CGCGCAAATGTCCAGA-1_V12D07-335_D1,0,1,0,0,0,1
TCTAATACTGCCTCAG-1_V12D07-335_D1,0,0,0,0,0,0
CTCGGTTGTCGGCCCT-1_V12D07-335_D1,0,0,4,1,0,5
GGTAACCGGGAGGATA-1_V12D07-335_D1,0,0,1,0,0,1
CAGGCGCACGGTGGTC-1_V12D07-335_D1,0,1,0,0,0,1
TCATCGATGGTCCCAA-1_V12D07-335_D1,0,0,0,0,0,0
CAAAGATTATTGGGCC-1_V12D07-335_D1,0,2,6,0,0,8
ACAATGAATACGGAGA-1_V12D07-335_D1,0,1,1,0,0,2
GCTCCTGACATACTGG-1_V12D07-335_D1,0,1,1,0,0,2
GATGACAAGTAGGGCA-1_V12D07-335_D1,0,0,0,0,0,0
TACGCCGAGGGTACCC-1_V12D07-335_D1,0,0,2,0,0,2
AAGCGTCCCTCATCGA-1_V12D07-335_D1,0,1,0,0,0,1
CACTCCTATGTAAGAT-1_V12D07-335_D1,0,1,2,0,0,3
TCGAGCCAGGCAGGCC-1_V12D07-335_D1,0,1,1,0,0,2
TCGTCAAGTACGCGCA-1_V12D07-335_D1,0,0,3,0,0,3
CCCGTAGCTGGGAAGA-1_V12D07-335_D1,0,0,3,0,0,3
ACCCTATGCCATATCG-1_V12D07-335_D1,0,4,4,0,0,8
GTGGTATAGTCTGCCG-1_V12D07-335_D1,0,0,0,0,0,0
CCGGTTTGTAATTGTG-1_V12D07-335_D1,0,1,1,0,0,2
GTCGCCGTTGTGTGTT-1_V12D07-335_D1,0,1,1,0,0,2
TACTGAACAGATTTAG-1_V12D07-335_D1,0,0,2,0,0,2
TATTAACCTGACCGCG-1_V12D07-335_D1,0,0,1,0,0,1
CTGTAGCCATCTCACT-1_V12D07-335_D1,0,2,1,0,0,3
TACTATGGTTCCTCAG-1_V12D07-335_D1,0,0,2,0,0,2
GAGTCAGACCAGAATC-1_V12D07-335_D1,0,0,1,0,0,1
TAAGGCATAACATCAA-1_V12D07-335_D1,0,0,4,0,0,4
CTTCCGCTCCGTGAAG-1_V12D07-335_D1,0,1,1,0,0,2
GGGCTATGATCGATGG-1_V12D07-335_D1,0,0,1,0,0,1
GGTCGGTCGTCCACAG-1_V12D07-335_D1,0,0,2,0,0,2
GGGACCCGTATATCTT-1_V12D07-335_D1,0,0,0,0,0,0
GAAAGCAGTGCACTTT-1_V12D07-335_D1,0,1,1,0,0,2
AGCGCATAATGAATCG-1_V12D07-335_D1,0,0,3,0,0,3
GCTGCTAAGTAGTCGA-1_V12D07-335_D1,0,0,6,0,0,6
AATAGTCCGTCCCGAC-1_V12D07-335_D1,0,0,2,0,0,2
AGCAGCCAGATGAATA-1_V12D07-335_D1,0,1,1,1,0,3
CCTCGCGCTGTGCGAT-1_V12D07-335_D1,0,0,3,0,0,3
TTGTGTATGCCACCAA-1_V12D07-335_D1,0,0,2,0,0,2
TGCTCGGCGAAACCCA-1_V12D07-335_D1,0,0,2,0,0,2
CGATTAAATATCTCCT-1_V12D07-335_D1,0,1,1,0,0,2
TGCCGTGGATCGTCCT-1_V12D07-335_D1,0,1,2,0,0,3
GTGGACGCATTTGTCC-1_V12D07-335_D1,0,0,1,0,0,1
ACCCGGAAACTCCCAG-1_V12D07-335_D1,1,0,2,0,0,3
CCGCATGTGGTACGAT-1_V12D07-335_D1,0,1,5,0,0,6
GCAAACCTTGGCCATA-1_V12D07-335_D1,0,0,2,0,0,2
ATTCACTGATGTTGGA-1_V12D07-335_D1,0,0,0,0,0,0
ACTCCCTAATGCTAAA-1_V12D07-335_D1,0,2,0,0,0,2
TCCTAAATTGGGAAGC-1_V12D07-335_D1,0,0,1,0,0,1
GAACAGATTACTAAAT-1_V12D07-335_D1,0,1,3,0,0,4
ATACAGGCCCTCCAAT-1_V12D07-335_D1,0,0,0,0,0,0
CGATTCGCCTGGCTGC-1_V12D07-335_D1,0,0,0,0,0,0
TCCGCCTGTCTACAAG-1_V12D07-335_D1,0,0,0,0,0,0
CACATCTCACCGACGA-1_V12D07-335_D1,0,1,1,0,1,3
CGTCGTCCTTCGCGAA-1_V12D07-335_D1,0,1,2,0,0,3
CGTTGAATACCGCGCT-1_V12D07-335_D1,0,0,1,0,0,1
ACCAATATGCAAGTTA-1_V12D07-335_D1,0,1,0,0,0,1
ACGGATGGTGCGGATA-1_V12D07-335_D1,0,1,2,0,0,3
CACCCTAACAAGATCT-1_V12D07-335_D1,0,2,1,0,0,3
AAGCTCTTTCATGGTG-1_V12D07-335_D1,0,0,0,0,0,0
CATGGGTATGCCTTAT-1_V12D07-335_D1,0,0,1,1,0,2
GCGCGTCATTGGTACA-1_V12D07-335_D1,0,0,0,0,0,0
TCTGAAGCACGTGGTC-1_V12D07-335_D1,0,1,0,0,0,1
AAGTTCACTCCAAGCT-1_V12D07-335_D1,0,2,0,0,0,2
TTGGACCTATAACAGT-1_V12D07-335_D1,0,1,0,0,0,1
ATCAGCCTCATGCTGC-1_V12D07-335_D1,0,1,0,0,0,1
AGTACTCTTATGCCCA-1_V12D07-335_D1,0,0,0,0,0,0
GCGCTTAAATAATTGG-1_V12D07-335_D1,0,0,1,0,0,1
TTGTGAACCTAATCCG-1_V12D07-335_D1,0,0,0,0,0,0
AGTCGTCGACCACCAA-1_V12D07-335_D1,1,0,0,0,0,1
TCCTTTAAATCCGCTT-1_V12D07-335_D1,0,1,1,0,0,2
ACTGAAACGCCGTTAG-1_V12D07-335_D1,0,1,0,0,0,1
GCACACACTGGTAGCC-1_V12D07-335_D1,0,0,0,0,0,0
TAAGGGCCTGTCCGAT-1_V12D07-335_D1,0,1,0,0,0,1
GCTAGAGTAGAGATGT-1_V12D07-335_D1,0,2,0,0,0,2
CACAGGGCCATATAGT-1_V12D07-335_D1,0,0,1,0,0,1
CCATGCCCTAGATTTC-1_V12D07-335_D1,0,1,0,0,0,1
TCGCGTAGCAGTGTCC-1_V12D07-335_D1,0,1,0,0,0,1
GACGAGGCTAATAAAC-1_V12D07-335_D1,0,0,0,0,0,0
CTACACTCGCAGATGG-1_V12D07-335_D1,0,0,0,0,0,0
ACGCATACGTTTACTA-1_V12D07-335_D1,0,0,0,0,0,0
GGAGCAACATTTCAAG-1_V12D07-335_D1,0,1,2,0,0,3
CGAGAGGGTAGCCGCG-1_V12D07-335_D1,0,0,0,0,0,0
TCGTGTTCGACCACAA-1_V12D07-335_D1,0,0,0,0,0,0
TCTACCCAATAGAGAG-1_V12D07-335_D1,0,1,0,0,0,1
ATAAACGTTGCACCAC-1_V12D07-335_D1,0,2,0,0,2,4
TCAACTGCAGAGTCAG-1_V12D07-335_D1,0,1,0,0,0,1
AGCTCCATATATGTTC-1_V12D07-335_D1,1,1,0,0,1,3
GTAACATCTAAGATAA-1_V12D07-335_D1,0,1,0,0,0,1
CCGACAATAGGCCGCC-1_V12D07-335_D1,0,0,1,1,1,3
ATGCTTAGGAGTTGAT-1_V12D07-335_D1,0,2,0,0,0,2
AACCCGAGCAGAATCG-1_V12D07-335_D1,0,1,0,0,0,1
CGGGTTTGTTAGGGCT-1_V12D07-335_D1,0,1,1,0,0,2
AGGCACGTGACTGTCC-1_V12D07-335_D1,0,0,0,0,0,0
GACAAGAGATGAGATT-1_V12D07-335_D1,0,1,1,0,1,3
AGCCCTTGGACATCCC-1_V12D07-335_D1,0,0,1,0,1,2
GCAGTTCGATCCGAGC-1_V12D07-335_D1,0,1,1,0,0,2
TCGAGGGCAACAGACG-1_V12D07-335_D1,0,0,0,0,0,0
ACTTTGTCGACGCACT-1_V12D07-335_D1,0,2,2,0,0,4
GAGTATCAAAGTTACA-1_V12D07-335_D1,0,0,0,0,0,0
CCAGGCTGGCGTCTGA-1_V12D07-335_D1,0,1,4,0,0,5
GGACTCTTCCGGTTGA-1_V12D07-335_D1,0,0,7,0,0,7
TCCCAGCACACGACAT-1_V12D07-335_D1,0,0,1,0,0,1
GCTCCATGAGTGCAGA-1_V12D07-335_D1,0,2,0,2,0,4
GCAGTGCGGGCGGATG-1_V12D07-335_D1,0,1,0,0,0,1
GCGTTCTGACTAAGCG-1_V12D07-335_D1,0,0,1,0,0,1
ATTTGGAGATTGCGGT-1_V12D07-335_D1,0,1,0,0,0,1
AAGGGTTTGATTTCAG-1_V12D07-335_D1,0,2,1,0,0,3
CCGGCCGCGAGCATAT-1_V12D07-335_D1,0,0,1,0,0,1
GAGTTCTGTGGGTGCT-1_V12D07-335_D1,0,0,0,0,0,0
AAACGAAGATGGAGTA-1_V12D07-335_D1,0,3,1,0,0,4
AATTACGAGACCCATC-1_V12D07-335_D1,0,1,0,0,0,1
CCTTTGAATTATGGCT-1_V12D07-335_D1,0,2,1,0,0,3
CATGGTATTAGTTTGT-1_V12D07-335_D1,0,1,0,0,0,1
AACGAAAGTCGTCCCA-1_V12D07-335_D1,0,1,1,0,1,3
ACATAAGTCGTGGTGA-1_V12D07-335_D1,0,2,1,0,0,3
GCACAACCTCGGGCGT-1_V12D07-335_D1,0,1,0,0,0,1
ATGCACGCGCTGTTCA-1_V12D07-335_D1,1,0,0,0,0,1
CGATGTTGTTATCTAC-1_V12D07-335_D1,0,2,1,0,0,3
GTCTCCTGCCAGTATG-1_V12D07-335_D1,0,4,0,0,0,4
GATGCCTTCTGCGGCA-1_V12D07-335_D1,3,0,2,0,0,5
ACCGGTCAGGTACACC-1_V12D07-335_D1,1,3,1,0,0,5
GTGGAGCGTTTACCGA-1_V12D07-335_D1,1,2,4,0,0,7
AGGCGGTTTGTCCCGC-1_V12D07-335_D1,1,2,1,1,0,5
TCCCTGGCGTATTAAC-1_V12D07-335_D1,2,1,0,1,0,4
AAACACCAATAACTGC-1_V12D07-335_D1,0,2,0,0,0,2
TGGACGCAATCCAGCC-1_V12D07-335_D1,1,1,2,0,0,4
GGAACCTTGACTCTGC-1_V12D07-335_D1,2,1,1,0,0,4
GTATCTCAGTCTTGAC-1_V12D07-335_D1,1,1,2,0,0,4
GCTGAATCTTCCAATC-1_V12D07-335_D1,0,4,0,0,0,4
AGATGCAAGACGTGCA-1_V12D07-335_D1,0,2,3,0,0,5
TTAAGGCCCGTACTTT-1_V12D07-335_D1,0,3,0,0,0,3
AGTATGCTGGAGACCA-1_V12D07-335_D1,0,1,2,0,1,4
GCGGCAAAGTATTGCC-1_V12D07-335_D1,0,3,0,0,0,3
GCGCAAATATATTCAA-1_V12D07-335_D1,0,0,1,0,0,1
GAAGAAACGATATTGT-1_V12D07-335_D1,0,2,0,0,0,2
GGACCTCTAGGCCGCC-1_V12D07-335_D1,0,0,2,0,0,2
AACAGCTGTGTGGCAA-1_V12D07-335_D1,0,0,1,0,0,1
TCGAATATCCCGCAGG-1_V12D07-335_D1,0,2,0,0,1,3
GCGACCCAACCATCTG-1_V12D07-335_D1,0,2,2,0,0,4
AGAGAAGGAGTACAAT-1_V12D07-335_D1,0,2,2,0,0,4
GGCTCCTCCACCTGTT-1_V12D07-335_D1,0,0,0,0,0,0
TCAGTGTATACGTCAT-1_V12D07-335_D1,0,3,3,1,0,7
ATTATTATGTCCGTCA-1_V12D07-335_D1,0,1,0,0,0,1
TTAGGTCATAACCGAC-1_V12D07-335_D1,0,1,1,0,0,2
AAGATGGCACCGGACC-1_V12D07-335_D1,0,1,2,0,0,3
CTACAAGAAATAACCC-1_V12D07-335_D1,0,1,0,0,0,1
ACTATTTCCGGGCCCA-1_V12D07-335_D1,0,0,1,0,0,1
TTGTTTCACATCCAGG-1_V12D07-335_D1,0,1,8,0,0,9
CGCTGTGTGGATGTTG-1_V12D07-335_D1,0,1,0,0,0,1
TCAACATAGCGCCCTA-1_V12D07-335_D1,0,0,0,0,0,0
GGCCGTTTGGGTTTCA-1_V12D07-335_D1,0,1,0,1,0,2
TACTCTTTCGTCTTCA-1_V12D07-335_D1,0,1,1,0,0,2
TTCGCGCGCCATACGA-1_V12D07-335_D1,1,2,2,0,0,5
CGGAAAGAATCAAACG-1_V12D07-335_D1,0,1,1,0,0,2
AGGCAGGGAGCGTACT-1_V12D07-335_D1,0,1,0,0,0,1
CCTTTAAGGGAGCACT-1_V12D07-335_D1,0,1,0,0,0,1
CGCCCAGCACGCCTAG-1_V12D07-335_D1,0,1,0,0,0,1
AGTATTTGGCACGACC-1_V12D07-335_D1,0,0,0,0,0,0
TATCCGCACCGTCGGG-1_V12D07-335_D1,0,1,1,0,0,2
ACCCGTGTCATCAGTA-1_V12D07-335_D1,0,0,1,0,0,1
CAACTGCTCATCCGAT-1_V12D07-335_D1,0,1,1,0,0,2
CCGGAGCGTACTTTCT-1_V12D07-335_D1,0,0,1,0,0,1
TACCGTAGGTTAACTA-1_V12D07-335_D1,0,0,1,0,0,1
TGAGGAGTGCCAGCTT-1_V12D07-335_D1,0,1,1,0,0,2
CCAGTCTTGTCATAGA-1_V12D07-335_D1,0,0,1,0,0,1
GGGCAGAGCAATCGTT-1_V12D07-335_D1,0,0,1,0,0,1
TACCAAATAGCCCAGA-1_V12D07-335_D1,0,3,4,0,0,7
TACCTACTCCCAGTAT-1_V12D07-335_D1,0,0,1,0,0,1
TGTGAGACTAGCCCAA-1_V12D07-335_D1,0,0,3,0,0,3
ATACCTAACCAAGAAA-1_V12D07-335_D1,0,1,0,0,0,1
GTCGGGAAGCAGAAAC-1_V12D07-335_D1,0,0,1,0,0,1
AATTAACGGATTTCCA-1_V12D07-335_D1,0,2,7,1,0,10
GAACCCTCTGTGTTCT-1_V12D07-335_D1,1,0,2,0,0,3
ATATAAAGCGCTCGTG-1_V12D07-335_D1,0,1,1,0,0,2
CCTGGTCGAATGTGGG-1_V12D07-335_D1,0,2,3,0,0,5
CTAGGTTCGGACGTGA-1_V12D07-335_D1,0,1,0,1,1,3
TCGGGAGACAGCGTAC-1_V12D07-335_D1,0,0,0,0,0,0
CATAAGAAGCTTGGCT-1_V12D07-335_D1,0,2,0,0,0,2
AAGCACCCTGCGTATC-1_V12D07-335_D1,0,0,0,0,0,0
AGTTTGCACCTGCCTC-1_V12D07-335_D1,0,0,1,0,0,1
GACTGCAAATCGAGCT-1_V12D07-335_D1,0,0,0,0,0,0
GTGTATATCAGCGGGC-1_V12D07-335_D1,0,1,0,0,0,1
CTTCAACTCCACTTGG-1_V12D07-335_D1,0,0,0,0,0,0
ACTTACGCATCCACGC-1_V12D07-335_D1,1,0,1,0,0,2
CATGAGATGCACTCTC-1_V12D07-335_D1,0,3,1,0,0,4
GAGCACCTGTGTCCAG-1_V12D07-335_D1,0,0,0,0,0,0
CGCGACCGCGACAGAT-1_V12D07-335_D1,0,2,0,0,0,2
GTCCCGCGACGTTATG-1_V12D07-335_D1,0,0,0,0,0,0
GCAGTGTGGCTATAGG-1_V12D07-335_D1,0,0,0,0,0,0
ATACTGCCTTACACCG-1_V12D07-335_D1,0,0,0,0,0,0
TACAGAAACGGTGGGC-1_V12D07-335_D1,0,2,1,0,0,3
GGCGCGGAGATCTTTC-1_V12D07-335_D1,0,1,0,0,0,1
CGTTAATGTCCCGACG-1_V12D07-335_D1,0,1,0,0,0,1
GCTAACTGAAGTCTGA-1_V12D07-335_D1,0,2,1,0,0,3
AGTGATAACCTGCGCG-1_V12D07-335_D1,0,0,0,0,0,0
TATGATCTTCTCTTTA-1_V12D07-335_D1,0,1,1,0,0,2
TGTACCTACACGAGGG-1_V12D07-335_D1,1,3,0,0,0,4
ATATCGTTCCTCGAAC-1_V12D07-335_D1,1,2,0,0,0,3
CGGCGCCATCAATCCC-1_V12D07-335_D1,0,3,0,0,0,3
CCTGTTTGAAGACACG-1_V12D07-335_D1,0,3,0,0,0,3
GCCACTCAGAGCGCGA-1_V12D07-335_D1,0,0,0,0,0,0
TCGGCTTGTATCGACG-1_V12D07-335_D1,0,2,2,0,0,4
TAGATGGTTCCTTACT-1_V12D07-335_D1,1,1,0,0,1,3
ATCGTTAGCTAGCGGA-1_V12D07-335_D1,1,2,0,0,0,3
ACAGCGACATTCTCAT-1_V12D07-335_D1,0,1,0,0,0,1
ATTCAACCATTTAAGG-1_V12D07-335_D1,2,0,0,0,0,2
CACTCTTCTGCTAGCC-1_V12D07-335_D1,1,0,2,0,0,3
CTAACTGATAATCGCC-1_V12D07-335_D1,0,1,2,0,0,3
TGATGTCAATTAAGTG-1_V12D07-335_D1,0,0,0,0,0,0
CGCCGTTCAGCATAGT-1_V12D07-335_D1,0,0,0,0,0,0
ATACTACCCGTACCAC-1_V12D07-335_D1,0,1,1,0,3,5
CCACTGTTTGGATTAA-1_V12D07-335_D1,0,0,0,0,0,0
CACTACGGGAGCTGCC-1_V12D07-335_D1,0,3,0,0,1,4
GACCAAACGTTGACTG-1_V12D07-335_D1,0,0,0,0,0,0
AAGAGGCCCTTTGGAA-1_V12D07-335_D1,0,0,0,0,0,0
ACACGTAGGCCACAAG-1_V12D07-335_D1,0,1,0,0,0,1
TACTCTTACTTTACTG-1_V12D07-335_D1,0,2,1,0,1,4
AGAGCCGCCGAGATTT-1_V12D07-335_D1,1,0,2,0,0,3
GGCCTGCTTCTCCCGA-1_V12D07-335_D1,0,0,0,0,0,0
TCAAGCGCGGACGGTA-1_V12D07-335_D1,0,0,0,0,0,0
ACACTGGGACAGTCGT-1_V12D07-335_D1,0,1,0,0,1,2
TGTGTAGTAGCACGTG-1_V12D07-335_D1,0,2,1,0,0,3
CTAGCCACAGGCGAGC-1_V12D07-335_D1,0,1,1,0,0,2
CTATCGCGTAGAGAAC-1_V12D07-335_D1,0,0,0,0,0,0
GTTCCCGTAAACATAT-1_V12D07-335_D1,0,0,0,0,0,0
TCTTTCCTTCGAGATA-1_V12D07-335_D1,0,3,1,0,0,4
ATATTGGAGAGGCCTT-1_V12D07-335_D1,0,0,1,1,0,2
AGGCGATAACTGGCGT-1_V12D07-335_D1,0,0,1,0,0,1
ACCCGGAGCACCACAA-1_V12D07-335_D1,0,0,0,2,0,2
TGAGCTCAACTGTATA-1_V12D07-335_D1,0,0,0,0,0,0
ACGACCCATGAGTTGC-1_V12D07-335_D1,0,0,0,1,0,1
CGGTCAGTCCATATTT-1_V12D07-335_D1,0,0,0,1,0,1
TCCGGCTGTCGGGTCG-1_V12D07-335_D1,0,0,0,1,0,1
ATTCCCGAAGGTACAG-1_V12D07-335_D1,0,1,1,0,0,2
CTAACAGCACAATAAC-1_V12D07-335_D1,0,0,1,0,0,1
TTGTGCGGAAGCGGAT-1_V12D07-335_D1,0,1,1,0,0,2
GGGCACTATTGACCAT-1_V12D07-335_D1,0,0,1,0,0,1
CCATAGAGGCTGCCAG-1_V12D07-335_D1,0,1,1,1,0,3
CCGAAGCATTGACCAA-1_V12D07-335_D1,0,1,2,0,0,3
TACTGAGGGAAGAAAG-1_V12D07-335_D1,0,1,0,0,0,1
TATGTAGAAACCCGGC-1_V12D07-335_D1,0,1,1,0,1,3
TGGTTAACTTACATTT-1_V12D07-335_D1,0,1,0,0,0,1
AGAACCCTCAATTGGG-1_V12D07-335_D1,0,0,1,0,0,1
CCTATATCGTGTCACG-1_V12D07-335_D1,0,1,0,0,0,1
ACGGCTGGATGTAGAA-1_V12D07-335_D1,0,0,0,0,0,0
CTCGCATTGCATAGCC-1_V12D07-335_D1,0,0,1,0,0,1
ACTTTGGTCGTGCTCC-1_V12D07-335_D1,2,0,1,0,0,3
GCTGGTTTAGGCCATA-1_V12D07-335_D1,2,1,1,1,0,5
TGTCGTTATCACATAT-1_V12D07-335_D1,1,2,0,0,0,3
ACACATGATCAAATCT-1_V12D07-335_D1,0,0,1,1,0,2
TATCCATCTCGGTTAG-1_V12D07-335_D1,0,2,1,0,1,4
CTCGTCGAGGGCTCAT-1_V12D07-335_D1,1,3,1,0,0,5
ATCAATGCCGTGGCTG-1_V12D07-335_D1,1,0,2,1,0,4
GAAACATAGGAAACAG-1_V12D07-335_D1,0,0,2,0,0,2
TAATAGGTCACCAGAA-1_V12D07-335_D1,0,1,1,0,1,3
CACCAGTCAGCATGCA-1_V12D07-335_D1,0,0,0,0,0,0
GAGCGCTGTTAGGTAA-1_V12D07-335_D1,0,2,0,0,2,4
CCCTATGTAGAGCAGA-1_V12D07-335_D1,0,0,0,0,0,0
GATCGCTATATCTCAG-1_V12D07-335_D1,0,2,0,1,0,3
AAGGGACTATGCATTC-1_V12D07-335_D1,0,0,1,0,0,1
CTCGGGTTCTCTGGCC-1_V12D07-335_D1,1,2,0,0,0,3
TATATATCGAGAAATG-1_V12D07-335_D1,0,2,1,0,0,3
ACCCGAGCGAAATTAC-1_V12D07-335_D1,0,3,0,3,0,6
TTGTTTCATTAGTCTA-1_V12D07-335_D1,1,1,1,0,0,3
ATGGGACCTGCTGAAC-1_V12D07-335_D1,1,3,0,0,0,4
TGCGACGGCCGAACGT-1_V12D07-335_D1,0,0,0,0,0,0
AGCTAACAAGCAATGT-1_V12D07-335_D1,1,2,0,0,0,3
CGTGTCTCGTTACGAC-1_V12D07-335_D1,0,1,1,0,0,2
CTAAATCCGGTGTACA-1_V12D07-335_D1,0,1,0,0,0,1
GAATAGTGCTCGATTA-1_V12D07-335_D1,0,1,1,0,0,2
AACAATACATTGTCGA-1_V12D07-335_D1,0,5,1,0,0,6
CACATCGTGCACGCGC-1_V12D07-335_D1,0,4,2,0,0,6
ACCGTGACCACGTGGG-1_V12D07-335_D1,0,0,0,0,0,0
CCCAATGAGATTTGCA-1_V12D07-335_D1,0,3,1,0,0,4
TCAGCAGTAGGCCCTG-1_V12D07-335_D1,0,0,0,0,0,0
CTACTCAAGGTATAGT-1_V12D07-335_D1,0,3,0,0,0,3
TAGTAGCTTATACCAG-1_V12D07-335_D1,0,2,0,0,2,4
ACGTTCGTTCAGGAAA-1_V12D07-335_D1,0,0,0,0,0,0
TTAGAATAAGGGTCGG-1_V12D07-335_D1,0,1,0,0,0,1
TTCTAGAAAGTCTTAT-1_V12D07-335_D1,1,1,0,0,0,2
CCTTCAGTTAAAGTGA-1_V12D07-335_D1,0,0,3,1,0,4
TAGCTAGTGATGATGG-1_V12D07-335_D1,0,0,1,0,0,1
AGCCCGGTAGCCTGTA-1_V12D07-335_D1,0,0,0,0,1,1
TACCTCAGTTGTCTGT-1_V12D07-335_D1,0,1,1,0,0,2
GACGGGTTGGCCCGTA-1_V12D07-335_D1,0,0,0,0,0,0
GAAACCTATACAAATG-1_V12D07-335_D1,0,3,4,0,0,7
TCCACCTCTAGCCTTT-1_V12D07-335_D1,0,0,0,0,0,0
AAGACCCAACTGAACA-1_V12D07-335_D1,0,1,2,0,0,3
CATACACGGTTCCCAC-1_V12D07-335_D1,0,1,0,0,0,1
ACTACGCGTTAGAATT-1_V12D07-335_D1,0,0,2,0,0,2
CTTGGCCAAGCTGGGA-1_V12D07-335_D1,0,0,0,1,0,1
TTACCCTAGGGATTGG-1_V12D07-335_D1,0,1,4,0,0,5
TTCGCACTGTACGACA-1_V12D07-335_D1,0,0,1,0,0,1
TAGGTGTTCCACAGAT-1_V12D07-335_D1,0,1,0,0,0,1
GAAGCCTGCACATTCC-1_V12D07-335_D1,0,0,1,0,0,1
GGCTTTCAATAAGGGT-1_V12D07-335_D1,0,1,1,0,0,2
TCCAGGGTATATACGA-1_V12D07-335_D1,0,1,0,0,0,1
CTCGCCGAATGTAGGG-1_V12D07-335_D1,0,0,0,0,0,0
AGGAAGCTGTCCGCCG-1_V12D07-335_D1,0,0,1,0,0,1
GTCTCAAGGCCCGGCT-1_V12D07-335_D1,0,1,0,0,0,1
ACCGACACATCTCCCA-1_V12D07-335_D1,0,3,3,0,0,6
TATACGCGTCATCACT-1_V12D07-335_D1,0,0,1,0,0,1
ATCTGGGCTGTTCTTG-1_V12D07-335_D1,0,0,0,0,0,0
TCAAATTTGAGACTCA-1_V12D07-335_D1,0,3,3,0,0,6
GTTAAGGGTGCGATGT-1_V12D07-335_D1,0,1,0,0,0,1
AGCAAAGGCCGCTAGT-1_V12D07-335_D1,0,3,2,0,0,5
TTATAGGTAATTGTCT-1_V12D07-335_D1,0,0,1,0,0,1
TTGTGCAGCCACGTCA-1_V12D07-335_D1,0,0,0,0,0,0
ACGGACTCTCAAAGCG-1_V12D07-335_D1,0,0,1,0,0,1
ATGCTCTGGCGCGGTA-1_V12D07-335_D1,0,0,0,0,0,0
ATAATCTTGGAGAACC-1_V12D07-335_D1,0,0,0,0,0,0
CTCATTGCTCTAACAA-1_V12D07-335_D1,0,0,0,0,0,0
TAGGTGACGATAACCT-1_V12D07-335_D1,0,3,0,0,0,3
CGGATCCTCAAGGACT-1_V12D07-335_D1,0,1,1,0,0,2
GGGCGTGGTTTCCCAG-1_V12D07-335_D1,0,1,0,0,0,1
TGGCTATGTGACATAC-1_V12D07-335_D1,0,0,0,0,0,0
CTTAGTGTAGTAGCAT-1_V12D07-335_D1,0,0,0,0,0,0
GGATTGCTGTGACTCC-1_V12D07-335_D1,0,1,0,0,0,1
ACTTCCATGCGGGACA-1_V12D07-335_D1,0,1,1,0,0,2
ACTCAAGTGCAAGGCT-1_V12D07-335_D1,0,1,0,0,0,1
ACAAGGATGCTTTAGG-1_V12D07-335_D1,0,2,0,0,0,2
TTGAACGACGTGCTGA-1_V12D07-335_D1,1,0,0,0,0,1
ATTCATCGTTGAGGCA-1_V12D07-335_D1,0,3,0,0,0,3
TGCAACCCATCTGCGG-1_V12D07-335_D1,1,1,0,0,0,2
AGTGCTAAACACAGCA-1_V12D07-335_D1,0,4,0,0,0,4
AACTCCAGAGCGTGTT-1_V12D07-335_D1,0,0,0,0,0,0
TCTCCACAAGTTGAAT-1_V12D07-335_D1,0,1,0,0,0,1
CTTTGCATCGCTCTTG-1_V12D07-335_D1,0,1,1,0,0,2
TCACAAACCGAGGTAC-1_V12D07-335_D1,0,2,0,0,0,2
CCGTAGGAAATCCCTG-1_V12D07-335_D1,0,3,0,0,0,3
AAACATTTCCCGGATT-1_V12D07-335_D1,0,1,1,0,0,2
GCCTCCGACAATTCAC-1_V12D07-335_D1,1,1,1,0,0,3
TCTGCATACCTTGCTT-1_V12D07-335_D1,2,2,1,0,0,5
ACCCATTTGTCCCTCT-1_V12D07-335_D1,0,1,1,1,0,3
CTGCAGAGAATCAGAG-1_V12D07-335_D1,0,0,0,0,0,0
GGAAACTAAATGGGCC-1_V12D07-335_D1,0,0,0,0,0,0
CAACCTACCGAGCAGT-1_V12D07-335_D1,0,0,2,0,0,2
CCGTAGGGTTGTTTAC-1_V12D07-335_D1,0,0,0,0,0,0
GGTTTGTGACCTGAGG-1_V12D07-335_D1,0,2,0,0,0,2
TAACCTAGGGAGTCCA-1_V12D07-335_D1,0,0,1,0,0,1
TTCCATCGACAGCGTG-1_V12D07-335_D1,0,0,1,0,0,1
ATCTCCCACGGAATAT-1_V12D07-335_D1,1,0,1,0,1,3
GTTTCAAACGAGTTGT-1_V12D07-335_D1,0,3,1,0,0,4
GGAACTTTGGCGATTA-1_V12D07-335_D1,0,0,1,0,0,1
CTGCAAGCACGTTCCG-1_V12D07-335_D1,0,1,0,0,0,1
CACAGTCCCGCTTCGC-1_V12D07-335_D1,0,0,0,0,0,0
TACGCTCGGTATTGGA-1_V12D07-335_D1,0,1,2,1,0,4
CTGGTAAAGTGTGGGC-1_V12D07-335_D1,0,1,1,0,0,2
CAACCAGTGGCCTACC-1_V12D07-335_D1,0,0,2,0,1,3
TCTTCGCGGTGAGAGG-1_V12D07-335_D1,1,0,1,0,1,3
TTCGGGTTGCCACGGG-1_V12D07-335_D1,0,0,1,0,0,1
ACCGATAGGCATAACC-1_V12D07-335_D1,0,0,0,1,0,1
CTTATAGATGGCTGTT-1_V12D07-335_D1,0,0,2,3,0,5
AGACGCCCACTTCGCC-1_V12D07-335_D1,0,0,3,1,0,4
AGGTCGCCTCCCAACA-1_V12D07-335_D1,3,0,0,1,0,4
CCTCACGTCAGCTAAT-1_V12D07-335_D1,0,0,0,1,0,1
CCACCTGTATGGAATA-1_V12D07-335_D1,0,0,0,1,0,1
GGACTCGAAGCTTTCA-1_V12D07-335_D1,0,0,0,2,0,2
AAGCCGGAGAGCAGGA-1_V12D07-335_D1,0,0,0,1,0,1
GCCTATCAGGTAAGAT-1_V12D07-335_D1,0,0,0,2,0,2
TCAGAGTGTGAGCATG-1_V12D07-335_D1,0,0,0,2,0,2
AAACATGGTGAGAGGA-1_V12D07-335_D1,0,3,2,0,0,5
ATCATTGTACCGCATT-1_V12D07-335_D1,0,0,2,1,0,3
TCAGCTTGAGCTTTCG-1_V12D07-335_D1,0,1,2,0,0,3
CCGCGCAAGATACCCA-1_V12D07-335_D1,0,0,3,1,0,4
CTATACTTAAAGCGAG-1_V12D07-335_D1,0,2,0,0,0,2
ACCGTCCACTGGGCCC-1_V12D07-335_D1,0,1,2,0,1,4
AAGACCAAATAACTCA-1_V12D07-335_D1,0,3,3,0,0,6
TGTTTCTGAAGCGTGC-1_V12D07-335_D1,1,1,4,0,0,6
TTCTCTTACAGGTGAT-1_V12D07-335_D1,0,2,1,0,0,3
AATTCATTGTCATGCA-1_V12D07-335_D1,1,6,1,0,1,9
GCCCGAGAGTCTAAAT-1_V12D07-335_D1,0,2,1,0,0,3
ATATAGAGTATTGGTC-1_V12D07-335_D1,0,1,0,0,0,1
TTGAAGGATGGGCGCC-1_V12D07-335_D1,0,3,1,0,1,5
TAGTACCACAACTTTC-1_V12D07-335_D1,0,1,0,0,0,1
ATCCCATCCACAGCGC-1_V12D07-335_D1,0,3,0,0,0,3
CTTAGGTATAGACCAG-1_V12D07-335_D1,0,3,0,0,2,5
TGACTCCGAATCATAC-1_V12D07-335_D1,0,2,2,0,0,4
ACTACATCCCGACAAG-1_V12D07-335_D1,1,1,0,0,0,2
TTGCCGCAGACCTACA-1_V12D07-335_D1,0,1,0,0,0,1
TAAGAGGGACAGGGAC-1_V12D07-335_D1,0,2,0,0,0,2
CGAATGAAGTCATTGC-1_V12D07-335_D1,0,1,3,0,0,4
AAGGGAACGACTGGCT-1_V12D07-335_D1,0,0,0,0,0,0
CGAATCTGCTCGACGC-1_V12D07-335_D1,0,1,1,0,0,2
ATCGTGGAAAGTCTGG-1_V12D07-335_D1,0,0,0,0,0,0
CCTATGGCTCCTAGTG-1_V12D07-335_D1,0,1,1,0,0,2
CGTCGCTTGGTTATAC-1_V12D07-335_D1,1,4,0,1,0,6
TGCTTAGAGAGAATGC-1_V12D07-335_D1,0,3,0,2,0,5
GATTGCTCCAGTTGCA-1_V12D07-335_D1,0,1,1,0,1,3
CGTGCTTCTACCTAAA-1_V12D07-335_D1,0,3,1,3,0,7
ACTCCAATATCATCAT-1_V12D07-335_D1,0,4,2,0,0,6
GCCGACCCACGACTGC-1_V12D07-335_D1,0,4,0,0,0,4
GAGGGTAGTAACAAAG-1_V12D07-335_D1,0,2,0,0,1,3
GGCCGAGACTCTGGTG-1_V12D07-335_D1,0,1,1,0,0,2
TATATAGGGCTTTACG-1_V12D07-335_D1,0,2,1,2,0,5
TGCCGGATGTACGAGC-1_V12D07-335_D1,0,2,0,0,0,2
AGGTAGATCGAGATAT-1_V12D07-335_D1,0,1,0,1,1,3
GATCAACATAAAGGGA-1_V12D07-335_D1,0,5,1,0,0,6
TAACAGCGTTTGTGCT-1_V12D07-335_D1,0,1,1,4,1,7
CTATAGGCGTTGATGT-1_V12D07-335_D1,0,4,0,0,0,4
GGTTTAATTACCATCG-1_V12D07-335_D1,0,2,0,1,0,3
CTCTTCTGGAAGTTAG-1_V12D07-335_D1,0,1,0,0,0,1
ATCTGACATGGAAGGA-1_V12D07-335_D1,1,2,1,0,0,4
TACGTACTAGTGCTGA-1_V12D07-335_D1,0,2,1,1,0,4
ATGACTATCAGCTGTG-1_V12D07-335_D1,0,2,0,0,0,2
CTTTGGGATTGTTGCA-1_V12D07-335_D1,0,3,1,0,0,4
AGACTGTTACCGGGTC-1_V12D07-335_D1,0,2,0,0,0,2
TCCTAACCGTCGGGCA-1_V12D07-335_D1,0,0,0,0,0,0
ACGCAAACTAATAGAT-1_V12D07-335_D1,0,5,1,0,0,6
AAGTGAGTCGGGTTTA-1_V12D07-335_D1,0,2,0,0,0,2
TAAAGCGGTATTTCCA-1_V12D07-335_D1,0,1,0,0,0,1
CTCCTCCAGCTCACAC-1_V12D07-335_D1,0,2,0,0,0,2
CGGTCCGTCGCAAGCC-1_V12D07-335_D1,0,1,0,0,0,1
CCTATATTTGTCCTGG-1_V12D07-335_D1,0,1,2,0,0,3
TCCAATAAAGGCTACC-1_V12D07-335_D1,0,2,2,0,0,4
AAAGGCTACGGACCAT-1_V12D07-335_D1,0,0,0,0,0,0
CGTGACCAGTCCTCTG-1_V12D07-335_D1,0,2,0,0,0,2
GATCTGCTATCTAAGG-1_V12D07-335_D1,0,0,1,0,0,1
CGAATGACGCATAATG-1_V12D07-335_D1,0,4,2,0,1,7
GCTCAATGTAATACCG-1_V12D07-335_D1,0,1,0,0,0,1
CTATGCCCGAATGCAA-1_V12D07-335_D1,0,2,0,0,0,2
CACAGGGCCGTTGTCA-1_V12D07-335_D1,0,2,0,0,0,2
TCAATACGCCGTCATG-1_V12D07-335_D1,0,2,2,0,0,4
AGCGGACACTTCGTAG-1_V12D07-335_D1,0,3,1,1,0,5
ATACGTTATGCACGGA-1_V12D07-335_D1,0,0,0,0,0,0
GAGTAGATACTAGTTG-1_V12D07-335_D1,0,4,1,0,0,5
CCAGCTCGAACGCATT-1_V12D07-335_D1,0,2,0,1,0,3
TGCTTCCCAAGCAGTA-1_V12D07-335_D1,0,0,0,0,0,0
GTAGACACGCCTGACT-1_V12D07-335_D1,0,0,0,0,0,0
CTCACATTTACTAAAT-1_V12D07-335_D1,0,1,1,0,0,2
GAATGCGAATCGGTTC-1_V12D07-335_D1,0,0,0,0,0,0
TAAGGCCCGTCACCCT-1_V12D07-335_D1,0,1,0,0,0,1
GAGTATGCGCGTGCAT-1_V12D07-335_D1,0,1,0,0,0,1
ATCCACATCGACAGAA-1_V12D07-335_D1,0,0,0,0,0,0
TAGACGAAACGCCAAT-1_V12D07-335_D1,0,1,1,0,0,2
CAGCAGTCTGTGCTGC-1_V12D07-335_D1,0,0,0,0,0,0
CTCACTGTGATACTTA-1_V12D07-335_D1,1,0,0,0,0,1
TTAATTGCTTTGGGTG-1_V12D07-335_D1,0,0,0,0,0,0
GTAGTCTACGATATTG-1_V12D07-335_D1,1,2,0,0,0,3
TTGCCGCTTTCTAGTA-1_V12D07-335_D1,0,0,0,0,0,0
GAACCTTTAACGATCC-1_V12D07-335_D1,0,2,0,1,0,3
TGGACCAATCTAAGAT-1_V12D07-335_D1,0,5,0,0,0,5
CTAGTAGAAAGGGATT-1_V12D07-335_D1,1,1,0,0,0,2
AACCTCGCTTTAGCCC-1_V12D07-335_D1,0,0,0,0,0,0
GAGTGTCAACCAGAAA-1_V12D07-335_D1,0,3,0,0,0,3
GTGATCCTTGTCATGA-1_V12D07-335_D1,0,5,0,0,0,5
CTCAACTAACCCGGAT-1_V12D07-335_D1,0,0,0,0,0,0
AGTGGCGTCTGAAGGT-1_V12D07-335_D1,1,2,2,0,0,5
GGGAAGGGCTTTCTCA-1_V12D07-335_D1,0,0,0,0,0,0
AGGCCTGAGAATCTCG-1_V12D07-335_D1,0,1,0,0,0,1
AGCCACAGGTTACCCG-1_V12D07-335_D1,0,1,2,0,0,3
TGCAATCTAACACGGT-1_V12D07-335_D1,0,0,0,0,0,0
GTTTGGGTTTCGCCCG-1_V12D07-335_D1,0,3,0,0,0,3
CCTATGTCCACTCCAC-1_V12D07-335_D1,1,3,0,1,0,5
CTGCCTTTCTAGTAAA-1_V12D07-335_D1,0,0,0,0,0,0
TTAGTAAACCTGCTCT-1_V12D07-335_D1,0,0,0,0,0,0
TTGTGGTGGTACTAAG-1_V12D07-335_D1,0,2,0,0,0,2
CCTCCTGTTGTGTCGT-1_V12D07-335_D1,0,1,0,0,0,1
ACAAAGCATGACCTAG-1_V12D07-335_D1,1,2,0,0,0,3
ATAGCAACTAGGGAAG-1_V12D07-335_D1,0,2,2,0,1,5
CCGCTCTTCCGAACTA-1_V12D07-335_D1,0,0,1,1,0,2
TAGAATAGCCGATGAA-1_V12D07-335_D1,0,2,1,0,0,3
GGTCTCCGTCCAGGTT-1_V12D07-335_D1,0,0,0,0,0,0
TAATTACGTCAGTAGA-1_V12D07-335_D1,0,2,0,0,0,2
TACGTAAAGCGGAGTG-1_V12D07-335_D1,0,3,1,0,1,5
GCTACAATCGAGGATA-1_V12D07-335_D1,0,0,0,0,0,0
TCAGCCAATCCGTAAA-1_V12D07-335_D1,0,2,0,0,0,2
ATCATAGCCCTATGTA-1_V12D07-335_D1,0,1,2,0,0,3
GAGGCCTGTTGATACA-1_V12D07-335_D1,0,1,0,0,0,1
ATATACGCTCGTGACG-1_V12D07-335_D1,0,0,0,0,0,0
CCCTTTAATGGAGTTC-1_V12D07-335_D1,0,2,1,0,0,3
TTACACGATCTGCGAC-1_V12D07-335_D1,0,1,1,0,0,2
TCGCATAAAGGGCGCA-1_V12D07-335_D1,0,2,0,0,0,2
TGTAGCCATCCCATTC-1_V12D07-335_D1,1,0,2,0,0,3
GGGTCTATCGCTTTCC-1_V12D07-335_D1,0,1,1,0,0,2
GGAGGGTCAAGTAAGA-1_V12D07-335_D1,0,1,1,0,0,2
TACGGCATGGACGCTA-1_V12D07-335_D1,0,0,1,0,0,1
CACGTCAATCAATGGA-1_V12D07-335_D1,0,1,3,1,0,5
CGCTTGGACGGATAGA-1_V12D07-335_D1,0,2,2,0,0,4
CGCGGTACGGTATACA-1_V12D07-335_D1,0,1,2,0,0,3
CCTACTCAACACGATT-1_V12D07-335_D1,0,0,0,0,0,0
CGTTTGGTGTTGTGGG-1_V12D07-335_D1,0,0,2,5,0,7
GTTGTTGCAAGATGGC-1_V12D07-335_D1,0,0,0,0,0,0
CATTCGTCGTAGCGGT-1_V12D07-335_D1,0,0,0,1,0,1
CAGCCTCGATAGCGGT-1_V12D07-335_D1,0,0,0,4,0,4
TCATAAGTCCAAGAAG-1_V12D07-335_D1,0,0,0,1,0,1
AAAGTGCCATCAATTA-1_V12D07-335_D1,0,0,0,0,0,0
GTTGCAGTCGACAACA-1_V12D07-335_D1,0,0,0,1,0,1
TAAATGGGCTACTGAG-1_V12D07-335_D1,0,0,0,7,0,7
GGACAAGCCATGATCG-1_V12D07-335_D1,0,0,1,0,0,1
TCCAATGCGTCGCCGC-1_V12D07-335_D1,0,1,3,0,0,4
AAAGAATGACCTTAGA-1_V12D07-335_D1,0,0,3,0,0,3
CCTATTATTCCGGCCG-1_V12D07-335_D1,0,1,2,0,0,3
CAGTAAGGGACGTCTC-1_V12D07-335_D1,0,2,2,1,0,5
GGGATGGACCCGCGTC-1_V12D07-335_D1,0,3,3,0,0,6
GACGCATACCCGTCGG-1_V12D07-335_D1,0,1,1,1,0,3
GGGCAGGATTTCTGTG-1_V12D07-335_D1,0,0,5,0,0,5
TATCTGAGCCGATATT-1_V12D07-335_D1,0,1,2,0,0,3
AATGTATGGCACTGTA-1_V12D07-335_D1,0,1,0,0,0,1
GCCTTTGTCAGTGGAC-1_V12D07-335_D1,0,2,0,0,0,2
AACCATAGGGTTGAAC-1_V12D07-335_D1,0,2,4,0,0,6
AAACTTAATTGCACGC-1_V12D07-335_D1,0,0,1,0,0,1
TAGGCGGCTGCAAAGA-1_V12D07-335_D1,0,0,2,0,0,2
TCCATCAATACTAATC-1_V12D07-335_D1,0,0,0,0,0,0
ACCTCGAACTTATGCT-1_V12D07-335_D1,0,0,1,0,0,1
ACAAACCATGCGTCCT-1_V12D07-335_D1,2,2,4,0,0,8
ACACCGGTCTGACCGC-1_V12D07-335_D1,0,0,1,0,0,1
ATGGCAGCATTACGAT-1_V12D07-335_D1,0,0,0,0,0,0
CTGGTGAATGGGCCTA-1_V12D07-335_D1,0,2,1,0,0,3
CACAGAGACGAGGACG-1_V12D07-335_D1,0,0,1,0,1,2
GCACAAACCCTAGATG-1_V12D07-335_D1,0,1,1,0,0,2
ACTATGTCCAGCTGCC-1_V12D07-335_D1,1,1,1,0,0,3
AAGCCGCCGTGAAATC-1_V12D07-335_D1,0,5,2,0,0,7
ATGGGTGTATACCTCC-1_V12D07-335_D1,0,2,0,0,0,2
TAAGCGCGAATCAAAT-1_V12D07-335_D1,0,3,3,1,0,7
AGCCCGGCATTAGAGG-1_V12D07-335_D1,1,1,1,0,1,4
GTGATCAAGCGTGCAC-1_V12D07-335_D1,0,0,1,0,0,1
CTGCCTTTAATACCTT-1_V12D07-335_D1,0,1,0,0,0,1
TACCTCCACACCAATG-1_V12D07-335_D1,0,0,0,0,0,0
GAGCATCAACAACTTG-1_V12D07-335_D1,1,1,2,0,1,5
CATACGAACTAGCTGG-1_V12D07-335_D1,0,2,1,0,4,7
GGGAACGGTTTCAGAT-1_V12D07-335_D1,1,2,1,0,1,5
AGGGTGCCGTTCTTTA-1_V12D07-335_D1,0,0,0,0,0,0
ACGACTGGTCATACTC-1_V12D07-335_D1,0,0,0,0,0,0
GGATCTTACTGCCCTT-1_V12D07-335_D1,0,2,0,0,0,2
TACTCCTCTAGTTGAC-1_V12D07-335_D1,0,1,0,0,0,1
GTAGCTCCGGGAGGCT-1_V12D07-335_D1,0,1,0,0,1,2
GGACTCGTGAGTGGTC-1_V12D07-335_D1,0,1,1,0,0,2
GTAGTTCGAAGGCGAA-1_V12D07-335_D1,0,3,0,0,1,4
CTCAAACCACTGCCCG-1_V12D07-335_D1,0,2,0,0,1,3
GAGGGAGTCAGATCGC-1_V12D07-335_D1,0,2,0,1,0,3
GCGTCCCTAAGACATA-1_V12D07-335_D1,0,2,0,1,0,3
TCTCTTACCGCGAACC-1_V12D07-335_D1,1,2,0,1,0,4
GGCTACTATACACTCC-1_V12D07-335_D1,0,0,0,1,0,1
CGTTGCCCGCGTGGGA-1_V12D07-335_D1,0,2,0,1,0,3
TATAGAGTCGCTTGAA-1_V12D07-335_D1,0,4,1,2,0,7
ATGTTGTAGTCTGTTT-1_V12D07-335_D1,0,3,0,0,0,3
AGTATACACAGCGACA-1_V12D07-335_D1,0,1,0,0,0,1
TGTGGTTGCTAAAGCT-1_V12D07-335_D1,0,1,0,0,0,1
TGATTCCCGGTTACCT-1_V12D07-335_D1,0,0,0,0,0,0
CACTGACGATTGTGGA-1_V12D07-335_D1,0,1,0,1,0,2
AACATTGTGACTCGAG-1_V12D07-335_D1,0,1,0,0,0,1
GTCCAATATTTAGCCT-1_V12D07-335_D1,0,4,1,0,0,5
GCTCTTTCCGCTAGTG-1_V12D07-335_D1,0,0,1,0,0,1
GGGTCAGGAGCTAGAT-1_V12D07-335_D1,0,2,0,0,1,3
AGGTGGTGACCTTCGC-1_V12D07-335_D1,1,2,0,0,0,3
CCCGGGTCGTTCAGGG-1_V12D07-335_D1,0,0,1,0,0,1
AGCCAAGCTTTGTGTC-1_V12D07-335_D1,0,2,0,0,0,2
TGTGGCGGGCTTCTGG-1_V12D07-335_D1,0,1,0,0,1,2
CGAGGGTATCCAGGTG-1_V12D07-335_D1,0,0,0,0,0,0
CGTTCAGACCCGCGAA-1_V12D07-335_D1,0,0,0,0,0,0
TCATATGAGCTTTGTT-1_V12D07-335_D1,0,0,0,0,0,0
AGTTGACGGTCCTTGC-1_V12D07-335_D1,0,0,0,0,1,1
ATAATTAGCTAAGTAG-1_V12D07-335_D1,0,1,0,0,0,1
GGTCTTGAGCGCTCTT-1_V12D07-335_D1,0,1,0,1,0,2
CGTTGTCGGCAATTGA-1_V12D07-335_D1,0,0,1,0,0,1
TCTTGCTCCCGATACT-1_V12D07-335_D1,0,2,0,0,0,2
AGCAGAAGGAGAAAGA-1_V12D07-335_D1,0,1,0,0,0,1
GAAGCCACTGATTATG-1_V12D07-335_D1,0,0,0,0,0,0
TGCTCTTGAGAGTTTG-1_V12D07-335_D1,0,0,0,1,0,1
GACATCCGTCGAACTG-1_V12D07-335_D1,1,2,0,0,0,3
AGATATAATACGACTA-1_V12D07-335_D1,0,0,2,0,0,2
TCGCTACTGGCTTTGA-1_V12D07-335_D1,0,3,1,0,0,4
GTGACAGCTTCCCACT-1_V12D07-335_D1,0,1,0,0,0,1
GTGACGCAGGTTTCAT-1_V12D07-335_D1,1,2,1,0,0,4
GGGAAGACGGTCTGTC-1_V12D07-335_D1,0,0,0,0,0,0
CGTCGCATGTGAGCCA-1_V12D07-335_D1,1,1,0,0,0,2
AGAAGGTTGTAGGTCG-1_V12D07-335_D1,0,1,0,0,0,1
GGCCGGCGTCTGCTAT-1_V12D07-335_D1,0,1,0,0,0,1
TTGACCAGGAACAACT-1_V12D07-335_D1,0,0,1,0,0,1
AGTCGTATAAAGCAGA-1_V12D07-335_D1,0,0,1,0,0,1
GGCGTAGGGAAAGCTG-1_V12D07-335_D1,0,1,1,0,0,2
AAACCTAAGCAGCCGG-1_V12D07-335_D1,0,1,1,1,0,3
ATTGCCTTTATGTTTG-1_V12D07-335_D1,0,3,0,0,0,3
CAGGCAGTCTTACCAG-1_V12D07-335_D1,0,0,1,0,0,1
AGCTAAGTACGCAGGC-1_V12D07-335_D1,0,0,0,0,0,0
AAATCCGATACACGCC-1_V12D07-335_D1,0,0,0,0,0,0
CGAGAGCTTTCACTAC-1_V12D07-335_D1,0,1,1,0,0,2
CGCCCAGCGTTTCACG-1_V12D07-335_D1,0,0,0,0,0,0
TTAAGTATTGTTATCC-1_V12D07-335_D1,1,2,0,0,0,3
AAACGGGCGTACGGGT-1_V12D07-335_D1,0,1,1,0,1,3
GTATCCTTTGGTAACC-1_V12D07-335_D1,0,2,1,0,0,3
CATAGTCAAATACATA-1_V12D07-335_D1,0,0,0,0,0,0
TCTATGCTATAACGAC-1_V12D07-335_D1,0,0,0,0,0,0
ACGTTCTGTACAAGTC-1_V12D07-335_D1,0,0,0,0,0,0
CGCGAAGTGGCATACT-1_V12D07-335_D1,0,0,0,0,0,0
ACCAACCGCACTCCAC-1_V12D07-335_D1,1,2,3,0,0,6
GTCATGCGCGAGGGCT-1_V12D07-335_D1,0,0,2,0,1,3
TAGGCTAAAGTGGCAC-1_V12D07-335_D1,1,2,1,0,1,5
TGGCTACACTCTACCT-1_V12D07-335_D1,0,2,1,0,0,3
TGTCCACGGCTCAACT-1_V12D07-335_D1,0,1,1,0,0,2
AATTGCAGCAATCGAC-1_V12D07-335_D1,0,0,0,0,0,0
GTCAACCAGGCCTATA-1_V12D07-335_D1,0,0,0,0,0,0
ATCTTATCGCACACCC-1_V12D07-335_D1,0,0,0,0,0,0
GTCTATTGCATGCTCG-1_V12D07-335_D1,0,2,0,0,0,2
GCACGTGGTTTACTTA-1_V12D07-335_D1,0,2,1,0,0,3
ATTCGCGCCTTGAGAG-1_V12D07-335_D1,0,0,1,0,0,1
AGCGATGCGCCTAATA-1_V12D07-335_D1,0,0,1,0,0,1
TCTATAGGTGGGTAAT-1_V12D07-335_D1,0,1,0,0,0,1
AGATACCAATAGAACC-1_V12D07-335_D1,0,0,4,0,0,4
CGTGTATGGGAGCTGA-1_V12D07-335_D1,1,1,2,0,1,5
ATGTACATGCGGTGAG-1_V12D07-335_D1,0,0,3,0,0,3
TTGGCTCAATATGTGT-1_V12D07-335_D1,0,1,2,0,0,3
GTTCGGAGCACTCAAC-1_V12D07-335_D1,0,0,3,0,0,3
TCCCTCTTCTCAAGGG-1_V12D07-335_D1,0,0,1,0,0,1
TTACGTATCTATGACA-1_V12D07-335_D1,0,0,4,0,0,4
CCCATATAGGTCGATT-1_V12D07-335_D1,0,0,4,0,0,4
GTCCACGTCGCATTCG-1_V12D07-335_D1,0,1,1,0,0,2
AATTGTGGTTGCCAAA-1_V12D07-335_D1,0,1,0,0,0,1
AGGAACGAACGACTTC-1_V12D07-335_D1,0,1,2,0,0,3
TAATTCCAATGCTTCA-1_V12D07-335_D1,0,0,2,0,0,2
AGGGCCCTAATGTTCT-1_V12D07-335_D1,0,0,0,0,0,0
AGGTGTTGCCGACCAC-1_V12D07-335_D1,0,0,1,0,0,1
CTGAGAGTAGAAATAC-1_V12D07-335_D1,0,0,1,4,0,5
TAGAAGAAGGGTTACA-1_V12D07-335_D1,0,2,3,0,0,5
GGTGACTGATAGAGAG-1_V12D07-335_D1,0,0,0,7,0,7
TACCCTCGGTAACCCT-1_V12D07-335_D1,0,0,0,0,0,0
TGTAAGACTGATAAGA-1_V12D07-335_D1,0,2,2,0,0,4
GTCACTCATGAGCGAT-1_V12D07-335_D1,0,2,7,1,0,10
CGGTTTACTGAACATT-1_V12D07-335_D1,0,0,2,1,0,3
GAGATCGATCTTACTC-1_V12D07-335_D1,1,0,6,1,0,8
TCTTTCATCCGTCCTT-1_V12D07-335_D1,0,0,1,0,0,1
TCGGATCTGGATGACC-1_V12D07-335_D1,0,1,3,0,0,4
GTCCTAGGATACCTTA-1_V12D07-335_D1,0,1,1,1,0,3
TGTACCCGACCCTAAT-1_V12D07-335_D1,0,2,1,2,0,5
AGGTTCTCCTTTCCGG-1_V12D07-335_D1,0,0,6,0,0,6
AATTGCGTGGATTACA-1_V12D07-335_D1,0,2,2,1,0,5
CGATAGCGATACAGTG-1_V12D07-335_D1,1,0,4,0,0,5
CGCCCTAATTGTTCAA-1_V12D07-335_D1,0,2,1,0,1,4
ATTATGAGACCCAATT-1_V12D07-335_D1,1,4,2,0,0,7
CCTCCTAGCTAGAGTC-1_V12D07-335_D1,0,1,6,1,0,8
CGAAGGGTTTCAGATT-1_V12D07-335_D1,0,0,4,0,0,4
CACAAGCTAAGAAAGG-1_V12D07-335_D1,0,1,3,0,0,4
CACCGGTAGAGACATT-1_V12D07-335_D1,1,2,3,0,0,6
ACTCATGGCAGCCTTC-1_V12D07-335_D1,0,2,1,0,0,3
CATCCAATATAGTTTG-1_V12D07-335_D1,0,2,1,0,0,3
CAGATATGAAGATGAC-1_V12D07-335_D1,0,3,2,0,0,5
GCAAAGGGCGTTAGCC-1_V12D07-335_D1,0,0,2,0,0,2
CTGTTGTTCAGTCGTA-1_V12D07-335_D1,0,1,2,0,0,3
AAAGGCCCTATAATAC-1_V12D07-335_D1,0,1,2,0,0,3
AACATTGAAGTTGATC-1_V12D07-335_D1,0,2,1,0,0,3
GCTAGCGATAGGTCTT-1_V12D07-335_D1,0,1,1,0,0,2
ATTGCCTATTAGACCG-1_V12D07-335_D1,0,1,3,0,0,4
GGGCGTTTACATTCAT-1_V12D07-335_D1,0,0,0,0,0,0
CCTCTACAAGGATTGG-1_V12D07-335_D1,0,0,1,0,0,1
AGTGACTGTGACACAA-1_V12D07-335_D1,0,3,1,0,0,4
AGCCCTCCCTGGTGGC-1_V12D07-335_D1,0,1,0,0,1,2
CGGTTGAGTATCCTTC-1_V12D07-335_D1,0,1,1,0,1,3
CATTATCCCATTAACG-1_V12D07-335_D1,0,1,2,0,0,3
AATGTGCTAATCTGAG-1_V12D07-335_D1,0,1,0,0,0,1
CTTAGTTGAGGAATCG-1_V12D07-335_D1,0,2,2,0,0,4
CTTCTGGGCGTACCTA-1_V12D07-335_D1,0,7,0,1,0,8
AGTCAAATGATGTGAT-1_V12D07-335_D1,1,1,1,0,2,5
TGAACAAGCAGGGACT-1_V12D07-335_D1,0,0,1,1,1,3
AATACCGGAGGGCTGT-1_V12D07-335_D1,1,3,0,0,0,4
GTTTGGTGATCGGTGC-1_V12D07-335_D1,0,1,0,0,0,1
GACTGCTGGTGAGAAA-1_V12D07-335_D1,0,0,0,0,0,0
CGATCCTCGCAACATA-1_V12D07-335_D1,0,0,1,0,0,1
CCAACCTTATGTAACT-1_V12D07-335_D1,1,2,0,0,0,3
CGTGGTACCCAAAGGC-1_V12D07-335_D1,0,1,0,0,0,1
AACCCGACAACCCGTG-1_V12D07-335_D1,1,0,0,0,0,1
TATGTAAAGTGCTTAA-1_V12D07-335_D1,0,2,0,0,0,2
GCAAGTGTAAAGCATG-1_V12D07-335_D1,1,1,1,0,1,4
GTAACTGCCCAAGGAG-1_V12D07-335_D1,1,0,0,2,0,3
GGTGCATAAATGATTA-1_V12D07-335_D1,0,0,1,0,1,2
TAGTCCCGGAGACCAC-1_V12D07-335_D1,0,2,0,0,0,2
CGGCCAGAGCGACCAT-1_V12D07-335_D1,0,0,0,0,0,0
TGAATGAGTGTTTCCC-1_V12D07-335_D1,0,1,0,0,0,1
TTCACTTCCTAGAACG-1_V12D07-335_D1,0,3,2,0,1,6
CGCTTAGTATTGATAC-1_V12D07-335_D1,0,1,2,0,0,3
AACGCGACCTTGGGCG-1_V12D07-335_D1,0,2,0,2,2,6
GTGCACCAGCTTCAAC-1_V12D07-335_D1,0,1,0,0,0,1
TTCTATTAAACGCAGC-1_V12D07-335_D1,0,1,0,0,0,1
TGGCAAGCACAAGTCG-1_V12D07-335_D1,0,2,0,1,0,3
ATCTGCTGTTATCGCC-1_V12D07-335_D1,0,0,1,2,0,3
AATTCCAAGCATGTAC-1_V12D07-335_D1,0,3,1,0,0,4
AAACGGTTGCGAACTG-1_V12D07-335_D1,0,0,1,0,2,3
GAAGGAGTCGAGTGCG-1_V12D07-335_D1,0,1,0,0,0,1
GGCAAGCCCATAGTGG-1_V12D07-335_D1,0,2,0,0,0,2
TGACCAAATCTTAAAC-1_V12D07-335_D1,0,0,0,0,1,1
TTCGGTACTGTAGAGG-1_V12D07-335_D1,1,2,0,0,0,3
ATGTACGATGACGTCG-1_V12D07-335_D1,0,0,1,0,0,1
ATCTAGCTTGTGAGGG-1_V12D07-335_D1,0,1,0,0,0,1
AGCGGGTCTGACACTC-1_V12D07-335_D1,0,1,1,0,0,2
GAGGTACGCGTGTCCC-1_V12D07-335_D1,0,1,0,0,0,1
GCACTGCCTACCTTTA-1_V12D07-335_D1,1,1,0,0,0,2
GGAGCGAGGCCTACTT-1_V12D07-335_D1,0,1,0,0,0,1
AAACTCGGTTCGCAAT-1_V12D07-335_D1,0,0,1,0,1,2
GGCGCTTCATTCCCTG-1_V12D07-335_D1,0,0,1,0,2,3
TGCTCGGTGGGTCACC-1_V12D07-335_D1,0,1,0,0,0,1
AAGCGCAGGGCTTTGA-1_V12D07-335_D1,0,1,0,0,0,1
GACCTTCCACGTCTAC-1_V12D07-335_D1,0,1,0,0,0,1
GTTAGCCCATGACATC-1_V12D07-335_D1,0,1,1,0,0,2
AATTCGATTCGAGGAT-1_V12D07-335_D1,0,1,0,0,0,1
AGTCTTTAAAGTGTCC-1_V12D07-335_D1,0,0,0,0,0,0
GACTAGGCCGTTAGGT-1_V12D07-335_D1,0,1,0,0,1,2
TCCAAGCCTAGACACA-1_V12D07-335_D1,0,1,1,0,0,2
GATTGGGAAAGGTTGT-1_V12D07-335_D1,0,1,1,0,0,2
GATGAGGAACCTTCGG-1_V12D07-335_D1,1,1,0,0,0,2
TGAATACCGACGCGTA-1_V12D07-335_D1,0,1,0,0,0,1
AATCGTGAGCCGAGCA-1_V12D07-335_D1,0,0,0,0,0,0
GCGAAGAATCTGACGG-1_V12D07-335_D1,0,0,0,0,1,1
GAACAACTGGGATGAA-1_V12D07-335_D1,0,1,3,0,0,4
TCGCCGACATATTCGC-1_V12D07-335_D1,0,1,0,1,0,2
CGTAGAGAGTAATTAT-1_V12D07-335_D1,0,0,1,0,1,2
CGATAGTCGTACTGCA-1_V12D07-335_D1,0,2,1,1,0,4
CGCATGCCGAATGCGT-1_V12D07-335_D1,0,1,0,0,0,1
CTCTAGCCCTCGGAAA-1_V12D07-335_D1,0,3,1,0,0,4
TCCAACTCAGCTATCT-1_V12D07-335_D1,0,0,0,0,0,0
GTCTAGTGAGCCGCTT-1_V12D07-335_D1,0,1,0,0,0,1
TACCGAATAATTGTAA-1_V12D07-335_D1,0,0,1,0,0,1
ATATAACACGGGCGCA-1_V12D07-335_D1,0,0,0,0,0,0
GCATGCTAATAACGAT-1_V12D07-335_D1,0,0,2,0,2,4
TCCGGGCTTGACGGGA-1_V12D07-335_D1,0,2,0,0,0,2
ATTATTCAGAGTCACT-1_V12D07-335_D1,0,0,0,0,4,4
TAGCAGTATGACTAAA-1_V12D07-335_D1,0,0,1,0,0,1
TATGAAGAATTAAGGT-1_V12D07-335_D1,0,0,0,0,0,0
CAAGGCCAGTGGTGCA-1_V12D07-335_D1,0,0,0,0,1,1
TGCGTACGGCTAATTG-1_V12D07-335_D1,0,0,0,1,0,1
CAGATAATGGGCGGGT-1_V12D07-335_D1,0,0,0,0,0,0
GAGAACGGTTCTGACT-1_V12D07-335_D1,0,0,1,0,0,1
CGCTTCGGTCTAAGAC-1_V12D07-335_D1,0,0,0,0,0,0
AGCATTACGAGGCAAG-1_V12D07-335_D1,0,0,0,0,1,1
AAGTTGTGATGTTATA-1_V12D07-335_D1,0,0,2,0,0,2
TTGCTCATAGTACGTG-1_V12D07-335_D1,1,0,2,0,0,3
TACTTAAACATGTACA-1_V12D07-335_D1,0,0,2,0,0,2
AGTGAGTCGAATTAAC-1_V12D07-335_D1,0,0,3,1,0,4
TAGGCCTATATAGTCT-1_V12D07-335_D1,0,0,2,0,1,3
ACTCGCCGTTCGATAA-1_V12D07-335_D1,0,1,1,0,2,4
GGTACGTTGCGGCCGG-1_V12D07-335_D1,0,0,0,0,0,0
TATTGCCGGGCTTGTA-1_V12D07-335_D1,0,1,3,1,0,5
GGTAAACTCTGCGCTG-1_V12D07-335_D1,0,0,1,0,0,1
TCCCTTGTCTGAAACT-1_V12D07-335_D1,0,1,2,0,0,3
CATGATCGCTTTGAGA-1_V12D07-335_D1,0,0,1,1,0,2
GGACGGGCGACCAACC-1_V12D07-335_D1,0,1,2,0,0,3
GAGAGGCCTATGTGTA-1_V12D07-335_D1,0,0,4,0,0,4
TCGTAACTCCCAAGAC-1_V12D07-335_D1,0,1,1,0,0,2
CGTATCTAGAACTAAG-1_V12D07-335_D1,0,2,0,0,0,2
GCACCTTCCCGAAGGT-1_V12D07-335_D1,0,0,1,1,0,2
TACCTCTTTACCATCC-1_V12D07-335_D1,0,2,4,0,0,6
TGACTCTAACTGGTAA-1_V12D07-335_D1,0,0,2,0,0,2
GAGAAACTGGATCCCA-1_V12D07-335_D1,0,2,1,0,0,3
TTATTTAGGTTCCTTA-1_V12D07-335_D1,0,6,0,0,0,6
TAGTTTGATCGGTCGC-1_V12D07-335_D1,0,1,5,0,0,6
AGTCGAAACGATTCAG-1_V12D07-335_D1,0,0,3,1,0,4
ACGTCGGGCAACTCGG-1_V12D07-335_D1,0,1,0,0,0,1
ACTTGCTCTATCTACC-1_V12D07-335_D1,0,0,2,0,0,2
ATTACGGGCTACGGTT-1_V12D07-335_D1,0,2,0,1,0,3
GCAAACGTAAGCGACC-1_V12D07-335_D1,0,1,1,0,0,2
TTCGGACTGGGCATGG-1_V12D07-335_D1,0,1,0,1,0,2
GGGCCATTCGTGCTGG-1_V12D07-335_D1,0,0,1,0,0,1
GAGTTGTCACCAGTCT-1_V12D07-335_D1,1,0,1,1,0,3
AGTAATTTGCAAGCGT-1_V12D07-335_D1,0,2,4,0,0,6
GTGGCCGGTTTCTCGG-1_V12D07-335_D1,0,1,5,1,0,7
ATCTTAGGGCATTAAT-1_V12D07-335_D1,0,0,4,0,0,4
CTACATATCGCGGGAC-1_V12D07-335_D1,0,0,5,1,0,6
ATGGTATTTACTGATT-1_V12D07-335_D1,0,0,0,0,0,0
CCGTCAACCTCTGGCG-1_V12D07-335_D1,0,2,3,0,0,5
GCTTCGACGTTCAATC-1_V12D07-335_D1,0,1,4,0,0,5
GACCGATTAAATATGT-1_V12D07-335_D1,0,1,5,0,0,6
GTCGAATTTGGGCGCT-1_V12D07-335_D1,0,1,5,2,0,8
TCACGGCCCAAGAGAG-1_V12D07-335_D1,0,0,4,0,0,4
CTACGATCCTATCCTA-1_V12D07-335_D1,0,1,1,0,0,2
TGCAGTGGTAGGGAAC-1_V12D07-335_D1,0,1,3,2,0,6
TTGCCTAATCCAAAGT-1_V12D07-335_D1,0,0,8,1,0,9
AGCGAGACGTGAAGGC-1_V12D07-335_D1,0,4,1,1,0,6
TTCTACCTCAATCGGT-1_V12D07-335_D1,0,0,1,0,0,1
TACGCTGCTGTGTTAA-1_V12D07-335_D1,0,3,3,0,0,6
TAGTCCTGCACTAAGC-1_V12D07-335_D1,0,1,2,0,0,3
AGCACACGTTTAGACT-1_V12D07-335_D1,0,1,4,0,0,5
GTTCGACAATTGTATA-1_V12D07-335_D1,0,4,3,0,0,7
CCATGTTCATCTATAT-1_V12D07-335_D1,0,0,3,0,0,3
CCCTCGATAATACACA-1_V12D07-335_D1,0,1,2,0,0,3
ACTGCCCGCCATTCTC-1_V12D07-335_D1,0,3,4,0,0,7
CTATATCCAGCCTGGC-1_V12D07-335_D1,0,2,3,0,0,5
CGCACGTCTGTTTATG-1_V12D07-335_D1,0,3,1,0,0,4
AATCAGGTTTCATTTA-1_V12D07-335_D1,0,1,1,0,0,2
AGAGAAACACCAGAAA-1_V12D07-335_D1,0,1,3,0,1,5
ACCCGATTGGTTCCGA-1_V12D07-335_D1,0,1,2,0,0,3
TACCAGGAATCCCGTC-1_V12D07-335_D1,0,2,1,0,0,3
AAGTGCTTCTCTATTG-1_V12D07-335_D1,0,1,2,0,0,3
TGCATGTGACCCATAG-1_V12D07-335_D1,1,2,1,0,0,4
TAGATTCAAAGTGCGG-1_V12D07-335_D1,0,3,1,0,0,4
AGGGTCAGAGCACTCG-1_V12D07-335_D1,0,2,0,1,0,3
GTGAGATAACCTTATA-1_V12D07-335_D1,0,2,0,0,0,2
GTGTCAGTGTACGTGG-1_V12D07-335_D1,0,1,0,0,0,1
CTGTAGTGAGGATCGA-1_V12D07-335_D1,0,2,1,0,0,3
GATAGTGCGAGTAAGT-1_V12D07-335_D1,0,0,0,0,1,1
AGGGTTCAGACGGTCC-1_V12D07-335_D1,0,0,5,0,0,5
GGACTCGACAGCGCAT-1_V12D07-335_D1,0,1,1,2,0,4
CACTCTCAAGCATCGA-1_V12D07-335_D1,0,0,0,0,1,1
GAGCGGAATGCGGTGT-1_V12D07-335_D1,0,0,0,0,0,0
CAGTTCGAGGACCCGA-1_V12D07-335_D1,0,0,1,0,1,2
CGTAACTTCGACACTT-1_V12D07-335_D1,0,0,0,0,0,0
TGATCACCACACTGAC-1_V12D07-335_D1,2,0,0,0,0,2
CATACTTCTTTCTCCG-1_V12D07-335_D1,0,0,0,0,0,0
CAAGTAAGTGATAGAC-1_V12D07-335_D1,1,2,2,0,0,5
AGCCCGCAACAAGCAG-1_V12D07-335_D1,0,0,0,0,0,0
GCTCCATGCAAAGCAA-1_V12D07-335_D1,3,0,0,0,0,3
TCGTACCGACGTCAAG-1_V12D07-335_D1,0,0,0,0,1,1
ATTATCGGAATGTACG-1_V12D07-335_D1,0,0,0,0,1,1
ACCTACTATAAATCTA-1_V12D07-335_D1,0,0,0,0,1,1
TATCCTATCAACTGGT-1_V12D07-335_D1,0,0,1,0,0,1
GCGCGGTCTAGTAACT-1_V12D07-335_D1,0,1,0,0,0,1
CCTTCGTATAGAATCC-1_V12D07-335_D1,0,0,0,0,0,0
TGGGCGATACAATAAG-1_V12D07-335_D1,0,2,0,0,0,2
TGACATGTAACGTGAC-1_V12D07-335_D1,0,2,1,1,0,4
TTGGGAAGACGAGCCG-1_V12D07-335_D1,0,1,0,0,0,1
GGTGTAAATCGATTGT-1_V12D07-335_D1,2,0,1,0,0,3
GAACTGTGGAGAGACA-1_V12D07-335_D1,0,1,1,0,0,2
TCCACATCGTATATTG-1_V12D07-335_D1,1,0,0,0,0,1
CCTATGGTCAAAGCTG-1_V12D07-335_D1,0,2,0,0,0,2
TCCTTGTCCTTTAATT-1_V12D07-335_D1,0,0,3,0,0,3
AAGTTTATGGGCCCAA-1_V12D07-335_D1,0,1,0,0,0,1
GTCCGGGTTCACATTA-1_V12D07-335_D1,0,1,0,0,0,1
ATGTAGCGCGCGTAGG-1_V12D07-335_D1,0,2,1,0,0,3
TACGGAAGCCAAACCA-1_V12D07-335_D1,0,0,0,0,0,0
GCCCTGAGGATGGGCT-1_V12D07-335_D1,0,3,0,1,0,4
CGGGCGATGGATCACG-1_V12D07-335_D1,1,1,0,0,1,3
TGCGGACTTGACTCCG-1_V12D07-335_D1,0,0,0,0,1,1
TAATACTAGAACAGAC-1_V12D07-335_D1,0,1,1,0,0,2
TCAAATTGTTGTGCCG-1_V12D07-335_D1,0,1,0,0,1,2
GGGCAGTCAACGCCAA-1_V12D07-335_D1,1,0,1,0,0,2
TCGCTGCCAATGCTGT-1_V12D07-335_D1,0,0,0,0,0,0
TACGTGGGCCCAGGGC-1_V12D07-335_D1,0,2,1,0,0,3
GCCTACGTTCTGTGCA-1_V12D07-335_D1,0,2,0,0,1,3
TTGCGTGTGTAGGCAT-1_V12D07-335_D1,0,1,0,0,1,2
TCCTAAAGATTCAGAC-1_V12D07-335_D1,0,1,0,3,1,5
TGGGTGCACAAGCCAT-1_V12D07-335_D1,0,2,0,0,0,2
GGGAGCGACCGTAGTG-1_V12D07-335_D1,0,0,0,0,0,0
CATAGAGGAGATACTA-1_V12D07-335_D1,0,0,0,0,0,0
CTTCGATTGCGCAAGC-1_V12D07-335_D1,0,1,2,0,0,3
GTGCCTGAGACCAAAC-1_V12D07-335_D1,0,1,0,0,0,1
TCATCCTCAGCTGCTT-1_V12D07-335_D1,0,0,0,0,1,1
TGCAACTACTGGTTGA-1_V12D07-335_D1,1,0,0,0,0,1
ATGTTGATTAGAGACT-1_V12D07-335_D1,0,1,1,0,2,4
GTTTCTAGAGGCGCGG-1_V12D07-335_D1,0,0,0,0,1,1
TACAAGGGCTTCTTTA-1_V12D07-335_D1,0,2,0,0,2,4
ACAGGCACGGATCCTT-1_V12D07-335_D1,0,0,1,1,2,4
CCCAAGTCATTACACT-1_V12D07-335_D1,0,0,0,1,0,1
ACTCTGACCTAATAGA-1_V12D07-335_D1,0,2,0,1,0,3
GGATGGCTTGAAGTAT-1_V12D07-335_D1,0,1,0,0,0,1
ACCCTCCCGTCAGGGC-1_V12D07-335_D1,0,1,0,0,0,1
AGCTTCTTCTCGAGCA-1_V12D07-335_D1,0,0,1,0,1,2
TTGCGCTTGATCAATA-1_V12D07-335_D1,0,2,1,0,1,4
TGGGTGTAATAGATTT-1_V12D07-335_D1,0,1,1,0,0,2
CATGGTTTATTAATCA-1_V12D07-335_D1,0,1,2,0,0,3
TTGCCTTCTCGCCGGG-1_V12D07-335_D1,0,0,3,0,1,4
TTAAAGTAAGTCGCCA-1_V12D07-335_D1,0,0,1,0,0,1
AGTTGGCAAGGCTAGA-1_V12D07-335_D1,0,0,2,0,0,2
CCGCACTTGCAATGAC-1_V12D07-335_D1,0,0,1,0,0,1
AATGTTGTCGTGAGAC-1_V12D07-335_D1,0,1,1,0,3,5
CCAAGGTTGCCCTTTC-1_V12D07-335_D1,0,0,2,0,0,2
TGTGACTAGAGTTTGC-1_V12D07-335_D1,0,0,6,1,0,7
TTGTGATCTGTTCAGT-1_V12D07-335_D1,0,1,0,0,1,2
GGAGTTGATTCTGTGT-1_V12D07-335_D1,0,0,3,1,0,4
GTAGTGAGCAACCTCA-1_V12D07-335_D1,0,0,0,0,0,0
AAGACATACGTGGTTT-1_V12D07-335_D1,0,0,1,0,0,1
CATCCCGAGATTCATA-1_V12D07-335_D1,0,1,3,0,0,4
GGCCGCAGGAACCGCA-1_V12D07-335_D1,0,0,0,0,0,0
CCAGAAACTGATGCGA-1_V12D07-335_D1,0,0,1,0,0,1
ACCCGTAGTCTAGTTG-1_V12D07-335_D1,0,0,3,0,0,3
AGGGTCTGGACGCAGT-1_V12D07-335_D1,0,0,4,0,0,4
TTGAAACCCTCATTCC-1_V12D07-335_D1,0,1,2,0,0,3
TCAATCCCGCGCCAAA-1_V12D07-335_D1,0,3,6,0,0,9
AGGACATCGGCACACT-1_V12D07-335_D1,0,1,5,0,0,6
GGGCGATCCATAGGCC-1_V12D07-335_D1,0,1,4,0,0,5
CGTATTGTTTGGCGCC-1_V12D07-335_D1,0,1,2,0,0,3
CGCGTGGGCCTGTGTT-1_V12D07-335_D1,0,0,2,0,0,2
AAATCTGCCCGCGTCC-1_V12D07-335_D1,0,1,5,0,0,6
GCTGAAGGGTTCTTGG-1_V12D07-335_D1,0,0,1,1,0,2
TAATTGCGCTGATTAC-1_V12D07-335_D1,0,0,0,2,0,2
TCGCGCGTTTACATGA-1_V12D07-335_D1,0,1,1,0,0,2
TAACTGAAATACGCCT-1_V12D07-335_D1,0,1,1,0,0,2
CCTGTCGTGTATGAAG-1_V12D07-335_D1,0,0,2,0,0,2
CGGGAACGCCCTGCAT-1_V12D07-335_D1,0,1,2,0,0,3
AGTTGCGGTCCTCAAC-1_V12D07-335_D1,0,0,1,1,0,2
GGGTCCTTGGAAGAAG-1_V12D07-335_D1,0,2,1,1,0,4
CGGGAAGTACCGTGGC-1_V12D07-335_D1,0,0,2,0,0,2
ACGGTCACCGAGAACA-1_V12D07-335_D1,0,0,0,0,0,0
TAGACTCAGTTGGCCT-1_V12D07-335_D1,0,1,0,1,0,2
CCTTCCGCAACGCTGC-1_V12D07-335_D1,0,0,3,0,0,3
CAGTGTTAATCTCTCA-1_V12D07-335_D1,0,1,2,0,0,3
CAGGCCAGTACCACCT-1_V12D07-335_D1,0,0,2,0,0,2
GATCGCTGTGGTGCGT-1_V12D07-335_D1,0,3,2,0,0,5
GTATCTCGGGCGCTTT-1_V12D07-335_D1,0,1,1,0,0,2
CCGGGCTAAGAATTTC-1_V12D07-335_D1,0,0,5,0,0,5
CTTCACGCCCTGGTAC-1_V12D07-335_D1,0,0,4,0,0,4
CGGATGAATGCTGTGA-1_V12D07-335_D1,0,1,5,0,0,6
CTCTGCAGGCATTCTT-1_V12D07-335_D1,0,0,9,1,0,10
TCAAAGTCACGGCGTC-1_V12D07-335_D1,0,3,4,1,0,8
TGGGTTTCGGGCGTAC-1_V12D07-335_D1,0,0,0,0,0,0
TGCTATGGCAAAGGGA-1_V12D07-335_D1,0,0,5,0,0,5
TTCACGGTCGTCACGT-1_V12D07-335_D1,0,0,0,0,0,0
CGTAAAGCAAGAAATC-1_V12D07-335_D1,0,0,0,0,0,0
CTGATCCCTTTATGCA-1_V12D07-335_D1,0,2,2,0,0,4
GAGTATACCCTAATCA-1_V12D07-335_D1,0,1,3,0,0,4
CCACGGCAGGTGTAGG-1_V12D07-335_D1,0,1,6,0,0,7
ACGTACTTTGGCACGG-1_V12D07-335_D1,0,1,2,0,0,3
CCTGAGAATAAATGCA-1_V12D07-335_D1,0,0,1,0,0,1
TTGATGCCGCTCGTCG-1_V12D07-335_D1,0,2,7,0,0,9
GCCAGGAAAGAACACT-1_V12D07-335_D1,0,0,1,0,0,1
TCCGACCGCTAATCAA-1_V12D07-335_D1,0,0,0,0,0,0
TATATCAAAGTGATCT-1_V12D07-335_D1,0,1,1,0,0,2
CCTCGGTTTCCTTGCC-1_V12D07-335_D1,0,1,2,1,2,6
TAAATTTAGTAACACC-1_V12D07-335_D1,0,4,0,0,0,4
CTCGTTACGGCTACCA-1_V12D07-335_D1,0,0,1,0,0,1
GCCGTCGGTTTCGGGC-1_V12D07-335_D1,0,0,4,0,0,4
GTTCCGTCCGCCTGCA-1_V12D07-335_D1,0,0,1,0,0,1
CTAGGGATAGGGACAA-1_V12D07-335_D1,0,0,5,0,0,5
GTCCAGGCACGTGTGC-1_V12D07-335_D1,0,3,4,0,1,8
GAGGAATATCTCTTTG-1_V12D07-335_D1,0,1,0,0,0,1
CGTTCAAGGAAACGGA-1_V12D07-335_D1,0,0,0,0,0,0
GTGGGAACAAACCGGG-1_V12D07-335_D1,0,1,2,0,0,3
GGGCACGTAGTACTGT-1_V12D07-335_D1,0,0,2,0,0,2
ACTACAAAGAGAGGTG-1_V12D07-335_D1,0,1,1,0,0,2
GGTGTAGGTAAGTAAA-1_V12D07-335_D1,0,0,0,0,0,0
CCTGTTCAACCTCGGG-1_V12D07-335_D1,0,2,0,0,0,2
TGAGGTGTGTGGCGGA-1_V12D07-335_D1,0,0,0,0,0,0
ATTGTCTGTTTCATGT-1_V12D07-335_D1,0,1,0,0,1,2
GCCGGTCGTATCTCTC-1_V12D07-335_D1,0,0,0,0,0,0
ATATGGGATAGCAACT-1_V12D07-335_D1,0,1,3,0,1,5
GATAGAACCCGCTAGG-1_V12D07-335_D1,0,0,0,0,1,1
ATCCCATTTCCGTGGG-1_V12D07-335_D1,1,0,0,0,0,1
GATGCTACCTTCGATG-1_V12D07-335_D1,1,1,0,0,2,4
TGCAAAGTTCGTCTGT-1_V12D07-335_D1,0,0,1,0,0,1
GTTCAGTCGCCAAATG-1_V12D07-335_D1,0,2,0,0,0,2
GTCTCCGCCTCAATAC-1_V12D07-335_D1,0,2,0,0,0,2
AGTAGAAGGCGCCTCA-1_V12D07-335_D1,0,1,0,0,0,1
GTTGTAGATTTATGAG-1_V12D07-335_D1,0,1,3,0,2,6
CTATTTGCTTGGAGGA-1_V12D07-335_D1,0,1,0,0,0,1
AGCCATATAGTATGTG-1_V12D07-335_D1,0,0,0,0,0,0
TGTTCCGGCCTGAGCT-1_V12D07-335_D1,0,0,0,1,0,1
TGCCGTGGGACCCAAT-1_V12D07-335_D1,0,0,1,1,0,2
TTGCAAGAAGACTCCT-1_V12D07-335_D1,0,1,1,0,0,2
CCGCTCCAGGGCGATC-1_V12D07-335_D1,1,1,2,0,0,4
CAAACCCTCCGGCGGG-1_V12D07-335_D1,1,1,0,0,0,2
CGGACCTTTACGTCCC-1_V12D07-335_D1,0,2,1,0,0,3
ACGTAGGAGAGTCGCT-1_V12D07-335_D1,0,0,1,0,0,1
CTGCGACCTCGCCGAA-1_V12D07-335_D1,0,0,0,0,0,0
GGCCCAGCTGGTTTGC-1_V12D07-335_D1,0,0,0,0,0,0
GGATTAATCATGGACC-1_V12D07-335_D1,0,0,0,0,0,0
GAGATGGCTTTAATCA-1_V12D07-335_D1,0,0,0,0,0,0
AGTACAGAAGCTTATA-1_V12D07-335_D1,0,0,1,0,3,4
GCGGCTTTAGCAAGTT-1_V12D07-335_D1,0,1,1,0,0,2
ACCGAGTCTCCTTATT-1_V12D07-335_D1,0,2,0,0,1,3
GACCACACTTCCCTTT-1_V12D07-335_D1,0,0,1,0,0,1
TGTAGCCAATTCCGTT-1_V12D07-335_D1,0,0,1,0,0,1
CTCGTCTGTGCCTTCG-1_V12D07-335_D1,0,1,1,0,1,3
GGACTCTTTGACTAAG-1_V12D07-335_D1,0,1,1,0,0,2
TCATCGACGACCGTCG-1_V12D07-335_D1,0,2,0,0,0,2
TACTACGTGCAATGCG-1_V12D07-335_D1,0,0,0,0,0,0
CCCTACTTGAACAATG-1_V12D07-335_D1,0,0,0,0,3,3
GCAGCTGTCAACGCAT-1_V12D07-335_D1,0,2,3,0,1,6
ATCTACCATCTGCTCC-1_V12D07-335_D1,0,0,0,0,2,2
TCTCAAATCAATCGGG-1_V12D07-335_D1,0,1,0,0,2,3
ACTCCGGCCGACCACT-1_V12D07-335_D1,0,0,0,0,1,1
TACACCTCTTCGAATC-1_V12D07-335_D1,0,1,0,0,0,1
GTGGCTGTTTCTGTTC-1_V12D07-335_D1,1,1,0,0,0,2
ACGACTCTAGGGCCGA-1_V12D07-335_D1,0,0,2,0,0,2
TCGTTTACGCGACCCT-1_V12D07-335_D1,0,1,2,0,1,4
AGGATATCCGACTGCA-1_V12D07-335_D1,0,0,1,0,0,1
GACACTTCCAATTACC-1_V12D07-335_D1,0,0,0,0,1,1
ACGGTACAGTTCAATG-1_V12D07-335_D1,0,0,1,0,1,2
CTTGATGACCATCCAG-1_V12D07-335_D1,0,0,1,0,1,2
CTGGTAAAGACTTACA-1_V12D07-335_D1,0,1,0,0,0,1
CTTGCCCACCCACGCA-1_V12D07-335_D1,0,0,4,0,0,4
CATTACGCAGGAAGGG-1_V12D07-335_D1,0,0,1,0,0,1
GGACAACCATGAAGCC-1_V12D07-335_D1,0,0,1,0,0,1
GTTATCAAGCTATCGA-1_V12D07-335_D1,0,2,2,0,0,4
AGGTGCACGTCCACAT-1_V12D07-335_D1,0,0,1,0,0,1
AAAGAATGTGGACTAA-1_V12D07-335_D1,0,2,2,0,1,5
ACCAAGTCATCGGCAG-1_V12D07-335_D1,0,3,0,0,0,3
AGTAACTATAGCAGCC-1_V12D07-335_D1,0,0,2,0,0,2
GGGAAAGAATGCCAAC-1_V12D07-335_D1,0,0,2,0,0,2
AATCGGTATAGCCCTC-1_V12D07-335_D1,0,0,0,0,0,0
GGCACTGCGGTGGTTT-1_V12D07-335_D1,0,0,4,0,1,5
CGTCCTCATCGCGTGC-1_V12D07-335_D1,0,0,1,0,0,1
CTTAACTTACAGTATA-1_V12D07-335_D1,0,0,0,0,0,0
GTGAGTCGACTAATAG-1_V12D07-335_D1,0,1,2,1,0,4
TGTACTTCCGGGCATG-1_V12D07-335_D1,0,0,1,0,0,1
CACAAACCGCAGAACT-1_V12D07-335_D1,0,5,2,0,0,7
GCTTTACACAACTGGG-1_V12D07-335_D1,0,0,0,0,0,0
CACCGATGATGGGTAC-1_V12D07-335_D1,0,1,4,0,0,5
TCAATATACAGGAGGC-1_V12D07-335_D1,0,1,4,0,0,5
AACGACCTCCTAGCCG-1_V12D07-335_D1,0,1,3,0,0,4
GTTACCAAGGCGTACG-1_V12D07-335_D1,0,0,1,0,0,1
TCCGCTGGGTCGATCG-1_V12D07-335_D1,0,0,1,0,0,1
TTAGCATCCCTCACGT-1_V12D07-335_D1,0,2,2,0,0,4
AGCCTTGTCACTGATA-1_V12D07-335_D1,0,2,1,0,0,3
GTTTCTTGTTAGAGCT-1_V12D07-335_D1,0,0,0,0,0,0
TCGGAGTCCTGGTTGC-1_V12D07-335_D1,0,1,1,1,0,3
ACGGGTTGTGACCTGT-1_V12D07-335_D1,0,1,2,0,0,3
TGACAGAAATCTTGCT-1_V12D07-335_D1,0,2,4,0,0,6
TAGCCATGATTGCCTA-1_V12D07-335_D1,0,1,1,2,0,4
CGAAGCCACAGCATGG-1_V12D07-335_D1,0,4,2,0,0,6
ACCCGTAGCAGAGAAT-1_V12D07-335_D1,0,0,1,0,0,1
AGCTTGATCAGGGTAG-1_V12D07-335_D1,0,1,3,0,0,4
CTATAAGTAGGGTTTG-1_V12D07-335_D1,0,0,7,0,0,7
TATAGTTAGGTGTACT-1_V12D07-335_D1,0,1,0,0,0,1
TACGCTGATAGTTGTA-1_V12D07-335_D1,0,1,1,0,0,2
TTCTCAATTGCTACAA-1_V12D07-335_D1,0,0,0,0,0,0
GTTGCCCTAACGGGTG-1_V12D07-335_D1,0,0,3,0,0,3
GACATTTCGCCCAGCC-1_V12D07-335_D1,0,5,3,0,0,8
GTAACTACGTAGACCT-1_V12D07-335_D1,0,0,6,0,0,6
CCAGTGTACAGACCGA-1_V12D07-335_D1,0,1,1,0,0,2
GCCCGATGCCCAGTTC-1_V12D07-335_D1,0,1,4,1,0,6
CGAACCTCTTTCCTAG-1_V12D07-335_D1,0,1,2,0,0,3
CATGCACATGAGAGGC-1_V12D07-335_D1,0,2,4,0,0,6
CCAAATCAAAGGGCAA-1_V12D07-335_D1,0,1,1,0,0,2
GTAGTTTAAGCACACG-1_V12D07-335_D1,0,0,2,0,0,2
TAAGTGAATAGTCTAC-1_V12D07-335_D1,0,0,1,0,0,1
GGTCCACGTCTATTTG-1_V12D07-335_D1,0,0,1,0,0,1
CCCTCAGATCGAGAAC-1_V12D07-335_D1,0,0,2,0,0,2
ACATTCGCGCGGAATA-1_V12D07-335_D1,0,3,2,1,0,6
CTATGAACACCTTGCC-1_V12D07-335_D1,0,0,3,0,0,3
CGAATGGTAGGTCGTC-1_V12D07-335_D1,0,1,2,0,0,3
TCGACATAGCGTAGCG-1_V12D07-335_D1,0,1,3,1,0,5
GACGTTGCTCGGCGGC-1_V12D07-335_D1,0,1,3,0,0,4
CTCGAGGCAAGTTTCA-1_V12D07-335_D1,0,2,3,0,0,5
GCTGGGAGCGCGTCAA-1_V12D07-335_D1,0,0,1,0,0,1
GACGATATCACTGGGT-1_V12D07-335_D1,0,0,3,0,0,3
CAGCTCTGGGCTCACT-1_V12D07-335_D1,0,1,3,0,0,4
TAGTCTGCGGCACATT-1_V12D07-335_D1,0,0,6,0,0,6
TGGTCGATATACCTCT-1_V12D07-335_D1,0,0,0,0,0,0
TTCAGTTCAAGAGGAG-1_V12D07-335_D1,0,0,2,0,0,2
GTCTGTAGGTTGAACA-1_V12D07-335_D1,0,0,0,1,0,1
GAGAGTCTCGGGAGAG-1_V12D07-335_D1,0,0,4,0,0,4
TTGTTTGTATTACACG-1_V12D07-335_D1,0,1,3,0,0,4
GCACAGCACGGGCCGA-1_V12D07-335_D1,0,2,0,2,0,4
AAACAGTGTTCCTGGG-1_V12D07-335_D1,0,2,3,0,0,5
TGGAGAATAATCGTCC-1_V12D07-335_D1,0,1,2,0,0,3
CGCCGCGTTCTGAACG-1_V12D07-335_D1,0,0,2,2,0,4
CATGCGTTGAGAGGAG-1_V12D07-335_D1,0,0,3,1,0,4
TACGCTCCTAGAACTG-1_V12D07-335_D1,0,3,2,0,0,5
CCTTGTGAACGTGGTT-1_V12D07-335_D1,0,0,1,0,0,1
TTAAAGGCGATGCTCG-1_V12D07-335_D1,1,1,1,0,0,3
TAAAGTGCACGTCTCG-1_V12D07-335_D1,0,2,2,0,0,4
TGTCCGCAAACAATTC-1_V12D07-335_D1,0,2,2,0,0,4
AGGCCTATCATACCAA-1_V12D07-335_D1,0,0,4,0,0,4
ACTGGGATGCCAGTGC-1_V12D07-335_D1,0,1,0,0,0,1
CGATCCACCATTGTTG-1_V12D07-335_D1,0,2,5,1,0,8
GGGCATGCATGTCGAG-1_V12D07-335_D1,0,1,2,0,0,3
TCCAGGCAGGACGATC-1_V12D07-335_D1,0,1,1,0,0,2
CAATGACCCTTAATTT-1_V12D07-335_D1,1,0,2,0,0,3
ATCAAGATCCCAGGAC-1_V12D07-335_D1,0,0,0,0,0,0
CTCAGAGCTAATGTCG-1_V12D07-335_D1,0,2,1,0,0,3
CTGCGATTTCGAGATT-1_V12D07-335_D1,0,2,2,0,0,4
ATGGTATTGGGAACCG-1_V12D07-335_D1,0,2,1,0,0,3
TAGGTTCTGCTGAGAA-1_V12D07-335_D1,0,1,2,0,1,4
GCCTGTCCCGGTGCAT-1_V12D07-335_D1,1,1,0,1,0,3
GGCCTGCTCTGATGTT-1_V12D07-335_D1,1,1,1,0,1,4
TAGAGGGAGTTTATCT-1_V12D07-335_D1,0,0,2,0,1,3
CTCTACATCCTGCGTG-1_V12D07-335_D1,0,0,1,0,1,2
ACACATTTCCGTAGAC-1_V12D07-335_D1,0,0,0,0,0,0
TGGGTGTTAAGTAGAA-1_V12D07-335_D1,1,2,1,0,0,4
GAGCTCAACATGAGCG-1_V12D07-335_D1,0,0,1,0,0,1
GCACACAGCTATTACC-1_V12D07-335_D1,0,0,0,0,1,1
GCGACGGTAGTCTCCT-1_V12D07-335_D1,0,1,0,0,1,2
GTATCAAGGTACTTCC-1_V12D07-335_D1,0,3,0,1,1,5
GGAAAGGGAATTGAGC-1_V12D07-335_D1,0,0,2,0,0,2
TACACAGCCGTGGTGC-1_V12D07-335_D1,0,2,1,0,2,5
CGGTTGGGCAGGGTCC-1_V12D07-335_D1,0,0,1,0,0,1
GCACGCCGATTCCCGC-1_V12D07-335_D1,1,0,3,0,0,4
CGCTTTCCGCCAAGGT-1_V12D07-335_D1,0,0,0,0,0,0
TGCCCGATAGTTAGAA-1_V12D07-335_D1,1,0,0,0,1,2
TCAGAACGGCGGTAAT-1_V12D07-335_D1,0,0,0,0,0,0
CCACTCAGATCCGCAA-1_V12D07-335_D1,0,0,0,0,0,0
GAAGGGTCATTAAGAC-1_V12D07-335_D1,0,1,1,0,1,3
GCGGTCTTGCTTTCAC-1_V12D07-335_D1,0,0,2,0,1,3
GGAAGGACACCGTATA-1_V12D07-335_D1,1,0,0,0,0,1
CGCGGGAATTCCTTTC-1_V12D07-335_D1,0,2,4,1,1,8
TCTATCCGATTGCACA-1_V12D07-335_D1,0,0,0,0,0,0
TACTCGTTTGAATCAA-1_V12D07-335_D1,0,1,1,0,1,3
GTCTGCCGACTCGACG-1_V12D07-335_D1,0,1,1,0,0,2
TACGGGTAATAACATA-1_V12D07-335_D1,0,0,2,0,0,2
CCAGTTCGGTAACTCA-1_V12D07-335_D1,0,1,0,0,0,1
CGTGCACACCACTGTA-1_V12D07-335_D1,0,0,0,0,1,1
CTTCAGTTGGACAACG-1_V12D07-335_D1,0,4,1,0,0,5
TGATCTATCACACTCT-1_V12D07-335_D1,0,0,1,0,0,1
TAGCAGATACTTAGGG-1_V12D07-335_D1,0,0,1,0,0,1
CACCGGGCATCACAAG-1_V12D07-335_D1,0,1,1,0,1,3
AGTGGCCCGCAAATGG-1_V12D07-335_D1,0,2,3,0,0,5
CTCGCTAGGTAAGCGA-1_V12D07-335_D1,0,0,1,0,0,1
GATAGATAGTACAGTC-1_V12D07-335_D1,0,0,1,1,1,3
CGAGACTACTGCTGCT-1_V12D07-335_D1,0,0,2,0,0,2
ACATTTGAAACCTAAC-1_V12D07-335_D1,1,0,0,0,0,1
GACACAGCCGGGACTG-1_V12D07-335_D1,0,1,1,0,0,2
ACGGAACACGAGTGCC-1_V12D07-335_D1,0,1,4,0,0,5
ACGCCAGTGCGTTTGC-1_V12D07-335_D1,0,2,2,0,0,4
GCACCTAGGCGAGTCC-1_V12D07-335_D1,0,0,1,0,0,1
TCACTATCCCTTCGGT-1_V12D07-335_D1,0,0,0,0,0,0
TGAGTGTAACAACGGG-1_V12D07-335_D1,0,1,3,0,1,5
ATTGGTTGTGCATTAC-1_V12D07-335_D1,0,0,2,0,0,2
CTGGCGATTTACATGT-1_V12D07-335_D1,0,0,1,0,0,1
TCCACCAAGACATAGG-1_V12D07-335_D1,0,0,1,0,0,1
AACGTCGCTGCACTTC-1_V12D07-335_D1,0,1,2,0,0,3
GTCTCCCGAGTCCCGT-1_V12D07-335_D1,0,0,1,0,0,1
AGCCCGCACTACAATG-1_V12D07-335_D1,0,1,1,0,0,2
GGCACGCTGCTACAGT-1_V12D07-335_D1,0,2,1,0,1,4
GCTTGAGTGACCTCTG-1_V12D07-335_D1,0,0,1,0,0,1
ATAGCCATAACAGTCA-1_V12D07-335_D1,0,1,1,0,0,2
TAGGAGGCTCGAGAAC-1_V12D07-335_D1,0,0,0,0,0,0
GTCGGGTGAAGTACCG-1_V12D07-335_D1,0,1,3,0,0,4
CACCCGCGTTTGACAC-1_V12D07-335_D1,0,7,1,0,2,10
TCTCAGGCTACTCGCT-1_V12D07-335_D1,0,3,0,0,1,4
ATACAGCGTCCACTGA-1_V12D07-335_D1,0,1,4,0,0,5
TCACGATTAATACGTT-1_V12D07-335_D1,0,0,1,2,0,3
CGTGAACTGACCCGAT-1_V12D07-335_D1,0,2,5,0,0,7
TCGATGTTACGGCCGT-1_V12D07-335_D1,0,3,1,0,0,4
GACCGGTGATACTCTC-1_V12D07-335_D1,0,2,2,0,0,4
TCTGTTTAGATTGTTC-1_V12D07-335_D1,0,1,1,1,0,3
GCTACTCGGACGCAGA-1_V12D07-335_D1,0,0,4,0,0,4
AAGAAAGTTTGATGGG-1_V12D07-335_D1,0,3,3,0,0,6
CGCCAGTAGTACCTTG-1_V12D07-335_D1,0,3,1,1,0,5
CTCCCTTGTATCAAGG-1_V12D07-335_D1,0,2,3,1,0,6
ACTTTATACACCACTT-1_V12D07-335_D1,0,1,2,0,0,3
AGATCTGGAGAGGATA-1_V12D07-335_D1,0,1,0,0,0,1
TCATCCATCTGATCAC-1_V12D07-335_D1,0,1,3,0,0,4
AGAACACGGCGATGGT-1_V12D07-335_D1,0,0,2,0,0,2
CCGCTCCGGATAAGCT-1_V12D07-335_D1,0,0,1,0,0,1
TGGTCGGGTACAGGGC-1_V12D07-335_D1,0,0,2,0,0,2
ACGGACGCAGCGACAA-1_V12D07-335_D1,0,0,0,0,0,0
ACATGCTTACGGCAGC-1_V12D07-335_D1,0,0,3,0,0,3
CAGGGAGATAGGCCAG-1_V12D07-335_D1,0,0,2,0,0,2
TCGCCACCCGGATTAC-1_V12D07-335_D1,0,0,1,0,0,1
TCTTGGTCAATGATAC-1_V12D07-335_D1,0,0,1,0,0,1
CATAGGGACACTTGTG-1_V12D07-335_D1,0,0,1,0,0,1
CACGAGCAAACCAGAC-1_V12D07-335_D1,0,0,1,0,0,1
GGGATATTGATCGCCA-1_V12D07-335_D1,0,2,3,0,0,5
TAATGTCGGTTCATGG-1_V12D07-335_D1,0,0,4,0,0,4
CGATTTGTCATTAATG-1_V12D07-335_D1,0,2,0,2,0,4
TTAAGATACCCAGAGA-1_V12D07-335_D1,0,1,7,1,0,9
CGACCGTTGGTATTCG-1_V12D07-335_D1,0,0,0,0,0,0
ACTACCATCCGAGGGC-1_V12D07-335_D1,0,0,1,0,0,1
TCTACGCACGATCTCC-1_V12D07-335_D1,0,1,3,0,0,4
AAGCCACTTGCAGGTA-1_V12D07-335_D1,0,1,0,1,0,2
ACGTTGTCGTTGAAAG-1_V12D07-335_D1,0,0,8,1,0,9
ACCGCTAGTCATTGGT-1_V12D07-335_D1,0,0,1,2,0,3
CATGAGTCCATCACGG-1_V12D07-335_D1,0,0,2,0,0,2
ATGTCTTGTTTGACTC-1_V12D07-335_D1,0,2,0,3,0,5
TCCCAAACATCCTCTA-1_V12D07-335_D1,0,0,1,0,0,1
CAACGCGATGAGCCAA-1_V12D07-335_D1,0,1,3,0,0,4
GACACCCAAAGACGCG-1_V12D07-335_D1,0,0,1,0,0,1
ACGTTCACTATGCCGC-1_V12D07-335_D1,0,4,0,0,0,4
ATGGACTGCTTAGTTG-1_V12D07-335_D1,0,0,1,0,0,1
CCATGGCAAACGCTCA-1_V12D07-335_D1,0,1,0,0,0,1
TTGTCTCGGCAAGATG-1_V12D07-335_D1,0,1,2,1,0,4
TTCGAACGAAACATGC-1_V12D07-335_D1,0,2,2,0,0,4
GGAAAGTCTTGATTGT-1_V12D07-335_D1,0,2,1,0,0,3
ATCATAGATCGACGAG-1_V12D07-335_D1,0,2,4,0,0,6
GATTAGAAACAAGCGT-1_V12D07-335_D1,0,1,0,0,0,1
GCTGCGAAGAATTATT-1_V12D07-335_D1,0,1,5,0,0,6
TTCCAGTGGGTTTCGT-1_V12D07-335_D1,0,0,1,0,0,1
GCTCATTGATCATATC-1_V12D07-335_D1,0,0,2,0,0,2
ATACGAGGTTTGTAAG-1_V12D07-335_D1,0,1,2,0,0,3
GTCTATACACGCATGG-1_V12D07-335_D1,0,0,5,0,0,5
GATTTGCGCTAACACC-1_V12D07-335_D1,1,1,2,1,0,5
TGGTGCCCTGCCTTAC-1_V12D07-335_D1,1,1,1,0,0,3
TCGAATCGCAGGGTAG-1_V12D07-335_D1,0,1,2,0,0,3
GGTAGGCCAATATCAC-1_V12D07-335_D1,0,0,2,0,0,2
CGTAAATAACAAAGGG-1_V12D07-335_D1,0,0,0,0,0,0
GACTCTAGAGTTCCAA-1_V12D07-335_D1,0,0,2,0,0,2
ACTTGTTACCGGATCA-1_V12D07-335_D1,0,4,1,0,0,5
GGCATTGAACATCTCA-1_V12D07-335_D1,0,0,3,0,0,3
AACCCGCTGTATTCCA-1_V12D07-335_D1,0,0,3,1,0,4
TAACAGGTTCCCTTAG-1_V12D07-335_D1,0,0,3,0,0,3
GTTCTTGTAACTCAAT-1_V12D07-335_D1,0,2,3,0,0,5
GATTCTGTTAATGAGT-1_V12D07-335_D1,0,0,3,0,0,3
GGACACCTCGGTGTTG-1_V12D07-335_D1,0,0,0,0,0,0
CGATCGAGAAGCACCA-1_V12D07-335_D1,0,0,2,0,0,2
CTGCTCTGACGGCAAA-1_V12D07-335_D1,0,0,2,0,0,2
CCCAGGAAGAATTCGA-1_V12D07-335_D1,0,0,6,2,0,8
TGTCGTGGGTATAGGC-1_V12D07-335_D1,0,2,2,0,0,4
ATATGTCTAGAGCGTG-1_V12D07-335_D1,0,0,1,0,0,1
GCGGGCAGACGGGTGA-1_V12D07-335_D1,0,2,6,0,0,8
CGAAGATCAGTTTCAT-1_V12D07-335_D1,0,1,3,0,1,5
ACGCCACTCGAAACAG-1_V12D07-335_D1,0,0,3,0,2,5
CTTAGATGTTTCATCC-1_V12D07-335_D1,0,1,1,0,0,2
GCGAATGGACTAGCGA-1_V12D07-335_D1,0,0,0,0,0,0
TAAATTGTGGGTAAAG-1_V12D07-335_D1,0,1,3,1,0,5
ATTTATACTGGTAAAG-1_V12D07-335_D1,0,1,2,0,0,3
GCGTCGTAACATGGTC-1_V12D07-335_D1,0,0,0,0,0,0
CGGTATGGGCACTCTG-1_V12D07-335_D1,0,0,0,0,2,2
CTATCACAACGCTGGA-1_V12D07-335_D1,0,0,0,0,0,0
ACCACACGGTTGATGG-1_V12D07-335_D1,0,1,2,0,1,4
TCAGCGCACGCCGTTT-1_V12D07-335_D1,0,1,1,0,0,2
AATGTTAAGACCCTGA-1_V12D07-335_D1,0,0,1,1,0,2
CTTACATAGATTTCTT-1_V12D07-335_D1,0,0,1,0,1,2
AACATAGCGTGTATCG-1_V12D07-335_D1,0,0,1,0,3,4
AGCAGTCGAAGCATGC-1_V12D07-335_D1,0,1,2,1,0,4
GTACTACGGCCTCGTT-1_V12D07-335_D1,0,0,6,1,0,7
TTGGCCAAATTGTATC-1_V12D07-335_D1,0,0,1,0,0,1
TCAGAGGACGCGTTAG-1_V12D07-335_D1,0,0,4,0,0,4
AGTAATCTAAGGGTGG-1_V12D07-335_D1,1,0,3,0,0,4
AATTATACCCAGCAAG-1_V12D07-335_D1,1,1,0,0,0,2
CCCTACCCACACCCAG-1_V12D07-335_D1,0,0,1,0,0,1
CTCTGTCCATGCACCA-1_V12D07-335_D1,0,1,1,1,0,3
TCGCCTCCTTCGGCTC-1_V12D07-335_D1,0,2,1,0,0,3
CCTGATTCGCGAAGAA-1_V12D07-335_D1,0,0,5,0,0,5
GACTTCAACGCATCAA-1_V12D07-335_D1,0,0,2,0,1,3
GCTTCCCGTAAGCTCC-1_V12D07-335_D1,0,0,1,0,1,2
AGAACTGTACTTTGTA-1_V12D07-335_D1,0,1,3,0,0,4
CCTTAAGTACGCAATT-1_V12D07-335_D1,0,0,1,0,0,1
GGCCAATTGTATAGAC-1_V12D07-335_D1,0,0,1,0,0,1
AGAATACAGGCTATCC-1_V12D07-335_D1,0,0,2,0,0,2
AATACCTGATGTGAAC-1_V12D07-335_D1,0,0,3,0,0,3
TAGAGTGTTCCGGGTA-1_V12D07-335_D1,0,1,2,0,0,3
GCTTCCATGTAACCGC-1_V12D07-335_D1,0,2,1,0,0,3
GGTTCGCATTTGCCGT-1_V12D07-335_D1,0,1,3,0,0,4
TCAATCCGGGAAGTTT-1_V12D07-335_D1,0,1,1,0,0,2
CCGGAAGTGCAATATG-1_V12D07-335_D1,0,0,0,0,0,0
CTCATAAATGTGTATA-1_V12D07-335_D1,0,0,0,0,0,0
GACGGGCATCGAATTT-1_V12D07-335_D1,0,0,4,0,0,4
GCTAAGCCCAGTATGC-1_V12D07-335_D1,0,1,0,0,0,1
GCTATAAGGGCCAGGA-1_V12D07-335_D1,0,1,3,0,0,4
GCGGATTACTTGTTCT-1_V12D07-335_D1,0,1,2,0,0,3
TACAACAGCGCATACA-1_V12D07-335_D1,0,0,1,0,0,1
TCTAACCTAGCCTGCG-1_V12D07-335_D1,0,0,3,0,0,3
TCTACCCGCATCATTT-1_V12D07-335_D1,0,7,0,0,2,9
GTCTTACCACGCCAAG-1_V12D07-335_D1,0,1,2,0,2,5
AATAACGTCGCGCCCA-1_V12D07-335_D1,0,1,0,0,0,1
CGTTTCGGTTATATGC-1_V12D07-335_D1,0,1,0,0,0,1
CTGTCCTGCGCACTAC-1_V12D07-335_D1,0,4,0,0,0,4
GCCCAGCGACACAAAG-1_V12D07-335_D1,6,4,5,1,0,16
TATAGCTATTATCTCT-1_V12D07-335_D1,0,4,0,0,0,4
AAGCTATGGATTGACC-1_V12D07-335_D1,0,9,0,0,0,9
CCGAAACACGACCTCT-1_V12D07-335_D1,0,5,0,1,0,6
ATCAGAAGCTGGTTGC-1_V12D07-335_D1,4,14,1,1,0,20
TGAACCTGAATGTGAG-1_V12D07-335_D1,0,0,4,1,0,5
TCAGAGCATGTCAACG-1_V12D07-335_D1,0,5,0,2,0,7
ATACCCTCCCGGCCAA-1_V12D07-335_D1,0,2,2,0,0,4
GCCACCTTATTCGCGA-1_V12D07-335_D1,0,0,0,0,0,0
CAACGAGCTTATTATG-1_V12D07-335_D1,0,3,1,0,0,4
GATCCAACCTTTAAAC-1_V12D07-335_D1,0,4,0,0,0,4
TTGTGGAGACAGCCGG-1_V12D07-335_D1,0,3,4,0,0,7
AGATAATCACACCTAT-1_V12D07-335_D1,0,0,3,0,0,3
GGTTAGGGATGCTAAT-1_V12D07-335_D1,0,3,2,0,0,5
TCATGAAGCGCTGCAT-1_V12D07-335_D1,0,1,0,2,0,3
CCAGGCGAGATGGTCT-1_V12D07-335_D1,0,0,10,1,0,11
CGACTTGCCGGGAAAT-1_V12D07-335_D1,0,2,1,0,0,3
GTGCCAAACGTTTCGA-1_V12D07-335_D1,0,0,4,0,0,4
TGCTCAAAGGATGCAC-1_V12D07-335_D1,0,1,2,0,0,3
GCCTCAGGTACCGGTC-1_V12D07-335_D1,0,0,3,0,0,3
ACAAGTAATTGTAAGG-1_V12D07-335_D1,0,0,1,0,0,1
TTAGAGTATTGTCGAG-1_V12D07-335_D1,0,2,3,0,0,5
GTCATCCCAAACTCAC-1_V12D07-335_D1,0,0,3,0,0,3
CTCCTAGTAATCGTGA-1_V12D07-335_D1,0,0,2,0,0,2
CCCTCATCACAGAGTA-1_V12D07-335_D1,0,2,5,0,0,7
GGAAACAGAGCTTGGG-1_V12D07-335_D1,0,0,3,0,0,3
ACATCGCAATATTCGG-1_V12D07-335_D1,0,1,2,0,0,3
TTAGCCATAGGGCTCG-1_V12D07-335_D1,0,0,2,2,0,4
CGGATTCTGCCTTATG-1_V12D07-335_D1,0,0,5,0,0,5
TTGTTGGCAATGACTG-1_V12D07-335_D1,0,3,3,0,0,6
GGATCTACCGTTCGTC-1_V12D07-335_D1,0,2,0,0,0,2
GGTGGGATTAGGTCCC-1_V12D07-335_D1,0,0,1,0,0,1
AATAGGCACGACCCTT-1_V12D07-335_D1,0,1,1,0,0,2
GAGGTCCGTTCGCTGT-1_V12D07-335_D1,0,0,0,0,0,0
TGACAACTTAAAGGTG-1_V12D07-335_D1,0,1,1,0,0,2
AGCTAAGCTCCGTCCG-1_V12D07-335_D1,0,2,8,0,0,10
CTAGCCCGGGAGACGA-1_V12D07-335_D1,0,2,0,0,0,2
CCCAGATTCCCGTGAC-1_V12D07-335_D1,0,1,4,0,0,5
GCCCGTTCACACAATT-1_V12D07-335_D1,0,1,6,1,0,8
ACAAACTCCATCAGAG-1_V12D07-335_D1,0,1,3,1,0,5
GGTTCCGTACGACTAA-1_V12D07-335_D1,0,0,1,1,0,2
TTGCGGAAAGCTGCCC-1_V12D07-335_D1,0,1,1,0,0,2
GGAACTCGTGAATACG-1_V12D07-335_D1,0,1,2,2,0,5
GGTTACCGCTCCCTAC-1_V12D07-335_D1,0,1,4,1,0,6
AGCGACTTTGAAGACA-1_V12D07-335_D1,0,1,2,0,0,3
CCGTTTCCTTTCCGTG-1_V12D07-335_D1,0,1,0,0,0,1
TGGATGGCATCTTGGA-1_V12D07-335_D1,0,0,2,0,0,2
CAAGTCGTTGAAATCT-1_V12D07-335_D1,0,1,0,0,0,1
TGCAAACGTACTAGTT-1_V12D07-335_D1,0,1,2,1,0,4
GGCTGTCCTACTGCGG-1_V12D07-335_D1,0,1,2,1,0,4
TACTGCATGATTAAAT-1_V12D07-335_D1,0,0,1,0,0,1
CGGACCTCTGTAGTTA-1_V12D07-335_D1,0,1,3,0,0,4
CCCTAGCTCTAAGGTC-1_V12D07-335_D1,0,0,0,0,0,0
GTAACAGGTTAACGGC-1_V12D07-335_D1,0,0,1,0,0,1
CCCGCAAATAATCATC-1_V12D07-335_D1,0,2,7,1,0,10
AATCCCGCTCAGAGCC-1_V12D07-335_D1,0,0,1,0,0,1
AACGTCATCCGGCTTG-1_V12D07-335_D1,0,2,3,0,0,5
CTCGTGGCACTGAAAG-1_V12D07-335_D1,0,2,2,0,0,4
CTTTATCCGACGCATG-1_V12D07-335_D1,0,0,4,1,0,5
AAATGACTGATCAAAC-1_V12D07-335_D1,0,0,3,0,0,3
TTCGTGCATGTTATAG-1_V12D07-335_D1,0,0,1,0,0,1
ATCAAAGAGCCGTGGT-1_V12D07-335_D1,0,1,1,0,0,2
ATGTCATAATAAACGA-1_V12D07-335_D1,0,1,0,0,0,1
CTTAATCGACTTAGTA-1_V12D07-335_D1,0,0,0,0,0,0
CTAAAGGATGAGATAC-1_V12D07-335_D1,0,1,0,0,0,1
GTGCTATCCAGCTGGA-1_V12D07-335_D1,0,2,2,0,0,4
GACAGAGGTCTTCAGT-1_V12D07-335_D1,0,0,3,0,0,3
TCGATTTACGAAACGA-1_V12D07-335_D1,0,1,1,0,0,2
AGGCTTAAGTTGCACA-1_V12D07-335_D1,0,0,0,0,0,0
TAGGATCTTAACCGCA-1_V12D07-335_D1,0,0,1,0,0,1
GACTTTCGAGCGGTTC-1_V12D07-335_D1,0,0,0,0,0,0
CCCTGGGAGGGATCCT-1_V12D07-335_D1,2,3,0,0,1,6
TAGTAGTTGCCGGACA-1_V12D07-335_D1,0,0,3,1,0,4
GCCCTAAGTGCAGGAT-1_V12D07-335_D1,0,1,0,0,0,1
ACTTGGGCTTTCGCCA-1_V12D07-335_D1,0,0,0,1,0,1
CATGATACGGTGAAAC-1_V12D07-335_D1,0,2,3,0,0,5
TCCTGCAGCCGCCAAT-1_V12D07-335_D1,0,0,2,0,0,2
GTCCGTTAGAGGGCCT-1_V12D07-335_D1,0,1,1,1,1,4
GCTTTATTAAGTTACC-1_V12D07-335_D1,0,1,3,1,0,5
AATCGAGGTCTCAAGG-1_V12D07-335_D1,0,1,4,0,1,6
GTGCTGTTAGAACATA-1_V12D07-335_D1,0,0,2,0,0,2
GGCTTCTCGTGGGTGG-1_V12D07-335_D1,0,3,1,0,0,4
CCTACAGTTGAGGGAG-1_V12D07-335_D1,0,0,0,0,0,0
TATCCCTCGATCTGCA-1_V12D07-335_D1,0,0,3,0,0,3
CCGGTATCTGGCGACT-1_V12D07-335_D1,0,2,0,0,0,2
CTCTAACACCGGCAGC-1_V12D07-335_D1,0,1,0,0,0,1
CTTCATCACCAGGGCT-1_V12D07-335_D1,0,0,3,0,0,3
GGCTGGCAATCCCACG-1_V12D07-335_D1,0,2,5,0,1,8
CAAACCATAAGCGTAT-1_V12D07-335_D1,0,1,2,1,0,4
CATGTGGGCTCATCAC-1_V12D07-335_D1,0,0,5,0,0,5
CCCGTGACAGTGCCTT-1_V12D07-335_D1,0,0,2,0,0,2
GATTATCTTGCATTAT-1_V12D07-335_D1,0,0,1,0,0,1
GAGTCCACCAGGTTTA-1_V12D07-335_D1,0,1,1,0,0,2
TGTACTATCGCTCGTT-1_V12D07-335_D1,0,0,0,0,0,0
TTAGCGAATAGATAGG-1_V12D07-335_D1,0,2,1,0,0,3
ACATACAATCAAGCGG-1_V12D07-335_D1,0,1,0,0,0,1
ATTCGTGTACCCATTC-1_V12D07-335_D1,0,0,2,0,0,2
GCTAGCAACGCACCTA-1_V12D07-335_D1,0,0,2,1,0,3
ACCTCAGCGAGGCGCA-1_V12D07-335_D1,0,1,1,0,0,2
TCCGGGCCACTAACGG-1_V12D07-335_D1,0,2,4,0,0,6
TCCCAATATCGACGAC-1_V12D07-335_D1,0,1,4,0,0,5
GGATTGAAGTAGCCTC-1_V12D07-335_D1,0,1,6,0,0,7
GGCGCACAGTTTACCT-1_V12D07-335_D1,0,5,2,0,0,7
CCCGGCACGTGTCAGG-1_V12D07-335_D1,0,2,0,0,0,2
AGTAAGGGACAGAATC-1_V12D07-335_D1,0,2,0,0,0,2
TTGCGCACAACCACGT-1_V12D07-335_D1,0,4,1,1,0,6
CCTGCTACAACCATAC-1_V12D07-335_D1,0,3,0,0,0,3
CTGGGCTACTGGAGAG-1_V12D07-335_D1,0,0,2,0,2,4
AGCTACGAATGGTGGT-1_V12D07-335_D1,0,0,0,0,0,0
ATTCGTTTATCGTATT-1_V12D07-335_D1,0,4,0,0,0,4
AGTTATTCAGACTGTG-1_V12D07-335_D1,0,6,0,0,0,6
