key,other,oligo,microglia,neuron,astrocyte,n_cells
AGGCAATACGGAGGAC-1_V12D07-335_B1,0,5,3,0,0,8
ATCTATCGATGATCAA-1_V12D07-335_B1,2,3,0,0,0,5
TCGCCGGAGAGTCTTA-1_V12D07-335_B1,0,1,0,0,0,1
TTAGGTGTGACTGGTC-1_V12D07-335_B1,5,1,0,0,0,6
CCCGTGGGTTAATTGA-1_V12D07-335_B1,0,2,1,0,0,3
GGTATCAAGCATAGAA-1_V12D07-335_B1,0,4,1,0,0,5
AATTCCAACTTGGTGA-1_V12D07-335_B1,0,1,0,0,0,1
GCTGGGTCCGCTGTTA-1_V12D07-335_B1,0,1,1,0,0,2
AACATTGGTCAGCCGT-1_V12D07-335_B1,0,1,0,0,0,1
CATCGAATGGATCTCT-1_V12D07-335_B1,2,1,0,0,0,3
CGGGTTGTAGCTTTGG-1_V12D07-335_B1,0,0,0,0,0,0
TCTGTGACTGACCGTT-1_V12D07-335_B1,1,0,0,0,0,1
AGGGTGTGCTACACGC-1_V12D07-335_B1,0,1,0,1,0,2
AATGGCCGCCAATGCG-1_V12D07-335_B1,0,2,2,1,0,5
GGGTCACTGAGTAGTG-1_V12D07-335_B1,0,0,3,3,0,6
GATCTTAGTGAACGTG-1_V12D07-335_B1,1,2,1,0,0,4
CTAATGCGCCCAACAA-1_V12D07-335_B1,0,3,0,0,0,3
GCCACCCATTCCACTT-1_V12D07-335_B1,0,2,1,0,0,3
TACTCACAACGTAGTA-1_V12D07-335_B1,1,1,0,0,0,2
GTTCGGTGTGGATTTA-1_V12D07-335_B1,2,5,0,0,0,7
TCTTTCGGCGGGACAC-1_V12D07-335_B1,2,0,1,0,0,3
GGAGACATTCACGGGC-1_V12D07-335_B1,2,0,0,0,0,2
GGGATTATCTCACAAC-1_V12D07-335_B1,0,0,0,0,0,0
TAGAACGCCAGTAACG-1_V12D07-335_B1,1,2,0,0,0,3
ACGAGTCGCCGGCGTT-1_V12D07-335_B1,0,6,0,0,0,6
TGATGGGACTAAGTCA-1_V12D07-335_B1,0,2,0,0,0,2
TGCGAGAAACGTTACG-1_V12D07-335_B1,1,2,0,0,0,3
TCGCCTCGACCTGTTG-1_V12D07-335_B1,0,1,1,0,0,2
AACTCGATAAACACGT-1_V12D07-335_B1,1,1,0,0,0,2
AGGAAAGCCTCTGATG-1_V12D07-335_B1,0,0,0,0,0,0
GAAGGACTAAATTGAA-1_V12D07-335_B1,0,3,1,0,0,4
GTATCGGGACGAGCTG-1_V12D07-335_B1,1,5,1,0,0,7
CCTGTGCATAGGAGAC-1_V12D07-335_B1,0,0,0,0,0,0
CATACGGGTGCATGAT-1_V12D07-335_B1,0,1,0,0,0,1
CCACTAAACTGAATCG-1_V12D07-335_B1,3,0,1,0,0,4
AAATTGCGGCGGTTCT-1_V12D07-335_B1,1,2,0,0,0,3
AGTCCAGCGGGTACGT-1_V12D07-335_B1,0,1,0,0,0,1
CATTCAGGTCAGTGCG-1_V12D07-335_B1,1,3,2,0,0,6
CTAAAGTCCGAAGCTA-1_V12D07-335_B1,0,1,1,0,0,2
AATCAGACTGCAGGAC-1_V12D07-335_B1,0,0,0,0,0,0
AGTATCCATAATAACG-1_V12D07-335_B1,1,0,0,0,0,1
CTGGCTGCTAACGTAA-1_V12D07-335_B1,0,3,0,0,0,3
GTTCCAAGACAGCGAC-1_V12D07-335_B1,1,5,1,0,0,7
AAGACTAACCCGTTGT-1_V12D07-335_B1,2,2,1,0,0,5
GATTAATCCTGGCTCA-1_V12D07-335_B1,0,4,4,0,0,8
CGCGCAAGGAACTACA-1_V12D07-335_B1,0,3,3,0,0,6
CAGTAGCGAGGTAGTA-1_V12D07-335_B1,1,6,0,0,0,7
ACGGCGGGTTGCCCTG-1_V12D07-335_B1,0,1,1,0,0,2
CTAGGCGGCAGAGAAT-1_V12D07-335_B1,1,2,2,0,0,5
GTGCGCAGCTTGCTCC-1_V12D07-335_B1,1,2,2,0,0,5
TCACTATCGTGCAATC-1_V12D07-335_B1,0,8,0,0,0,8
TATGATTCTGCTTGGT-1_V12D07-335_B1,0,0,0,0,0,0
TAAGATTTAGCGGGAG-1_V12D07-335_B1,2,3,1,0,0,6
TTACGGTGTCACCGAG-1_V12D07-335_B1,0,3,0,0,0,3
CTACACTAGCTTGTTC-1_V12D07-335_B1,1,1,1,0,0,3
TGAGCAGTCGTGAAGT-1_V12D07-335_B1,0,4,1,0,0,5
CGCTGAGGACGTCCAA-1_V12D07-335_B1,0,3,0,0,0,3
GTGTATGACTTTAAAG-1_V12D07-335_B1,0,0,1,0,0,1
CTAAACGGGTGTAATC-1_V12D07-335_B1,0,1,0,0,0,1
TGTACTGTGCCAAAGT-1_V12D07-335_B1,0,2,1,0,0,3
GGCCACAAGCGATGGC-1_V12D07-335_B1,4,3,0,0,0,7
GTCAATTGTACTGAAG-1_V12D07-335_B1,1,0,0,0,0,1
AGGGACAGCACGGCGG-1_V12D07-335_B1,0,0,0,0,0,0
AGCTTATAGAGACCTG-1_V12D07-335_B1,1,3,1,0,0,5
AACTAGCGTATCGCAC-1_V12D07-335_B1,1,0,0,0,0,1
AACTTTAGCTGCTGAG-1_V12D07-335_B1,1,4,0,0,0,5
CCCAAGACAGAGTATG-1_V12D07-335_B1,1,0,0,0,0,1
GGCATCAACGAGCACG-1_V12D07-335_B1,0,2,1,0,0,3
ATGCATTCCGTGATGG-1_V12D07-335_B1,0,1,0,0,0,1
TTATAGATGCACATTA-1_V12D07-335_B1,0,1,0,0,0,1
GAACCATCTGGGAGAC-1_V12D07-335_B1,1,2,0,0,0,3
TGCTATACAAACGGAC-1_V12D07-335_B1,1,2,0,0,0,3
ACTTGCCATATTGTAC-1_V12D07-335_B1,0,1,0,0,0,1
TATTCCGGCAGTCCTA-1_V12D07-335_B1,0,3,0,0,0,3
GACGGACCGCGTTCCT-1_V12D07-335_B1,0,1,0,0,0,1
ATGTGTAGTTTAGTCA-1_V12D07-335_B1,0,0,1,0,0,1
ATACCAGCAAATTGCT-1_V12D07-335_B1,0,0,0,0,0,0
AAGTTTACTAATGGCA-1_V12D07-335_B1,0,3,2,0,0,5
CTCTCGATGTGCGCCT-1_V12D07-335_B1,0,0,0,0,0,0
GATTGACACTCTGCTC-1_V12D07-335_B1,1,2,0,0,0,3
TATCACAGCACGGGCA-1_V12D07-335_B1,0,0,0,0,0,0
ACCGTTCCCGCTCTGA-1_V12D07-335_B1,1,4,0,0,0,5
CCGCCACCACAATCCA-1_V12D07-335_B1,1,0,0,0,0,1
CATTCACTGACAGCTA-1_V12D07-335_B1,0,1,0,0,0,1
CGGCTGCAAGATTAAG-1_V12D07-335_B1,0,1,0,0,0,1
CATGAACCTCTTATCA-1_V12D07-335_B1,1,1,0,0,0,2
TTAATGCGAGGTAACT-1_V12D07-335_B1,1,0,0,0,0,1
AATAAGTCCTCGAGAC-1_V12D07-335_B1,6,1,0,0,0,7
ACCAGCCCGGTCTTTG-1_V12D07-335_B1,0,0,0,0,0,0
CTACGAACTAGGTCGA-1_V12D07-335_B1,0,3,2,0,0,5
ACATCTCAACGCGTAA-1_V12D07-335_B1,2,0,0,0,0,2
CACTACTCAGTTCTGT-1_V12D07-335_B1,0,3,1,0,0,4
CCGACTCGCATAGTCT-1_V12D07-335_B1,2,0,0,0,0,2
CATTTATCGTTCAAGA-1_V12D07-335_B1,0,1,1,0,0,2
CAAACGTGGTCTTGCG-1_V12D07-335_B1,3,1,1,0,0,5
TAGAAACCACTAAGTA-1_V12D07-335_B1,0,1,1,0,0,2
ACTGATTTAGTGATTC-1_V12D07-335_B1,0,1,0,0,0,1
TCGTATTTCGTCCGGA-1_V12D07-335_B1,0,1,0,0,0,1
CGGAAATTTCACATCC-1_V12D07-335_B1,1,0,0,0,0,1
ATCCACGCTAAATGTT-1_V12D07-335_B1,1,1,1,0,0,3
GTTCAATCTATGTCAA-1_V12D07-335_B1,1,0,1,0,0,2
ATAAAGGTCAAGTACG-1_V12D07-335_B1,0,1,3,0,0,4
CAACTCCAACGTTTAG-1_V12D07-335_B1,0,1,0,0,0,1
TAGGAACAGCCTCCAG-1_V12D07-335_B1,1,1,0,0,0,2
ATGGGAACGGAAGCGG-1_V12D07-335_B1,3,3,0,0,0,6
CACACGTTTCAATGGG-1_V12D07-335_B1,0,2,3,0,0,5
GGTGTTCTGTTTCTAC-1_V12D07-335_B1,2,1,2,0,0,5
AGTAACGTTCATCCTG-1_V12D07-335_B1,0,6,0,2,0,8
GTATAGTGGCCCATGT-1_V12D07-335_B1,1,0,0,0,0,1
TCTACACGTTCATGCA-1_V12D07-335_B1,0,0,2,0,0,2
AATCTGGGTAGACCCT-1_V12D07-335_B1,0,1,0,0,0,1
TCGGTTAGCCATGTAG-1_V12D07-335_B1,1,0,0,0,0,1
TGCCATGGCTTATAAG-1_V12D07-335_B1,1,2,2,0,0,5
TAAGTAAATGTGCCGC-1_V12D07-335_B1,0,1,0,0,0,1
GTGTCCGATAAGGCAT-1_V12D07-335_B1,0,1,1,0,0,2
TGGCACGAGCTCGAGT-1_V12D07-335_B1,0,0,1,0,0,1
ACCGGTCTGAGTACGG-1_V12D07-335_B1,0,3,0,0,0,3
GAACTTAGCGCCCGGT-1_V12D07-335_B1,0,3,1,0,0,4
AGTAGCTAGACGCCGA-1_V12D07-335_B1,0,0,1,0,0,1
ATAGGAATCTAAGCTT-1_V12D07-335_B1,1,2,1,0,0,4
CTTCCTGCATATTTAC-1_V12D07-335_B1,0,1,1,0,0,2
CAATATGTAGATTTAC-1_V12D07-335_B1,0,4,0,0,0,4
ACAAGGCCTACCAGCC-1_V12D07-335_B1,0,2,0,0,0,2
TTATAGTCCAAGGTGC-1_V12D07-335_B1,1,3,1,0,0,5
AAACGCCCGAGATCGG-1_V12D07-335_B1,1,3,1,0,0,5
CCTCGTTACGCCTGTT-1_V12D07-335_B1,1,2,0,0,0,3
GAACGGTGTAAAGCAG-1_V12D07-335_B1,2,0,0,0,0,2
ACGCATAAATGACATG-1_V12D07-335_B1,0,0,1,0,0,1
GGTTCGATGCTGAGTT-1_V12D07-335_B1,3,3,1,0,0,7
CTTTGGCAGACAGAGT-1_V12D07-335_B1,0,0,0,0,1,1
TTCGTGGGCTGGAAGC-1_V12D07-335_B1,0,2,0,0,0,2
CAAAGGTTAAATTCAG-1_V12D07-335_B1,0,3,0,0,0,3
GTTTGGCGTCAGGCAC-1_V12D07-335_B1,0,3,0,0,0,3
GCTTTCTATCTCAACT-1_V12D07-335_B1,1,3,1,0,0,5
TGCATCTCCGGATCTT-1_V12D07-335_B1,1,0,0,0,0,1
CTGAAACGGCCCTCAG-1_V12D07-335_B1,0,3,3,0,0,6
TAGCAGTAAATACGCG-1_V12D07-335_B1,0,2,2,3,0,7
CGGGCTACTTAAATTG-1_V12D07-335_B1,0,5,3,1,0,9
ATTATGCTCAGTATTG-1_V12D07-335_B1,0,6,9,2,0,17
TGATGCTCACGTAGTC-1_V12D07-335_B1,0,15,0,0,0,15
GTCTAAGATGCCCAGC-1_V12D07-335_B1,0,6,10,0,0,16
AACCCGATAGGGCTTC-1_V12D07-335_B1,0,13,0,0,0,13
CGCTATCGTGGCTTTA-1_V12D07-335_B1,0,6,1,0,0,7
CGTCTCTCGCCGAGGC-1_V12D07-335_B1,0,3,6,0,0,9
AGTGGGAGTATACACG-1_V12D07-335_B1,2,1,0,0,0,3
GGTCTTGGTGTTAACT-1_V12D07-335_B1,0,1,0,0,0,1
GGCTGGCAGCTTTATG-1_V12D07-335_B1,0,1,1,0,0,2
CGCCAATTATTGCGTT-1_V12D07-335_B1,0,0,0,0,0,0
GGTAACCGGCAAAGGT-1_V12D07-335_B1,1,2,1,0,0,4
TGGGACCATTGGGAGT-1_V12D07-335_B1,0,2,0,0,0,2
CTGCAGGTGCTCGGCC-1_V12D07-335_B1,0,4,0,0,0,4
CCGGTGCGAGTGATAG-1_V12D07-335_B1,1,1,0,0,0,2
GGGTACACTCTGGAGG-1_V12D07-335_B1,0,2,0,0,0,2
TAGCCAGAGGGTCCGG-1_V12D07-335_B1,0,2,3,0,0,5
CTTGTGAGGACAGCGG-1_V12D07-335_B1,0,2,0,0,0,2
GAAGGGCATAACCATG-1_V12D07-335_B1,1,4,0,0,0,5
CAACATGGCCTGATAA-1_V12D07-335_B1,0,4,2,0,0,6
CAATTTGACCGGGAAG-1_V12D07-335_B1,0,1,2,0,0,3
TCTGACTGTAATGGTT-1_V12D07-335_B1,0,3,1,0,0,4
TTCATAGCCTTGTAAC-1_V12D07-335_B1,2,2,1,0,0,5
TGGAAACGGAGTGAAC-1_V12D07-335_B1,0,0,0,0,0,0
ATCGCACGATTGTTCA-1_V12D07-335_B1,1,3,0,0,0,4
CGCCACCCGCATTAAC-1_V12D07-335_B1,1,3,0,0,0,4
TGGACCACGGCGTTGA-1_V12D07-335_B1,1,2,0,0,0,3
GTATATGTTACGGCGG-1_V12D07-335_B1,2,1,0,0,0,3
GTATTCTTACCGTGCT-1_V12D07-335_B1,0,4,0,0,0,4
TTCAGAGTAACCTGAC-1_V12D07-335_B1,1,5,0,0,0,6
GCGGTAACCCAAATGA-1_V12D07-335_B1,1,1,0,0,0,2
CTACGTGTTGCCACCA-1_V12D07-335_B1,0,3,0,0,0,3
CTAGATAAACTCCTCG-1_V12D07-335_B1,0,3,0,0,0,3
TCCATTAGTTGGATAG-1_V12D07-335_B1,0,1,1,0,0,2
CTGGCTCCTGCGGGAT-1_V12D07-335_B1,2,5,0,0,0,7
CAGTCTCTCGGCTAAT-1_V12D07-335_B1,0,2,1,0,0,3
GTATGACGTGGGAAAC-1_V12D07-335_B1,1,2,0,0,0,3
AGTCACTCCGCCTCAT-1_V12D07-335_B1,1,5,0,0,0,6
GCAGCGGTGGGCATTA-1_V12D07-335_B1,1,0,1,0,0,2
TATGGAGTTTCTCGTT-1_V12D07-335_B1,1,1,0,0,0,2
ACTCAACGAATGTATT-1_V12D07-335_B1,1,2,1,0,0,4
AACACGCGGCCGCGAA-1_V12D07-335_B1,1,2,0,0,0,3
CGATATTAGCCGCAGG-1_V12D07-335_B1,0,5,1,0,0,6
AGCGTCTGAACCCGCA-1_V12D07-335_B1,2,2,0,0,0,4
GATGTCCGGATCACAT-1_V12D07-335_B1,0,5,0,0,0,5
GGTCACGTTAGATTCA-1_V12D07-335_B1,0,2,0,0,0,2
TTAAGGATACGGAGGT-1_V12D07-335_B1,0,1,0,0,0,1
GTGCGGGACCATCGGC-1_V12D07-335_B1,1,0,0,0,0,1
CCATCTTGTTCACAAT-1_V12D07-335_B1,0,0,1,0,0,1
TCCGAGAAGGCTAAGC-1_V12D07-335_B1,0,0,5,0,0,5
TGGCGGTGTGCGATTG-1_V12D07-335_B1,1,3,0,0,0,4
ATCCTGCTGCAGATAG-1_V12D07-335_B1,0,0,0,0,0,0
TTATGCGTCCCGGTCC-1_V12D07-335_B1,1,1,0,0,0,2
CATAATGAGCGGGCGA-1_V12D07-335_B1,1,1,0,0,0,2
AGACATAGATCCTTCC-1_V12D07-335_B1,1,4,1,0,0,6
GGTGAAACCGGGAATG-1_V12D07-335_B1,0,2,1,0,0,3
AACTGGTGTGGGCCTT-1_V12D07-335_B1,0,2,2,0,0,4
GTAGCGCTGTTGTAGT-1_V12D07-335_B1,1,3,1,0,0,5
TTGTTTGTGTAAATTC-1_V12D07-335_B1,1,1,2,0,0,4
GGATCAAAGGACGAGG-1_V12D07-335_B1,0,0,1,1,0,2
CGTAGCGCCGACGTTG-1_V12D07-335_B1,0,2,1,0,0,3
CAAGTGAACTTTGGTT-1_V12D07-335_B1,1,7,1,0,0,9
GTAGACAACCGATGAA-1_V12D07-335_B1,1,0,0,0,0,1
CAATGGTCGGCCTGGG-1_V12D07-335_B1,1,2,0,0,0,3
ACAGATTAGGTTAGTG-1_V12D07-335_B1,0,4,0,0,0,4
GTTATCACCTTCTGAA-1_V12D07-335_B1,1,1,0,0,0,2
TGGTATCGGTCTGTAT-1_V12D07-335_B1,0,4,1,0,0,5
GGAATAACCTCAAGAA-1_V12D07-335_B1,0,3,0,0,0,3
ATTATCTCGACAGATC-1_V12D07-335_B1,0,1,1,0,0,2
CCGAGGGATGTTAGGC-1_V12D07-335_B1,1,3,1,0,0,5
TGAGATCAAATACTCA-1_V12D07-335_B1,2,2,2,0,0,6
AAACGAAGAACATACC-1_V12D07-335_B1,2,2,1,0,0,5
CTGGTCCTAACTTGGC-1_V12D07-335_B1,2,5,1,0,0,8
TGCACGAGTCGGCAGC-1_V12D07-335_B1,1,3,0,0,0,4
ATAGTCTTTGACGTGC-1_V12D07-335_B1,0,1,0,0,0,1
TGGAGCTAAAGTTCCC-1_V12D07-335_B1,1,2,0,0,0,3
GGGTGGTCCAGCCTGT-1_V12D07-335_B1,0,4,0,0,0,4
CATGCATGGAGACCCT-1_V12D07-335_B1,1,2,0,0,0,3
ACACGGCACTATGCAT-1_V12D07-335_B1,2,4,1,0,0,7
CCCTGGTATGGGCGGC-1_V12D07-335_B1,0,1,1,0,0,2
GGAGGATTGAAAGGAG-1_V12D07-335_B1,1,4,0,0,0,5
CCGCTGGTGCCATTCA-1_V12D07-335_B1,0,1,1,0,0,2
GTTAGAGTGTGCCGCT-1_V12D07-335_B1,1,2,0,0,0,3
TCGGAATGACCATCAA-1_V12D07-335_B1,0,2,1,0,0,3
TTCAATTAGCCATAAT-1_V12D07-335_B1,1,1,0,0,0,2
GATGTGTTGTCACAAG-1_V12D07-335_B1,0,3,0,0,0,3
TCTTTCTCTTAAGGAG-1_V12D07-335_B1,1,2,2,0,0,5
ACCCTTTAGTTCTCCA-1_V12D07-335_B1,0,2,1,0,0,3
ACCACAACTCAGAACA-1_V12D07-335_B1,0,3,1,0,0,4
TATGATAAATCTAACG-1_V12D07-335_B1,1,0,0,0,0,1
GATCCTCTTGCGCTTA-1_V12D07-335_B1,1,0,1,0,0,2
TTCTACCTTTATGTTG-1_V12D07-335_B1,1,3,0,0,0,4
GAAATACCTGCTGGCT-1_V12D07-335_B1,3,0,0,0,0,3
ATTCTGAGTATGAACT-1_V12D07-335_B1,0,1,5,0,0,6
GGATTAAGCTAAGGTC-1_V12D07-335_B1,1,2,0,0,0,3
AGTACGTGGCCTGTCT-1_V12D07-335_B1,0,0,1,0,0,1
TCAGGGTGCACGAAAC-1_V12D07-335_B1,2,2,2,0,0,6
AAATTTACCGAAATCC-1_V12D07-335_B1,0,2,3,0,0,5
TTGAGGCATTTAACTC-1_V12D07-335_B1,0,4,1,0,0,5
AACCAGTATCACTCTT-1_V12D07-335_B1,1,1,0,0,0,2
CACCGGAGATATCTCC-1_V12D07-335_B1,0,2,2,0,0,4
GACTGGGCGCCGCAAC-1_V12D07-335_B1,0,3,1,0,0,4
CACGTCTATGATGTGG-1_V12D07-335_B1,2,1,0,0,0,3
TTAAGACGAACGAACC-1_V12D07-335_B1,1,1,0,0,0,2
TGACCAGCTTCAAAGT-1_V12D07-335_B1,1,3,0,0,0,4
AGAGTTAGAGACCGAT-1_V12D07-335_B1,1,0,0,0,0,1
TTCGGACTGATGCCTT-1_V12D07-335_B1,1,1,0,0,0,2
CTCGAATGGAACGTAT-1_V12D07-335_B1,3,3,0,0,0,6
GGACGGCTTGCGCAAC-1_V12D07-335_B1,0,1,0,0,0,1
CTAAGTACAGGGCTAC-1_V12D07-335_B1,1,0,0,0,0,1
ACAAATTCAGATCTGA-1_V12D07-335_B1,0,4,0,0,0,4
CATGGAAATGGGACCA-1_V12D07-335_B1,0,0,0,0,0,0
GGTGGACCACGTGTTA-1_V12D07-335_B1,0,1,2,0,0,3
CACGACGTAATAGTAA-1_V12D07-335_B1,0,3,0,0,0,3
CGGGTTCGGCACGTAT-1_V12D07-335_B1,0,0,1,0,0,1
CTGGGCTATCCTTTGG-1_V12D07-335_B1,0,1,1,0,5,7
GTATTAGGGTTCGCGT-1_V12D07-335_B1,0,1,2,0,0,3
TCATTCGTATAATTTG-1_V12D07-335_B1,0,2,0,0,2,4
AATAGCAAGCCTCCTG-1_V12D07-335_B1,0,0,4,0,0,4
CATCTACCCGAGAACG-1_V12D07-335_B1,0,1,0,0,1,2
GCTTCAGTGGGATTAC-1_V12D07-335_B1,1,1,0,0,0,2
TCTGTGATGGAGGTTG-1_V12D07-335_B1,1,2,1,0,0,4
ATCCACTTTCAGACTA-1_V12D07-335_B1,0,1,0,0,0,1
ATGGTTACGAAACATG-1_V12D07-335_B1,1,5,1,0,0,7
GGCCCAATCTAGAGGG-1_V12D07-335_B1,0,2,0,0,0,2
GATGGTGAAATAACCC-1_V12D07-335_B1,1,1,2,0,0,4
AGAGGGACAATTGTCC-1_V12D07-335_B1,0,1,2,1,0,4
CGCGTACATTCTGGAA-1_V12D07-335_B1,0,9,2,0,0,11
CAAGAAACCCTAAACT-1_V12D07-335_B1,0,11,2,1,0,14
TTGGTGCGGTGTTGAA-1_V12D07-335_B1,0,12,2,0,0,14
GGTTCCCTAGTGTCTC-1_V12D07-335_B1,0,12,0,0,0,12
CGATAACCAATTTGAG-1_V12D07-335_B1,0,9,1,0,0,10
GCCCACTGGTCCACAA-1_V12D07-335_B1,0,11,0,0,0,11
GAGGGCCGGCAGAGTC-1_V12D07-335_B1,0,10,1,0,0,11
CGACACGGATGCCCAC-1_V12D07-335_B1,0,13,3,0,0,16
CTGTCTGTGGCTGGCT-1_V12D07-335_B1,0,4,2,0,0,6
ATATTATCCCGTATTT-1_V12D07-335_B1,1,2,1,0,0,4
GCGCTGGCGGAAAGTC-1_V12D07-335_B1,0,1,1,0,0,2
ATCTAACGTCCCTATG-1_V12D07-335_B1,0,2,0,0,0,2
GTCAGACAGCGTTGGA-1_V12D07-335_B1,3,6,0,0,0,9
GCCAGGCTTAGTGGTA-1_V12D07-335_B1,2,5,1,0,0,8
ATTCAAAGTACCTGTT-1_V12D07-335_B1,0,5,2,0,1,8
TGGACGTAGGCGAATC-1_V12D07-335_B1,0,3,1,0,0,4
ACACATTGACGCAACA-1_V12D07-335_B1,0,0,1,0,1,2
GATATCAGTATGTATC-1_V12D07-335_B1,0,1,0,0,0,1
TGGGCCTTGCCTGCAT-1_V12D07-335_B1,1,3,3,0,0,7
CAAAGTCAGGTTAGCT-1_V12D07-335_B1,1,3,0,0,0,4
GGATCCCTACCAGCTA-1_V12D07-335_B1,0,2,1,0,0,3
ATCGTCCAATCGAGTC-1_V12D07-335_B1,1,1,0,0,0,2
ACATGGCTCAATTTAG-1_V12D07-335_B1,1,1,1,0,0,3
AGGCCCAGTGACTGGT-1_V12D07-335_B1,0,2,1,0,0,3
GCTTCCAGCTTAGATT-1_V12D07-335_B1,0,2,1,0,0,3
TGCTTGAAACCATGCA-1_V12D07-335_B1,1,2,0,0,0,3
CAATATTGGACTAGTG-1_V12D07-335_B1,1,4,0,0,0,5
CGTGCTGGCCTAGTCG-1_V12D07-335_B1,1,1,0,0,0,2
CCTGCGATAGAACTGT-1_V12D07-335_B1,0,2,0,0,0,2
GGGTAATGCTGTGTTT-1_V12D07-335_B1,0,0,1,0,0,1
AACGCGAACGGCAACA-1_V12D07-335_B1,0,2,1,0,0,3
TGTCGGCATGGTGGAA-1_V12D07-335_B1,0,2,0,0,0,2
AGCGTACGAGAGCTAG-1_V12D07-335_B1,0,2,0,0,0,2
ATACTCTCGCCACTCT-1_V12D07-335_B1,0,5,1,0,0,6
AATCCATGCAAGGGTG-1_V12D07-335_B1,0,0,0,0,0,0
TTAAACAGAGTCCCGC-1_V12D07-335_B1,3,0,0,0,0,3
CCACAGCTGAAATCAT-1_V12D07-335_B1,1,2,3,0,0,6
CGGTTCCGGCTTCTTG-1_V12D07-335_B1,1,2,0,0,0,3
GACGTGAGACTCCATG-1_V12D07-335_B1,0,8,0,0,0,8
TCGTTGGCTCGTCAAT-1_V12D07-335_B1,0,5,0,0,0,5
GGTGAACGGGCTAGCC-1_V12D07-335_B1,1,3,0,0,0,4
GCACTGTGCAAATGTA-1_V12D07-335_B1,1,1,2,0,0,4
ACGAGAACCCATCACG-1_V12D07-335_B1,2,0,2,0,0,4
CCAGCTACGCCTCATA-1_V12D07-335_B1,1,3,0,0,0,4
TCCCGGTCAGGAATTT-1_V12D07-335_B1,1,0,1,0,0,2
TCGCATTCAATGACTT-1_V12D07-335_B1,5,2,1,0,0,8
CTGGTTCAACGCATCA-1_V12D07-335_B1,1,4,1,0,0,6
GGTGATTTCATCTTGT-1_V12D07-335_B1,0,6,0,0,0,6
CACCCTTTCCTCGCTC-1_V12D07-335_B1,0,2,0,0,0,2
CAACTTGTAGTGGGCA-1_V12D07-335_B1,0,3,0,0,0,3
AATATCAAGGTCGGAT-1_V12D07-335_B1,0,1,1,0,0,2
ACTCAGACCTGCTTCT-1_V12D07-335_B1,0,0,0,0,0,0
TTGGAGTCTCCCTTCT-1_V12D07-335_B1,0,2,1,0,0,3
GGATACTCATGAATTG-1_V12D07-335_B1,0,3,0,0,0,3
TGGGCACAAACAGAAC-1_V12D07-335_B1,1,3,0,0,0,4
GAGCCACGGTAGTAGG-1_V12D07-335_B1,0,3,0,0,0,3
TCGATAGGCTAGTCGC-1_V12D07-335_B1,1,0,0,0,0,1
TAACCGCCCGCAGTGC-1_V12D07-335_B1,0,3,0,0,0,3
GCCTATTTGCTACACA-1_V12D07-335_B1,1,3,1,0,0,5
TTGACGATTCAGCACG-1_V12D07-335_B1,0,3,0,0,0,3
TTAAACCGGTAGCGAC-1_V12D07-335_B1,0,3,0,0,0,3
ACCGAAAGGGCCCTGC-1_V12D07-335_B1,0,1,0,0,0,1
ACGTTCCGCGCTCCGT-1_V12D07-335_B1,2,3,0,0,0,5
ATACCAGGCTAATAGA-1_V12D07-335_B1,0,3,1,0,0,4
CGGCTTTGTATGATAA-1_V12D07-335_B1,3,1,0,0,0,4
CTTGACCCGAAAGATA-1_V12D07-335_B1,1,3,1,0,0,5
CGCAGAAACATTTGCG-1_V12D07-335_B1,0,4,0,0,0,4
GACCCGTCGCCGGCTA-1_V12D07-335_B1,0,1,1,0,0,2
AATCGGGACACTACGA-1_V12D07-335_B1,1,1,1,0,0,3
GTCACAAAGTTTCCAA-1_V12D07-335_B1,1,2,1,0,0,4
TATATTCGCGTCGATA-1_V12D07-335_B1,1,1,0,0,0,2
CCTCCCGACAATCCCT-1_V12D07-335_B1,0,1,0,0,0,1
CGACATGCGATCTTCT-1_V12D07-335_B1,1,1,0,0,0,2
AACACGACTGTACTGA-1_V12D07-335_B1,2,1,1,0,0,4
CCCAACCACACTAACA-1_V12D07-335_B1,0,3,0,0,0,3
CACCGCCGACCAGCGA-1_V12D07-335_B1,0,4,0,0,0,4
TGGTATCGCATCCCAA-1_V12D07-335_B1,0,2,1,0,0,3
CAGAGTGATTTAACGT-1_V12D07-335_B1,1,3,0,0,0,4
AACCCTGGTGGAACCA-1_V12D07-335_B1,1,1,0,0,0,2
GTCAGTTGTGCTCGTT-1_V12D07-335_B1,2,1,1,0,0,4
ATTGACGTAACTCGGT-1_V12D07-335_B1,0,3,1,0,0,4
GATGTCGGTCAACTGC-1_V12D07-335_B1,1,4,0,0,0,5
AGGGCAGCGGCGTGGT-1_V12D07-335_B1,1,0,0,0,0,1
ACATCGTTAACCTAGT-1_V12D07-335_B1,0,0,1,0,1,2
TCCATTGTGACCTCGT-1_V12D07-335_B1,0,3,1,0,2,6
TGTTTAATACTTCATC-1_V12D07-335_B1,2,3,0,0,0,5
TTGCTGGCCGGGCTTC-1_V12D07-335_B1,0,2,0,0,0,2
CATATTATTTGCCCTA-1_V12D07-335_B1,0,2,0,0,0,2
CTGCCTAGCCACCAAG-1_V12D07-335_B1,0,2,0,0,0,2
ACGAGATATTTGCTTA-1_V12D07-335_B1,0,4,0,0,0,4
GACTACAATTGCTCGT-1_V12D07-335_B1,1,0,1,0,0,2
AACGTGATGAAGGACA-1_V12D07-335_B1,0,6,0,0,0,6
ACTCTCTTATACACGA-1_V12D07-335_B1,1,2,0,0,0,3
CGCATCATGGCTTCAG-1_V12D07-335_B1,0,1,2,0,0,3
CGGCTCTTCGTCGAAC-1_V12D07-335_B1,0,1,1,0,0,2
ATTCTTCGTACTTATG-1_V12D07-335_B1,0,2,0,0,0,2
AGTGAGGGTTTCTGAC-1_V12D07-335_B1,0,2,2,0,0,4
GCCAGGCGTTCGCATG-1_V12D07-335_B1,0,5,1,0,0,6
GACTAACACAGCACCT-1_V12D07-335_B1,0,3,0,0,0,3
CAATGGAATCTACATA-1_V12D07-335_B1,0,3,2,0,0,5
GTGGTCAGCGAAGTAT-1_V12D07-335_B1,0,0,0,0,0,0
ATGGCTGGAAATGGCC-1_V12D07-335_B1,1,1,2,0,0,4
ATCAGGTCGCCATTGC-1_V12D07-335_B1,2,1,1,0,0,4
TATCACCATGTAAAGT-1_V12D07-335_B1,0,5,0,0,0,5
AGCGCTTATGGGCAAG-1_V12D07-335_B1,0,1,0,0,0,1
AAGCGGCGTCATGGGT-1_V12D07-335_B1,1,4,0,0,0,5
ACTAATACGTCAGGCG-1_V12D07-335_B1,0,2,0,0,0,2
GGCTGAGCATCGTAAG-1_V12D07-335_B1,0,1,1,0,0,2
CGGTTGGGTTCAAGTT-1_V12D07-335_B1,0,3,1,0,0,4
GACTGATTGGTCACAA-1_V12D07-335_B1,0,2,0,0,0,2
AGACGGGCCGATTTAA-1_V12D07-335_B1,0,1,1,0,0,2
ACCAGTGCCCGGTCAA-1_V12D07-335_B1,0,1,0,0,0,1
GTCCTTTAATGACTTC-1_V12D07-335_B1,2,2,0,0,0,4
CCTACAAGTCCGGAAT-1_V12D07-335_B1,0,3,0,0,0,3
GCCTGCTACACTGAGA-1_V12D07-335_B1,0,5,1,0,0,6
GACTCGGTCGGCGGAT-1_V12D07-335_B1,0,1,0,0,0,1
CTAGACATATATGTAG-1_V12D07-335_B1,0,2,0,0,0,2
TCGCCCAACTGACTCC-1_V12D07-335_B1,0,5,0,0,0,5
AAACTAACGTGGCGAC-1_V12D07-335_B1,1,3,0,0,0,4
AACTGAGGTCAGCGTC-1_V12D07-335_B1,1,2,0,0,0,3
ACAATGATTCTTCTAC-1_V12D07-335_B1,0,2,1,0,0,3
ATAAGTACCCGATTGT-1_V12D07-335_B1,0,0,1,0,0,1
ATTGGGAGTTCTGTAA-1_V12D07-335_B1,0,1,3,0,2,6
CGAACATAGTCAGAAA-1_V12D07-335_B1,0,6,0,0,0,6
TAGCTCAGATCCTAGT-1_V12D07-335_B1,0,2,0,0,0,2
GTGTCGTATTCACCTT-1_V12D07-335_B1,0,3,0,0,0,3
CTCACCGATCCAAACT-1_V12D07-335_B1,0,2,0,0,0,2
ATATGTGCACAAACCA-1_V12D07-335_B1,0,0,3,0,0,3
CAGTCCAACGCCTTCT-1_V12D07-335_B1,0,3,4,0,0,7
TCGTCCGGGTACACTC-1_V12D07-335_B1,0,6,2,0,0,8
GCAGAAACGTAATCCA-1_V12D07-335_B1,0,8,3,0,0,11
TTCGAGCCGGCGCTAC-1_V12D07-335_B1,0,9,1,0,0,10
GGAAGATAAGACTGTA-1_V12D07-335_B1,0,10,1,0,0,11
ATAAGCAAACACCGAG-1_V12D07-335_B1,0,14,1,0,0,15
GCATAAATTGAACGCC-1_V12D07-335_B1,0,10,1,0,0,11
CGCCGGTGTCGCAGTA-1_V12D07-335_B1,0,6,1,0,0,7
GACCTGGTCTGGGCGT-1_V12D07-335_B1,0,4,0,0,0,4
AGCCGCTTGATTAGCG-1_V12D07-335_B1,1,1,0,0,0,2
CCCGGCTAGGTGAGAA-1_V12D07-335_B1,2,2,0,0,0,4
CGAGCCGAGCACTCGA-1_V12D07-335_B1,1,2,1,0,0,4
TAGTGCTTGAATCCTT-1_V12D07-335_B1,1,1,3,0,0,5
CAACCGCACCTAGACA-1_V12D07-335_B1,3,1,1,0,0,5
ACCACTGTTCAAGAAG-1_V12D07-335_B1,1,4,0,0,0,5
AGATGCTATAACGAGC-1_V12D07-335_B1,0,1,2,0,0,3
AATTACTCGTACGCTC-1_V12D07-335_B1,1,3,2,0,0,6
CGTCAATCTTTAACAT-1_V12D07-335_B1,0,1,0,0,0,1
CCAAAGCAGTTGGTTG-1_V12D07-335_B1,0,3,0,0,0,3
CCATATTGGATCATGA-1_V12D07-335_B1,0,0,1,0,0,1
CGTACCGAAAGTCTAG-1_V12D07-335_B1,0,0,1,0,0,1
CTCGAGATCCAAAGCA-1_V12D07-335_B1,1,7,0,0,0,8
TGGATAGAGTAACAGA-1_V12D07-335_B1,2,1,1,0,0,4
TCACAGATCCTCAAAC-1_V12D07-335_B1,0,2,1,0,0,3
AGAGCTACGAAAGCAT-1_V12D07-335_B1,0,2,1,0,0,3
TGCGTGATTGGGTGTC-1_V12D07-335_B1,1,0,1,0,0,2
CACATGTTTGGACATG-1_V12D07-335_B1,1,3,1,0,0,5
TTCGCATCCGGAAGCA-1_V12D07-335_B1,0,2,0,0,0,2
CCCTAGTGTCAGGTGT-1_V12D07-335_B1,0,6,3,0,0,9
TTACCGCCTTAGGGAA-1_V12D07-335_B1,0,3,0,0,0,3
CCAGTCCATTATTCGA-1_V12D07-335_B1,0,0,0,0,0,0
CGTAAACGCTTGAGTG-1_V12D07-335_B1,1,4,0,0,0,5
ATTCCTTCCAGGCGGT-1_V12D07-335_B1,1,6,1,0,0,8
TTCCTTTCTGTGTTGC-1_V12D07-335_B1,0,3,1,0,0,4
AGTTGACATCGGCTGG-1_V12D07-335_B1,1,3,0,0,0,4
AACTCGATGGCGCAGT-1_V12D07-335_B1,0,6,0,0,0,6
GATAAGGCAGATGCAA-1_V12D07-335_B1,0,1,1,0,0,2
GGCTGGCTAGCTTAAA-1_V12D07-335_B1,1,1,2,0,0,4
CCTCATGCAGCTACGA-1_V12D07-335_B1,1,2,1,0,0,4
GACGCCTGTTGCAGGG-1_V12D07-335_B1,0,3,0,0,0,3
TAATTAGATGGATATG-1_V12D07-335_B1,1,3,0,0,0,4
GAGGGCATCGCGTATC-1_V12D07-335_B1,0,3,0,0,0,3
CTTGTGAGTCTTTGAC-1_V12D07-335_B1,2,2,1,0,0,5
TCAACACATTGGGTAA-1_V12D07-335_B1,0,0,0,0,0,0
ACTGTATACGCGAGCA-1_V12D07-335_B1,0,2,0,0,0,2
GTGAAACGTGCTCCAC-1_V12D07-335_B1,0,1,3,0,0,4
CGAGTGCTATAGTTCG-1_V12D07-335_B1,0,1,1,0,0,2
GTACTGCATGAAGCGT-1_V12D07-335_B1,0,0,1,0,0,1
GTAACTTGCGGCAGTC-1_V12D07-335_B1,0,4,0,0,0,4
GAATCGCCGGACACGG-1_V12D07-335_B1,2,2,2,0,0,6
GGGAGTAATGGCTGGC-1_V12D07-335_B1,1,2,3,0,0,6
CATGAACCGACATTTG-1_V12D07-335_B1,2,3,1,0,0,6
TCTGTCATACAAGAGC-1_V12D07-335_B1,1,1,3,0,0,5
GTCGTCAATTATAAGG-1_V12D07-335_B1,0,3,0,0,0,3
TAAAGAGCCCGAAACC-1_V12D07-335_B1,1,0,0,0,0,1
GTACTGAGGTCGTAAC-1_V12D07-335_B1,3,3,0,0,0,6
AAAGACCCAAGTCGCG-1_V12D07-335_B1,0,2,3,0,0,5
CGTCAGTGCGCACAAG-1_V12D07-335_B1,0,4,0,0,0,4
TGTATCCTTATTCCAT-1_V12D07-335_B1,2,3,0,0,0,5
ATTCTCGTCTCTTTAG-1_V12D07-335_B1,0,5,0,0,0,5
AAAGTCACTGATGTAA-1_V12D07-335_B1,0,3,1,0,0,4
TGTCTACAGTTTCTGT-1_V12D07-335_B1,0,3,0,0,0,3
TTAACGTCGCAAGACC-1_V12D07-335_B1,0,2,0,0,0,2
CTATGTCTATTGAAAC-1_V12D07-335_B1,2,3,0,0,0,5
TCGGGTGAAACTGCTA-1_V12D07-335_B1,0,0,0,0,0,0
TGTCCCGACATAGCAC-1_V12D07-335_B1,0,2,1,0,0,3
ACAGCATAGAGCCAGT-1_V12D07-335_B1,0,0,1,0,0,1
ATATTCCCACAGGTCA-1_V12D07-335_B1,0,2,0,0,0,2
TTGGATCGACTTCTGG-1_V12D07-335_B1,0,3,1,0,0,4
CACCATCGGAGGAGAC-1_V12D07-335_B1,1,4,0,0,0,5
TCGTTCGTTATTATGT-1_V12D07-335_B1,1,1,1,0,0,3
CTTAACTTCGAAGTAC-1_V12D07-335_B1,0,0,0,0,0,0
GCACAAGTGTCGGAAG-1_V12D07-335_B1,2,1,0,0,0,3
TACCAGCTAGGTTTAA-1_V12D07-335_B1,1,0,1,0,0,2
ACGTACAGATTTCTCT-1_V12D07-335_B1,1,1,0,0,0,2
AATTTGGTTCCAAAGA-1_V12D07-335_B1,0,3,0,0,0,3
GTAAGGATTTGTCGGA-1_V12D07-335_B1,0,5,1,0,0,6
CATCATCTACCCGGAC-1_V12D07-335_B1,0,4,0,0,0,4
ACGATGGATCCGATGC-1_V12D07-335_B1,1,2,2,0,0,5
CACTCAGCTCTTGAGG-1_V12D07-335_B1,0,1,0,0,0,1
TAGATCCGAAGTCGCA-1_V12D07-335_B1,1,0,0,0,0,1
TGAAACTTATGCAAGC-1_V12D07-335_B1,0,3,1,0,2,6
GCGATTCTGGAAGCAG-1_V12D07-335_B1,0,3,0,0,1,4
CAAACTATTGAGCTTC-1_V12D07-335_B1,2,0,0,0,0,2
TAGAATTAAGGGCAAC-1_V12D07-335_B1,2,3,0,0,0,5
CGAAACATAGATGGCA-1_V12D07-335_B1,0,2,0,0,0,2
GATGGTGCCCTAGGCA-1_V12D07-335_B1,0,0,2,0,0,2
CCCGCAGGGCCCAAAG-1_V12D07-335_B1,0,0,1,0,0,1
ACAGCGCACCCGCAGC-1_V12D07-335_B1,1,0,0,0,0,1
GGTAAATGTGCGTTAC-1_V12D07-335_B1,2,2,0,0,0,4
GTCCTTCTAGTGGGTT-1_V12D07-335_B1,0,2,0,0,0,2
GGAAGCTCGCTTACAG-1_V12D07-335_B1,0,1,0,0,0,1
CACCGATACACCGAGC-1_V12D07-335_B1,0,0,2,0,0,2
CAGCCGGGCCCTCTAT-1_V12D07-335_B1,2,1,0,0,0,3
CGGAGCTTATAACACC-1_V12D07-335_B1,0,1,0,0,0,1
ATTACAACTACCGGCC-1_V12D07-335_B1,1,0,1,0,0,2
TCCTCTGGCCCATTAG-1_V12D07-335_B1,0,2,1,0,0,3
CGGCACCGTTAGCGCC-1_V12D07-335_B1,0,1,1,0,0,2
TCGGTCCCTGACTCCA-1_V12D07-335_B1,0,0,3,0,0,3
TGGTTGGAGGATCCTG-1_V12D07-335_B1,1,3,1,0,0,5
CTGCGGTAGTCACGTG-1_V12D07-335_B1,0,2,0,0,0,2
GTGCCTCAGTGTACGG-1_V12D07-335_B1,0,2,1,0,0,3
ATCGTTCACTTTCGCC-1_V12D07-335_B1,0,3,1,0,0,4
ACTTACCGGGCGCGCA-1_V12D07-335_B1,0,2,0,0,0,2
CTAGACTGCATTTCGT-1_V12D07-335_B1,0,3,0,0,0,3
TTGCCGGTGATCCCTC-1_V12D07-335_B1,0,1,0,0,0,1
CTGTCACGCCAGGCGC-1_V12D07-335_B1,1,3,0,0,0,4
CGGTATAGGTATTAGC-1_V12D07-335_B1,1,2,1,0,0,4
CCAACGCTTGCCAGGG-1_V12D07-335_B1,0,1,0,0,0,1
CGTTGAGTAATTGCGT-1_V12D07-335_B1,0,2,0,0,0,2
TGTATTTACCTAATGC-1_V12D07-335_B1,0,4,0,0,0,4
TAAATGCCGTCTCATG-1_V12D07-335_B1,1,2,0,0,0,3
CGGTTTATGAAGGAAC-1_V12D07-335_B1,1,3,0,0,0,4
GCAAGATGTGTTCGCG-1_V12D07-335_B1,0,3,0,0,0,3
AAAGGTAAGCTGTACC-1_V12D07-335_B1,0,3,1,0,0,4
GTACGTCACGTATTAA-1_V12D07-335_B1,2,2,0,0,0,4
AGTACCTTCGAGTGCT-1_V12D07-335_B1,0,1,0,0,0,1
ATTGTGACTTCGCTGC-1_V12D07-335_B1,0,1,0,0,0,1
TGTATCAGACTGAAGC-1_V12D07-335_B1,0,3,0,0,0,3
GAGACCCTGCAACGCC-1_V12D07-335_B1,0,0,0,0,1,1
TGGGTGGGATGTCATT-1_V12D07-335_B1,0,3,0,0,1,4
GGCTAATGATTGAAAT-1_V12D07-335_B1,0,3,1,0,0,4
ATAACGTTACCTCCAC-1_V12D07-335_B1,1,4,1,0,0,6
TGCGAGATGGCGGCCA-1_V12D07-335_B1,0,4,1,0,0,5
CACACTTGTATTGCGA-1_V12D07-335_B1,0,2,2,0,0,4
GCTGGTGACTCGTAGT-1_V12D07-335_B1,0,2,1,0,0,3
CGACACCGCTTAAGGA-1_V12D07-335_B1,0,2,2,0,0,4
GTAACAACTGACCTTG-1_V12D07-335_B1,0,1,1,0,0,2
CAACTGAGGGTATGAC-1_V12D07-335_B1,0,2,3,0,0,5
CTAATTATGAAGCGTA-1_V12D07-335_B1,0,4,7,0,0,11
CCGATCTTAAGAGGCT-1_V12D07-335_B1,0,6,3,0,0,9
CGACTCGGTACACGGT-1_V12D07-335_B1,0,7,0,0,0,7
TGCTGCGTCAGAGTTA-1_V12D07-335_B1,0,10,0,0,0,10
AGAGTTGCAGGCCTCC-1_V12D07-335_B1,0,14,0,0,0,14
ACTGGCGAACCTGCGT-1_V12D07-335_B1,0,9,6,0,0,15
ACTAAGGACGCACACC-1_V12D07-335_B1,0,7,4,0,0,11
CGTCCAGATGGCTCCA-1_V12D07-335_B1,3,1,0,0,0,4
ACTATCGCCGGCTAAA-1_V12D07-335_B1,2,5,0,0,0,7
GATAGCGTACCACGCG-1_V12D07-335_B1,1,1,3,0,0,5
AGGACTTATAGGAGAA-1_V12D07-335_B1,0,2,1,0,0,3
TAGTCGGGATTCTTCG-1_V12D07-335_B1,0,2,1,0,0,3
ACCATTAAGGGTGTCA-1_V12D07-335_B1,2,2,0,0,0,4
TTAATGTGTTTGCAGG-1_V12D07-335_B1,3,1,3,0,0,7
TCCGCAGCCACCTAGC-1_V12D07-335_B1,1,4,0,0,0,5
GAGGAGATCCTCATGC-1_V12D07-335_B1,1,2,0,1,0,4
GGTCCTTCATACGACT-1_V12D07-335_B1,0,2,0,0,0,2
CCCTGTTGGCAAAGAC-1_V12D07-335_B1,1,4,2,0,0,7
GTGCCTAGCTATGCTT-1_V12D07-335_B1,0,5,0,0,0,5
GTCATCTCCTACAGCT-1_V12D07-335_B1,0,1,0,0,0,1
GCGAGAAACGGGAGTT-1_V12D07-335_B1,0,2,0,0,0,2
CGTCGCGGCGGGATTT-1_V12D07-335_B1,1,3,0,0,0,4
CATTGTGTGCTAGATC-1_V12D07-335_B1,1,1,0,0,0,2
CGCGGCAGTATTACGG-1_V12D07-335_B1,0,4,1,0,0,5
GAAATGGGATGTAAAC-1_V12D07-335_B1,0,0,3,0,0,3
CATTCCCTAAGTACAA-1_V12D07-335_B1,0,3,3,0,0,6
AGTTCTGCGTTGTATC-1_V12D07-335_B1,1,2,0,0,0,3
ACCCTATAGGACTGAG-1_V12D07-335_B1,1,5,0,1,0,7
TTAGATAGGTCGATAC-1_V12D07-335_B1,1,4,0,0,0,5
ATTGATAGCAACGAGA-1_V12D07-335_B1,0,2,2,0,0,4
TCTCGGCTCCAGGACT-1_V12D07-335_B1,1,4,1,0,0,6
CTTGAGGTTATCCCGA-1_V12D07-335_B1,1,2,0,0,0,3
AAGAAGGATCAGTTAG-1_V12D07-335_B1,1,0,0,0,0,1
GTACGACGGCGCTGCG-1_V12D07-335_B1,0,3,2,0,0,5
CTTATGTTGACTACCA-1_V12D07-335_B1,2,3,1,0,0,6
CGGCACTCAAGAAAGT-1_V12D07-335_B1,1,0,0,0,0,1
GTCAAAGTTTACATAG-1_V12D07-335_B1,1,4,1,0,0,6
CTCCTAAGTTATGTCT-1_V12D07-335_B1,1,3,2,0,0,6
ACTGTGCTAGTAGATC-1_V12D07-335_B1,1,0,1,0,0,2
GTTTGGCCGCTCAGCG-1_V12D07-335_B1,0,0,2,0,0,2
TTATCCAATCGAACTC-1_V12D07-335_B1,0,5,0,0,0,5
CCGTACCCAAGCGCCA-1_V12D07-335_B1,0,0,0,0,0,0
CATACAAAGCCGAACC-1_V12D07-335_B1,0,2,0,0,0,2
GGTCGGTAATTAGACA-1_V12D07-335_B1,0,4,0,0,0,4
AGCGGGAAGGGTCCAT-1_V12D07-335_B1,1,1,0,0,0,2
GCCCACCAAGGCTGTC-1_V12D07-335_B1,0,1,0,0,0,1
GTAGACGTCGTTACAT-1_V12D07-335_B1,0,1,0,0,0,1
GAGCATCATCCCTGGG-1_V12D07-335_B1,1,4,0,0,0,5
AGGTAACCTCCTATTC-1_V12D07-335_B1,0,2,0,0,0,2
GGTTTGAGTGCTGGAA-1_V12D07-335_B1,1,1,1,0,0,3
GCACTAGTCGCGCTAT-1_V12D07-335_B1,1,3,0,0,0,4
GGTAACTATGTATCTG-1_V12D07-335_B1,0,2,0,0,0,2
GCGGTCCCTAGACGCA-1_V12D07-335_B1,1,2,2,0,0,5
CGAGCGTTGATCAGCC-1_V12D07-335_B1,0,0,1,0,0,1
AATCCAAGGGCCTGAG-1_V12D07-335_B1,1,0,1,0,0,2
CCGTGCCCATGACGGC-1_V12D07-335_B1,2,0,1,0,0,3
GAAATTCACATCGCTG-1_V12D07-335_B1,1,2,1,0,0,4
CTCTGCGAAGCAAGCA-1_V12D07-335_B1,2,0,1,0,0,3
AGTAGGTAACATACAT-1_V12D07-335_B1,1,2,1,0,0,4
ATTGGGAATATCTTGG-1_V12D07-335_B1,0,2,0,0,0,2
TAGAGCTACGAAGAAC-1_V12D07-335_B1,2,3,1,0,0,6
TGCGGCATAGTTCAAC-1_V12D07-335_B1,0,1,0,0,0,1
CCGCCGGTCAACACAC-1_V12D07-335_B1,0,2,0,0,0,2
TCGTATAGTGCAATTA-1_V12D07-335_B1,1,4,0,0,0,5
TAGTTTATTCTTGCTT-1_V12D07-335_B1,3,0,0,0,0,3
GATATCTCATGCAATA-1_V12D07-335_B1,0,2,0,0,0,2
CGTTTAAGCGGAGCAC-1_V12D07-335_B1,1,2,2,0,0,5
CATGCTGGCTCCAATT-1_V12D07-335_B1,2,3,1,0,0,6
GAAACAGCCATGCAGT-1_V12D07-335_B1,0,5,0,0,0,5
AGTTTCGCAGGTCGGA-1_V12D07-335_B1,1,3,0,0,0,4
CTCATGGCTCACAATC-1_V12D07-335_B1,1,2,1,0,0,4
AACCGTTGTGTTTGCT-1_V12D07-335_B1,1,0,0,0,0,1
ACCCTTCATCTGCGAA-1_V12D07-335_B1,1,0,0,0,0,1
TGCGGTGAAATTTCAT-1_V12D07-335_B1,1,1,1,0,0,3
CAAATTGTCAGCAAGC-1_V12D07-335_B1,2,0,0,0,0,2
GAGGTACATCCATCTT-1_V12D07-335_B1,0,2,1,0,0,3
AAATGGCATGTCTTGT-1_V12D07-335_B1,0,1,1,0,0,2
TCATCCCAGAGGGTGG-1_V12D07-335_B1,3,2,0,0,0,5
CGTAGCGAATTGTCAG-1_V12D07-335_B1,0,2,1,0,2,5
CCTAGTTAGTCGCATG-1_V12D07-335_B1,0,2,0,0,0,2
GAAACTCTAATGAAGG-1_V12D07-335_B1,0,2,0,0,0,2
TTGTATCACACAGAAT-1_V12D07-335_B1,0,3,0,0,0,3
TTCAAGCCGAGCTGAG-1_V12D07-335_B1,0,1,0,0,0,1
AGGTACGATATTGCCA-1_V12D07-335_B1,1,3,0,0,0,4
TTAAGCCGACAACTTC-1_V12D07-335_B1,1,2,0,0,0,3
GTCTTAGTACAGCCGG-1_V12D07-335_B1,5,1,0,0,0,6
TGGGTAAGGTTCCCGC-1_V12D07-335_B1,0,4,0,0,0,4
CTACGCCATTTCCGAT-1_V12D07-335_B1,2,2,0,0,0,4
GACCGTCAGGTCGTGA-1_V12D07-335_B1,0,2,0,0,0,2
TAGTTAAGATAGGATA-1_V12D07-335_B1,1,0,1,0,0,2
GAATATTCGGAGTCCC-1_V12D07-335_B1,1,1,0,0,0,2
CAAACTACGATAGAGA-1_V12D07-335_B1,0,4,0,0,0,4
CAGGAAGACTTTATAT-1_V12D07-335_B1,0,4,0,0,0,4
TTCGTAATCCCAGCGG-1_V12D07-335_B1,1,1,1,0,0,3
GTGAGGAGCGGTTGAG-1_V12D07-335_B1,0,4,1,0,0,5
CAATCCCTATACCAGC-1_V12D07-335_B1,0,2,0,0,0,2
AGGGAAACGAGGTACT-1_V12D07-335_B1,0,3,1,0,0,4
TCCTGCCAACTGGAGA-1_V12D07-335_B1,0,2,2,0,0,4
AATTTGGGACATAGTA-1_V12D07-335_B1,0,3,2,0,0,5
AACTCCTAATCCCATG-1_V12D07-335_B1,3,1,0,0,0,4
GCTCATTACTGCATGT-1_V12D07-335_B1,0,0,0,0,0,0
TCTCGAACGAGGTCAC-1_V12D07-335_B1,0,1,1,0,0,2
TCACTACGACCAATGC-1_V12D07-335_B1,0,1,1,0,0,2
GTGATGCACAACATCT-1_V12D07-335_B1,0,1,0,0,0,1
CCGACGTAAACACAAC-1_V12D07-335_B1,1,2,1,0,0,4
TGGGATGCACTCATTC-1_V12D07-335_B1,1,0,0,0,0,1
TTCCATCATGCGGTGA-1_V12D07-335_B1,2,3,0,0,0,5
TGCACAGTGAAGTTAT-1_V12D07-335_B1,0,0,0,0,0,0
CTATTGTGTTTGGTCA-1_V12D07-335_B1,0,0,2,1,0,3
TGCGAGCCCTTCCGCG-1_V12D07-335_B1,1,3,0,0,0,4
TTGAAAGGTGTAAAGG-1_V12D07-335_B1,0,1,2,0,0,3
GGTGCAGAGCCTATCG-1_V12D07-335_B1,0,4,0,0,0,4
ACTATATGCTGTGTTC-1_V12D07-335_B1,0,2,0,0,0,2
TCCTGGCGCTGCCTGG-1_V12D07-335_B1,1,2,0,0,0,3
GAGCCGAGCGTTTATT-1_V12D07-335_B1,0,1,0,0,0,1
AGAATGCGGGTTCGGA-1_V12D07-335_B1,0,1,2,0,0,3
ATGCGACAATTGGTCC-1_V12D07-335_B1,1,0,1,0,0,2
TTCCGGCTCGACTTCT-1_V12D07-335_B1,0,2,0,0,0,2
TGATTATGGCACGCAG-1_V12D07-335_B1,1,1,1,0,0,3
GGTTTGACAAGAAGCT-1_V12D07-335_B1,0,3,0,0,0,3
GCAGCTATGGACAGGT-1_V12D07-335_B1,0,1,0,0,0,1
CACCATGATCGCAAAG-1_V12D07-335_B1,0,3,1,0,0,4
GTCGGAAGGATACCAG-1_V12D07-335_B1,0,5,1,0,0,6
GGCCCAGTTATCAGCA-1_V12D07-335_B1,0,2,4,0,0,6
GGGCCTATTTAAGTAT-1_V12D07-335_B1,0,3,0,0,0,3
GTTGTTACATTGCGCT-1_V12D07-335_B1,0,4,0,0,0,4
CAACTCCGTAACTTGC-1_V12D07-335_B1,0,3,3,0,0,6
GATCTTTGCTCAAAGA-1_V12D07-335_B1,0,0,3,0,0,3
TCGCTTAATTACGAAG-1_V12D07-335_B1,0,6,1,0,0,7
CGATCATTAGAGGCAC-1_V12D07-335_B1,0,10,2,1,0,13
TGTTCTCTACTCCCTA-1_V12D07-335_B1,0,9,1,0,0,10
GCTTAGGGAAGCGGTA-1_V12D07-335_B1,0,8,0,0,0,8
CAGGTTTAGTACTACA-1_V12D07-335_B1,0,10,1,0,0,11
AAGCGGAGTGCGCGCA-1_V12D07-335_B1,0,7,5,0,0,12
TCAGATGGAGACGTAG-1_V12D07-335_B1,0,6,3,0,0,9
TCGCACTAACGTTTGT-1_V12D07-335_B1,1,1,1,0,0,3
CACGTCGGGTTCTAGA-1_V12D07-335_B1,0,3,1,0,0,4
GGAGTACACATGAGCT-1_V12D07-335_B1,3,1,1,0,0,5
GTGTGTCGACGTCGCT-1_V12D07-335_B1,0,3,4,0,0,7
GAAGCTCTTTGCTTAG-1_V12D07-335_B1,0,5,1,0,0,6
ACACCGAGCGCTCTTT-1_V12D07-335_B1,2,1,0,0,0,3
CGTAATAATTACGAGT-1_V12D07-335_B1,0,3,0,0,0,3
CATCAACACCTACTAA-1_V12D07-335_B1,0,1,0,0,0,1
CCAAGTTTCTACAGAT-1_V12D07-335_B1,2,0,0,0,0,2
ACGGGTCATGTGACTT-1_V12D07-335_B1,2,2,2,0,0,6
AGTGTGCTAAGATCGC-1_V12D07-335_B1,2,3,0,0,0,5
GGCGGTTTGCCGGTGC-1_V12D07-335_B1,0,2,3,0,0,5
GTATAATCTCCCGGAT-1_V12D07-335_B1,1,4,0,0,0,5
TAGTCCGTATGCATAA-1_V12D07-335_B1,0,2,0,0,0,2
CACTTCGTCTTATCTC-1_V12D07-335_B1,0,1,0,0,0,1
CATCCGCAGGCCCGAA-1_V12D07-335_B1,1,0,0,0,0,1
CCCTGATGTAACTCGT-1_V12D07-335_B1,1,0,0,0,0,1
CCATAGTCAGTAACCC-1_V12D07-335_B1,1,3,0,0,0,4
CGGGCCATAGCCGCAC-1_V12D07-335_B1,1,1,1,0,0,3
CTCCGGCTTGTAGACA-1_V12D07-335_B1,0,2,3,0,0,5
AACTTGCGTTCTCGCG-1_V12D07-335_B1,0,2,0,0,0,2
AATGAGTTCGCATATG-1_V12D07-335_B1,1,2,0,0,0,3
CGAGGCCAGGCATTGG-1_V12D07-335_B1,1,4,1,0,0,6
TCTGCGTCCGGTTTCT-1_V12D07-335_B1,0,1,1,0,0,2
CAATCCTGCCGTGGAG-1_V12D07-335_B1,1,1,0,0,0,2
CTGAGCAAGTAACAAG-1_V12D07-335_B1,1,1,2,0,0,4
GGGTACCCACGGTCCT-1_V12D07-335_B1,2,3,0,0,0,5
ACGGAATTTAGCAAAT-1_V12D07-335_B1,2,2,1,0,0,5
GGGCGGTCCTATTGTC-1_V12D07-335_B1,1,1,0,0,0,2
ATGTTACGAGCAATAC-1_V12D07-335_B1,0,1,1,0,0,2
AACCATGGGATCGCTA-1_V12D07-335_B1,0,2,0,0,0,2
TCGCATCCCTAAGTGT-1_V12D07-335_B1,0,0,0,0,0,0
ACTTAGTACGACAAGA-1_V12D07-335_B1,0,0,0,0,0,0
GAGCTCTCGGACCTAA-1_V12D07-335_B1,1,7,0,0,0,8
TCTATTACGCTGGCGA-1_V12D07-335_B1,0,2,0,0,0,2
AGATACGACTTCATAT-1_V12D07-335_B1,0,1,1,0,0,2
CGCTATACCGCCCACT-1_V12D07-335_B1,0,0,3,1,0,4
CAGTGTCCGCAGAATG-1_V12D07-335_B1,1,1,0,0,0,2
CCATCCATACCAAGTC-1_V12D07-335_B1,0,4,0,0,0,4
AACCCAGAGACGGAGA-1_V12D07-335_B1,0,2,2,0,0,4
GAAGAACGGTGCAGGT-1_V12D07-335_B1,2,1,0,0,0,3
GATAAATCGGTGGATG-1_V12D07-335_B1,0,2,3,0,0,5
CAGCTCGTGCTTGTGT-1_V12D07-335_B1,1,2,0,0,0,3
GAGTACGGGTATACAA-1_V12D07-335_B1,0,1,0,0,0,1
CATCGCCCGCGGCCAA-1_V12D07-335_B1,1,2,0,0,0,3
TCTTACAGAGGTACCG-1_V12D07-335_B1,2,1,0,0,0,3
TGGAAGACGAACACCA-1_V12D07-335_B1,0,1,0,0,0,1
GTTGTCGTGTTAGTTG-1_V12D07-335_B1,2,4,1,0,0,7
CCAAGGAACAGAGAGG-1_V12D07-335_B1,0,1,1,0,0,2
CTGCACCTGGAACCGC-1_V12D07-335_B1,3,2,0,0,0,5
CGCTTTCATACCGGTG-1_V12D07-335_B1,1,2,0,0,0,3
GTTCTTCCCTCGATGT-1_V12D07-335_B1,1,1,0,0,0,2
ATTTAACTCGTATTAC-1_V12D07-335_B1,0,1,2,0,0,3
AACGATAGAAGGGCCG-1_V12D07-335_B1,4,0,1,0,0,5
TATCCTGCATGGGAAT-1_V12D07-335_B1,2,1,0,0,0,3
AGGCCCATTGTACAGG-1_V12D07-335_B1,1,1,1,0,0,3
CCGGCGCATATTGGAT-1_V12D07-335_B1,2,1,0,0,0,3
ATCTGTAATTGTACCC-1_V12D07-335_B1,2,1,0,0,0,3
GAGCGAGGGAGTACCG-1_V12D07-335_B1,0,1,0,0,0,1
TTATTAGGGAAGCATC-1_V12D07-335_B1,2,0,1,0,0,3
CTTCTTACGTCGTATA-1_V12D07-335_B1,2,1,2,0,0,5
GAAGTGCTGGATAGCT-1_V12D07-335_B1,0,1,0,0,0,1
GTGCAACAAATGTGGC-1_V12D07-335_B1,0,2,1,0,0,3
CATGCGTTAGACAGAA-1_V12D07-335_B1,3,0,0,0,0,3
ACACACTTTCTACACG-1_V12D07-335_B1,0,1,0,0,0,1
AGCCCTAAGCGAAGTT-1_V12D07-335_B1,0,2,0,0,0,2
ATTAATTCGGTCACTC-1_V12D07-335_B1,1,2,1,0,0,4
AACAGGAAATCGAATA-1_V12D07-335_B1,1,2,2,0,0,5
ACGTTTAGTTGTGATC-1_V12D07-335_B1,2,4,0,0,0,6
TCCTTCAGTGGTCGAA-1_V12D07-335_B1,2,0,0,0,0,2
CGAACGCCCAGTGCCG-1_V12D07-335_B1,2,2,1,0,0,5
CCTCGAAGTGGACGGG-1_V12D07-335_B1,1,2,2,0,0,5
CTCTGTTTGAGGATTC-1_V12D07-335_B1,0,1,0,0,0,1
TGGGCACGTTCTATGG-1_V12D07-335_B1,1,1,2,0,0,4
ACTATTCGTCCGTGGT-1_V12D07-335_B1,1,0,0,0,0,1
CCTCTGGCCTAGACGG-1_V12D07-335_B1,1,2,0,0,0,3
CCATAAACAACCCGAC-1_V12D07-335_B1,0,2,0,0,0,2
CATAGTACATTGAGAG-1_V12D07-335_B1,1,1,1,0,0,3
ATTTCATTATTTCGCG-1_V12D07-335_B1,1,1,0,0,0,2
CAACTATATCGAATGC-1_V12D07-335_B1,0,3,2,0,0,5
CTAGTATTCGGAATTA-1_V12D07-335_B1,0,2,1,0,0,3
GTGGAACCTACATGCG-1_V12D07-335_B1,2,0,0,0,0,2
CCTAAAGGCTGACGCT-1_V12D07-335_B1,1,5,0,0,0,6
CGTGACATTGGGTCGT-1_V12D07-335_B1,3,1,0,0,0,4
CCAATCGGTAGATCGA-1_V12D07-335_B1,1,3,0,0,0,4
ATTGTCGCAATACCTT-1_V12D07-335_B1,0,1,1,0,0,2
AAATTACACGACTCTG-1_V12D07-335_B1,1,1,0,0,0,2
CACTCCTCTCGGTCGG-1_V12D07-335_B1,0,1,3,0,0,4
AAATAACCATACGGGA-1_V12D07-335_B1,0,0,2,0,0,2
AGTTACTCTATCGTGG-1_V12D07-335_B1,0,7,0,0,0,7
CGTTAGCTCACAACTG-1_V12D07-335_B1,2,1,2,0,0,5
GAATGTATGGCAGGTC-1_V12D07-335_B1,1,1,0,0,0,2
GCAACCACCAGACCGG-1_V12D07-335_B1,0,3,2,0,0,5
TCACTCGTGCAACGGC-1_V12D07-335_B1,3,0,2,0,0,5
AAACAGAGCGACTCCT-1_V12D07-335_B1,1,9,0,0,0,10
CAGCCTCTCCTCAAGA-1_V12D07-335_B1,1,1,1,0,0,3
TTGCGTGAACGCTTAG-1_V12D07-335_B1,0,4,0,0,0,4
CCGCCTGCGAATTGGT-1_V12D07-335_B1,1,1,0,0,0,2
AGATGAGGGTTGCGAT-1_V12D07-335_B1,1,2,0,0,0,3
CGGTGGGCTCCAGCCT-1_V12D07-335_B1,1,1,0,0,0,2
GGCAGCGGTAATCCTA-1_V12D07-335_B1,1,1,0,0,0,2
GCTAGCAGGGAGTGGG-1_V12D07-335_B1,0,5,2,0,0,7
CTCAAGACATTAGCGC-1_V12D07-335_B1,0,1,2,0,0,3
CACGGCGCGCCAAAGG-1_V12D07-335_B1,0,2,2,0,0,4
TGCAATTTGGGCACGG-1_V12D07-335_B1,1,0,1,0,0,2
ATGCCAATCGCTCTGC-1_V12D07-335_B1,0,3,1,0,0,4
GCTGGACCCAAAGTGG-1_V12D07-335_B1,2,4,0,0,0,6
ATTCCTAAGACGTGGA-1_V12D07-335_B1,0,2,2,0,0,4
TCCGGAGGAAGGGCTG-1_V12D07-335_B1,0,5,0,0,0,5
TCGGTGACCGCTCCGG-1_V12D07-335_B1,1,4,0,0,0,5
TCCGAAGTAGTCACCA-1_V12D07-335_B1,0,2,0,0,0,2
CATGTAGGAGCGCCAA-1_V12D07-335_B1,1,0,1,0,0,2
CACAAGAAAGATATTA-1_V12D07-335_B1,3,2,1,1,0,7
AGGGTCAGTAACCCTA-1_V12D07-335_B1,0,2,0,0,0,2
TAAGCCCTTACGACCA-1_V12D07-335_B1,0,1,1,0,0,2
ATACCGTCATCCATAA-1_V12D07-335_B1,1,0,0,0,0,1
GGACGTCCATAGTTGG-1_V12D07-335_B1,1,1,2,0,0,4
CATCAAACTGGCGCCC-1_V12D07-335_B1,0,3,3,0,0,6
AAACGTGTTCGCCCTA-1_V12D07-335_B1,0,2,0,0,0,2
AAATTGGTGAGAAGCA-1_V12D07-335_B1,0,1,1,0,0,2
GGTCATTGTAGTCATA-1_V12D07-335_B1,0,0,1,0,0,1
TGCAGTGAGGCTCGGG-1_V12D07-335_B1,0,3,4,0,0,7
GAACATTAGTATGTTA-1_V12D07-335_B1,0,4,6,3,0,13
GGTTTGCGAACACGTA-1_V12D07-335_B1,0,9,1,0,0,10
ACACAAATATTCCTAG-1_V12D07-335_B1,0,12,0,0,0,12
TTGGGTTTATTCAGCG-1_V12D07-335_B1,0,10,0,0,0,10
ATTCGCAGAGGACACT-1_V12D07-335_B1,0,8,5,0,0,13
GATTTAGTGCGTACTG-1_V12D07-335_B1,0,8,5,1,0,14
TAGAAACACAATAGTG-1_V12D07-335_B1,0,5,0,0,0,5
CAGTAGATGATGTCCG-1_V12D07-335_B1,2,3,0,0,0,5
TCTTAACTCGGATGTA-1_V12D07-335_B1,0,2,0,0,0,2
TACATCTTGTTTCTTG-1_V12D07-335_B1,0,0,0,0,0,0
TTCATAGGGTGTCCAT-1_V12D07-335_B1,2,1,0,0,0,3
TGAAGTAGCTTACGGA-1_V12D07-335_B1,0,1,1,0,0,2
GCACAAGTGGATCATA-1_V12D07-335_B1,1,3,1,0,0,5
GGGCGAATTTCTCCAC-1_V12D07-335_B1,1,2,4,0,0,7
ATGTTCCTGCCCACCT-1_V12D07-335_B1,0,1,0,0,0,1
GCTCAACCTCTTAGAG-1_V12D07-335_B1,0,1,3,0,0,4
ATAGCTGCTCTTGTTA-1_V12D07-335_B1,0,4,0,0,0,4
CGTCAGCTATTTACTC-1_V12D07-335_B1,0,6,2,0,0,8
ATCTGATAGTGTCTTA-1_V12D07-335_B1,2,3,1,0,0,6
TGCACTATGTGAGTGC-1_V12D07-335_B1,0,1,1,0,0,2
CCGACAAACACATGAG-1_V12D07-335_B1,1,0,1,0,0,2
GCCTTGTATATGCAGT-1_V12D07-335_B1,1,1,0,0,0,2
ATAATACCGTTAGCCG-1_V12D07-335_B1,0,2,0,0,0,2
ACACTCCAATGTCACT-1_V12D07-335_B1,0,1,0,0,0,1
AGTTGCTGACTGATAT-1_V12D07-335_B1,0,3,1,0,0,4
GGCGCTCCTCATCAAT-1_V12D07-335_B1,2,0,0,0,0,2
TGCCTGACATCGGTCA-1_V12D07-335_B1,0,1,0,0,0,1
TTGGCCATCTTGCGCT-1_V12D07-335_B1,1,2,0,0,0,3
CAGTGGTTGCACATGA-1_V12D07-335_B1,1,3,1,0,0,5
AGAATTGTTTGACATA-1_V12D07-335_B1,0,5,0,0,0,5
AAATGCTCGTTACGTT-1_V12D07-335_B1,0,1,2,0,0,3
CACCTAATAGAGTCGT-1_V12D07-335_B1,1,0,2,0,0,3
CATTTCTAGCAGACTA-1_V12D07-335_B1,1,1,1,0,0,3
CCGAAAGTGGTGAGCA-1_V12D07-335_B1,0,0,0,0,0,0
AGTCAGCCACCGCCTG-1_V12D07-335_B1,0,2,1,0,0,3
TCATCACTCGAGCTCG-1_V12D07-335_B1,0,2,1,0,0,3
CTCAGGACTCACCTGT-1_V12D07-335_B1,0,2,1,0,0,3
CGGTGTACTTGATCCC-1_V12D07-335_B1,0,3,0,0,0,3
CCTACGGCTCAGTCGA-1_V12D07-335_B1,0,1,0,0,0,1
GTACTTGGGCACTTCT-1_V12D07-335_B1,0,5,0,0,0,5
TGATTTCCTCCTGACG-1_V12D07-335_B1,1,0,1,0,0,2
CCTCACCAATCTTGAC-1_V12D07-335_B1,0,2,1,0,0,3
GGTGAGATGCAGATAA-1_V12D07-335_B1,0,3,1,0,0,4
GCTAGTTTCATTGAGG-1_V12D07-335_B1,1,1,0,0,0,2
AGGACATCGCACGTCG-1_V12D07-335_B1,0,0,0,0,0,0
GTGGACGTGCTGAGAC-1_V12D07-335_B1,1,2,1,0,0,4
TAAGGAACTTGTGGGA-1_V12D07-335_B1,1,2,0,0,0,3
TCGCTGTGCGTAAATC-1_V12D07-335_B1,0,6,0,0,0,6
GCATCCCTAACTTTGA-1_V12D07-335_B1,1,0,0,0,0,1
CACCCACACGTCACCC-1_V12D07-335_B1,0,1,1,0,0,2
CCCTCATTCTGGAATT-1_V12D07-335_B1,2,1,0,0,0,3
AGGGCGTGATCGGCTA-1_V12D07-335_B1,2,0,1,0,0,3
GGTGCGGATAAGTGGC-1_V12D07-335_B1,1,1,0,0,0,2
TAATATTGAAATTCGC-1_V12D07-335_B1,0,1,0,0,0,1
CTTACACTGGGAAATA-1_V12D07-335_B1,0,2,1,0,0,3
ACCAAGAACGCGTGTC-1_V12D07-335_B1,2,1,0,0,0,3
GCCTTCAGCCCTACCG-1_V12D07-335_B1,1,4,0,0,0,5
GATGCTACAAGCGCCT-1_V12D07-335_B1,1,0,0,0,0,1
CCGGGACCCGCAGAGA-1_V12D07-335_B1,1,0,1,0,0,2
GTTCCAGTCTGACCAT-1_V12D07-335_B1,0,1,1,0,0,2
ATGATCGGGAATAGAC-1_V12D07-335_B1,0,4,0,0,0,4
TTGGATTGGGTACCAC-1_V12D07-335_B1,0,5,2,0,0,7
TACCTCACGCTTGTAC-1_V12D07-335_B1,0,3,0,0,0,3
CATGGCAGGAAGATCG-1_V12D07-335_B1,0,2,0,0,0,2
ATGACGCCGGCTCTAA-1_V12D07-335_B1,2,4,0,0,0,6
AGCGACATCCCATTCA-1_V12D07-335_B1,1,3,1,0,0,5
AGTAATGTCTTGCCGC-1_V12D07-335_B1,1,1,0,0,0,2
TTCTTAGTGGCTCAGA-1_V12D07-335_B1,1,4,0,0,0,5
CGTCTGGAAGGGCCCG-1_V12D07-335_B1,2,1,0,0,0,3
ACGTGCGCCTCGTGCA-1_V12D07-335_B1,1,3,0,0,0,4
AGAGCGGGCTAATCAT-1_V12D07-335_B1,0,4,1,0,0,5
GCGTCGAAATGTCGGT-1_V12D07-335_B1,1,2,0,0,0,3
AACTGATATTAGGCCT-1_V12D07-335_B1,0,3,2,0,0,5
CGAGCTGGGCTTTAGG-1_V12D07-335_B1,1,1,0,0,0,2
GGGTGTTTCAGCTATG-1_V12D07-335_B1,0,1,0,0,0,1
TTAATTTCAGACGCGG-1_V12D07-335_B1,0,0,0,0,0,0
ACTGCCGTCGTAACTC-1_V12D07-335_B1,0,5,0,0,0,5
GTGCACGAAAGTGACT-1_V12D07-335_B1,0,1,3,0,0,4
ATCTCCCTGCAATCTA-1_V12D07-335_B1,0,0,1,0,0,1
ACGCCAGATGATTTCT-1_V12D07-335_B1,4,4,0,0,0,8
AGCTATTTAATCCAAC-1_V12D07-335_B1,0,2,0,0,0,2
CCACGAGAAGAGAATC-1_V12D07-335_B1,1,1,0,0,0,2
GATTCCGCGTTTCCGT-1_V12D07-335_B1,0,3,0,0,0,3
GTCGGATGTAGCGCGC-1_V12D07-335_B1,0,1,0,0,0,1
TATTTATACCGAGTAG-1_V12D07-335_B1,0,2,1,0,0,3
GTAGGTGATCCGTGTA-1_V12D07-335_B1,1,6,0,0,0,7
AGTTAAGCGGTCCCGG-1_V12D07-335_B1,1,3,0,0,0,4
CTGGCGACATAAGTCC-1_V12D07-335_B1,0,6,0,0,0,6
TTGGCCTAGAATTTCG-1_V12D07-335_B1,0,0,0,0,0,0
GGCATATCGGTTCTGC-1_V12D07-335_B1,2,3,1,0,0,6
GGGCGTCCACTGGCTC-1_V12D07-335_B1,0,2,0,0,0,2
TTACCCATTGCCGGGT-1_V12D07-335_B1,3,2,1,0,0,6
TTAGACACGATCGTTG-1_V12D07-335_B1,0,1,0,0,0,1
GCGCTGATCCAGACTC-1_V12D07-335_B1,0,4,0,0,0,4
TTCGGCAACCCGCTGA-1_V12D07-335_B1,0,2,2,0,0,4
GATATTTCCTACATGG-1_V12D07-335_B1,0,2,3,0,0,5
CTGCGTTACGATATAA-1_V12D07-335_B1,0,1,1,0,0,2
TAATAAACAAGGAGAT-1_V12D07-335_B1,0,2,2,0,0,4
AACCTTTACGACGTCT-1_V12D07-335_B1,0,0,0,0,0,0
AGTCCCGCCTTTAATT-1_V12D07-335_B1,0,3,2,0,0,5
TGAGATTAGGCCCTAA-1_V12D07-335_B1,2,3,4,0,0,9
AGTGTATTGCGCATTG-1_V12D07-335_B1,0,0,3,0,0,3
GTTGGATTCAGTGGCT-1_V12D07-335_B1,2,1,0,0,0,3
TAAAGCTGCAATAGGG-1_V12D07-335_B1,0,3,1,0,0,4
AGTAGGAAGGAAGTTG-1_V12D07-335_B1,2,1,0,0,0,3
TATCACTTCGAGTAAC-1_V12D07-335_B1,2,2,0,0,0,4
TGATCTACGCTGATCT-1_V12D07-335_B1,3,3,1,0,0,7
GGATCATCCCGTACGC-1_V12D07-335_B1,1,1,2,0,0,4
TGACACTTCTCTTTGC-1_V12D07-335_B1,2,0,1,1,0,4
AGCCCTTCTAATCCGA-1_V12D07-335_B1,1,2,0,0,0,3
CACCGCGTCCACTCTA-1_V12D07-335_B1,1,1,1,0,0,3
TAATTGGAATCGGGAA-1_V12D07-335_B1,1,0,0,0,0,1
TCGTAAGCTCCGAGGA-1_V12D07-335_B1,0,0,0,0,0,0
TATATTACAAATGTCG-1_V12D07-335_B1,1,3,2,0,0,6
CGCGAGAGGGACTTGT-1_V12D07-335_B1,2,3,0,0,0,5
GGACCTACGGTAACGT-1_V12D07-335_B1,0,3,0,0,0,3
GAAATATGCTTGAATG-1_V12D07-335_B1,1,2,0,0,0,3
CCGTATTAGCGCAGTT-1_V12D07-335_B1,0,3,1,0,0,4
AGGCGTCTATGGACGG-1_V12D07-335_B1,1,0,0,0,0,1
AACATCGATACGTCTA-1_V12D07-335_B1,0,1,2,0,0,3
TGAATATGCTATAAAC-1_V12D07-335_B1,0,1,0,0,0,1
ACCAAACACCCAGCGA-1_V12D07-335_B1,2,2,0,0,0,4
TGGCTTGTACAAGCTT-1_V12D07-335_B1,0,2,2,0,0,4
GAATGAAGGTCTTCAG-1_V12D07-335_B1,1,0,1,0,0,2
AGATACCAGCACTTCA-1_V12D07-335_B1,0,2,3,0,0,5
GCGGTCCCGGTGAAGG-1_V12D07-335_B1,1,0,3,0,0,4
GAGGCATTTGCAGCAG-1_V12D07-335_B1,0,1,0,0,0,1
GGCAAGCCAGGGATAG-1_V12D07-335_B1,0,1,3,0,0,4
TCTACGGGCTCAGTTG-1_V12D07-335_B1,0,3,5,3,0,11
TCTGCGAATCGTTCGC-1_V12D07-335_B1,0,13,1,0,0,14
AGCTCGTTGATGGAAA-1_V12D07-335_B1,0,11,0,0,0,11
TGAATGAGATACAGCA-1_V12D07-335_B1,0,13,0,0,0,13
ACCCTTGCCTGGGTCG-1_V12D07-335_B1,0,14,2,0,0,16
GGCGAACCGTTCTGAT-1_V12D07-335_B1,0,5,6,0,0,11
GCGATGTCTGTGCTTG-1_V12D07-335_B1,0,3,0,0,0,3
ATTAACACCTGAGATA-1_V12D07-335_B1,1,2,1,0,0,4
GAAATCTGACCAAGTT-1_V12D07-335_B1,0,1,0,0,0,1
CCTGACAAACTCGCGC-1_V12D07-335_B1,1,0,0,0,0,1
ATGTCATTTCCCATTG-1_V12D07-335_B1,1,2,0,0,0,3
GCGGTGCGGAGCATCG-1_V12D07-335_B1,1,1,4,0,0,6
CGGAAAGCAAATGTGC-1_V12D07-335_B1,2,4,0,0,0,6
GCTGAGCAACGGTTCT-1_V12D07-335_B1,0,0,1,0,0,1
TCACTCTTCGTCTGTC-1_V12D07-335_B1,0,0,1,0,0,1
GATCTTCATTGTCCTC-1_V12D07-335_B1,2,2,0,0,0,4
ACTCGATGTATTTCAT-1_V12D07-335_B1,0,1,0,0,0,1
TGAAGAGCGGTCCTAG-1_V12D07-335_B1,0,1,0,0,0,1
TAAACGTCGTCAATGA-1_V12D07-335_B1,0,1,2,0,0,3
ACGTTATTGGTCACTC-1_V12D07-335_B1,0,4,2,0,0,6
ATAGCCTCAGTACCCA-1_V12D07-335_B1,0,5,1,0,0,6
CGGGAGTATACCGCCG-1_V12D07-335_B1,1,1,2,0,0,4
GTCCTACAGGCGGCTC-1_V12D07-335_B1,1,2,0,0,0,3
CGGATAAGCGGACATG-1_V12D07-335_B1,0,1,1,0,0,2
AACTTCTGCGTCTATC-1_V12D07-335_B1,0,2,0,0,0,2
GGGTTCAGACGAACAA-1_V12D07-335_B1,0,0,2,0,0,2
AGTCTGGACATCCTTG-1_V12D07-335_B1,2,5,0,0,0,7
TTGAACGAATCCTTTG-1_V12D07-335_B1,1,2,0,0,0,3
GAAATACTAAACGTTT-1_V12D07-335_B1,2,0,0,0,0,2
CCCGCGCAATGCACCC-1_V12D07-335_B1,1,1,0,0,0,2
TTCGGCTAGAGATGGT-1_V12D07-335_B1,2,2,0,0,0,4
GACACGAGTTAGAGGA-1_V12D07-335_B1,1,4,1,0,0,6
GAGGTCCCAAAGATCT-1_V12D07-335_B1,0,3,0,0,0,3
TAACTCCATGGAGGCT-1_V12D07-335_B1,1,2,1,0,0,4
CTTGTTTATGTAGCCA-1_V12D07-335_B1,1,1,0,0,0,2
GATGGCGCACACATTA-1_V12D07-335_B1,1,2,0,0,0,3
ATAATAGTGTAGGGAC-1_V12D07-335_B1,0,5,0,0,0,5
CGCTATTCAATGTATG-1_V12D07-335_B1,0,0,0,0,0,0
ATATTGCTGTCAAAGT-1_V12D07-335_B1,1,4,0,0,0,5
GGATTCAGTACGGTGG-1_V12D07-335_B1,4,2,0,0,0,6
TTCTTAGTGAACGGTG-1_V12D07-335_B1,0,3,0,0,0,3
AATGGTTCTCACAAGC-1_V12D07-335_B1,0,1,0,0,0,1
TATACACGCAAAGTAT-1_V12D07-335_B1,0,2,0,0,0,2
CTTCATAGCTCAAGAA-1_V12D07-335_B1,1,2,0,0,0,3
CAACGGTTCTTGATAC-1_V12D07-335_B1,1,3,1,0,0,5
ACACCCGAGAAATCCG-1_V12D07-335_B1,0,2,1,0,0,3
TCTATCATGCAGTTAC-1_V12D07-335_B1,0,1,0,0,0,1
CCCGCCATGCTCCCGT-1_V12D07-335_B1,1,2,1,0,0,4
CGCTTCCACTGAAATC-1_V12D07-335_B1,3,0,0,0,0,3
CACTGTCCAAGTGAGA-1_V12D07-335_B1,2,2,1,0,0,5
ATTACTAGCCTCTTGC-1_V12D07-335_B1,0,1,0,0,0,1
CATAGTAGCATAGTAG-1_V12D07-335_B1,0,0,1,0,0,1
CAACTCCTTGATCCCG-1_V12D07-335_B1,1,0,0,0,0,1
AAGTAGAAGACCGGGT-1_V12D07-335_B1,0,0,0,0,0,0
GCGGGAACCAGGCCCT-1_V12D07-335_B1,0,1,0,0,0,1
ATTAGATTGATAGCGG-1_V12D07-335_B1,2,1,0,0,0,3
CTCGGTCCGTAGCCTG-1_V12D07-335_B1,2,0,0,0,0,2
TGGCTTTGGGTAGACA-1_V12D07-335_B1,2,0,0,0,0,2
TATCCATATCATGCGA-1_V12D07-335_B1,1,4,0,0,0,5
GGAGTGCCGCCCTGGA-1_V12D07-335_B1,0,1,1,0,0,2
TGAGAATGCTTTACCG-1_V12D07-335_B1,0,2,0,0,0,2
TTAACCAACCCTCCCT-1_V12D07-335_B1,1,0,2,0,0,3
TGTTTCGGTACTTCTC-1_V12D07-335_B1,1,4,0,0,0,5
TTGCTGAAGGAACCAC-1_V12D07-335_B1,1,2,2,0,0,5
TATTTAGTCTAGATCG-1_V12D07-335_B1,1,0,0,0,0,1
CTCCGGCCTAATATGC-1_V12D07-335_B1,1,0,0,0,0,1
TTGTGGCCCTGACAGT-1_V12D07-335_B1,2,0,0,0,0,2
TCGCCGGTCGATCCGT-1_V12D07-335_B1,1,3,0,0,0,4
CCATAGGTTGGCGTGG-1_V12D07-335_B1,3,1,3,0,0,7
GAACGACCGAATGATA-1_V12D07-335_B1,0,2,2,0,0,4
TCCGATAATTGCCATA-1_V12D07-335_B1,0,2,0,0,0,2
CATTACGTCGGCCCGT-1_V12D07-335_B1,0,2,1,0,0,3
CAAGCACCAAATGCCT-1_V12D07-335_B1,1,6,1,0,0,8
TGCATGGATCGGATCT-1_V12D07-335_B1,1,1,1,0,0,3
GAAATCGCGCGCAACT-1_V12D07-335_B1,1,1,1,0,0,3
CTGAAAGAGATCCGAC-1_V12D07-335_B1,3,0,0,0,0,3
CACCTCGATGGTGGAC-1_V12D07-335_B1,2,2,0,0,0,4
ATTTGTTCCAGGGCTC-1_V12D07-335_B1,0,3,1,0,0,4
TGGGCCACAAGAGCGC-1_V12D07-335_B1,1,4,0,0,0,5
CCTTCTTGATCCAGTG-1_V12D07-335_B1,2,2,0,0,0,4
CCTCGCCAGCAAATTA-1_V12D07-335_B1,0,2,2,0,0,4
TTCATGGCGCAACAGG-1_V12D07-335_B1,1,0,1,0,0,2
TTAATCAGTACGTCAG-1_V12D07-335_B1,0,1,0,0,0,1
CCTATCTATATCGGAA-1_V12D07-335_B1,2,2,0,0,0,4
ATTATACTTTGCTCGT-1_V12D07-335_B1,1,7,1,0,0,9
ATGGATCCGGCGTCCG-1_V12D07-335_B1,0,4,2,0,0,6
CGCCCGCTTCCGTACA-1_V12D07-335_B1,1,2,2,0,0,5
GGATTCCGCTATACCC-1_V12D07-335_B1,1,1,2,0,0,4
CGGTCTATCAACCCGT-1_V12D07-335_B1,1,1,0,0,0,2
ATGCCGGTTGATGGGA-1_V12D07-335_B1,0,2,0,0,0,2
TCATGCAGGTTCTCAT-1_V12D07-335_B1,0,3,1,0,0,4
TGAGCTTTAATGACGC-1_V12D07-335_B1,0,2,1,0,0,3
TCCCTTAGATTACTCG-1_V12D07-335_B1,3,0,0,0,0,3
ATATCTCCCTCGTTAA-1_V12D07-335_B1,0,3,1,0,0,4
AGCTCTTCCCAGTGCA-1_V12D07-335_B1,1,1,1,0,0,3
TCGCTAAACCGCTATC-1_V12D07-335_B1,0,4,0,0,0,4
CACATTCTTTCGATGG-1_V12D07-335_B1,0,4,2,0,0,6
GATATGCGGTAGCCAA-1_V12D07-335_B1,1,0,2,0,0,3
CGTTTCACTTCGGGCG-1_V12D07-335_B1,1,3,0,0,0,4
CCAATTACGGGTCGAG-1_V12D07-335_B1,0,3,2,0,0,5
GCAGGTAGAGTATGGT-1_V12D07-335_B1,0,4,4,0,0,8
GTCGTATTGGCGTACA-1_V12D07-335_B1,2,1,1,0,0,4
GAAATTAGCACGGATA-1_V12D07-335_B1,0,2,0,0,0,2
AATGCACCAAGCAATG-1_V12D07-335_B1,0,2,0,0,0,2
AGGACGCTCGATGTTG-1_V12D07-335_B1,0,1,0,0,0,1
GGCTAAAGGGCGGGTC-1_V12D07-335_B1,1,2,0,0,0,3
CATCTATCCCGTGTCT-1_V12D07-335_B1,0,1,2,0,0,3
CAGTAACTATTTATTG-1_V12D07-335_B1,0,1,1,0,0,2
CATATACTACTGATAA-1_V12D07-335_B1,0,1,1,0,0,2
GCGTTCGGAGACCGGG-1_V12D07-335_B1,1,1,0,0,0,2
AAGTTCAGTCTGCGTA-1_V12D07-335_B1,1,2,0,0,0,3
CGAAGCTATAAATTCA-1_V12D07-335_B1,0,1,1,0,1,3
CGCGGTCACAAACCAA-1_V12D07-335_B1,0,2,0,0,1,3
GGGAATGAGCCCTCAC-1_V12D07-335_B1,0,0,3,0,0,3
ACGGAGCGCAAATTAC-1_V12D07-335_B1,0,0,1,0,0,1
CGTTCTTCGCACACCT-1_V12D07-335_B1,0,2,0,0,3,5
GAATAGCCCTGCGGTC-1_V12D07-335_B1,0,2,1,0,1,4
AATAGCTACCGCGTGC-1_V12D07-335_B1,0,1,1,0,0,2
CCGAGCTGTGCTTGTC-1_V12D07-335_B1,0,3,1,0,0,4
GATGACGATGATCGCG-1_V12D07-335_B1,0,2,0,0,0,2
GCCTATGCTGGGCCTT-1_V12D07-335_B1,0,2,1,0,0,3
TTACTGTCTAGAGCTC-1_V12D07-335_B1,0,1,2,0,0,3
AGCGGTTGCCGCTCTG-1_V12D07-335_B1,0,1,0,0,0,1
GCTTGCAGCACAATTG-1_V12D07-335_B1,1,2,2,0,0,5
CCGGAGGTCTTATGGT-1_V12D07-335_B1,0,2,0,0,0,2
ACAGTATACCGTGGGA-1_V12D07-335_B1,3,1,1,0,0,5
GGGATCCCAATACAAA-1_V12D07-335_B1,0,0,2,0,0,2
ATTACGACTCCACAGT-1_V12D07-335_B1,0,0,1,0,0,1
CTCACACGCAAGCCTA-1_V12D07-335_B1,0,3,3,1,0,7
CCAGATGTAAATGGGT-1_V12D07-335_B1,0,6,4,0,0,10
GAACTTGTGCACGGGA-1_V12D07-335_B1,0,10,0,0,0,10
AAGCCGCTTTACCTTG-1_V12D07-335_B1,0,10,1,0,0,11
TCCATTCCCACTAGAG-1_V12D07-335_B1,0,12,0,0,0,12
AGAGCGCTTGTAACGG-1_V12D07-335_B1,0,11,4,0,0,15
TGGGTTCCCGGACGGA-1_V12D07-335_B1,2,3,3,0,0,8
GCTGCGCCTCCCACGT-1_V12D07-335_B1,1,1,0,0,0,2
CTGTTGGCTCTTCTGA-1_V12D07-335_B1,0,5,0,0,0,5
TTGTTCTAGATACGCT-1_V12D07-335_B1,1,4,1,0,0,6
CCCTCAAGCTCTTAGT-1_V12D07-335_B1,1,3,2,0,0,6
TGGTCTAGCTTACATG-1_V12D07-335_B1,0,2,0,0,0,2
ATGCACCTTCCTTAAT-1_V12D07-335_B1,0,2,0,0,0,2
GGGATACGGTAATAAT-1_V12D07-335_B1,2,4,1,0,0,7
AGTTCACCGGTTGGAC-1_V12D07-335_B1,2,4,1,1,0,8
GACATACTGTCGCAGA-1_V12D07-335_B1,0,2,2,0,0,4
TGGACACCGTTGCTTG-1_V12D07-335_B1,0,0,0,0,0,0
TGCGATGCTAATGGCT-1_V12D07-335_B1,0,6,0,0,0,6
TTCTGTTTCCTGTCGC-1_V12D07-335_B1,1,1,0,0,0,2
CGTTGTAAACGTCAGG-1_V12D07-335_B1,3,1,1,0,0,5
GATCGGCGATAAGTCG-1_V12D07-335_B1,0,3,1,0,0,4
AGCCTTAAAGCGGAAG-1_V12D07-335_B1,1,3,1,0,0,5
TCCGTAACCACAATCC-1_V12D07-335_B1,0,1,1,0,0,2
GAATGCCGAAATGACC-1_V12D07-335_B1,1,5,0,0,0,6
TATACTCATGCGGCAA-1_V12D07-335_B1,1,2,0,0,0,3
TAGTGTCAGAAACGGC-1_V12D07-335_B1,0,1,1,0,0,2
CGTCATACCATATCCA-1_V12D07-335_B1,1,0,1,0,0,2
TAGTACCTTAGTGGTC-1_V12D07-335_B1,2,3,0,0,0,5
CTGGCGGGAATAAGTA-1_V12D07-335_B1,2,2,1,0,0,5
AGTGTGGTCTATTGTG-1_V12D07-335_B1,1,2,0,1,0,4
GCTATCGCGGCGCAAC-1_V12D07-335_B1,1,2,0,0,0,3
CAGTAATCCCTCCCAG-1_V12D07-335_B1,2,2,1,0,0,5
GTATTAAGGCGTCTAA-1_V12D07-335_B1,0,4,0,0,0,4
CTAATTTCAACAACAC-1_V12D07-335_B1,1,1,2,0,0,4
TTAGCAACATGGATGT-1_V12D07-335_B1,0,6,0,0,0,6
ATGCTCAGTGTTGCAT-1_V12D07-335_B1,0,4,0,0,0,4
GATGTTTGTGCGAGAT-1_V12D07-335_B1,0,2,2,0,0,4
CACTTCGCCACAGGCT-1_V12D07-335_B1,0,2,2,0,0,4
CTGTATGGTGTAGAAA-1_V12D07-335_B1,1,1,1,0,0,3
TACGTGCACTATGCTG-1_V12D07-335_B1,1,3,1,0,0,5
GTATCAGCTTGGGTTC-1_V12D07-335_B1,0,1,1,0,0,2
TAACAAAGGGAGAAGC-1_V12D07-335_B1,0,1,2,0,0,3
TTACATCGTGGCCTGG-1_V12D07-335_B1,1,0,1,0,0,2
TCTGAACCGGTCGGCT-1_V12D07-335_B1,1,1,2,0,0,4
GGCTCGTGCCACCAGC-1_V12D07-335_B1,1,3,0,0,0,4
TATAAGTGAGGATAGC-1_V12D07-335_B1,0,7,0,0,0,7
GCCCGCGCGTTTGACA-1_V12D07-335_B1,1,3,2,0,0,6
TGCTGGTTGGACAATT-1_V12D07-335_B1,1,6,0,0,0,7
GCCTAGCGATCTGACC-1_V12D07-335_B1,0,4,1,0,0,5
CCATGCTCTGCAGGAA-1_V12D07-335_B1,1,1,0,0,0,2
TATAAATCCACAAGCT-1_V12D07-335_B1,0,3,0,0,0,3
CGCTCGACATAATGAT-1_V12D07-335_B1,4,0,0,0,0,4
CCAATTGAATGTTAAT-1_V12D07-335_B1,1,1,0,0,0,2
GCTAATACCGAATGCC-1_V12D07-335_B1,1,1,1,0,0,3
TTCAACGACCCGACCG-1_V12D07-335_B1,1,1,2,0,0,4
TTCCTCGAGGGTGTCT-1_V12D07-335_B1,1,1,0,0,0,2
CAACGACCCGTTTACA-1_V12D07-335_B1,2,1,1,0,0,4
CTTGTACTTGTTGACT-1_V12D07-335_B1,2,1,0,0,0,3
TCTCTAATAGCTGGTA-1_V12D07-335_B1,0,2,1,0,0,3
ATTATGCCATAGGGAG-1_V12D07-335_B1,1,1,2,0,0,4
GACAACGCAGCTTACG-1_V12D07-335_B1,1,2,2,0,0,5
AGATGACTCGCCCACG-1_V12D07-335_B1,4,0,1,0,0,5
GTGCGGGTCTCCAAAT-1_V12D07-335_B1,0,3,2,0,0,5
GTACGAGATTGCGACA-1_V12D07-335_B1,4,1,1,0,0,6
GTATAGGACTCAGTAG-1_V12D07-335_B1,0,7,0,0,0,7
TTGCACGGAGCAGCAC-1_V12D07-335_B1,0,1,0,0,0,1
CACAGCTAGGGAGTGA-1_V12D07-335_B1,0,3,1,0,0,4
ATACTAGCATGACCCT-1_V12D07-335_B1,0,2,0,0,0,2
CCAAGACTTCTGCGAA-1_V12D07-335_B1,2,0,0,0,0,2
ACATAATAAGGCGGTG-1_V12D07-335_B1,3,0,0,0,0,3
TAATACACAGTAGTAT-1_V12D07-335_B1,2,2,1,0,0,5
TCTTGGTAACACCAAA-1_V12D07-335_B1,1,2,0,0,0,3
AACTGGGTCCCGACGT-1_V12D07-335_B1,0,1,0,0,0,1
ATCACTTCATCCTCGC-1_V12D07-335_B1,0,0,3,0,0,3
TGGAAGGATAAAGATG-1_V12D07-335_B1,0,2,1,0,0,3
CATGATGCACAATTCT-1_V12D07-335_B1,1,2,1,0,0,4
TGCCTGATCAAACGAT-1_V12D07-335_B1,0,2,1,0,0,3
ATAGGGATATCCTTGA-1_V12D07-335_B1,1,1,0,0,0,2
CACCTAATCAGTTTAC-1_V12D07-335_B1,0,0,0,0,0,0
TGTGACTACGCCAGTC-1_V12D07-335_B1,0,1,0,0,0,1
CCCGACCATAGTCCGC-1_V12D07-335_B1,2,4,0,0,0,6
CGCGCCCGACTTAATA-1_V12D07-335_B1,0,3,0,0,0,3
TGCCACCTGGCGAAAC-1_V12D07-335_B1,0,1,1,0,0,2
CTGCCAAGGTTGGAAG-1_V12D07-335_B1,0,3,1,0,0,4
TCTCCAACGTAGGTTA-1_V12D07-335_B1,1,4,0,0,0,5
TTCTTGGAGTAATGAG-1_V12D07-335_B1,1,2,1,0,0,4
GTCTCGATCTGCTTTC-1_V12D07-335_B1,1,1,1,0,0,3
TACTCTCCGAACAAAT-1_V12D07-335_B1,0,2,0,0,0,2
ATCACATTAGAATATC-1_V12D07-335_B1,1,4,2,0,0,7
TACGGGATGCTAGCAG-1_V12D07-335_B1,0,0,0,0,0,0
AGCTGAAGTAAACCAA-1_V12D07-335_B1,0,2,2,0,0,4
CATGGGTCGGGTGTGG-1_V12D07-335_B1,0,0,0,0,0,0
CACCCACGAGGCAATT-1_V12D07-335_B1,1,1,1,0,0,3
TGCCATTACTAAAGAA-1_V12D07-335_B1,0,1,0,0,0,1
CCGTTACGTTAGAACA-1_V12D07-335_B1,0,2,0,0,0,2
GCCAGGAGTAACCGAT-1_V12D07-335_B1,0,2,1,0,0,3
GGAAAGTGCCCATGCC-1_V12D07-335_B1,0,2,0,0,0,2
TCTTACCGGAACTCGT-1_V12D07-335_B1,0,1,3,0,0,4
TATGTCAAGACCGACT-1_V12D07-335_B1,1,1,0,0,0,2
CCTAACTAAGGCTCTA-1_V12D07-335_B1,0,2,0,0,0,2
GCGGTGAACTGCGCTC-1_V12D07-335_B1,1,1,0,0,0,2
CCTCGCGCGATATAGG-1_V12D07-335_B1,1,1,1,0,0,3
ATCGGCAAGCAGTCCA-1_V12D07-335_B1,1,2,0,0,0,3
AGATCGTGCATAAGAT-1_V12D07-335_B1,2,3,0,0,0,5
ATTCAGGACCTATTTC-1_V12D07-335_B1,1,2,2,0,0,5
AGCTAGAAGCAGAAGT-1_V12D07-335_B1,0,1,0,0,2,3
TTCGCTATCTGACGTG-1_V12D07-335_B1,1,2,1,0,0,4
TTCCGCAGAGAAATAT-1_V12D07-335_B1,0,2,2,0,1,5
CAGTACATTCTCTAAA-1_V12D07-335_B1,1,1,0,0,0,2
GTGAAGATTTCAAGTG-1_V12D07-335_B1,0,0,4,1,0,5
AACGCATGATCTGGGT-1_V12D07-335_B1,0,0,1,0,0,1
CCCAGAGGAGGGCGTA-1_V12D07-335_B1,0,0,4,0,0,4
GGAAACCTTGTTGAAT-1_V12D07-335_B1,0,0,4,0,0,4
GTGAAGCCGTATAGTC-1_V12D07-335_B1,1,4,0,0,0,5
GAGCTGTCGTCTCGGA-1_V12D07-335_B1,0,1,0,0,3,4
TGTCATTTGTTGGGAA-1_V12D07-335_B1,0,2,1,0,0,3
ACCAACACCACACACT-1_V12D07-335_B1,1,2,0,0,0,3
AAATGATTCGATCAGC-1_V12D07-335_B1,0,3,1,0,0,4
CTGCTTTATGTCCGCG-1_V12D07-335_B1,1,2,0,0,0,3
GCGAGAGGCCATGTAA-1_V12D07-335_B1,0,3,1,0,0,4
ATTGACCGGCGATGAC-1_V12D07-335_B1,0,2,2,0,0,4
ACCCTGGTAACGCCCT-1_V12D07-335_B1,1,2,0,0,0,3
GTTGGACCGCATCAGG-1_V12D07-335_B1,0,0,1,0,0,1
CGTTTACAAGGCAGCT-1_V12D07-335_B1,0,0,1,0,0,1
CGGTCCATGAGACTCC-1_V12D07-335_B1,0,2,0,0,1,3
GTTCGTCTGGGTCCCT-1_V12D07-335_B1,0,2,0,0,0,2
TGTACTACTCTCACGG-1_V12D07-335_B1,0,2,1,0,0,3
AGTGAAGATGGTGTCC-1_V12D07-335_B1,0,0,2,0,0,2
GAGGGCCATAATATTA-1_V12D07-335_B1,0,3,2,2,0,7
ACTCCCGTAGACTAGG-1_V12D07-335_B1,0,1,4,0,0,5
CGTCAAATGGTCGCAG-1_V12D07-335_B1,0,9,0,0,0,9
AAGTCTAGTAGCTGCC-1_V12D07-335_B1,0,7,1,0,0,8
AAGAAATCACCAGATT-1_V12D07-335_B1,0,9,0,0,0,9
GAGTGCACGGACAACA-1_V12D07-335_B1,0,8,0,0,0,8
GTTCAAATCAGATGTC-1_V12D07-335_B1,1,3,1,0,0,5
CATGGCTCCCTATGTC-1_V12D07-335_B1,0,5,0,0,0,5
GGCCACACGAAAGCCT-1_V12D07-335_B1,1,1,1,0,0,3
GAAGCCGGGTAAGCTC-1_V12D07-335_B1,1,4,1,0,0,6
TTGCGCTCTCTCGCTT-1_V12D07-335_B1,0,0,0,0,0,0
TACATGACCTTATCCG-1_V12D07-335_B1,1,2,1,0,0,4
GTCCTTCTACAACCCA-1_V12D07-335_B1,0,1,1,0,1,3
TATATGCTGGGTTGCC-1_V12D07-335_B1,2,1,1,0,0,4
GTTTATGGGATTTAGA-1_V12D07-335_B1,0,1,0,0,0,1
GGAACCCGAACAAGAA-1_V12D07-335_B1,0,0,0,0,0,0
AACGTTATCAGCACCT-1_V12D07-335_B1,1,2,0,0,0,3
CATCGTCCGGTTACTA-1_V12D07-335_B1,1,2,0,0,0,3
AGACAGCTCAGAATCC-1_V12D07-335_B1,0,2,1,0,0,3
GCAGATCCTCGCAAAT-1_V12D07-335_B1,1,2,0,0,0,3
GGGTCATGCGTACCAT-1_V12D07-335_B1,1,1,1,0,0,3
CTGGTCATTCCAATCC-1_V12D07-335_B1,0,1,1,0,0,2
TCAGGGCGCAAACTCG-1_V12D07-335_B1,0,4,1,0,0,5
GATGCCAGCAGAAGGC-1_V12D07-335_B1,0,2,0,0,0,2
GTTATTAACGTGGGAG-1_V12D07-335_B1,0,2,1,0,0,3
AATACAATGTTTCAGG-1_V12D07-335_B1,2,1,0,0,0,3
TTGCTGCACCTATCCA-1_V12D07-335_B1,0,2,1,0,0,3
CCAGAGACAAAGCCGG-1_V12D07-335_B1,2,3,1,0,0,6
CCGAAGTATATTGTTC-1_V12D07-335_B1,0,3,2,0,0,5
GCTAAACCTGAGGTGA-1_V12D07-335_B1,0,4,0,0,0,4
TCATACTTACAGATCC-1_V12D07-335_B1,0,1,0,0,0,1
CGAGCACTTCAAGTTT-1_V12D07-335_B1,0,3,3,0,0,6
TAGCAACCTGTCACAA-1_V12D07-335_B1,1,4,0,0,0,5
TGGGAAATGCCTTTCC-1_V12D07-335_B1,0,2,0,0,0,2
AGACCATGGGATACAA-1_V12D07-335_B1,0,1,2,0,0,3
TAAATGAATCCGTTTC-1_V12D07-335_B1,1,1,4,0,0,6
ACAACGGTCCCTGCGA-1_V12D07-335_B1,3,0,0,0,0,3
GTCACTCTCCAAATCT-1_V12D07-335_B1,0,2,1,0,0,3
TTCTACTTGCGAGGGC-1_V12D07-335_B1,0,0,0,0,0,0
CGCAATTACTTTCGGT-1_V12D07-335_B1,0,5,1,0,0,6
CTGTTCATCTCACGGG-1_V12D07-335_B1,1,2,2,0,0,5
TTCTTGTAACCTAATG-1_V12D07-335_B1,0,2,0,0,0,2
GCTTGATGATAATCAG-1_V12D07-335_B1,0,2,0,0,0,2
TTGGCTCGCATGAGAC-1_V12D07-335_B1,2,3,1,0,0,6
GCCCAGTTGGTATGCC-1_V12D07-335_B1,1,3,1,0,0,5
ATTCCTCCGCCAGTGC-1_V12D07-335_B1,1,2,0,0,0,3
TCGTCCGCTGGCGTCT-1_V12D07-335_B1,1,0,0,0,0,1
GGAGAAGTCATTGGCA-1_V12D07-335_B1,1,2,1,0,0,4
TTGTTAGCAAATTCGA-1_V12D07-335_B1,2,0,0,0,0,2
TCTAGCATCTTCGATG-1_V12D07-335_B1,0,2,2,0,0,4
TTCTAGGCCAATTGTG-1_V12D07-335_B1,0,5,0,0,0,5
TCACGGTCATCGCACA-1_V12D07-335_B1,0,2,0,0,0,2
ATGAAGCCAAGGAGCC-1_V12D07-335_B1,3,0,1,0,0,4
AATGACTGTCAGCCGG-1_V12D07-335_B1,2,1,0,0,0,3
CCAAACAGAACCCTCG-1_V12D07-335_B1,1,2,0,0,0,3
TATCGATGATTAAACG-1_V12D07-335_B1,1,1,0,0,0,2
GAACACACATCAACCA-1_V12D07-335_B1,3,0,0,0,0,3
CCCGTCAGCGTCTGAC-1_V12D07-335_B1,0,0,3,0,0,3
AGCATCGTCGATAATT-1_V12D07-335_B1,2,0,1,0,0,3
GACTAAGATCATGCAC-1_V12D07-335_B1,0,1,0,0,0,1
TAGGGTGTTTCAAGAG-1_V12D07-335_B1,3,1,0,0,0,4
TGGTTCGTAGCAAAGG-1_V12D07-335_B1,1,1,0,0,0,2
CTGTTCACTGCCTGTG-1_V12D07-335_B1,5,1,1,0,0,7
ATGTGCATCCGACGCA-1_V12D07-335_B1,1,0,0,0,0,1
TTGTCGTTCAGTTACC-1_V12D07-335_B1,3,1,0,0,0,4
CGGGATCAATGTAAGA-1_V12D07-335_B1,3,1,0,0,0,4
TTATCTGTATCATAAC-1_V12D07-335_B1,4,2,0,0,0,6
ATCGACTCTTTCCGTT-1_V12D07-335_B1,2,1,0,0,0,3
CTCATTTGATGGGCGG-1_V12D07-335_B1,0,3,0,0,0,3
GTAAGCGGGCAGTCAG-1_V12D07-335_B1,0,2,1,0,0,3
TCTATCGGTCGCAACA-1_V12D07-335_B1,1,1,0,0,0,2
AACGCGGTCTCCAGCC-1_V12D07-335_B1,2,1,0,0,0,3
ATTAATACTACGCGGG-1_V12D07-335_B1,1,3,1,0,0,5
CTTTAACTTTCAAAGG-1_V12D07-335_B1,0,2,0,0,0,2
CGTACCTGATAGGCCT-1_V12D07-335_B1,1,2,1,0,0,4
GAATGTTGGGTAATCT-1_V12D07-335_B1,1,3,0,0,0,4
TGCGGAGTAAAGGTGC-1_V12D07-335_B1,3,1,1,0,0,5
CCTGAATATTTACATA-1_V12D07-335_B1,1,1,0,0,0,2
TTGCTCCCATACCGGA-1_V12D07-335_B1,0,3,0,0,0,3
CCTCTAATCTGCCAAG-1_V12D07-335_B1,0,1,0,0,0,1
AGGTTGAGGCACGCTT-1_V12D07-335_B1,0,1,1,0,0,2
TCCCGTCAGTCCCGCA-1_V12D07-335_B1,0,1,0,0,0,1
TCCGATGACTGAGCTC-1_V12D07-335_B1,2,2,0,0,0,4
CAGCCTCCTGCAGAGG-1_V12D07-335_B1,0,3,0,0,0,3
CTTAGCCTTCCACATG-1_V12D07-335_B1,0,3,0,0,0,3
ATTAATGAACCAGTCG-1_V12D07-335_B1,0,1,1,0,0,2
ACGATACATAGAACTA-1_V12D07-335_B1,3,2,0,0,0,5
AGCCACTCCCGTGCTT-1_V12D07-335_B1,2,0,0,0,0,2
ATACGGGTTTCGATTG-1_V12D07-335_B1,1,4,0,0,0,5
CTGTCAAATGGCTCGG-1_V12D07-335_B1,1,2,1,0,0,4
GCTCGGAATTTAAAGC-1_V12D07-335_B1,0,1,0,0,0,1
TAGGCATGTTACGCCA-1_V12D07-335_B1,1,3,0,0,0,4
TGGCAACTCGCGCGCC-1_V12D07-335_B1,0,2,1,0,0,3
ATCAGTAGGCAGGGAT-1_V12D07-335_B1,1,3,0,0,0,4
TATCGATCTATGCATA-1_V12D07-335_B1,0,1,0,0,0,1
CGACTCAGGATGTTAT-1_V12D07-335_B1,0,1,1,0,0,2
GCCATATTGCACACAG-1_V12D07-335_B1,3,1,1,0,0,5
AATTCATAAGGGATCT-1_V12D07-335_B1,1,2,1,0,0,4
CGGTAGAGGTGCAGGT-1_V12D07-335_B1,0,1,5,0,0,6
AATGATGATACGCTAT-1_V12D07-335_B1,3,0,1,0,0,4
CTTGTGCTCACCGATT-1_V12D07-335_B1,0,2,2,0,0,4
TTCCAATCAGAGCTAG-1_V12D07-335_B1,0,0,0,0,1,1
CGATGGACCCTACGCC-1_V12D07-335_B1,0,3,0,0,0,3
GGTCGGATAAACGGCG-1_V12D07-335_B1,0,1,0,0,2,3
TTAGCTAATACGATCT-1_V12D07-335_B1,0,0,2,0,2,4
CTCGATATTTGCGAGC-1_V12D07-335_B1,0,0,1,0,0,1
ATTACTTACTGGGCAT-1_V12D07-335_B1,0,0,3,0,0,3
CTAGCCGATGTTATGA-1_V12D07-335_B1,0,0,1,0,0,1
TACTGCAATCAATTAC-1_V12D07-335_B1,0,0,2,1,0,3
TAGTCTGTGACGTTGC-1_V12D07-335_B1,0,0,4,0,0,4
CTCGTTTCTAATGTTT-1_V12D07-335_B1,0,0,5,0,0,5
TTCGTTCAACGAAGTT-1_V12D07-335_B1,1,0,0,0,1,2
CTGAATTTATTGCCAG-1_V12D07-335_B1,0,0,0,0,1,1
TGGAATATCCTTGACC-1_V12D07-335_B1,1,0,0,0,0,1
CAGATCATTTAAAGTC-1_V12D07-335_B1,1,3,0,0,0,4
CTCCTTTACGCAAGTC-1_V12D07-335_B1,0,3,2,0,0,5
TCCCAAACAGACAACG-1_V12D07-335_B1,0,1,1,0,0,2
ATCGCTGCGTGCAGCA-1_V12D07-335_B1,0,3,0,0,0,3
TTAGTTCAAGTGTTCG-1_V12D07-335_B1,0,1,0,0,0,1
AAACTCGTGATATAAG-1_V12D07-335_B1,0,0,0,0,0,0
TTAACGAACAAGCAGT-1_V12D07-335_B1,1,2,0,0,0,3
GTTATATCAGGAGCCA-1_V12D07-335_B1,1,4,0,0,0,5
CAAATTGGATTATGCC-1_V12D07-335_B1,1,1,0,0,0,2
CGAGGAGCTTCCATAT-1_V12D07-335_B1,1,4,0,0,0,5
GGAGACCAATGTGCTT-1_V12D07-335_B1,0,2,0,0,0,2
CATTGATGAACACGCC-1_V12D07-335_B1,0,4,1,0,0,5
GTCAATGCTATAATTT-1_V12D07-335_B1,1,1,0,0,0,2
ACCACCCTCTCTTCTA-1_V12D07-335_B1,0,2,0,0,0,2
TGGAGGGAAACACCTC-1_V12D07-335_B1,0,4,3,0,0,7
CACGGACGTGGATGGC-1_V12D07-335_B1,0,6,3,2,0,11
AACTTTCTCGATCATG-1_V12D07-335_B1,0,6,5,0,0,11
CGTATTGTTTCCTAAT-1_V12D07-335_B1,0,13,0,0,0,13
CCTACTGCGGCGGCCA-1_V12D07-335_B1,0,8,0,0,0,8
CTTAGGTCCCAATCGT-1_V12D07-335_B1,0,10,1,0,0,11
CGCAATCGATCATTAG-1_V12D07-335_B1,2,0,0,0,0,2
TGGTTATGCTTGCGGT-1_V12D07-335_B1,4,1,0,0,0,5
GGCTTGGCTCTCACCT-1_V12D07-335_B1,1,2,0,0,0,3
ATTGGTAGGATCCGCT-1_V12D07-335_B1,3,0,0,0,0,3
TCAGGGCGACTTCCTT-1_V12D07-335_B1,0,1,1,0,0,2
TCTGCAGATTCGAGTC-1_V12D07-335_B1,0,0,2,0,0,2
CTCTCGCTGTACTATG-1_V12D07-335_B1,0,0,1,0,0,1
AATAGTCGCGAGTCGG-1_V12D07-335_B1,3,0,2,0,1,6
AGTTACCCTTAAGACT-1_V12D07-335_B1,2,1,0,0,0,3
CTTAAATAAGACCCAT-1_V12D07-335_B1,2,0,1,0,0,3
GGTTGTGCTCTTGTCC-1_V12D07-335_B1,5,0,0,0,0,5
GTGAGTCTAAGACGGA-1_V12D07-335_B1,0,1,4,0,0,5
CGCGACACTGCGCAGC-1_V12D07-335_B1,0,0,2,0,0,2
GCTCGCGGTTCCGCTC-1_V12D07-335_B1,1,2,0,0,0,3
TTAACTCACGCGTGGA-1_V12D07-335_B1,1,0,0,0,0,1
GGAACGGCCTGCAGCC-1_V12D07-335_B1,2,0,0,0,0,2
GTAGAAACGGGTGGAG-1_V12D07-335_B1,0,1,1,0,0,2
TAATGAAAGACCCTTG-1_V12D07-335_B1,0,0,3,0,0,3
AGGCTTGCTAGACACC-1_V12D07-335_B1,1,1,0,0,0,2
TTGCGTAGTTTGAGGA-1_V12D07-335_B1,1,0,0,0,0,1
CGCCCTTGAAGGCTGA-1_V12D07-335_B1,0,2,1,0,0,3
CCCGGTGGAAGAACCT-1_V12D07-335_B1,2,1,2,0,0,5
TTAACACCTCGAACAT-1_V12D07-335_B1,0,1,1,0,0,2
GATTCCTATACGGCGC-1_V12D07-335_B1,0,3,2,0,0,5
TTACCCTAACAGTCCT-1_V12D07-335_B1,0,1,2,0,0,3
ACCCACCTACATGCTC-1_V12D07-335_B1,1,1,0,0,0,2
AAAGGGCAGCTTGAAT-1_V12D07-335_B1,1,2,0,0,0,3
CACACAGGGATAGATT-1_V12D07-335_B1,0,1,0,0,0,1
AGAGCGTACAAGCTCG-1_V12D07-335_B1,1,6,0,0,0,7
TCTTACGGCATCCGAC-1_V12D07-335_B1,0,1,0,0,0,1
GCCTATTCCGATATAG-1_V12D07-335_B1,0,2,0,0,0,2
GAAAGTGACTAACTGC-1_V12D07-335_B1,2,2,0,0,0,4
CCGGAATGGTTTCAGT-1_V12D07-335_B1,1,1,0,0,0,2
AGTATAATACTAGGCA-1_V12D07-335_B1,1,3,0,0,0,4
TAACTATCGAAGGTCC-1_V12D07-335_B1,2,1,1,0,0,4
ATGAGGAGTGTTAATC-1_V12D07-335_B1,2,3,0,0,0,5
TGTGTCGCGAGTTGCA-1_V12D07-335_B1,1,0,0,0,0,1
ATCCAACGCAGTCATA-1_V12D07-335_B1,0,2,0,0,0,2
AAGGCGCGTAAAGCTT-1_V12D07-335_B1,1,1,0,0,0,2
AGTCGGCCCAAACGAC-1_V12D07-335_B1,3,3,0,0,0,6
AACGTCAGACTAGTGG-1_V12D07-335_B1,0,2,0,0,0,2
ACTACCAGCTCTCTGG-1_V12D07-335_B1,0,0,1,0,0,1
GCAAGTGCACAGAGAA-1_V12D07-335_B1,2,1,1,0,0,4
ACACCTTAAGTAGGGC-1_V12D07-335_B1,0,1,2,0,0,3
TTCGACGGGAAGGGCG-1_V12D07-335_B1,1,4,0,0,0,5
TTCGCACTCGCGTGCT-1_V12D07-335_B1,2,2,1,0,0,5
TATTTGTTACCCTTTA-1_V12D07-335_B1,2,0,1,0,0,3
CGCTGTGACGCCGCAC-1_V12D07-335_B1,2,0,1,0,0,3
GTTGCACGGAGTTTCG-1_V12D07-335_B1,1,1,1,0,0,3
GTTTCCTGGAGGGTGA-1_V12D07-335_B1,1,1,0,0,0,2
ACACCCAGCATGCAGC-1_V12D07-335_B1,1,4,0,0,0,5
TCAACCATGTTCGGGC-1_V12D07-335_B1,1,1,0,0,0,2
TTACAACTACGCATCC-1_V12D07-335_B1,0,2,1,0,0,3
TCCGATGGTGCGACAT-1_V12D07-335_B1,0,0,1,0,0,1
GGGCGTACATTTATAT-1_V12D07-335_B1,5,1,0,0,0,6
AGCGACCAACGATATT-1_V12D07-335_B1,2,3,0,0,0,5
ACACAAAGACGGGTGG-1_V12D07-335_B1,2,1,0,0,0,3
ATCGCACGCCGGGAGA-1_V12D07-335_B1,0,1,0,0,0,1
GCTCTAAACCCTGACG-1_V12D07-335_B1,5,0,0,0,0,5
AATGCAACCGGGTACC-1_V12D07-335_B1,1,0,1,0,0,2
TCAAACAACCGCGTCG-1_V12D07-335_B1,1,0,0,0,0,1
TATGCTCCCTACTTAC-1_V12D07-335_B1,2,2,1,0,0,5
AAAGGGATGTAGCAAG-1_V12D07-335_B1,0,2,0,0,0,2
ACGATCATACATAGAG-1_V12D07-335_B1,8,1,1,0,0,10
TTGTTCAGTGTGCTAC-1_V12D07-335_B1,0,0,0,0,0,0
ATGCATGATCCAGGAT-1_V12D07-335_B1,0,1,1,0,0,2
AGTCTTCTCCTCAAAT-1_V12D07-335_B1,0,1,1,0,0,2
GATTCCCTTGTCGCAG-1_V12D07-335_B1,4,0,0,0,0,4
CTCGCACCTATATAGT-1_V12D07-335_B1,2,1,1,0,0,4
ACTCAATAAAGGCACG-1_V12D07-335_B1,1,0,0,0,0,1
AACCGAGCTTGGTCAT-1_V12D07-335_B1,1,0,1,0,0,2
TAAGGCAACATAAGAT-1_V12D07-335_B1,0,2,0,0,0,2
CACGCACAGCGCAGCT-1_V12D07-335_B1,1,1,1,0,0,3
GGTTTACAATCTCAAT-1_V12D07-335_B1,1,5,1,0,0,7
TGCAGGATCGGCAAAG-1_V12D07-335_B1,0,0,1,0,0,1
ATAACGGAGTCCAACG-1_V12D07-335_B1,1,1,1,0,0,3
AACGATATGTCAACTG-1_V12D07-335_B1,1,1,0,0,0,2
GACAACGACCATTGAA-1_V12D07-335_B1,1,0,0,0,0,1
TTGACCATGTTCTCCG-1_V12D07-335_B1,0,2,1,0,0,3
AGTACGGGCACCTGGC-1_V12D07-335_B1,0,2,2,0,0,4
CGCCATCCGATTATGA-1_V12D07-335_B1,1,0,1,0,0,2
AAGGTATCCTAATATA-1_V12D07-335_B1,0,0,1,0,0,1
TGTTGTCAAGAAGTCT-1_V12D07-335_B1,1,2,1,0,0,4
CAGTGAATAAATGACT-1_V12D07-335_B1,5,1,1,0,0,7
CACCTTGCGAAACTCG-1_V12D07-335_B1,2,4,2,1,0,9
CATTTAGCGGACCATG-1_V12D07-335_B1,3,0,1,0,0,4
CCAGTCTAGACGGCGC-1_V12D07-335_B1,2,0,0,0,0,2
TCGCTTTAAACGTTTG-1_V12D07-335_B1,0,1,1,0,1,3
GTGAAACGGCGCCACC-1_V12D07-335_B1,1,2,0,0,0,3
GGGCTCATCGAACCCA-1_V12D07-335_B1,0,1,0,0,0,1
TTGATGTGTAGTCCCG-1_V12D07-335_B1,1,4,1,0,0,6
CAGTAGCCCACGCGGT-1_V12D07-335_B1,0,2,1,0,2,5
AGCGCGGGTGCCAATG-1_V12D07-335_B1,0,2,1,0,0,3
TAATCGATCCGTACGT-1_V12D07-335_B1,0,1,3,0,1,5
AGTGGCGGCAATTTGA-1_V12D07-335_B1,0,3,2,0,0,5
CCTTTCAATGAAGAAA-1_V12D07-335_B1,0,3,1,0,1,5
CTCAGTCACGACAAAT-1_V12D07-335_B1,0,1,0,0,1,2
ATAGGCTAGCTTCGCA-1_V12D07-335_B1,0,0,1,0,2,3
CGGTTCAAGTAGGTGT-1_V12D07-335_B1,0,0,1,0,3,4
CAGTCGAGGATGCAAT-1_V12D07-335_B1,0,0,0,0,2,2
TATCACCCAACCGACC-1_V12D07-335_B1,0,0,2,0,0,2
AATGATGCGACTCCTG-1_V12D07-335_B1,0,0,0,0,1,1
TGGAACCACTGACACA-1_V12D07-335_B1,0,0,0,0,2,2
GCCAATAGGGCATCTC-1_V12D07-335_B1,2,2,0,0,1,5
TTCTTTGGTCGCGACG-1_V12D07-335_B1,1,3,0,0,0,4
ATTAGATTCCTCAGCA-1_V12D07-335_B1,1,2,0,0,0,3
CCGTGGAACGATCCAA-1_V12D07-335_B1,1,3,1,0,0,5
GGGTCGTGGCAAGTGT-1_V12D07-335_B1,0,3,1,0,0,4
TCGCTCGGCACCAGCG-1_V12D07-335_B1,0,2,2,0,0,4
ACGCAATCACTACAGC-1_V12D07-335_B1,2,2,0,0,0,4
CTCTAATGCATTGATC-1_V12D07-335_B1,0,2,1,0,0,3
GTCTCGACTAAGTTTG-1_V12D07-335_B1,0,2,1,0,0,3
TGGTTTAAACGTGGGT-1_V12D07-335_B1,1,2,1,0,0,4
CGCAGATCTTCACCCG-1_V12D07-335_B1,0,1,0,0,0,1
TCCAGATGTACGCCAA-1_V12D07-335_B1,1,2,0,0,0,3
CATTGCGGGTCAATTC-1_V12D07-335_B1,1,0,2,0,0,3
GACGTTCGTAAATACA-1_V12D07-335_B1,1,1,0,0,0,2
TACACCGTCGTTAGTC-1_V12D07-335_B1,2,0,2,0,0,4
ACGGGCGTATGCGACA-1_V12D07-335_B1,0,2,1,0,0,3
GAAGGCTACCATTGTT-1_V12D07-335_B1,0,4,0,0,0,4
TAAATCTTTACACCTC-1_V12D07-335_B1,0,1,1,0,0,2
AGTTTATGTAAAGACA-1_V12D07-335_B1,1,1,0,0,0,2
AGGAGACATCCACAGT-1_V12D07-335_B1,0,2,2,0,0,4
CAACCTGAACCTGCCA-1_V12D07-335_B1,0,7,4,1,0,12
AGTCCCTCGCAGAAAG-1_V12D07-335_B1,0,12,1,0,0,13
TGTATACGGATGATGA-1_V12D07-335_B1,0,9,1,0,0,10
TTGTGGTATAGGTATG-1_V12D07-335_B1,0,12,0,0,0,12
TCTGCACCATTAGTAA-1_V12D07-335_B1,0,14,1,0,0,15
AAATGTATCTTATCCC-1_V12D07-335_B1,1,0,1,0,0,2
ACTCTAAACCTGGGAT-1_V12D07-335_B1,2,1,0,0,0,3
GCTGGCAGGTGCCGTG-1_V12D07-335_B1,0,0,2,0,0,2
CTCATTCGTGAACATC-1_V12D07-335_B1,5,0,2,0,0,7
TCGCCGGATGGGCAAG-1_V12D07-335_B1,3,1,1,0,0,5
GGACTAAGTCAGGAGT-1_V12D07-335_B1,1,1,4,0,0,6
TATCAAAGGTCTGTAA-1_V12D07-335_B1,2,0,2,0,0,4
TTCAGTTTGTGGCAGC-1_V12D07-335_B1,1,0,0,0,0,1
TGTTCATAAATGTGCT-1_V12D07-335_B1,2,0,2,0,0,4
CTTAGCCCGGATAGTG-1_V12D07-335_B1,2,0,1,0,0,3
GATGCGAATGGTATTA-1_V12D07-335_B1,3,0,0,0,0,3
TCTAACTGTATGTAAA-1_V12D07-335_B1,2,0,0,0,0,2
TTAAACCTGGTTCCTT-1_V12D07-335_B1,1,0,2,0,0,3
GCTAAGTAAAGGCGAT-1_V12D07-335_B1,0,0,2,0,0,2
AGTTACCGCACATGGT-1_V12D07-335_B1,2,0,1,0,0,3
GACTGCGGCACGTGTA-1_V12D07-335_B1,3,1,0,0,0,4
TGGTGATCGTATTTGT-1_V12D07-335_B1,4,0,1,0,0,5
TTATCGCCTGCGAAGC-1_V12D07-335_B1,3,0,1,0,0,4
TGGAATTAGACGCTTT-1_V12D07-335_B1,1,0,0,0,0,1
TCGTCACACTGTTAGC-1_V12D07-335_B1,3,3,0,0,0,6
TTATGTTTGCGATAGA-1_V12D07-335_B1,2,2,2,0,0,6
GGTGCTGATCACAAAG-1_V12D07-335_B1,3,1,2,0,0,6
CATAGCCGCCCGGGAT-1_V12D07-335_B1,0,3,2,0,0,5
GGTTAGTTACGGCGCC-1_V12D07-335_B1,1,1,0,0,0,2
ATTCCCACATAAACAA-1_V12D07-335_B1,0,0,1,0,0,1
ATTCAGTAGCAGGGTC-1_V12D07-335_B1,1,3,1,0,0,5
CAGTTCCGCGGGTCGA-1_V12D07-335_B1,0,1,1,0,0,2
AAGAGATGAATCGGTA-1_V12D07-335_B1,0,2,0,0,0,2
CGCAATTCTACAATAA-1_V12D07-335_B1,0,4,0,0,0,4
TAACGCTTTGAGAGCG-1_V12D07-335_B1,0,1,0,0,0,1
AGGCTATGGTTAGCTT-1_V12D07-335_B1,0,3,1,0,0,4
GAGGAATGGAGAGGTT-1_V12D07-335_B1,0,2,0,0,0,2
TCCTCTACGAGATGGC-1_V12D07-335_B1,0,4,1,0,0,5
TTGATTATGCAGATGA-1_V12D07-335_B1,0,2,0,0,0,2
TCAGTACTGACCCGCG-1_V12D07-335_B1,1,3,0,0,0,4
TTATGACAAACTGGAT-1_V12D07-335_B1,0,1,0,0,0,1
GTAAGTAGGGTATACC-1_V12D07-335_B1,1,3,0,0,0,4
CGCAAACACGAGTTAC-1_V12D07-335_B1,0,3,0,0,0,3
TGGCCGTATATTGACC-1_V12D07-335_B1,1,2,1,0,0,4
ACTGTAGCACTTTGGA-1_V12D07-335_B1,0,0,1,0,0,1
GCTCTATGTTACGTGC-1_V12D07-335_B1,0,3,2,0,0,5
TGCGCGATTAACGGAG-1_V12D07-335_B1,0,0,1,0,0,1
GAATCGACATGGTCAC-1_V12D07-335_B1,0,5,1,0,0,6
GACTAAGTAGGCTCAC-1_V12D07-335_B1,0,3,0,0,0,3
ATCTTGACCTGCAACG-1_V12D07-335_B1,1,4,1,0,0,6
ATGCACTACCGCATTG-1_V12D07-335_B1,1,0,0,1,0,2
CAGATACTAACATAGT-1_V12D07-335_B1,3,2,0,0,0,5
GATCGACACTATCTGA-1_V12D07-335_B1,0,2,1,0,0,3
ATAGAGTACTGGGACA-1_V12D07-335_B1,2,3,1,0,0,6
CCTACTGCTTACACTT-1_V12D07-335_B1,1,4,0,1,0,6
CCTGCTATTTGAGAAG-1_V12D07-335_B1,0,2,0,0,0,2
CGCGTTCATGAAATAC-1_V12D07-335_B1,1,2,0,0,0,3
CATTATGCTTGTTGTG-1_V12D07-335_B1,1,3,0,0,0,4
CCAGGGACGTGGCCTC-1_V12D07-335_B1,0,1,1,0,0,2
TATGGATGTGCTACGC-1_V12D07-335_B1,0,3,0,0,0,3
GTACTAAGATTTGGAG-1_V12D07-335_B1,0,2,0,0,0,2
AGACCCGCCCTCCTCG-1_V12D07-335_B1,9,1,0,0,0,10
CGCATTAGCTAATAGG-1_V12D07-335_B1,3,1,0,0,0,4
GCTCTCGGGTACCGAA-1_V12D07-335_B1,2,1,0,0,0,3
CACCGCCAGAAGGTTT-1_V12D07-335_B1,7,0,0,0,0,7
TCCCAAAGACGAAGGA-1_V12D07-335_B1,2,2,1,0,0,5
ATGGATTGACCAAACG-1_V12D07-335_B1,2,1,0,0,0,3
GTCATGGACATGACTA-1_V12D07-335_B1,1,1,1,0,0,3
CTACTGCCACCTGACC-1_V12D07-335_B1,0,2,0,0,0,2
TTATATTTGGCAATCC-1_V12D07-335_B1,2,0,1,0,0,3
AGCACCAGTACTCACG-1_V12D07-335_B1,1,1,0,0,0,2
CATGGTCTAGATACCG-1_V12D07-335_B1,1,4,0,0,0,5
TCTACCGTCCACAAGC-1_V12D07-335_B1,2,2,1,0,0,5
CTAGTTGGGCCCGGTA-1_V12D07-335_B1,1,1,1,0,0,3
TCCCGCGTACTCCTGG-1_V12D07-335_B1,0,2,1,0,0,3
CAGAGCATGAGCTTGC-1_V12D07-335_B1,2,1,0,0,0,3
ACACGGGAACTTAGGG-1_V12D07-335_B1,2,3,0,0,0,5
GGCTCTGCTCCAACGC-1_V12D07-335_B1,0,0,0,0,0,0
AGAACGTGGTACATTC-1_V12D07-335_B1,2,1,1,0,0,4
CAATAAACCTTGGCCC-1_V12D07-335_B1,0,0,1,0,0,1
ACTTCGCCATACGCAC-1_V12D07-335_B1,0,0,2,0,0,2
ATCTGGTTAAGACTGT-1_V12D07-335_B1,0,3,1,0,0,4
TCGTAAGACGACATTG-1_V12D07-335_B1,2,1,1,0,0,4
GTGTACCTTGGCTACG-1_V12D07-335_B1,0,1,2,0,0,3
GCCCGTAATACCTTCT-1_V12D07-335_B1,0,2,1,0,0,3
CGGTCAAGTGGGAACC-1_V12D07-335_B1,0,3,1,0,0,4
TTGTAAGGCCAGTTGG-1_V12D07-335_B1,0,0,1,0,0,1
GGAGCACCAAGAACTA-1_V12D07-335_B1,1,4,2,0,0,7
TAATAGTGACGACCAG-1_V12D07-335_B1,0,0,1,0,1,2
CTAAATCCTATTCCGG-1_V12D07-335_B1,0,2,0,0,0,2
CGAGTTCTGTCCCACC-1_V12D07-335_B1,0,0,0,0,3,3
AGGCAGATGCGTAAAC-1_V12D07-335_B1,0,0,0,0,3,3
AAGGATGAGGGACCTC-1_V12D07-335_B1,0,0,0,0,2,2
AGAGAACCGTCTAGGA-1_V12D07-335_B1,0,1,0,0,0,1
GAGGGCGCAGCTCTGC-1_V12D07-335_B1,0,1,1,0,2,4
AAGATTGGCGGAACGT-1_V12D07-335_B1,0,0,1,0,1,2
CCAGTAGTCTGATCCA-1_V12D07-335_B1,0,2,1,0,1,4
AAGGGACAGATTCTGT-1_V12D07-335_B1,0,1,3,0,1,5
ATAGAGTTATCAACTT-1_V12D07-335_B1,0,3,5,0,1,9
AAATTACCTATCGATG-1_V12D07-335_B1,0,0,0,0,1,1
GATCCTAAATCGGGAC-1_V12D07-335_B1,0,0,0,0,3,3
TTACAGACCTAAATGA-1_V12D07-335_B1,0,0,1,0,3,4
CCTCACCTTAGCATCG-1_V12D07-335_B1,0,1,0,0,1,2
CATGCGACCAGTTTAA-1_V12D07-335_B1,0,0,2,0,3,5
AACATATCAACTGGTG-1_V12D07-335_B1,0,0,0,0,1,1
CTATAAGAGCCAATCG-1_V12D07-335_B1,0,0,1,0,1,2
AATATCGAGGGTTCTC-1_V12D07-335_B1,1,0,1,0,0,2
GTACTCCTGGGTATGC-1_V12D07-335_B1,0,1,0,0,0,1
ATAAGTAGGATTCAGA-1_V12D07-335_B1,1,1,1,0,0,3
AGGTCGCGGAGTTACT-1_V12D07-335_B1,1,1,1,0,0,3
CTAATTCTCAGATATT-1_V12D07-335_B1,0,3,0,0,0,3
GCCAACCATTTCCGGA-1_V12D07-335_B1,0,1,0,0,0,1
TGATCCCAGCATTAGT-1_V12D07-335_B1,0,3,2,0,0,5
CGTTGTAAGATTGATT-1_V12D07-335_B1,0,2,0,0,0,2
GAAACCATGGTGCGCT-1_V12D07-335_B1,1,2,0,0,0,3
AATCTATGCCGGAGCC-1_V12D07-335_B1,1,6,0,0,0,7
GACTCCCAGAATAAGG-1_V12D07-335_B1,3,0,0,0,0,3
TATGATCCGGCACGCC-1_V12D07-335_B1,1,1,0,0,0,2
CCGCTTGCTGACATGG-1_V12D07-335_B1,0,4,0,0,0,4
TGGTTAAGGGCGCTGG-1_V12D07-335_B1,1,0,1,0,0,2
TTGATAGTCAATACAT-1_V12D07-335_B1,0,1,0,0,0,1
GGTTTAATTGAGCAGG-1_V12D07-335_B1,0,4,1,0,0,5
CATTACATAGATTGTG-1_V12D07-335_B1,1,3,0,0,0,4
GGTACACCAGATTTAT-1_V12D07-335_B1,0,2,0,0,0,2
GGCCCGTATACCATGC-1_V12D07-335_B1,0,3,0,0,0,3
ATCTTTCGTATAACCA-1_V12D07-335_B1,1,1,0,0,0,2
GAGATGACAATCCTTA-1_V12D07-335_B1,0,0,0,0,0,0
AAAGCTTGCCTACATA-1_V12D07-335_B1,0,0,1,0,0,1
GAACGATAAGTTAAAG-1_V12D07-335_B1,0,2,4,1,0,7
TAATAGCTAAATGATG-1_V12D07-335_B1,0,8,0,1,0,9
TATGGCTAGGCTAATT-1_V12D07-335_B1,0,8,3,0,0,11
AGGAGAGTCTGGCTAC-1_V12D07-335_B1,0,11,0,0,0,11
TGCTCTGCCGGTTCAC-1_V12D07-335_B1,0,7,1,0,0,8
CCAATAGATTTCATCT-1_V12D07-335_B1,2,0,0,0,0,2
GGGCACGAATTGGCCG-1_V12D07-335_B1,1,0,1,0,0,2
TCGTTGACAGGGTCCC-1_V12D07-335_B1,3,0,2,0,0,5
ATCGTATTCCGAGAAC-1_V12D07-335_B1,3,1,1,0,0,5
GGGAATTCTGTCCAGT-1_V12D07-335_B1,2,0,0,1,0,3
ACGCGTTTCTTAAGAG-1_V12D07-335_B1,5,1,0,0,0,6
GAGAGCGCAGTCCCTG-1_V12D07-335_B1,4,0,1,0,0,5
GTCCTATTGTTGTGGT-1_V12D07-335_B1,2,0,2,0,0,4
CATCTGCAGGATCATT-1_V12D07-335_B1,1,1,4,0,0,6
GAGTCGACAGACCCTC-1_V12D07-335_B1,1,0,2,0,0,3
AAGTGCAAAGGTAGAC-1_V12D07-335_B1,2,0,1,0,0,3
AGGGTGGATAGTGCAT-1_V12D07-335_B1,1,0,0,0,0,1
TGATAGCGGGATTCTA-1_V12D07-335_B1,2,2,0,0,0,4
GTCAGTTTGGTAGTCG-1_V12D07-335_B1,4,2,1,0,0,7
GCATTCGAAATGAACA-1_V12D07-335_B1,2,0,0,0,0,2
AAAGACTGGGCGCTTT-1_V12D07-335_B1,4,3,0,0,0,7
TAACAATATTTGTTGC-1_V12D07-335_B1,4,0,1,0,0,5
CCAGCTTCCGCCCGCA-1_V12D07-335_B1,2,0,0,0,0,2
GATATGGATTACGCGG-1_V12D07-335_B1,3,1,3,0,0,7
AGAGCAGTTATGAGAC-1_V12D07-335_B1,2,2,1,0,0,5
TCACATCTTATCTGAT-1_V12D07-335_B1,5,0,0,0,0,5
TATGAAGACAGGTGCG-1_V12D07-335_B1,3,0,3,0,0,6
TACCTGCTGCACTGTG-1_V12D07-335_B1,2,1,2,0,0,5
TAGGTCCAAGTAAGGA-1_V12D07-335_B1,0,3,0,0,0,3
GAAACTCGTGCGATGC-1_V12D07-335_B1,1,5,0,0,0,6
AACAATTACTCTACGC-1_V12D07-335_B1,0,3,0,0,0,3
CCGCACGTGACCTCGG-1_V12D07-335_B1,0,3,2,0,0,5
AACTTGCCCGTATGCA-1_V12D07-335_B1,1,2,0,0,0,3
GGGTATGTATGCACTT-1_V12D07-335_B1,1,2,0,0,0,3
TTCGTACTCCAGAACG-1_V12D07-335_B1,1,2,0,0,0,3
GAATTTCTCGCTGCAG-1_V12D07-335_B1,0,1,1,0,0,2
AACAGGATGGGCCGCG-1_V12D07-335_B1,0,4,1,0,0,5
GACGTGTAGGGATTAT-1_V12D07-335_B1,0,3,1,0,0,4
TAGGTGAGCCCTACTC-1_V12D07-335_B1,0,1,0,0,0,1
CTAATTCGCACGCGCT-1_V12D07-335_B1,0,1,0,0,0,1
GAAGCTTGCTGACCGC-1_V12D07-335_B1,0,2,0,0,0,2
GGTTAGGCTTGGAGAA-1_V12D07-335_B1,1,1,0,0,0,2
ACAAGGACAAGAGGTT-1_V12D07-335_B1,1,1,2,0,0,4
AGGCCACCCGTTATGA-1_V12D07-335_B1,0,1,0,0,0,1
GTGGGCTTAGACACAC-1_V12D07-335_B1,0,1,0,0,0,1
CGTGTCCCATTCGCGA-1_V12D07-335_B1,0,0,1,0,0,1
TGGAGTGATGCGATGA-1_V12D07-335_B1,0,5,2,0,0,7
AACAACTGGTAGTTGC-1_V12D07-335_B1,0,0,1,0,0,1
CCTGGCTAGACCCGCC-1_V12D07-335_B1,0,0,1,0,0,1
CGCAATTAGGGTAATA-1_V12D07-335_B1,0,1,0,0,0,1
TCGAAATTTAGGACCA-1_V12D07-335_B1,0,0,5,0,0,5
AGACTAGCCTTCCAGA-1_V12D07-335_B1,0,1,2,0,0,3
TTGATCTAACTTTGTC-1_V12D07-335_B1,0,2,0,0,0,2
AAGGAGCGGTTGGTGC-1_V12D07-335_B1,1,1,1,0,0,3
ACTTGGGACCCGGTGG-1_V12D07-335_B1,2,0,0,0,0,2
TGATCTCCGGCGCCAG-1_V12D07-335_B1,0,1,2,0,0,3
CAGTTCAAATTGACAC-1_V12D07-335_B1,0,5,1,0,0,6
GTCCGGCTGAATTGCG-1_V12D07-335_B1,2,1,0,0,0,3
CTGGAAATGGATGCTT-1_V12D07-335_B1,0,2,0,0,0,2
TGATCGGTTTGACCCT-1_V12D07-335_B1,1,3,0,0,0,4
TAGAGTCTAAGCGAAC-1_V12D07-335_B1,4,0,0,0,0,4
GAGACTGATGGGTAGA-1_V12D07-335_B1,3,1,0,0,0,4
TAGCTAAGTCCGGGAG-1_V12D07-335_B1,1,0,1,0,0,2
GGGCGATATGTGTGAA-1_V12D07-335_B1,0,1,0,0,0,1
CTCGAGGTCGAACAGT-1_V12D07-335_B1,3,0,1,0,0,4
GATCCCTTTATACTGC-1_V12D07-335_B1,2,1,0,0,0,3
GTCATGCACCTCCGTT-1_V12D07-335_B1,1,0,0,0,0,1
ACTTTCCTATAGCTTC-1_V12D07-335_B1,0,0,0,0,0,0
TCGCTCGATATATTCC-1_V12D07-335_B1,2,0,0,0,0,2
ATAGGTTGGGCAGATG-1_V12D07-335_B1,1,0,0,0,0,1
CAATTAAGGGTGATGA-1_V12D07-335_B1,2,0,0,0,0,2
ACCGACTGAGTCCCAC-1_V12D07-335_B1,3,0,1,0,0,4
CCTGTCACCCGGGCTC-1_V12D07-335_B1,1,0,0,0,0,1
GATCGGTGGCCATAAC-1_V12D07-335_B1,0,0,0,0,0,0
CCTATGGGTTACCGTC-1_V12D07-335_B1,1,0,2,0,0,3
TTGGGACACTGCCCGC-1_V12D07-335_B1,2,0,0,0,0,2
CGAGGCTAAATATGGC-1_V12D07-335_B1,1,0,0,0,0,1
TCAGGGTGTAACGTAA-1_V12D07-335_B1,1,1,2,0,0,4
CGAGAGATGTGAACCT-1_V12D07-335_B1,6,0,2,0,0,8
TCGCTGGGCGGATTGT-1_V12D07-335_B1,3,0,0,0,0,3
AGATCTCAGGTGTGAT-1_V12D07-335_B1,2,0,3,0,0,5
TGGCCAAACTGAAGTA-1_V12D07-335_B1,2,0,0,0,0,2
GCTTCCGTCCCTAGAC-1_V12D07-335_B1,4,0,1,0,0,5
CAGCAGCCCGTTCCTT-1_V12D07-335_B1,4,0,0,0,0,4
TGTATAACAGATCCTG-1_V12D07-335_B1,1,0,0,0,2,3
CGCGGGAATTAGGCAG-1_V12D07-335_B1,0,0,0,0,2,2
TGCATGTGGTAATCTA-1_V12D07-335_B1,0,1,0,0,2,3
ACAATTTGAGCAGTGG-1_V12D07-335_B1,0,0,1,0,1,2
GAGCTAAGGGCATATC-1_V12D07-335_B1,0,1,1,0,1,3
CCAGATAGTTGAGTGA-1_V12D07-335_B1,0,0,0,0,3,3
CCACAATGTACGTCTT-1_V12D07-335_B1,0,2,1,0,1,4
CAATGGATCTCTACCA-1_V12D07-335_B1,0,3,0,0,1,4
TGTGGCAAAGCGTATG-1_V12D07-335_B1,0,0,0,0,2,2
TAAAGCGTTAGGAGAA-1_V12D07-335_B1,0,1,0,0,1,2
TCCGTTTAGCCTTGAA-1_V12D07-335_B1,0,3,1,0,2,6
CAGCTCGACAAGTTAA-1_V12D07-335_B1,0,2,0,0,1,3
GCCTATAGTGTCAGGG-1_V12D07-335_B1,0,2,1,0,2,5
ATAGACAACGGGACCT-1_V12D07-335_B1,0,1,0,0,3,4
CTACTATCTTTCAGAG-1_V12D07-335_B1,0,1,0,0,1,2
GCGCTGCTTTGCATTT-1_V12D07-335_B1,0,0,0,0,2,2
GCGCATCCAGTCAGCA-1_V12D07-335_B1,0,2,1,0,2,5
GACTCGCGGGAATGAC-1_V12D07-335_B1,0,1,0,0,3,4
CTGGTAACGAGCTCTT-1_V12D07-335_B1,1,4,0,0,0,5
TCCGGCCTAGCGTACA-1_V12D07-335_B1,0,1,1,0,1,3
TCTAGGTGGCGACGCT-1_V12D07-335_B1,0,2,0,0,0,2
ACGCTAGTGATACACT-1_V12D07-335_B1,2,2,0,0,0,4
ATCTGCACCTCTGCGA-1_V12D07-335_B1,0,5,0,0,0,5
CCTCACCTGAGGGAGC-1_V12D07-335_B1,0,1,0,0,0,1
AGTGAGCCTCGCCGCC-1_V12D07-335_B1,1,0,0,0,0,1
ACGAGTACGGATGCCC-1_V12D07-335_B1,0,1,0,0,0,1
GGTACCATTAAGACGG-1_V12D07-335_B1,1,1,0,0,0,2
TTCTGCTAGACTCCAA-1_V12D07-335_B1,2,1,0,0,0,3
TAACTATTACGCCAAA-1_V12D07-335_B1,1,1,0,0,0,2
GCATTCAAGGCAACGC-1_V12D07-335_B1,0,3,0,0,0,3
AGTACATCATTTATCA-1_V12D07-335_B1,0,3,0,0,0,3
GTCGTGTCTGGTCATC-1_V12D07-335_B1,0,1,0,0,0,1
AGTCTAAAGTATACTC-1_V12D07-335_B1,1,1,0,0,0,2
CGGCCCAACCTGTAGT-1_V12D07-335_B1,1,2,0,0,0,3
AGGGAGACATACTTCG-1_V12D07-335_B1,2,4,0,0,0,6
TCCCTAGATCAATAGG-1_V12D07-335_B1,1,1,1,0,0,3
TCCCGTCGCGTCATAG-1_V12D07-335_B1,0,2,1,0,0,3
CGCATCCATCAGCCAG-1_V12D07-335_B1,2,1,1,0,0,4
CTGCACCTAGTCCACA-1_V12D07-335_B1,0,2,0,0,0,2
CGAGGATCGGGAACGA-1_V12D07-335_B1,0,1,1,0,0,2
CAATGAGGTTCGACTA-1_V12D07-335_B1,1,3,0,0,0,4
TCTGACGGGCTAACCC-1_V12D07-335_B1,2,0,1,0,0,3
TTCTATGCCTTTCGCA-1_V12D07-335_B1,1,2,1,0,0,4
AGAGTATAGTGTTACG-1_V12D07-335_B1,0,1,1,0,0,2
CCATTGTTTCCTCCAT-1_V12D07-335_B1,0,3,1,2,0,6
CTCATCACTTAGTGAT-1_V12D07-335_B1,0,2,1,0,0,3
CCGAAGGGCGTACCGC-1_V12D07-335_B1,0,10,2,0,0,12
TCAAGCTGCCTTGAAA-1_V12D07-335_B1,0,9,0,0,0,9
CTCATTAACGTTGCCC-1_V12D07-335_B1,0,10,0,0,0,10
GTCTTCCTCACCTAAG-1_V12D07-335_B1,0,2,0,0,0,2
GGTGATGAAGGAAGTG-1_V12D07-335_B1,1,1,0,0,0,2
TCAATACAATTGCTGC-1_V12D07-335_B1,2,0,3,0,0,5
GCAACCCAAGTTGTTT-1_V12D07-335_B1,3,0,1,0,0,4
ATGAAGTGGACCCAGC-1_V12D07-335_B1,3,1,1,0,0,5
GAGAATCTCACGATCA-1_V12D07-335_B1,2,3,0,0,1,6
TATATCATTGATCAGT-1_V12D07-335_B1,3,0,1,0,3,7
AACTTTACGGGAGCTT-1_V12D07-335_B1,1,0,0,0,0,1
TTCTTGTGTCCATCAG-1_V12D07-335_B1,4,0,0,0,0,4
ACAATTTAGGAGGCTC-1_V12D07-335_B1,4,1,0,0,0,5
ATACTTGTTCTCGAGC-1_V12D07-335_B1,2,4,3,0,0,9
CACGGGATTGAGGGTT-1_V12D07-335_B1,3,0,2,0,0,5
GTTAATGTCTATCTTA-1_V12D07-335_B1,2,0,2,0,0,4
GCGTTATATTTGGAAC-1_V12D07-335_B1,3,1,0,0,0,4
CGTCAAGGCTATAAAT-1_V12D07-335_B1,4,0,3,0,0,7
TTAGCTCTGTAATCCG-1_V12D07-335_B1,5,0,2,0,0,7
AATGGTCCACCGTTCA-1_V12D07-335_B1,2,0,1,0,0,3
GTCATTGCATTGACCC-1_V12D07-335_B1,3,1,0,0,0,4
TGTCCGTGGCGCCTTT-1_V12D07-335_B1,1,2,0,0,0,3
TCAACTAACGTATAAC-1_V12D07-335_B1,1,0,0,0,0,1
TCCTCTCCAGTTGTCC-1_V12D07-335_B1,0,0,1,0,0,1
TGTGTTCGTATCCAAG-1_V12D07-335_B1,3,2,0,0,0,5
CCGCGTAGGTAAGGGC-1_V12D07-335_B1,2,0,1,0,0,3
CTGCGGGTGAAATGTT-1_V12D07-335_B1,3,0,0,0,0,3
TATCTACAGAGGTAAT-1_V12D07-335_B1,0,1,0,0,0,1
CTACTCTAGGCCCGGC-1_V12D07-335_B1,1,2,0,0,0,3
ACAAGCAGTGCCTAGC-1_V12D07-335_B1,0,4,1,0,0,5
TACAAGTCTCGTGCAT-1_V12D07-335_B1,0,0,1,0,0,1
TCGGAATGCGCTCTGA-1_V12D07-335_B1,0,2,1,0,0,3
TCGCGTCCAGAAGGTC-1_V12D07-335_B1,0,3,0,0,0,3
TATGGCCCGGCCTCGC-1_V12D07-335_B1,1,2,0,0,0,3
GCTGGCATATTCACCT-1_V12D07-335_B1,0,1,0,0,0,1
GTCAGAATAGTCTATG-1_V12D07-335_B1,0,4,1,0,0,5
GGCGTCCTATCCGCTG-1_V12D07-335_B1,0,5,0,0,0,5
CGGAGTTTGAGAGACA-1_V12D07-335_B1,0,3,1,0,0,4
AGCACTTAAGGACGCC-1_V12D07-335_B1,1,4,0,0,0,5
TCCACAATGGTTTACG-1_V12D07-335_B1,0,0,0,0,0,0
CCAACGATGCACTGAT-1_V12D07-335_B1,0,3,1,0,0,4
ATTTACAGTTTACTGG-1_V12D07-335_B1,0,1,0,0,0,1
CCCTGAAATGAGTTGA-1_V12D07-335_B1,0,1,1,0,0,2
CAAACGGTCGCACTTT-1_V12D07-335_B1,0,2,1,0,0,3
TGATTCGTCTATCACT-1_V12D07-335_B1,0,1,0,0,0,1
TCAGGTTCTTTGAGAA-1_V12D07-335_B1,2,0,0,0,0,2
CACGCAGCGAGGCTTT-1_V12D07-335_B1,0,3,1,0,0,4
TTAAGCGCCTGACCCA-1_V12D07-335_B1,0,3,0,0,0,3
CTTACACGGTATTCCA-1_V12D07-335_B1,0,2,3,0,0,5
AAGGCTGTGCTCATCG-1_V12D07-335_B1,1,2,0,0,0,3
GACCAGAGCCCTGTAG-1_V12D07-335_B1,1,0,0,0,0,1
TCCCAGGCTTAGCTAA-1_V12D07-335_B1,1,3,0,0,0,4
ATTGAAGATCTTAGTG-1_V12D07-335_B1,2,0,0,0,0,2
AGTTCCTACAGAATTA-1_V12D07-335_B1,5,1,0,0,0,6
GGGCTGGTTAGTCGCG-1_V12D07-335_B1,0,1,0,0,0,1
GAAATGGCGGTGTTAG-1_V12D07-335_B1,1,0,1,0,0,2
TACGAACACGACTTCA-1_V12D07-335_B1,1,1,0,0,0,2
ACCACAAGTTTCTATC-1_V12D07-335_B1,1,2,0,0,0,3
ATATTTAACCCTCAAG-1_V12D07-335_B1,3,0,1,0,0,4
GATCATTCCAAACATT-1_V12D07-335_B1,0,0,1,0,0,1
TCCAGGCGAGTACGGT-1_V12D07-335_B1,2,0,2,0,0,4
GTTTGACCAAATCCTA-1_V12D07-335_B1,0,0,1,0,0,1
CACAGCACCCACGGCA-1_V12D07-335_B1,0,0,0,0,0,0
TGCAAGAATGACGTAA-1_V12D07-335_B1,0,0,0,0,0,0
GCGAAGCCATACCCGT-1_V12D07-335_B1,2,0,1,0,0,3
TCCTTTCTTACGCTTA-1_V12D07-335_B1,0,0,0,0,0,0
GCTGCTCTCCGGACAC-1_V12D07-335_B1,1,0,0,0,0,1
ACTGTCTTCTTTAGAA-1_V12D07-335_B1,1,0,1,0,0,2
TCAAACTTAGATTGTT-1_V12D07-335_B1,2,0,2,0,0,4
CTATGTCACTAGCCCA-1_V12D07-335_B1,1,0,1,0,0,2
TGCGCAAAGCATTTGG-1_V12D07-335_B1,1,0,2,0,0,3
TTAATGTAGACCAGGT-1_V12D07-335_B1,0,0,0,0,0,0
GGCGGTAGGATCATTG-1_V12D07-335_B1,2,1,0,0,0,3
GGCAATAGTCAATGAG-1_V12D07-335_B1,3,0,1,0,0,4
ACACGAGACTCCTTCT-1_V12D07-335_B1,5,0,1,0,0,6
GACACAAGGGAAGAAA-1_V12D07-335_B1,4,0,0,0,0,4
TCAGCAAATGCATCTC-1_V12D07-335_B1,0,0,0,0,0,0
GAGATCTGTCACTCCG-1_V12D07-335_B1,3,0,0,0,0,3
ATGCCGGTCTTGCATA-1_V12D07-335_B1,5,0,1,0,0,6
TTGGGCGGCGGTTGCC-1_V12D07-335_B1,2,0,0,0,1,3
TTGTTGTGTGTCAAGA-1_V12D07-335_B1,0,0,3,0,4,7
ACTGTACGATACACAT-1_V12D07-335_B1,0,0,0,0,0,0
TCCACTTTATCTAGGT-1_V12D07-335_B1,0,0,0,0,3,3
GGTCTGAGAATCTGGA-1_V12D07-335_B1,0,0,2,0,1,3
TAGAAAGGTGGCGCTA-1_V12D07-335_B1,1,1,0,0,1,3
TATGTCTCATTGTGCC-1_V12D07-335_B1,0,0,2,0,0,2
GGATTTCACTTCTATA-1_V12D07-335_B1,0,1,0,0,2,3
TGAGTGGTCCGTGACG-1_V12D07-335_B1,0,2,1,0,1,4
CGCTTTCTTGCATTCG-1_V12D07-335_B1,0,1,0,0,1,2
ACCCAACGCCCGTGGC-1_V12D07-335_B1,0,0,0,0,2,2
GAACGTCTCATGGTCG-1_V12D07-335_B1,0,3,0,0,1,4
AGGGTTCCCTTTGGTT-1_V12D07-335_B1,0,2,0,0,1,3
GTAGCTTCCTCTTGTT-1_V12D07-335_B1,1,2,1,0,0,4
GCATGAGGGACGCGGC-1_V12D07-335_B1,0,2,0,0,1,3
CTACCCTAAGGTCATA-1_V12D07-335_B1,2,1,0,0,0,3
TCACCGCTCGGCACTC-1_V12D07-335_B1,1,1,4,0,0,6
GGCTCGCGTTGAGGTA-1_V12D07-335_B1,3,2,1,0,0,6
CTAACGAAACTTGCTG-1_V12D07-335_B1,1,1,0,0,0,2
TTAAACTCGAATTCAT-1_V12D07-335_B1,0,3,0,0,0,3
TACTTTACTGAGCCGG-1_V12D07-335_B1,1,5,1,0,0,7
GCTTGGATCGATTAGG-1_V12D07-335_B1,0,0,0,0,0,0
CGGTTATCCAACAGTG-1_V12D07-335_B1,0,0,0,0,0,0
CAGACCTGTAAGTGTT-1_V12D07-335_B1,0,0,1,0,0,1
GACGGTCAATAGAAGC-1_V12D07-335_B1,2,0,0,0,0,2
CTGACTGCGCAGCTCG-1_V12D07-335_B1,1,1,0,0,0,2
CCATACCTTTACTTGT-1_V12D07-335_B1,1,3,1,0,0,5
GTAATAAAGGGCTCCC-1_V12D07-335_B1,0,2,0,0,0,2
GTGAACTCCCATTCGA-1_V12D07-335_B1,1,2,0,0,0,3
GTGGTTACTTCTTTCG-1_V12D07-335_B1,1,2,0,0,0,3
TCAGAACCTCCACAGG-1_V12D07-335_B1,1,2,0,0,0,3
TCCCACTCTCTTCCGG-1_V12D07-335_B1,1,3,0,0,0,4
ATCTTGACTTGTCCAA-1_V12D07-335_B1,0,2,2,0,0,4
TCGGGAACGTGCCTAG-1_V12D07-335_B1,2,1,0,0,0,3
GTTAGCCGTAAATCAA-1_V12D07-335_B1,1,1,1,0,0,3
ATTTACTAAGTCCATT-1_V12D07-335_B1,0,4,0,0,0,4
GGGTGCATATGAAAGC-1_V12D07-335_B1,0,1,0,0,0,1
TCCGAATGGTCCTGAG-1_V12D07-335_B1,0,2,0,0,0,2
TGATGGCTGTTTCTGA-1_V12D07-335_B1,1,0,0,0,0,1
AAATAAGGTAGTGCCC-1_V12D07-335_B1,0,0,3,0,0,3
CCACTATCCGGGTCAC-1_V12D07-335_B1,1,1,2,0,0,4
ACACCACATAATTAGC-1_V12D07-335_B1,0,2,2,0,0,4
CGCGGTAAGTCTAGCT-1_V12D07-335_B1,0,2,1,0,0,3
GCGGGCATTACGATGC-1_V12D07-335_B1,0,1,0,0,0,1
AGGATTGCTTACGACA-1_V12D07-335_B1,0,1,0,0,0,1
CTCGGGATAACACCTA-1_V12D07-335_B1,1,1,0,0,0,2
GTCGTCTGGTTGGCTA-1_V12D07-335_B1,1,2,0,0,0,3
GCAATTAGTCGCACCG-1_V12D07-335_B1,0,2,1,0,0,3
GTGACCTAAAGAATAA-1_V12D07-335_B1,0,9,3,3,0,15
CTGAGCGAGACTTATT-1_V12D07-335_B1,0,2,2,0,0,4
CAAGACTCAGAAGCGC-1_V12D07-335_B1,0,14,3,0,0,17
ACTTCGCTAGCGAGTG-1_V12D07-335_B1,0,11,1,0,0,12
CCATACTCGCCTCTCC-1_V12D07-335_B1,0,1,1,0,0,2
ACGATACCTATCCTGA-1_V12D07-335_B1,0,2,1,0,0,3
CTCACCAGTACAAGTG-1_V12D07-335_B1,2,0,0,0,0,2
CGAAGACGGTGAGTGC-1_V12D07-335_B1,1,1,0,0,0,2
AAATTAATAAGCGCGA-1_V12D07-335_B1,3,0,1,0,0,4
GGGCCCTTATCTATAC-1_V12D07-335_B1,1,0,1,0,0,2
CTGCCCACGAAGCGTT-1_V12D07-335_B1,3,0,0,0,0,3
GGACAAGTTGCAGTGA-1_V12D07-335_B1,3,1,1,0,0,5
GTCCGAGAGCAATCAT-1_V12D07-335_B1,5,1,2,0,0,8
ATGGCAGCCGAGAAAC-1_V12D07-335_B1,3,3,1,0,0,7
CCTCGGATGCTACCTG-1_V12D07-335_B1,4,1,0,0,0,5
ATACGGTGAAGATGCA-1_V12D07-335_B1,0,5,2,0,0,7
ACATCAGCTGGGACGC-1_V12D07-335_B1,0,1,0,0,0,1
GGTTGTGTAGCCTGGC-1_V12D07-335_B1,1,3,0,0,0,4
CCTGCGTTCTACGCTT-1_V12D07-335_B1,3,1,0,0,0,4
GAACGTTAGGAAGACG-1_V12D07-335_B1,3,1,0,0,0,4
CTGATAGTGTATCTCA-1_V12D07-335_B1,3,0,0,0,0,3
TTCTGCGAGCGCCCTT-1_V12D07-335_B1,2,0,0,0,0,2
CTTTGGCGCTTTATAC-1_V12D07-335_B1,2,2,0,0,0,4
TCCGAACTTGGCTTAC-1_V12D07-335_B1,2,3,0,0,0,5
TAGATTCCTGGTTATT-1_V12D07-335_B1,0,0,0,0,0,0
CCGACAAAGGGAGTGC-1_V12D07-335_B1,1,0,0,0,0,1
CCATGGCCCTTGTACC-1_V12D07-335_B1,3,0,0,0,0,3
GAAATATCACCATCAG-1_V12D07-335_B1,1,2,0,0,0,3
ACGAAATGGGCGGCAC-1_V12D07-335_B1,1,4,1,0,0,6
GTGAGCGTGCTGCACT-1_V12D07-335_B1,0,1,0,0,0,1
CCGCGGGTACGAAGAA-1_V12D07-335_B1,1,3,1,0,0,5
TCCCTGGCTCGCTGGA-1_V12D07-335_B1,0,1,2,0,0,3
CAGCTTAGTAGGTAGC-1_V12D07-335_B1,0,1,1,0,0,2
CACGAAAGTTAGTCCC-1_V12D07-335_B1,0,3,1,0,0,4
ACCTAATCGACTTCCT-1_V12D07-335_B1,0,2,0,0,0,2
AAGTAGTGACGCGAGG-1_V12D07-335_B1,0,4,1,0,0,5
TCCGATTACATTGCCG-1_V12D07-335_B1,0,1,1,0,0,2
CCTCCGACAATTCAAG-1_V12D07-335_B1,0,3,0,0,0,3
GTTCACAGGAGTCTAG-1_V12D07-335_B1,2,0,0,0,0,2
CGAAGTTGCTCTGTGT-1_V12D07-335_B1,0,0,0,0,0,0
GTCGGATATCTCAGAC-1_V12D07-335_B1,0,0,1,0,0,1
CGCTCTCCGTAGATTA-1_V12D07-335_B1,1,1,0,0,0,2
CAAGCAACGTCGGAGT-1_V12D07-335_B1,1,3,2,0,0,6
CCATTCCCTGCCCACA-1_V12D07-335_B1,1,3,1,0,0,5
CTTTGGCTTTAGTAAA-1_V12D07-335_B1,0,0,0,0,0,0
GGCTATTAAGTTGTAT-1_V12D07-335_B1,0,1,0,0,0,1
CCATTAGCGATAATCC-1_V12D07-335_B1,0,2,1,0,0,3
TGTTCTTCCATTGACT-1_V12D07-335_B1,1,1,0,0,0,2
AGATAACTTCAGGGCC-1_V12D07-335_B1,0,3,2,0,0,5
ATAGACGAAGAGAAAG-1_V12D07-335_B1,0,4,0,0,0,4
GGCGGAGTAATATTAG-1_V12D07-335_B1,0,2,0,0,0,2
TGACCCACGTTAGACA-1_V12D07-335_B1,0,3,0,0,0,3
TCACAGGTTATTGGGC-1_V12D07-335_B1,2,1,0,0,0,3
TCACGCATTGTAGATC-1_V12D07-335_B1,0,1,1,0,0,2
TTGAAGAATTCCCAGG-1_V12D07-335_B1,0,2,1,0,0,3
AAATGGTCAATGTGCC-1_V12D07-335_B1,0,0,0,0,0,0
TAGTGCCCTCCAGAGT-1_V12D07-335_B1,0,0,0,0,0,0
GGTATTGCCGAGTTTA-1_V12D07-335_B1,0,1,0,0,0,1
CGTATTAAGAGATCTA-1_V12D07-335_B1,2,0,0,0,0,2
ACTGTCCAGGATTATA-1_V12D07-335_B1,1,0,0,0,0,1
CGGGCAGCTAAACCGC-1_V12D07-335_B1,0,1,1,0,0,2
TTGCTGATCATGTTCG-1_V12D07-335_B1,3,2,0,0,0,5
TATGGGTACGTATCGT-1_V12D07-335_B1,0,1,1,0,0,2
CAGCTCACTGAGACAT-1_V12D07-335_B1,2,0,0,0,0,2
GGGACTGCATAGATAG-1_V12D07-335_B1,4,0,0,0,0,4
ACGCATTCGTGAGTAC-1_V12D07-335_B1,1,0,0,0,0,1
CTCTGGACGCCTGGTG-1_V12D07-335_B1,0,1,1,0,0,2
AGGGTTTAGTTCGGGA-1_V12D07-335_B1,1,0,1,0,0,2
GGGAGAACTCACAGTA-1_V12D07-335_B1,2,0,0,0,0,2
ATCAATCTGGGCTGCA-1_V12D07-335_B1,2,0,2,0,0,4
TCTTCGATACCAATAA-1_V12D07-335_B1,0,0,1,0,0,1
ACGTAGATTGCTGATG-1_V12D07-335_B1,2,0,0,0,0,2
TCTTGATGCGTAGCGA-1_V12D07-335_B1,2,1,0,0,0,3
GGGCTGCCTAGGGCGA-1_V12D07-335_B1,1,0,0,0,0,1
CTCTCACAATCGATGA-1_V12D07-335_B1,2,0,1,0,0,3
CCAAGCGTAACTCGTA-1_V12D07-335_B1,3,1,0,0,0,4
ACAACAGCATGAGCTA-1_V12D07-335_B1,2,0,1,0,0,3
GTCCCAACGTAAAGTA-1_V12D07-335_B1,2,0,0,0,0,2
TCGGAGTACATGAGTA-1_V12D07-335_B1,3,0,1,0,0,4
GGGAGTTAATGAGGCG-1_V12D07-335_B1,7,0,1,0,2,10
CCGGGCGGTCTCGTCA-1_V12D07-335_B1,0,0,1,0,2,3
CCGTAAGTTGGTCCCA-1_V12D07-335_B1,4,0,0,0,0,4
GGAGGGCTTGGTTGGC-1_V12D07-335_B1,0,0,1,0,0,1
TCGGACGCCCAGCCCA-1_V12D07-335_B1,0,0,2,0,0,2
TCTGTGCCATCATAGT-1_V12D07-335_B1,3,0,1,0,0,4
GTACTGGAGTTAGACC-1_V12D07-335_B1,1,0,2,0,0,3
GGAATGCGCTAGCGTG-1_V12D07-335_B1,1,1,1,0,0,3
GTGTGAATAACTTAGG-1_V12D07-335_B1,0,3,3,0,0,6
GGTCGGCCAGGAGCTT-1_V12D07-335_B1,0,0,1,0,0,1
TAGCCGGCGGTCAGCG-1_V12D07-335_B1,0,2,1,0,0,3
CGGGTGTACCCATTTA-1_V12D07-335_B1,0,4,1,0,0,5
AGTGATTCAAGCAGGA-1_V12D07-335_B1,2,3,0,0,0,5
GTTGGATTGAGAACAC-1_V12D07-335_B1,1,2,2,0,0,5
CACACGCGCTGTCTTA-1_V12D07-335_B1,1,2,2,0,0,5
TAGACGCCCGTACCGG-1_V12D07-335_B1,1,1,0,0,0,2
GGTTTCAATCGGTCAG-1_V12D07-335_B1,1,1,0,0,1,3
AATCTGCGTTGGGACG-1_V12D07-335_B1,0,3,1,0,0,4
TTACGGATGGTTCGAG-1_V12D07-335_B1,0,2,2,0,0,4
CGGCAGGGTCGGGTTG-1_V12D07-335_B1,0,2,1,0,0,3
GCTTTCAGAGGAGGTG-1_V12D07-335_B1,1,2,1,0,0,4
TCTTCCCATGGGCACA-1_V12D07-335_B1,0,2,0,0,0,2
TACCGCGGACTTGCAG-1_V12D07-335_B1,1,1,1,0,0,3
AGAATTATGGATTCGA-1_V12D07-335_B1,1,5,0,0,0,6
ATTGATGAGTCCTAAC-1_V12D07-335_B1,1,1,0,0,0,2
TAGGTCGCCGGAACTG-1_V12D07-335_B1,1,1,0,0,0,2
TAACCTACCGTCCGAG-1_V12D07-335_B1,0,1,0,0,0,1
CTTAGTAGGCCTACAG-1_V12D07-335_B1,1,2,0,0,0,3
CTAGATGTGAGTGTAA-1_V12D07-335_B1,1,3,0,0,0,4
ACTCCCGAATTCGTTT-1_V12D07-335_B1,1,3,0,0,0,4
GTTCATCGTTTGGCTG-1_V12D07-335_B1,1,2,1,0,0,4
ACTTTACCCTCATGAA-1_V12D07-335_B1,1,1,0,0,0,2
GCGAGAGTTGCGTCCA-1_V12D07-335_B1,0,2,0,0,0,2
GTTCGGGCGTACCATT-1_V12D07-335_B1,1,3,0,0,0,4
CGACTTTGTATAGCCT-1_V12D07-335_B1,1,1,0,0,0,2
GCCATCGATGCTGCAT-1_V12D07-335_B1,0,5,0,0,0,5
GCATTTCCAAGGCTCC-1_V12D07-335_B1,0,1,1,0,0,2
ATGTAAGGCTGCTCTT-1_V12D07-335_B1,2,0,1,0,0,3
ACGTTCGCAATCAATT-1_V12D07-335_B1,0,1,0,0,0,1
GTGACGAGGGTGACCC-1_V12D07-335_B1,1,4,1,0,0,6
ATTATAGCTACTTTAC-1_V12D07-335_B1,1,4,0,0,0,5
CGTGTGTTAAACCCTG-1_V12D07-335_B1,0,2,0,0,0,2
TTGGTATGGCTTGTGT-1_V12D07-335_B1,0,3,0,0,0,3
CATTCCCATTCCGTCG-1_V12D07-335_B1,1,0,0,0,0,1
TGCCGAAAGCGTATTC-1_V12D07-335_B1,1,2,1,0,0,4
CAACACATCTCCTGCC-1_V12D07-335_B1,0,2,0,0,0,2
CTGCCTCATATGCAAC-1_V12D07-335_B1,0,2,1,0,0,3
TCCCGCCTATGTGCGT-1_V12D07-335_B1,0,1,1,0,0,2
GGTTACCCGACACTTT-1_V12D07-335_B1,1,1,2,0,0,4
CCAGCGGGATCACCAG-1_V12D07-335_B1,0,7,1,1,0,9
ATGTTTCGGCCCGGAG-1_V12D07-335_B1,0,10,6,1,0,17
GCGTCTAACCTCCTAA-1_V12D07-335_B1,0,15,2,0,0,17
ATCAGGTAGCTGACAG-1_V12D07-335_B1,0,15,2,0,0,17
GGTATGAAAGAACTGA-1_V12D07-335_B1,2,2,1,0,0,5
GTGGCCTAATATCATT-1_V12D07-335_B1,2,0,0,0,0,2
CCTGTGAAACCGTAAC-1_V12D07-335_B1,2,0,1,0,0,3
GGCAGAGAGATCGGGA-1_V12D07-335_B1,4,1,1,0,0,6
TAGCGTCGAATATTGA-1_V12D07-335_B1,1,0,2,0,0,3
CGCCGACTATTCGCTA-1_V12D07-335_B1,4,4,0,0,0,8
TCTGGCGCAAGCCGGG-1_V12D07-335_B1,1,2,7,0,0,10
AGTGGTTGCGTATAGG-1_V12D07-335_B1,3,0,1,0,0,4
ATCGGTTACCTAGTAA-1_V12D07-335_B1,2,1,0,0,0,3
CCTGCCCGTTGTCTAG-1_V12D07-335_B1,2,0,0,0,0,2
GCACACGCCCATGGTC-1_V12D07-335_B1,2,1,2,0,0,5
AGTACGGCCCGTATCG-1_V12D07-335_B1,2,1,0,0,0,3
TATCTAGCCTAAAGGA-1_V12D07-335_B1,1,3,1,0,0,5
CACTCGGTTAGGAGGA-1_V12D07-335_B1,2,0,1,0,0,3
ATGTTCGTCGACCCAC-1_V12D07-335_B1,1,6,0,0,0,7
TTCCTCTGCCCGAATA-1_V12D07-335_B1,3,2,0,0,0,5
TTACTATCGGCTTCTC-1_V12D07-335_B1,2,2,1,0,0,5
GCCGCATTAGTCCGGC-1_V12D07-335_B1,2,1,0,0,0,3
TAAGGGCTGGGAGAGG-1_V12D07-335_B1,0,4,0,0,0,4
TAAGCAGGCGACACGC-1_V12D07-335_B1,2,1,0,0,0,3
AGCACTACCGGCCTGT-1_V12D07-335_B1,0,2,0,0,0,2
GAAAGCCCTTTGGACC-1_V12D07-335_B1,0,5,0,0,0,5
GACCGACTGAAGCGTC-1_V12D07-335_B1,0,1,0,0,0,1
CGGTGAAGACTAAAGT-1_V12D07-335_B1,2,3,0,0,0,5
CCCTGCGCTACGCATA-1_V12D07-335_B1,1,2,1,0,0,4
TACTGGACAGCTCGGC-1_V12D07-335_B1,1,1,1,0,0,3
TTAGTAGGGCGGCGGG-1_V12D07-335_B1,2,6,0,0,0,8
GAGGCTATCAAAGTCG-1_V12D07-335_B1,1,1,0,0,0,2
TTACCATTGATTACCC-1_V12D07-335_B1,2,4,0,0,0,6
ATACCACGGGCAACTT-1_V12D07-335_B1,0,1,0,0,0,1
TGTCCTAAGTCACCGC-1_V12D07-335_B1,0,0,2,0,0,2
AGGTAGGTACAAAGCT-1_V12D07-335_B1,2,3,0,0,0,5
GGCATACAGGTAGCGG-1_V12D07-335_B1,1,2,0,0,0,3
TGTAGTGATCTATAAT-1_V12D07-335_B1,2,2,0,0,0,4
TCCCGGGTGTGCTGCT-1_V12D07-335_B1,0,1,0,0,0,1
TACGATGTTGATCATC-1_V12D07-335_B1,0,1,0,0,0,1
CCTCTCTCCCATCTAG-1_V12D07-335_B1,2,2,0,0,0,4
GCAGGACTATAGAATA-1_V12D07-335_B1,0,2,3,0,0,5
CTAGTGAAGGACAGGA-1_V12D07-335_B1,0,5,2,0,0,7
TACGAGAACTTCACGT-1_V12D07-335_B1,0,0,0,0,0,0
CGTTGTTTCAATTCCC-1_V12D07-335_B1,0,2,0,0,0,2
GCAAATATTACGCTTT-1_V12D07-335_B1,3,3,0,0,0,6
CCAATAGTGCCGTCGA-1_V12D07-335_B1,0,1,0,0,0,1
ATTGCTGCTCCTCCAT-1_V12D07-335_B1,1,1,0,0,0,2
GAGATCTGCTTGGCAT-1_V12D07-335_B1,1,1,0,0,0,2
GCCGAAATTCCTACGT-1_V12D07-335_B1,2,2,0,0,0,4
GGCACTCCACTGGGCA-1_V12D07-335_B1,0,0,1,0,0,1
GGGTCACCGTGACGGT-1_V12D07-335_B1,1,2,0,0,0,3
CACTTAATCAGACGGA-1_V12D07-335_B1,0,1,1,0,0,2
CGTTTCGCTCATTACA-1_V12D07-335_B1,2,2,1,0,0,5
ATAAAGGCTCGGTCGT-1_V12D07-335_B1,1,1,0,0,0,2
CACTAAAGTTGCCTAT-1_V12D07-335_B1,1,2,0,0,0,3
GTGCTCAAGTACTGTC-1_V12D07-335_B1,0,0,0,0,0,0
CCATGCCTGTTTAGTA-1_V12D07-335_B1,1,1,0,0,0,2
TCTAGTTATCAGAAGA-1_V12D07-335_B1,0,0,0,1,0,1
TTGTAATCCGTACTCG-1_V12D07-335_B1,2,0,0,0,0,2
TCCCAGCTTTAGTCTG-1_V12D07-335_B1,3,0,0,0,0,3
CTACGCACGGAGTACC-1_V12D07-335_B1,0,0,1,0,0,1
AAATTAACGGGTAGCT-1_V12D07-335_B1,2,2,2,0,0,6
CGGCCACGCACAAAGT-1_V12D07-335_B1,2,1,1,0,0,4
GAAGCGTGAGGAATTT-1_V12D07-335_B1,1,1,0,0,0,2
ATATCTTAGGGCCTTC-1_V12D07-335_B1,1,0,1,0,0,2
ACGCGGGCCAAGGACA-1_V12D07-335_B1,1,0,0,0,0,1
GCGAGTTCTGCAAAGA-1_V12D07-335_B1,0,0,1,0,0,1
TATTCGTGCCAGAATA-1_V12D07-335_B1,3,1,1,0,0,5
AGGGCTGCAGTTACAG-1_V12D07-335_B1,8,0,2,0,0,10
CTAGCATAGTATAATG-1_V12D07-335_B1,3,2,2,0,0,7
TAGGTTCGAGTTCGTC-1_V12D07-335_B1,3,0,1,0,0,4
GAATTATAGTGAAAGG-1_V12D07-335_B1,3,0,0,0,0,3
CTATCGGGTCTCAACA-1_V12D07-335_B1,1,0,0,0,0,1
GCGCTAATTGAATAGA-1_V12D07-335_B1,1,0,2,0,0,3
ATGCGACAGTCCCATT-1_V12D07-335_B1,0,0,2,0,0,2
GGTAGTGCTCGCACCA-1_V12D07-335_B1,2,0,2,0,0,4
AAGCTCGTGCCAAGTC-1_V12D07-335_B1,0,0,1,0,0,1
TATTCAATTCTAATCC-1_V12D07-335_B1,1,0,2,0,0,3
TTCAAAGTCTCTAGCC-1_V12D07-335_B1,4,1,1,0,0,6
TTGAATATGGACTTTC-1_V12D07-335_B1,5,0,1,0,0,6
AAGAGCTCTTTATCGG-1_V12D07-335_B1,3,0,1,0,0,4
TTACTCCGGCCGGGAA-1_V12D07-335_B1,0,0,1,0,0,1
AAACGAGACGGTTGAT-1_V12D07-335_B1,1,1,0,0,0,2
GCTAAGTAGTTTCTCT-1_V12D07-335_B1,2,0,5,0,0,7
ATAACGCCGGAGGGTC-1_V12D07-335_B1,3,2,1,0,0,6
GGATCCGGAATATACT-1_V12D07-335_B1,0,4,1,0,0,5
TGAAAGGACCTGACTC-1_V12D07-335_B1,0,2,1,0,0,3
TCCGCGGCAGCATCTG-1_V12D07-335_B1,1,3,0,0,0,4
TGCATATGTCTGTCAC-1_V12D07-335_B1,0,2,2,0,0,4
TGTAGGAGAAATTTCC-1_V12D07-335_B1,1,4,0,0,0,5
AGTGAGACTTCCAGTA-1_V12D07-335_B1,1,3,0,0,0,4
CCCAAACATGCTGCTC-1_V12D07-335_B1,0,3,0,0,0,3
GCTTATGAAGCAGGAA-1_V12D07-335_B1,0,4,0,0,0,4
TTCTAACCGAAGCTTA-1_V12D07-335_B1,2,1,0,0,0,3
GGATGTCCTTACCGCA-1_V12D07-335_B1,1,5,0,0,0,6
AGGGTGCTCTCGAGGG-1_V12D07-335_B1,1,1,0,0,1,3
AACTCTCAATAGAGCG-1_V12D07-335_B1,0,2,3,0,0,5
TCTGAATTCCGTACAA-1_V12D07-335_B1,2,3,3,0,0,8
GCGTGGTACTGGGTTA-1_V12D07-335_B1,1,2,0,0,0,3
CGTCGGATAGTGTTGA-1_V12D07-335_B1,1,0,2,0,0,3
ATATGTCTCCCTAGCC-1_V12D07-335_B1,1,2,0,0,0,3
TCTTTAAGACTATGAA-1_V12D07-335_B1,1,1,1,0,0,3
TCATTTAAGTCTCCGA-1_V12D07-335_B1,0,2,0,0,0,2
GATATTGAGATTGGCG-1_V12D07-335_B1,0,3,0,0,0,3
TGACATCGAGCGGACC-1_V12D07-335_B1,0,1,2,0,0,3
GCGTAAATGGCCATAA-1_V12D07-335_B1,0,1,1,0,0,2
ATTGTACAACTCGGCT-1_V12D07-335_B1,0,3,0,0,0,3
TACGCTATAGAAACCT-1_V12D07-335_B1,0,5,0,0,0,5
CACCCAAATCTTATGT-1_V12D07-335_B1,0,0,0,0,0,0
AGATGATGGAGTCTGG-1_V12D07-335_B1,3,1,2,0,0,6
CCACGGTGCCCGGTAG-1_V12D07-335_B1,0,3,2,0,0,5
TCAAGAAATACTAGCT-1_V12D07-335_B1,2,1,0,0,0,3
AGGTATAATTGATAGT-1_V12D07-335_B1,1,0,3,0,0,4
CAAGGTCCTATAGGCT-1_V12D07-335_B1,0,1,2,0,0,3
CCGGCACGACCGTTTC-1_V12D07-335_B1,1,2,0,0,0,3
ACCTCCGTTATTCACC-1_V12D07-335_B1,1,2,1,0,0,4
GCAGCCTATATCACAT-1_V12D07-335_B1,0,2,0,0,0,2
GGTATAGTGACACATA-1_V12D07-335_B1,1,1,2,0,0,4
AAATTCCAGGTCCAAA-1_V12D07-335_B1,0,1,0,0,0,1
TCTTTAGCAGGCGAAC-1_V12D07-335_B1,1,2,0,0,0,3
TATTGACATTTCTGCC-1_V12D07-335_B1,0,1,0,0,0,1
TCTGATCGGGTGCTAG-1_V12D07-335_B1,0,1,3,0,0,4
GGCCCGGAGCATGTCT-1_V12D07-335_B1,0,2,1,0,0,3
GGGCGCAGCGTTACTC-1_V12D07-335_B1,0,2,1,0,0,3
TTGGCGATCCGAATAT-1_V12D07-335_B1,0,0,1,0,0,1
CCACGTAAATTAGACT-1_V12D07-335_B1,0,1,0,0,0,1
TCTGATTGGAAATGGA-1_V12D07-335_B1,0,1,2,0,0,3
ATGGCGGAATAGTCGC-1_V12D07-335_B1,0,3,3,0,0,6
ATCGCTTTACGTCTCA-1_V12D07-335_B1,0,7,4,4,0,15
TACGTGCAAGGTTCCT-1_V12D07-335_B1,0,7,2,0,0,9
CAGGACAGCTGCCCTT-1_V12D07-335_B1,0,16,1,0,0,17
CAAACCAGGTCTGCAT-1_V12D07-335_B1,1,1,0,0,0,2
ACAAGCTATATGGAAG-1_V12D07-335_B1,0,2,0,0,0,2
TCGCCCACTGCGAGAG-1_V12D07-335_B1,0,3,0,0,0,3
AGCCGCAAATTCAAAT-1_V12D07-335_B1,3,2,1,0,0,6
TTAACGTTAAAGCCTG-1_V12D07-335_B1,3,3,0,0,0,6
CAGCGCCAACACGATA-1_V12D07-335_B1,0,2,0,0,0,2
ATCCAATGGTACCGAA-1_V12D07-335_B1,2,0,0,0,0,2
GTGCTGCAGATAAGGA-1_V12D07-335_B1,0,5,0,0,0,5
GGCCTTTGCAACTGGC-1_V12D07-335_B1,0,3,1,0,0,4
GTCGTACCTACGATTG-1_V12D07-335_B1,8,0,3,0,0,11
TAGAAATTCACGTATA-1_V12D07-335_B1,1,3,0,0,0,4
AGAATAAATCTTCAGG-1_V12D07-335_B1,0,3,0,0,0,3
CATTGCGAAATGGGCG-1_V12D07-335_B1,3,4,0,0,0,7
GTCTACTCAATTACAA-1_V12D07-335_B1,0,3,0,0,0,3
TGTAATGACCACAATA-1_V12D07-335_B1,0,2,0,0,0,2
AAAGTCGACCCTCAGT-1_V12D07-335_B1,0,4,0,0,0,4
TACTCGGCACGCCGGG-1_V12D07-335_B1,2,2,3,0,0,7
AGGTGTATCGCCATGA-1_V12D07-335_B1,0,5,1,1,0,7
TGTGCTTTACGTAAGA-1_V12D07-335_B1,1,1,0,0,0,2
AAACCTCATGAAGTTG-1_V12D07-335_B1,0,4,0,0,0,4
TATAGGGTACTCATGA-1_V12D07-335_B1,1,3,0,0,0,4
CCAGCTGATGGTACTT-1_V12D07-335_B1,0,2,0,0,0,2
AATATTGGAGTATTGA-1_V12D07-335_B1,1,4,0,0,0,5
GGCCCTCACCCACTTA-1_V12D07-335_B1,1,2,0,0,0,3
AACCAAGACTTCTCTG-1_V12D07-335_B1,2,4,0,0,0,6
TCGTATTACCCATTGC-1_V12D07-335_B1,0,3,1,0,0,4
ATTCGACGCCGGGCCT-1_V12D07-335_B1,1,1,0,0,0,2
GGCGCAGGACATCTTC-1_V12D07-335_B1,1,3,0,0,0,4
GTACTCCCTTATCGCT-1_V12D07-335_B1,1,3,0,0,0,4
TGGTCTGTTGGGCGTA-1_V12D07-335_B1,0,2,0,0,0,2
AATAACAACGCTCGGC-1_V12D07-335_B1,2,2,0,0,0,4
CATACCCGTACCCAGT-1_V12D07-335_B1,0,2,2,0,0,4
ACAATCCATTTAAACC-1_V12D07-335_B1,1,2,0,0,0,3
GTTACAATTGGTGACG-1_V12D07-335_B1,0,0,0,0,0,0
TTGCCCTGATCACGGG-1_V12D07-335_B1,1,0,0,0,0,1
CTAACCGCGCGCCCGT-1_V12D07-335_B1,1,2,0,0,0,3
CTAAAGAATGCCTACT-1_V12D07-335_B1,0,2,0,0,0,2
ACCCATCTTGAGGGTA-1_V12D07-335_B1,2,5,0,0,0,7
GATCTTTGCAGGGTAT-1_V12D07-335_B1,2,1,0,0,0,3
GGGTACTTCATGAACT-1_V12D07-335_B1,0,1,1,0,0,2
GCCGCTTGTGAGAAAC-1_V12D07-335_B1,0,2,1,0,0,3
CCTGTAAGACATGATA-1_V12D07-335_B1,0,2,0,0,0,2
CGACAGTTCGCGTTAT-1_V12D07-335_B1,0,4,0,0,0,4
ACGATGCATATGTTAT-1_V12D07-335_B1,1,1,0,0,0,2
TGTTCCGCTTCCATGA-1_V12D07-335_B1,0,3,1,0,0,4
GGATGACGCGAGTTTA-1_V12D07-335_B1,1,3,0,0,1,5
GAAGTTTCCACTCAAT-1_V12D07-335_B1,0,0,0,0,0,0
GCGAGGCCCGAGCAGA-1_V12D07-335_B1,0,1,0,0,0,1
CATACTATGTAATTGT-1_V12D07-335_B1,0,2,0,0,0,2
CCAATGTCACAGCAAG-1_V12D07-335_B1,1,0,1,0,0,2
GTTGGATTTGCGTTGG-1_V12D07-335_B1,0,0,2,0,0,2
GGGAGGATGCCCGAAA-1_V12D07-335_B1,3,2,0,0,0,5
GATCGCGGGCTCTCCA-1_V12D07-335_B1,0,2,0,0,0,2
GTTCGCCATAAGTGCC-1_V12D07-335_B1,0,4,0,0,0,4
AGATTATAGGACGTTT-1_V12D07-335_B1,1,0,0,0,0,1
TCGAGACCAACACCGT-1_V12D07-335_B1,1,0,1,0,0,2
TATGGGACCGAGCAGG-1_V12D07-335_B1,0,0,2,0,0,2
GATGCGTCCTGCATTC-1_V12D07-335_B1,1,0,2,0,0,3
TATGGTCTGAGTAACA-1_V12D07-335_B1,4,0,1,0,0,5
GCATAGAGCACTCAGG-1_V12D07-335_B1,2,1,1,0,0,4
CTTCATTGTCAGTGGA-1_V12D07-335_B1,1,0,1,0,0,2
GCAGATTAGGGATATC-1_V12D07-335_B1,1,1,0,0,0,2
CCTGTCGCCCGTAAAT-1_V12D07-335_B1,2,0,0,0,0,2
CAATTTCGTATAAGGG-1_V12D07-335_B1,1,0,0,0,0,1
GTACACTTACCTGAAG-1_V12D07-335_B1,1,0,0,0,0,1
CCAGCCTGGACCAATA-1_V12D07-335_B1,1,0,0,0,0,1
ATGGAGCAGGCCGTGA-1_V12D07-335_B1,5,0,0,0,0,5
GTCATTAGAGCGAACG-1_V12D07-335_B1,4,0,0,0,0,4
AAGACTGCAAGCTACT-1_V12D07-335_B1,1,0,2,0,0,3
CTAGTCACGTCTTAAG-1_V12D07-335_B1,3,0,1,0,0,4
ACTCTTGTATAGTAAC-1_V12D07-335_B1,2,0,1,0,0,3
ATTAGGCGATGCTTTC-1_V12D07-335_B1,3,0,1,0,0,4
TTCGGGACTAATCGCG-1_V12D07-335_B1,5,2,0,0,0,7
TGGACTGTTCGCTCAA-1_V12D07-335_B1,0,0,1,0,0,1
AACGTGCGAAAGTCTC-1_V12D07-335_B1,0,0,4,0,0,4
CCACCCAAGGAAAGTG-1_V12D07-335_B1,2,0,3,0,0,5
CCGCACAAAGACCAAC-1_V12D07-335_B1,3,0,0,0,0,3
GCGATTGTTAACGTTA-1_V12D07-335_B1,1,0,0,0,0,1
ACTCGTCAGTAATCCC-1_V12D07-335_B1,0,0,2,0,0,2
GGTGATAAGGAGCAGT-1_V12D07-335_B1,0,1,2,0,0,3
AAGAGGCATGGATCGC-1_V12D07-335_B1,1,0,0,1,0,2
CACGTTCGTGCTCTAG-1_V12D07-335_B1,1,5,4,0,0,10
CTATTTGGTTACGGAT-1_V12D07-335_B1,0,2,1,0,0,3
GTACAGAGGCAAGGGT-1_V12D07-335_B1,0,5,1,0,0,6
GGGCCGGCCGAAGTAC-1_V12D07-335_B1,0,4,0,0,0,4
CCTGAACGATATATTC-1_V12D07-335_B1,1,3,0,0,0,4
CCGGGCTGCTCCATAC-1_V12D07-335_B1,0,0,1,0,0,1
TACTTGTTAGTAGTCC-1_V12D07-335_B1,0,1,0,0,0,1
CCTAGGCGTAGCGATC-1_V12D07-335_B1,0,1,2,0,0,3
CTGGCGCACAGGTCTG-1_V12D07-335_B1,0,4,0,0,0,4
ACTTATACTTACCCGG-1_V12D07-335_B1,2,2,0,0,0,4
GAAGTCTCCCTAGCGA-1_V12D07-335_B1,5,1,2,0,0,8
ACCGATGGTAGCATCG-1_V12D07-335_B1,0,1,1,0,0,2
CGAGTTTATCGGACTG-1_V12D07-335_B1,1,1,3,0,0,5
CATAACGGACAGTCGT-1_V12D07-335_B1,0,2,1,0,0,3
TGACGATGCACTAGAA-1_V12D07-335_B1,1,2,1,0,0,4
TAGGGAGCTTGGGATG-1_V12D07-335_B1,1,0,1,0,0,2
AGGGTCGATGCGAACT-1_V12D07-335_B1,1,1,0,0,0,2
TATATCCCTGGGAGGA-1_V12D07-335_B1,2,2,0,0,0,4
CATCTTACACCACCTC-1_V12D07-335_B1,0,2,0,0,0,2
GTGCGACAGGGAGTGT-1_V12D07-335_B1,1,1,1,0,0,3
CCGATCTCAACCTTAT-1_V12D07-335_B1,0,2,1,0,0,3
ACGATCATCTTGTAAA-1_V12D07-335_B1,3,1,0,0,0,4
GAAAGAACAGCGTTAT-1_V12D07-335_B1,1,2,0,0,0,3
CTAGGTCTGAAGGAAT-1_V12D07-335_B1,1,0,2,0,0,3
ATATCAACCTACAGAG-1_V12D07-335_B1,0,2,0,0,0,2
AAATAGCTTAGACTTT-1_V12D07-335_B1,1,1,0,0,0,2
GCGACATGTAAACATC-1_V12D07-335_B1,3,1,0,0,0,4
ATAAGTAGGGCGACTC-1_V12D07-335_B1,0,3,1,0,0,4
GCGAGCGCATGCTCCC-1_V12D07-335_B1,1,1,0,0,0,2
AGGGACCGGCTGCGTT-1_V12D07-335_B1,1,4,0,0,0,5
CCTATGAAGTGGTGCC-1_V12D07-335_B1,1,1,1,0,0,3
GCTTACGTAGTTAGTA-1_V12D07-335_B1,2,1,0,0,0,3
CATACTTAGGCAATAC-1_V12D07-335_B1,1,4,0,0,0,5
CCTGTCCCTCACGTTA-1_V12D07-335_B1,0,3,0,0,0,3
CAATGTGCCAACCCTT-1_V12D07-335_B1,0,2,1,0,0,3
GTTAAGTTAGAGTGGG-1_V12D07-335_B1,0,3,0,0,0,3
CTGGGATACGCTACCC-1_V12D07-335_B1,2,4,1,0,0,7
AACCTGTCACGGAATT-1_V12D07-335_B1,0,1,1,0,0,2
ACTGCGGACACACCGT-1_V12D07-335_B1,1,1,0,0,0,2
CCGTGAGGCATTCATG-1_V12D07-335_B1,0,2,1,0,0,3
GCCCAGATGCTGGAGA-1_V12D07-335_B1,0,3,0,0,0,3
TCTGGCCGTTCAAGTT-1_V12D07-335_B1,0,2,4,0,0,6
ATACGAAGGCTTTCCA-1_V12D07-335_B1,0,1,0,0,0,1
GATCCGAATATAAGTG-1_V12D07-335_B1,0,1,5,0,0,6
GTGGAGCATGTCGGCC-1_V12D07-335_B1,0,5,3,2,0,10
ACTCTTCAGCTCCCGC-1_V12D07-335_B1,0,5,5,0,0,10
CCCGATAGCCTCGCCT-1_V12D07-335_B1,0,11,0,0,0,11
ACAGGTGTGTTGTTGC-1_V12D07-335_B1,0,3,0,0,0,3
TGAACTGCTATGACTT-1_V12D07-335_B1,1,1,0,0,0,2
TGACATATATGACGAT-1_V12D07-335_B1,0,1,0,0,0,1
AAGTCTTCTGTGGCCT-1_V12D07-335_B1,1,2,0,0,0,3
ACCAGACCATAACAAC-1_V12D07-335_B1,0,4,0,0,0,4
TGAGACGTACCTCTCA-1_V12D07-335_B1,3,2,0,0,0,5
GACCGTTACATGCGAC-1_V12D07-335_B1,0,3,0,0,0,3
GGTTCGGATTATACTA-1_V12D07-335_B1,1,3,0,0,0,4
CCTCCTGAGCCCACAT-1_V12D07-335_B1,0,3,0,0,0,3
CCGCGATTTGGTAGGT-1_V12D07-335_B1,0,2,0,1,0,3
AATCTCTACTGTGGTT-1_V12D07-335_B1,0,0,1,0,0,1
ACTTTGACTGCATCCT-1_V12D07-335_B1,1,6,1,0,0,8
CCCTGACTAACAAATT-1_V12D07-335_B1,2,1,0,0,0,3
ACGCTGTGAGGCGTAG-1_V12D07-335_B1,3,1,0,1,0,5
GCATACGAGGTCTTTA-1_V12D07-335_B1,2,4,0,0,0,6
TCGGGATTCAAACATA-1_V12D07-335_B1,0,4,0,1,0,5
GGGCCCTACGAAAGGG-1_V12D07-335_B1,0,2,0,0,0,2
CGCCAAGAAGCCGAGT-1_V12D07-335_B1,0,1,1,0,0,2
GGTACATCTGGGACGA-1_V12D07-335_B1,2,4,2,0,0,8
GGATGCTGGCGTTCCT-1_V12D07-335_B1,0,2,1,0,0,3
CCGATTCGAGGGACCC-1_V12D07-335_B1,0,2,0,0,0,2
CCACTGGTGGCTGGTT-1_V12D07-335_B1,0,4,0,0,0,4
GACAGGCACACACTAT-1_V12D07-335_B1,1,0,1,0,0,2
TCAACGCGACCGGCAG-1_V12D07-335_B1,0,4,0,0,0,4
CTACGACTAGCTATAA-1_V12D07-335_B1,1,3,1,0,0,5
CGGTTGACCTGGCATA-1_V12D07-335_B1,1,2,0,0,0,3
ATCCTGAATCGCTGCG-1_V12D07-335_B1,1,4,0,0,0,5
GTTTCATATCGTCGCT-1_V12D07-335_B1,0,2,0,0,0,2
ATAAATATTAGCAGCT-1_V12D07-335_B1,1,3,0,0,0,4
AAGAGGATGTACGCGA-1_V12D07-335_B1,0,2,0,0,0,2
TCCTGCGTTGATACTC-1_V12D07-335_B1,1,4,0,0,0,5
CGTGCATTGTCGACGC-1_V12D07-335_B1,0,2,0,0,0,2
CCGGGTTCGAGGTTAC-1_V12D07-335_B1,1,2,1,0,0,4
CCCAATTTCACAACTT-1_V12D07-335_B1,0,0,0,0,0,0
TGATTTATTAGCTGTG-1_V12D07-335_B1,1,3,0,0,0,4
TGGAAGAAGGGAACGT-1_V12D07-335_B1,0,1,0,0,0,1
GACGCTTGCTTCTAAA-1_V12D07-335_B1,1,1,2,0,0,4
GGGAACGGGAGGTTAG-1_V12D07-335_B1,1,0,0,0,0,1
GCGGCTCTGACGTACC-1_V12D07-335_B1,0,3,0,0,0,3
ACGTTAGATTTGCCCG-1_V12D07-335_B1,1,4,0,0,0,5
GAGAGGGCGCGAGGTT-1_V12D07-335_B1,1,1,0,0,0,2
GCGTCTCTGCATTGGG-1_V12D07-335_B1,0,5,1,0,0,6
GCAGCACACAGCCCAG-1_V12D07-335_B1,0,1,0,0,0,1
CAGGCCGTTTGGGTGT-1_V12D07-335_B1,1,1,0,0,0,2
AACTCAAGTTAATTGC-1_V12D07-335_B1,0,0,0,0,0,0
CTTCGTAGATAGGTGA-1_V12D07-335_B1,1,2,1,0,0,4
TGCAGAGTACCGAGCA-1_V12D07-335_B1,0,5,0,0,1,6
GAAGTGATTTATCGTG-1_V12D07-335_B1,0,0,0,0,0,0
CGCTACGGGACATTTA-1_V12D07-335_B1,0,1,0,0,0,1
CCACACTGAGATATTA-1_V12D07-335_B1,0,2,0,0,0,2
CGATCCGACCCAGTGC-1_V12D07-335_B1,0,3,0,0,0,3
CTGTACTTCTTAGCAT-1_V12D07-335_B1,1,0,1,0,0,2
ACTTATTAGGATCGGT-1_V12D07-335_B1,1,1,1,0,0,3
TAGTCCGCAGAGAATG-1_V12D07-335_B1,0,4,0,0,0,4
TTCACGAAAGGATCAC-1_V12D07-335_B1,0,0,0,0,0,0
TACATTTCTAACGTGC-1_V12D07-335_B1,4,1,0,0,0,5
ACCATATCCGCAATAA-1_V12D07-335_B1,0,0,0,0,0,0
CACTCAAGAGCTATGG-1_V12D07-335_B1,2,0,0,0,0,2
TGTACGAACAAATCCG-1_V12D07-335_B1,3,0,0,0,0,3
ATCATCCAATATTTGT-1_V12D07-335_B1,0,0,0,0,0,0
CGCTATTCTTAGGCTC-1_V12D07-335_B1,1,1,0,0,0,2
TGGCAGCAGTAATAGT-1_V12D07-335_B1,2,1,1,0,0,4
TCACGTGCCCGATTCA-1_V12D07-335_B1,1,1,0,0,0,2
CATACGGCGTCTGGGC-1_V12D07-335_B1,3,0,1,0,0,4
CACATGATTCAGCAAC-1_V12D07-335_B1,7,0,0,0,0,7
GCTAGTAGAGCTTGTA-1_V12D07-335_B1,1,0,0,0,0,1
TGCTGTTGAAGAACTC-1_V12D07-335_B1,1,0,3,0,0,4
CGGAGCATGGCGATCC-1_V12D07-335_B1,1,0,2,0,0,3
TAGCGTTGGGTCTTAC-1_V12D07-335_B1,1,1,0,0,0,2
GTAGCGGCTATACACT-1_V12D07-335_B1,2,0,1,0,0,3
TAACATACAATGTGGG-1_V12D07-335_B1,1,0,1,0,0,2
TCTTCGAATAGACGTT-1_V12D07-335_B1,0,1,0,0,0,1
GATCGTGACTGATATC-1_V12D07-335_B1,1,0,2,0,0,3
GATCCGGGAATTAACA-1_V12D07-335_B1,3,0,1,0,0,4
TTATATACGCTGTCAC-1_V12D07-335_B1,3,0,0,0,0,3
GTCGCGTAACCCGTTG-1_V12D07-335_B1,2,1,1,0,0,4
AGCTCTAGACGTTCCA-1_V12D07-335_B1,0,1,3,0,0,4
GTCAAGCGGACTCGGG-1_V12D07-335_B1,1,2,2,0,0,5
CGAGGGACTGCGGTCG-1_V12D07-335_B1,1,0,1,0,0,2
AATCGCCTCAGCGCCA-1_V12D07-335_B1,1,1,3,0,0,5
CTTGTTGCTGAGTCAA-1_V12D07-335_B1,1,0,2,0,0,3
GATATGAGACACTAAC-1_V12D07-335_B1,0,3,0,0,0,3
TTATGATCTTAACGAA-1_V12D07-335_B1,1,2,1,0,0,4
CGCCGCCCATGCCTGT-1_V12D07-335_B1,1,2,1,0,0,4
CTGGGATAAATAATGG-1_V12D07-335_B1,2,1,1,0,0,4
GTGCCCGTTCGGATTC-1_V12D07-335_B1,2,2,0,0,0,4
TTCAATACTCTGAATC-1_V12D07-335_B1,3,1,0,0,0,4
CGCACATGTCCACTAC-1_V12D07-335_B1,0,4,1,0,0,5
AGAAGAGCGCCGTTCC-1_V12D07-335_B1,1,3,0,0,0,4
GATAACTCGCACTGTG-1_V12D07-335_B1,0,1,0,0,0,1
AGTCGACGGTCTCAAG-1_V12D07-335_B1,0,8,0,0,0,8
GTGACCGCACACTACG-1_V12D07-335_B1,2,2,0,0,0,4
GTATGTGGGTCTAGTT-1_V12D07-335_B1,3,2,3,0,0,8
CTTGAGTTAGGGTAAT-1_V12D07-335_B1,2,0,0,0,0,2
TTAGCTGATTTGCCGT-1_V12D07-335_B1,1,3,0,0,0,4
GCTGTTGCTACCGAAC-1_V12D07-335_B1,1,5,0,0,0,6
TATTACCATCCTGCTT-1_V12D07-335_B1,0,4,0,0,0,4
TTGAATTCACGTGAGG-1_V12D07-335_B1,1,1,0,0,0,2
CCATCTCACCAGTGAA-1_V12D07-335_B1,0,1,2,0,0,3
CGCACGTGCGCTATCA-1_V12D07-335_B1,1,2,1,0,0,4
ACCCGGATGACGCATC-1_V12D07-335_B1,0,0,0,0,0,0
CGCTAGAGACCGCTGC-1_V12D07-335_B1,0,4,0,0,0,4
ATAGTTCCACCCACTC-1_V12D07-335_B1,1,4,0,0,0,5
GCAGACCCAGCACGTA-1_V12D07-335_B1,0,1,0,0,0,1
TAGACTACCTAGCGTT-1_V12D07-335_B1,0,0,1,0,0,1
GGTTCTACTCGTCTGA-1_V12D07-335_B1,0,4,0,0,0,4
GACTCACCCACGTGAG-1_V12D07-335_B1,0,2,0,0,0,2
AGCTCTTCGTAACCTT-1_V12D07-335_B1,1,0,0,0,0,1
ACTATCCAGGGCATGG-1_V12D07-335_B1,1,1,1,0,0,3
AAGGATCGATCGCTTG-1_V12D07-335_B1,0,0,2,0,0,2
ATATCGGTAGGGAGAT-1_V12D07-335_B1,0,1,0,0,0,1
TTCCAGACGAGATTTA-1_V12D07-335_B1,0,3,0,0,0,3
GACCGACGTGAAAGCA-1_V12D07-335_B1,1,2,0,0,0,3
CCTGGAAACGTTCTGC-1_V12D07-335_B1,0,1,0,0,0,1
CCGGTAATGGCTAGTC-1_V12D07-335_B1,1,1,1,0,0,3
GCCGTGGAAGAAATGT-1_V12D07-335_B1,0,2,1,0,0,3
GTCTTGAGGAGCAGTG-1_V12D07-335_B1,0,1,2,0,0,3
TCCCAAAGCCCTAAAT-1_V12D07-335_B1,1,1,1,1,0,4
TTGAGCGCCACGTGAT-1_V12D07-335_B1,1,2,0,1,0,4
TTGAGTCCCGCTGCTG-1_V12D07-335_B1,1,3,0,0,0,4
ATGGAACCTTTGCACA-1_V12D07-335_B1,0,0,2,0,0,2
GCTAGCACCTGGGCCA-1_V12D07-335_B1,0,0,2,0,0,2
CGCCGTCTACCCATCG-1_V12D07-335_B1,0,1,2,0,0,3
GATAGGTGTCCCGGGC-1_V12D07-335_B1,2,2,0,0,0,4
AGGTATGCGGACATTA-1_V12D07-335_B1,0,0,1,0,0,1
TTGGTTCGCTCAAAGG-1_V12D07-335_B1,0,0,1,3,0,4
TCTGGAGCGTAAGAGT-1_V12D07-335_B1,0,6,5,1,0,12
TGCCTAAATTTAATAG-1_V12D07-335_B1,0,10,7,0,0,17
TAATTTCCGTCCAGTA-1_V12D07-335_B1,1,0,0,0,0,1
TCCTTCAATCCCTACG-1_V12D07-335_B1,1,3,1,0,1,6
TACCTATCCCTAGAGG-1_V12D07-335_B1,3,1,0,0,0,4
GCATGGGTACTGACGC-1_V12D07-335_B1,1,0,0,0,0,1
GTCGGGAACATGGTAG-1_V12D07-335_B1,0,4,0,0,0,4
GCAAATGAGGACACTT-1_V12D07-335_B1,0,1,0,1,0,2
GAATGGGCTTATCGAC-1_V12D07-335_B1,0,4,0,0,0,4
TGGTCGTGCAAGGCAA-1_V12D07-335_B1,0,2,1,0,0,3
CACCACGCCACACAGA-1_V12D07-335_B1,1,3,1,0,0,5
GAACCTCGACCTACAC-1_V12D07-335_B1,1,1,0,0,0,2
CAATACGCTCTGAGGC-1_V12D07-335_B1,1,2,0,0,0,3
TGGTAAGCAGGATTGA-1_V12D07-335_B1,2,1,1,0,0,4
AGTGGCTCCGTCGGCC-1_V12D07-335_B1,0,1,0,0,0,1
GATCGGATAGAACCAT-1_V12D07-335_B1,0,3,2,0,0,5
GCTACAGTACGGACCG-1_V12D07-335_B1,0,1,0,0,0,1
TCTATTACTAGAGGAT-1_V12D07-335_B1,0,2,2,0,0,4
TTCAGGCGTCAAAGCC-1_V12D07-335_B1,3,4,0,0,0,7
AGACCGGGAAACCCTG-1_V12D07-335_B1,0,3,1,0,0,4
AGAGATCTCTAAAGCG-1_V12D07-335_B1,2,2,0,0,0,4
CCCTGCCCAATCCGCT-1_V12D07-335_B1,0,7,0,0,0,7
GTGGCGGTCCCAGCGT-1_V12D07-335_B1,0,2,0,0,0,2
GCATTGTAATTCATAT-1_V12D07-335_B1,1,3,3,0,0,7
CCGTTCCGAATCTCGG-1_V12D07-335_B1,1,2,0,0,0,3
AGCTTGATCTTAACTT-1_V12D07-335_B1,8,1,3,1,0,13
CCTGTACTCACGCCCA-1_V12D07-335_B1,2,3,0,0,0,5
AAGTGACGACCGAATT-1_V12D07-335_B1,1,2,0,0,0,3
CTCACTTGGCTGGTAA-1_V12D07-335_B1,0,3,0,0,0,3
CGCCTGGCCTACGTAA-1_V12D07-335_B1,0,0,0,0,0,0
CCCGTAAGTCTAGGCC-1_V12D07-335_B1,0,1,0,0,0,1
TTGGACATGTGGCTTA-1_V12D07-335_B1,1,2,0,0,0,3
ATTACGCGCTGGCAGG-1_V12D07-335_B1,0,1,0,0,0,1
ACGCGCTACACAGGGT-1_V12D07-335_B1,0,2,0,0,0,2
TACGTTTACCGGCAAT-1_V12D07-335_B1,3,2,0,0,0,5
CGAAACGCAATTCATG-1_V12D07-335_B1,1,0,0,0,0,1
TAGTCTAACAACGAGA-1_V12D07-335_B1,1,0,1,0,0,2
TTGCATGCTGATCACG-1_V12D07-335_B1,3,0,0,0,0,3
TCTGGGTAGCGCTCAT-1_V12D07-335_B1,0,0,0,0,0,0
ACATCGGTCAGCCGCG-1_V12D07-335_B1,0,2,0,0,0,2
AGATACCGGTGTTCAC-1_V12D07-335_B1,0,1,0,0,0,1
GATTACTGAATTTGGG-1_V12D07-335_B1,0,0,0,0,0,0
TCCAACTTTAAATTCT-1_V12D07-335_B1,0,1,0,0,0,1
TCCTAGCAAAGAAGCT-1_V12D07-335_B1,1,0,0,0,0,1
GTCTATCTGAGTTTCT-1_V12D07-335_B1,0,1,1,0,0,2
GATGTTCAATCCACGA-1_V12D07-335_B1,0,2,0,0,0,2
AGTTAAACACTTGCGA-1_V12D07-335_B1,1,1,0,0,0,2
AGCTCTTTACTCAGTT-1_V12D07-335_B1,3,3,1,0,0,7
ATCCAGGATTCGTGAA-1_V12D07-335_B1,0,0,0,0,0,0
AGTCAACACCACCATC-1_V12D07-335_B1,0,2,0,0,0,2
CGATACCTCGCGGACA-1_V12D07-335_B1,0,2,0,0,0,2
TACAACGCACAACTCA-1_V12D07-335_B1,0,3,0,0,0,3
AATTAAAGGTCGGCGT-1_V12D07-335_B1,2,1,1,0,0,4
TACGCAGTTCTTTCCT-1_V12D07-335_B1,0,2,0,0,0,2
GACCGTGCTGACGGTG-1_V12D07-335_B1,1,0,0,0,0,1
GGCAAATTACTTTACT-1_V12D07-335_B1,1,2,0,0,0,3
GGTACAAACATGCTAT-1_V12D07-335_B1,0,0,0,0,0,0
CGGGCCTTCTTTGTAA-1_V12D07-335_B1,0,3,2,0,0,5
CGTGAAGTTAATTCAC-1_V12D07-335_B1,1,0,0,0,0,1
ATAGTGAAGCGTTCTC-1_V12D07-335_B1,1,0,0,0,0,1
TACGCCATATTCTAAT-1_V12D07-335_B1,1,0,0,0,0,1
GCCGGGTTAGGGTCGC-1_V12D07-335_B1,1,1,1,0,0,3
TACATAGGCATACACC-1_V12D07-335_B1,0,1,1,0,0,2
GCCGATTGGCCAAGCT-1_V12D07-335_B1,0,1,0,0,0,1
CTGCCATGCATCACAT-1_V12D07-335_B1,0,0,0,0,0,0
TTATGAATGAAAGGGA-1_V12D07-335_B1,1,2,0,0,0,3
GCTGAGGCGTGAGTAT-1_V12D07-335_B1,0,4,0,0,0,4
GCGCCGTTCCACGATA-1_V12D07-335_B1,0,1,1,0,0,2
CGCATGGTGCGATGCT-1_V12D07-335_B1,2,2,0,0,0,4
AGGTTTCACACACCTT-1_V12D07-335_B1,5,1,1,0,0,7
CAAGGATCGCATGTTC-1_V12D07-335_B1,1,1,0,0,0,2
ACGTTAATGTCGAAGA-1_V12D07-335_B1,0,1,0,0,0,1
TCCAGAGCACCGGTTC-1_V12D07-335_B1,0,0,0,0,0,0
GATTCGACGGTTCACG-1_V12D07-335_B1,1,3,0,0,0,4
GTTTCTGCAGTCTCCC-1_V12D07-335_B1,2,0,0,0,0,2
GCTGCACGGTTTCTTA-1_V12D07-335_B1,0,3,1,0,0,4
CGTGCAGACTGGGACA-1_V12D07-335_B1,1,4,3,0,0,8
GTGTTACTATGCGTCC-1_V12D07-335_B1,0,1,0,0,0,1
TCCTCGGGCTGGGCTT-1_V12D07-335_B1,1,4,1,0,0,6
GTGAGGACACTTAAGG-1_V12D07-335_B1,1,2,0,0,0,3
ATACGCCGGCGAAACC-1_V12D07-335_B1,0,2,1,0,0,3
TCTGCCAGAAACTGCA-1_V12D07-335_B1,0,2,1,0,0,3
TTCTGCGGGTTAGCGG-1_V12D07-335_B1,0,0,0,0,0,0
CTCGGTACCACTGCTC-1_V12D07-335_B1,1,3,3,0,0,7
GTAAGTAACAGTCTGG-1_V12D07-335_B1,1,1,0,0,0,2
GTGCGTGTATATGAGC-1_V12D07-335_B1,2,4,3,0,0,9
ATTTGTCTTGGGAGCT-1_V12D07-335_B1,1,0,0,0,0,1
CCTCGGACCGGGATAG-1_V12D07-335_B1,1,2,0,0,0,3
TAGGTGCTCGCCTAGC-1_V12D07-335_B1,1,0,0,0,0,1
CTTTAGGAACACTGTT-1_V12D07-335_B1,1,4,2,0,0,7
TCGGGCCGTCGTGGTA-1_V12D07-335_B1,1,1,0,0,0,2
AGTGCTTGCACGAATA-1_V12D07-335_B1,0,3,0,0,0,3
TGCAGTTTCCTCCCAT-1_V12D07-335_B1,1,1,0,0,0,2
TGAGAGATTTACCACG-1_V12D07-335_B1,0,3,2,0,0,5
GAAACAGATGACCACC-1_V12D07-335_B1,1,3,0,0,0,4
AGCAACATATCTTATT-1_V12D07-335_B1,0,3,1,0,0,4
CAAGTGTGGTTGCAAA-1_V12D07-335_B1,1,4,1,0,0,6
GCCTCATCTGGAAATA-1_V12D07-335_B1,0,1,0,0,0,1
AACCCTACTGTCAATA-1_V12D07-335_B1,0,3,1,0,0,4
ACGTATTACTCCGATC-1_V12D07-335_B1,2,2,0,0,0,4
TCTGGGAACCTTTGAA-1_V12D07-335_B1,0,3,1,0,0,4
GCTCGCTCATGTCCAA-1_V12D07-335_B1,0,5,0,0,0,5
GCGCAAGAGCGCGCTG-1_V12D07-335_B1,2,2,1,0,0,5
TTGACGCTCCATGAGC-1_V12D07-335_B1,2,2,0,0,0,4
TATAGATGGTCGCAGT-1_V12D07-335_B1,0,3,1,0,0,4
TTACATGCCACAACTA-1_V12D07-335_B1,2,4,1,0,0,7
ACATGGCGCCAAAGTA-1_V12D07-335_B1,0,5,0,0,0,5
TATGGTTAGTGGGAGA-1_V12D07-335_B1,0,3,1,0,0,4
CATGACTTCGCTGAAT-1_V12D07-335_B1,0,1,0,0,0,1
ACCACCAATGTAACAA-1_V12D07-335_B1,0,1,2,0,0,3
TCTTAGAGCTCCAATT-1_V12D07-335_B1,0,2,1,0,0,3
CCACGAATTTAACCTC-1_V12D07-335_B1,0,4,1,0,0,5
TTCTTGCTAGCATCTC-1_V12D07-335_B1,1,6,1,0,0,8
ACACCTTACTACTTGC-1_V12D07-335_B1,1,1,0,0,0,2
AGTCGGTTGCGTGAGA-1_V12D07-335_B1,0,3,1,0,0,4
ACCTACAGTATGTGGT-1_V12D07-335_B1,0,1,1,0,0,2
GAGGATAAACAGTGCT-1_V12D07-335_B1,0,2,0,0,0,2
TTCCGGTATCTGTGTC-1_V12D07-335_B1,0,0,1,0,0,1
GGAGGCCGAAGTCGTC-1_V12D07-335_B1,1,3,0,0,0,4
TTCGCTAGGAAGTTGT-1_V12D07-335_B1,0,2,1,0,0,3
TAAAGACAACCCTTTA-1_V12D07-335_B1,1,1,0,0,0,2
GTTGCGCTAACATTAC-1_V12D07-335_B1,1,1,0,0,0,2
GCTGAACTCTCCAGGG-1_V12D07-335_B1,1,3,2,0,0,6
AGCCCTGTCGCACCGT-1_V12D07-335_B1,0,4,0,0,0,4
AGCGCTAGAGCGATGT-1_V12D07-335_B1,0,1,1,1,0,3
TGCGCCGTTAATAACG-1_V12D07-335_B1,1,1,0,0,0,2
TGACAACGCATGTCGC-1_V12D07-335_B1,0,2,1,0,0,3
CGTCTTGAGTGTGACG-1_V12D07-335_B1,0,3,2,0,0,5
GATAGGATTAATTACA-1_V12D07-335_B1,0,9,2,5,0,16
GATACCGTGTCGGAGT-1_V12D07-335_B1,0,5,8,0,0,13
TGTGTCGAAGTCGAGG-1_V12D07-335_B1,0,1,0,0,0,1
GGATCAGAGCCATCAG-1_V12D07-335_B1,0,2,0,0,0,2
GTCCCAATCATCCCGC-1_V12D07-335_B1,0,2,0,0,0,2
TGCCACACTAGAGGAA-1_V12D07-335_B1,0,2,1,1,0,4
TGAATTTCACTTGCCT-1_V12D07-335_B1,1,2,0,0,0,3
CTCAGATTGTGATAAG-1_V12D07-335_B1,1,2,0,0,0,3
CGGACGTTACTTGAAG-1_V12D07-335_B1,1,1,0,0,0,2
CCGCCTTGCGATGTCG-1_V12D07-335_B1,1,6,1,0,0,8
CCAGTCAAATCTCTTA-1_V12D07-335_B1,0,3,0,0,0,3
AAACAGCTTTCAGAAG-1_V12D07-335_B1,2,0,0,0,0,2
TAGCTGATGTGAAGCG-1_V12D07-335_B1,1,3,0,0,0,4
CTTATGCGCTCAGGGC-1_V12D07-335_B1,0,3,0,1,0,4
TGGCTCTTGTCGCGTA-1_V12D07-335_B1,0,6,0,1,0,7
TTGTGAGGCATGACGC-1_V12D07-335_B1,2,3,0,0,0,5
CATAAGCTCTCCGTCT-1_V12D07-335_B1,1,2,0,0,0,3
CCTTCTCAGCGTTCCT-1_V12D07-335_B1,1,2,0,0,0,3
TGCAGCTACGTACTTC-1_V12D07-335_B1,0,2,0,0,0,2
CTCTACACTGGCGATT-1_V12D07-335_B1,0,1,1,0,0,2
TGCAGATCGTCCTAGG-1_V12D07-335_B1,0,5,0,0,0,5
TGCCAAAGTCAGACTT-1_V12D07-335_B1,2,4,0,0,0,6
ACAATAGTCGTACGTT-1_V12D07-335_B1,1,1,0,1,0,3
CATGCCAACTCGCAAA-1_V12D07-335_B1,1,5,0,0,0,6
TGCAGAACTATATCGT-1_V12D07-335_B1,0,4,1,0,0,5
TCGTGTCACGCTGACA-1_V12D07-335_B1,0,2,0,0,0,2
TGATCAGGGAACTGCT-1_V12D07-335_B1,0,2,0,0,0,2
CTTGCAACCGCCTCCT-1_V12D07-335_B1,2,1,0,0,0,3
AGCCCATACATGTAAG-1_V12D07-335_B1,1,3,2,0,0,6
ATCCAATGGAGGGTCC-1_V12D07-335_B1,3,0,0,1,0,4
AAACCGGGTAGGTACC-1_V12D07-335_B1,0,0,0,0,0,0
GCAACCACGGCCGCGT-1_V12D07-335_B1,0,3,3,0,0,6
CGCTTATTCCCGGTCG-1_V12D07-335_B1,3,0,0,0,0,3
TTACTCTGGTACGTAC-1_V12D07-335_B1,0,0,0,0,0,0
GTGGTTTCCGCCTTTC-1_V12D07-335_B1,0,0,0,0,0,0
ATAGGCGGCTATAGAA-1_V12D07-335_B1,1,1,1,0,0,3
GTGCCATCACACGGTG-1_V12D07-335_B1,1,4,1,0,0,6
CCCAACATACGTCGCG-1_V12D07-335_B1,2,2,0,0,0,4
CGGTGCAGATAGAACG-1_V12D07-335_B1,2,0,0,0,0,2
GGGCGGGTTCCCTACG-1_V12D07-335_B1,1,0,0,0,0,1
TGAGCCATACAGTCTC-1_V12D07-335_B1,2,0,0,0,0,2
CTCCGCCCACATGAGG-1_V12D07-335_B1,0,2,0,1,0,3
GTTGAACCGGTTCCAT-1_V12D07-335_B1,1,1,0,0,0,2
TTGACTACCATATGGT-1_V12D07-335_B1,0,2,0,0,0,2
ACCATCGTATATGGTA-1_V12D07-335_B1,0,0,0,0,0,0
TGCGTAAGAACCTGAT-1_V12D07-335_B1,0,7,1,0,0,8
AGAAGGTTGCCGAATT-1_V12D07-335_B1,1,3,0,0,0,4
AGGACGACCCATTAGA-1_V12D07-335_B1,1,2,2,0,0,5
GGTGCTGGTACACATT-1_V12D07-335_B1,0,0,0,1,0,1
GCGCTATGCCGAGGCA-1_V12D07-335_B1,2,2,0,0,0,4
ACCCGGTTACACTTCC-1_V12D07-335_B1,1,2,0,0,0,3
TAACTCATCCGCGCGG-1_V12D07-335_B1,0,0,1,0,0,1
CACAATGAGCTGCTAT-1_V12D07-335_B1,3,1,0,0,0,4
GTTACTTTGGGCCTAG-1_V12D07-335_B1,0,0,0,0,0,0
GGGCCCGTCTTAAACA-1_V12D07-335_B1,0,1,1,0,0,2
GAAATTGTCTCTATAA-1_V12D07-335_B1,2,1,0,0,0,3
GGCGCATGAATTGATG-1_V12D07-335_B1,0,2,0,0,0,2
CATATAGGTACAGTCA-1_V12D07-335_B1,0,3,0,0,0,3
TCAACGAGGAGACAAA-1_V12D07-335_B1,1,5,0,0,0,6
TTGCACAATTCAGAAA-1_V12D07-335_B1,0,0,0,0,0,0
CATCGGACGGGTTAAT-1_V12D07-335_B1,0,1,1,0,0,2
ATTAAACATGCGGACC-1_V12D07-335_B1,1,2,1,0,0,4
TATCTACCACAGCGGG-1_V12D07-335_B1,0,1,0,0,0,1
CGAGACCCTAGAGTGT-1_V12D07-335_B1,1,3,0,0,0,4
ACATCGATCGTTTACC-1_V12D07-335_B1,1,1,0,0,0,2
ATCGACCCAATACAGA-1_V12D07-335_B1,2,1,2,0,0,5
GAATCTGAACATTCTC-1_V12D07-335_B1,0,1,0,0,0,1
AGTTCCTATTTATGTT-1_V12D07-335_B1,1,2,0,0,0,3
CAGTCTGTATACTGGG-1_V12D07-335_B1,1,4,0,0,0,5
GGAGACGACACCTTTG-1_V12D07-335_B1,0,2,0,0,0,2
CCTAAATTAACGGTTC-1_V12D07-335_B1,0,4,2,0,0,6
GCTACGACTTATTGGG-1_V12D07-335_B1,1,4,1,0,0,6
CTGTGCAGGGTAGGTC-1_V12D07-335_B1,1,4,0,0,0,5
ACGCCGCTAGACGACC-1_V12D07-335_B1,1,1,1,0,0,3
ACTTGACTCCCTCTTT-1_V12D07-335_B1,2,1,0,0,0,3
CGCCTCCCTCCTCTAT-1_V12D07-335_B1,0,4,0,0,0,4
CTAGATTTACGACGGC-1_V12D07-335_B1,0,1,1,0,0,2
GATGCTGTATTTCATC-1_V12D07-335_B1,1,2,0,0,0,3
TGCGTTTGTTGACACT-1_V12D07-335_B1,1,3,3,0,0,7
CGTGCCCTCCCGAAGA-1_V12D07-335_B1,1,2,2,0,0,5
ACTCTCTGACTTAGGT-1_V12D07-335_B1,0,2,0,0,0,2
CTGGGTAGGCAGTTAA-1_V12D07-335_B1,0,3,1,0,0,4
GTTTGGCCCAAGTTAT-1_V12D07-335_B1,0,3,1,0,0,4
GAATGTGGTCCGGATT-1_V12D07-335_B1,0,4,0,0,0,4
CCCAGTTAAGGCGCCG-1_V12D07-335_B1,1,1,0,0,0,2
CGGTACTAGAATCAAA-1_V12D07-335_B1,0,4,1,0,0,5
GCTTAATGTAACTAAC-1_V12D07-335_B1,0,3,3,0,0,6
AGGACAGTCGAATCCC-1_V12D07-335_B1,0,2,0,0,0,2
GACAGCCAGACCTGAC-1_V12D07-335_B1,1,1,1,0,0,3
GGCGAAATCTAACTTG-1_V12D07-335_B1,0,3,0,0,0,3
CTGGTAACACATAGAA-1_V12D07-335_B1,0,1,1,0,0,2
TAGCCATTTCAAAGTC-1_V12D07-335_B1,2,2,1,0,0,5
GGGATTTACCGCACCT-1_V12D07-335_B1,0,3,1,0,0,4
ATGCCATTTGCGACCA-1_V12D07-335_B1,0,5,2,0,0,7
GAATAGACGCGACCCA-1_V12D07-335_B1,1,3,0,0,0,4
TGTATGGCGCAGACAG-1_V12D07-335_B1,0,3,4,0,0,7
GGATGAAGATCGCTGA-1_V12D07-335_B1,0,2,0,0,0,2
CGACAATTTGATCTAA-1_V12D07-335_B1,0,0,0,0,0,0
AAAGTTGACTCCCGTA-1_V12D07-335_B1,0,4,0,0,0,4
CGCGGCTCAACTTGAA-1_V12D07-335_B1,0,3,1,0,0,4
CACGCGGAACTGTTGC-1_V12D07-335_B1,1,0,0,0,0,1
TCTTAGAGTGAACTCT-1_V12D07-335_B1,1,4,0,0,0,5
AGTCCATTGGCTGATG-1_V12D07-335_B1,0,1,1,0,0,2
TTAAGATAGGATTGAC-1_V12D07-335_B1,0,3,1,0,0,4
ACATCCTGGTAACTGT-1_V12D07-335_B1,1,2,0,0,0,3
CACCTTGGCGCCTTTG-1_V12D07-335_B1,0,0,2,0,0,2
GCTAGACCGTCTACTG-1_V12D07-335_B1,1,2,0,0,0,3
CGGCCCAGGTATATCC-1_V12D07-335_B1,0,2,2,0,0,4
GTCCATTACTGCTACG-1_V12D07-335_B1,0,2,2,0,0,4
GGGTTTAGGATAGGAT-1_V12D07-335_B1,0,0,5,0,0,5
TAATTAGGACATCCGT-1_V12D07-335_B1,0,2,0,0,0,2
GCTCCCAGTCGGTCCA-1_V12D07-335_B1,0,0,0,0,0,0
ATTCGTGCTATCTCTT-1_V12D07-335_B1,0,2,0,0,0,2
GTTAACTATGTTGTCA-1_V12D07-335_B1,0,1,4,0,0,5
GCTCCGCTCGCTTCAG-1_V12D07-335_B1,0,5,1,0,0,6
GCAACGGCTAGTTATG-1_V12D07-335_B1,0,4,1,0,0,5
AATCGCGCAGAGGACT-1_V12D07-335_B1,2,2,1,0,0,5
AGGTTACACCATGCCG-1_V12D07-335_B1,0,1,0,0,0,1
CGAGATTTCGCTCGGG-1_V12D07-335_B1,1,2,0,0,0,3
CGATAATACTCAGGTT-1_V12D07-335_B1,0,2,0,0,0,2
AAGGCAGGCTGTCTCC-1_V12D07-335_B1,1,3,0,0,0,4
GTAAGTCCACACTCTA-1_V12D07-335_B1,0,0,1,0,0,1
ATGAGGGCAGCGGCTA-1_V12D07-335_B1,0,3,1,0,0,4
GCCGCACTCCGTTTCA-1_V12D07-335_B1,0,3,2,1,0,6
GAGCACGGCGCCTCTT-1_V12D07-335_B1,0,1,1,0,0,2
ACAATTTGGCCATATT-1_V12D07-335_B1,0,1,2,0,0,3
CTGGTTCGCGAGCTAC-1_V12D07-335_B1,0,1,0,0,0,1
GACGGTCCTAGGGTGT-1_V12D07-335_B1,0,3,2,1,0,6
ACTCGCGATCTGACGC-1_V12D07-335_B1,0,11,7,3,0,21
GTGTACGAACCGTTCC-1_V12D07-335_B1,0,12,3,0,0,15
CTTTGACGTCGCTTCT-1_V12D07-335_B1,1,3,1,0,1,6
CGTTATCATACTTCCA-1_V12D07-335_B1,0,1,0,0,1,2
GCTATGCCAGCTTATG-1_V12D07-335_B1,1,0,0,1,0,2
CAGTCGGCCTAGATAT-1_V12D07-335_B1,0,5,0,0,0,5
CCCGTGAGGGCGGTGA-1_V12D07-335_B1,0,1,0,0,0,1
TCTCGTGTTACGAGGA-1_V12D07-335_B1,0,3,0,3,0,6
ACGTCTCGTTCCGGGA-1_V12D07-335_B1,1,0,1,2,0,4
CGAGAGCGCGTAGATA-1_V12D07-335_B1,0,4,0,1,0,5
GACAGATTTCTGGCTC-1_V12D07-335_B1,2,3,0,0,0,5
GGGCCTAAATGGGCTA-1_V12D07-335_B1,1,1,1,2,1,6
ACTTGTAGTCCCTTCA-1_V12D07-335_B1,1,1,1,2,0,5
CCCGAAGTTTCGCGAA-1_V12D07-335_B1,1,1,0,0,0,2
ACCATCCGCCAACTAG-1_V12D07-335_B1,0,2,0,1,0,3
TGCGAATATGGGATTT-1_V12D07-335_B1,3,2,1,1,0,7
TACATCCCTATCCCTG-1_V12D07-335_B1,0,2,0,0,0,2
GTGGGAAGACTGAATC-1_V12D07-335_B1,1,2,0,0,0,3
TCAACATCGACCGAGA-1_V12D07-335_B1,0,1,0,1,0,2
CTATGTGAGTCACGGC-1_V12D07-335_B1,1,2,0,0,0,3
CCGAACACTGGGCCTC-1_V12D07-335_B1,1,2,0,0,0,3
AAACTTGCAAACGTAT-1_V12D07-335_B1,1,1,0,0,0,2
AGGGCGAGCAGCTGAT-1_V12D07-335_B1,1,2,0,1,0,4
AACACGAGACGCGGCC-1_V12D07-335_B1,1,1,0,2,0,4
TGACGAATATTTCCCT-1_V12D07-335_B1,1,1,0,0,0,2
TCGGAGAGTATCGGGA-1_V12D07-335_B1,0,1,0,0,0,1
CAAATCTCTCACAAGG-1_V12D07-335_B1,1,4,0,0,0,5
AGGCCCTAGAACGCCA-1_V12D07-335_B1,1,0,0,0,0,1
TAGAGATCATGCAACT-1_V12D07-335_B1,3,2,0,0,0,5
TTGTTTCCATACAACT-1_V12D07-335_B1,0,0,0,0,0,0
GAGAGGTGCATTCTGG-1_V12D07-335_B1,2,2,0,1,0,5
GTGGACCAACCCGATT-1_V12D07-335_B1,0,1,0,2,0,3
CTGGGCCTGCTATATC-1_V12D07-335_B1,2,2,2,0,0,6
CATAGTCCACAAGAAC-1_V12D07-335_B1,0,6,0,0,0,6
TTGACATGAACGTGGA-1_V12D07-335_B1,0,0,0,0,0,0
GGTTACCACCCTCGGG-1_V12D07-335_B1,1,0,0,0,0,1
TACCGGTCGTTTCCAT-1_V12D07-335_B1,2,1,1,0,0,4
CGAGTACTAAAGAGGA-1_V12D07-335_B1,0,1,0,0,0,1
GCAAGAATTCCTTGGC-1_V12D07-335_B1,0,0,0,0,0,0
TCGCCGAAGTTGCGTC-1_V12D07-335_B1,2,0,0,0,0,2
TTGAGAGTACTGCTAA-1_V12D07-335_B1,2,2,0,0,0,4
GCCACAATTTAAGGAC-1_V12D07-335_B1,1,6,0,1,0,8
ATATTCAGTTAAACCT-1_V12D07-335_B1,1,0,0,1,0,2
TGAGTGCCTCTTAAAT-1_V12D07-335_B1,0,0,0,0,0,0
ATCAGACGGCACGCCG-1_V12D07-335_B1,1,0,0,3,0,4
GTGCGAAATCGAACAC-1_V12D07-335_B1,2,1,0,0,0,3
GTGCCGCTTCAAAGGT-1_V12D07-335_B1,0,2,0,0,0,2
GATACGATGGGAGTCA-1_V12D07-335_B1,1,0,0,0,0,1
GACACTGAGTTCAGTG-1_V12D07-335_B1,2,3,0,0,0,5
ATCCTGCGTGGAATGG-1_V12D07-335_B1,2,0,0,0,0,2
ATCCTACCTAAGCTCT-1_V12D07-335_B1,0,0,0,0,0,0
AGTGATATGAGTAGTT-1_V12D07-335_B1,2,0,0,0,0,2
ATGATGCAATGGTACA-1_V12D07-335_B1,0,1,0,0,0,1
GAAACCGAATTACCTT-1_V12D07-335_B1,0,0,0,0,0,0
AGTGACCTACTTTACG-1_V12D07-335_B1,0,2,2,0,0,4
CAAATGTCCTTCCGTG-1_V12D07-335_B1,1,0,0,0,0,1
TTACTGGGATATTTCA-1_V12D07-335_B1,1,0,0,0,0,1
CTTGCCCAGGCTCTAC-1_V12D07-335_B1,0,0,0,0,0,0
AAATCGTGTACCACAA-1_V12D07-335_B1,0,2,0,0,0,2
GTGATCATAGATCTGC-1_V12D07-335_B1,0,1,1,0,0,2
TGGCAGATTACGATCA-1_V12D07-335_B1,0,2,1,0,0,3
TCACCCTCTTAAGATT-1_V12D07-335_B1,4,0,1,0,0,5
CAGGATATATCGTTGT-1_V12D07-335_B1,0,1,0,0,0,1
CCTGACCACCGATGGT-1_V12D07-335_B1,3,0,0,0,0,3
CTAAAGGGAAATAGGA-1_V12D07-335_B1,0,1,1,1,0,3
CCGCTATCAGCACCAG-1_V12D07-335_B1,0,3,0,0,0,3
CTTTAGTGCTATTATT-1_V12D07-335_B1,0,1,1,0,0,2
CGGGAATTTATGTAAA-1_V12D07-335_B1,1,2,1,0,0,4
TACGACTGCCTCTTAG-1_V12D07-335_B1,1,1,1,0,0,3
AAACTGCTGGCTCCAA-1_V12D07-335_B1,1,0,0,0,0,1
GTACGTTTGCCCGTCA-1_V12D07-335_B1,0,2,1,0,0,3
GGCAAGGCGAAATAGC-1_V12D07-335_B1,0,8,0,0,0,8
GATCTTGGAGGGCATA-1_V12D07-335_B1,1,0,2,0,0,3
AGCGTGGTATTCTACT-1_V12D07-335_B1,0,1,0,0,0,1
CTAAGGGAATGATTGG-1_V12D07-335_B1,1,2,0,0,0,3
CATGGTAAGTAGCGTT-1_V12D07-335_B1,0,1,0,0,0,1
CGTTGAGCGACCGTCG-1_V12D07-335_B1,0,3,0,0,0,3
TGCCCGTACCGTTAAA-1_V12D07-335_B1,1,2,0,0,0,3
ACAAGGGCAGGCTCTG-1_V12D07-335_B1,0,2,1,0,0,3
GAGATCTTCCATGACA-1_V12D07-335_B1,0,1,0,0,0,1
AATGACGTAGGATGTC-1_V12D07-335_B1,0,5,0,0,0,5
GTGGTGGCCAAGTGAA-1_V12D07-335_B1,0,4,0,0,0,4
TCCCGTGTGCAATTTG-1_V12D07-335_B1,0,2,0,0,0,2
ACATCGTATGCAATGG-1_V12D07-335_B1,0,5,2,0,0,7
GCGAAACTTAACTGGA-1_V12D07-335_B1,1,2,2,0,0,5
AATTGAACGCTCTGGT-1_V12D07-335_B1,0,2,1,0,0,3
ACAAATGGTAGTGTTT-1_V12D07-335_B1,0,3,1,0,0,4
ATGGTCGCGTGGTTTC-1_V12D07-335_B1,1,2,2,0,0,5
TGTTATTGTATGTGGC-1_V12D07-335_B1,0,1,0,0,0,1
TTCCGGTTACCCACTT-1_V12D07-335_B1,1,2,1,0,0,4
GAGTGTGCGGTACCCA-1_V12D07-335_B1,0,4,1,0,0,5
CAAGATATTATAACGT-1_V12D07-335_B1,0,2,0,0,0,2
ACACACCAGGACCAGT-1_V12D07-335_B1,0,0,0,0,0,0
ATGGGCCTCGGCCTCT-1_V12D07-335_B1,0,3,0,0,0,3
AAGGTGATAAACCAGC-1_V12D07-335_B1,0,6,1,0,0,7
TCTTACTTATGCCTCT-1_V12D07-335_B1,1,3,0,0,0,4
AAAGTGTGATTTATCT-1_V12D07-335_B1,1,1,3,0,0,5
TGCTCCACAGTTCTTA-1_V12D07-335_B1,0,3,2,0,0,5
CTGGCTGATTCATCCT-1_V12D07-335_B1,0,7,2,0,0,9
TAAGGCTGAATCCCTC-1_V12D07-335_B1,1,6,0,0,0,7
TCTAGTGATATCGTGG-1_V12D07-335_B1,1,4,1,0,0,6
TCGAAGAACCGAGCAC-1_V12D07-335_B1,0,2,0,0,0,2
GACAAACATATGCAGG-1_V12D07-335_B1,0,1,0,0,0,1
AAGTCAATTGTCGTCA-1_V12D07-335_B1,1,3,0,0,0,4
AGTGAACAAACTTCTC-1_V12D07-335_B1,1,1,1,0,0,3
CATGATGGAAGTTAGC-1_V12D07-335_B1,0,0,2,0,0,2
AAGTGCCTTGACTGTA-1_V12D07-335_B1,0,3,1,0,0,4
ATCGCCAGTCAACATT-1_V12D07-335_B1,2,4,1,0,0,7
ACCGCGGTGGAAGTCG-1_V12D07-335_B1,0,2,1,0,0,3
TCTTCTATAACCCGCC-1_V12D07-335_B1,1,0,1,0,0,2
CACATTTCTTGTCAGA-1_V12D07-335_B1,1,1,1,0,0,3
TAGCGTCCCTCGATTG-1_V12D07-335_B1,1,1,1,0,0,3
GTTCGGATCGGGAACA-1_V12D07-335_B1,2,0,0,0,0,2
CAAACTCGCGACGCCG-1_V12D07-335_B1,0,2,1,0,0,3
GTCTTGTAGCTATTCA-1_V12D07-335_B1,1,0,0,0,0,1
TCTCGACGTATCGCCG-1_V12D07-335_B1,0,4,0,0,0,4
TTGCCAAGCAGAACCC-1_V12D07-335_B1,0,4,0,0,0,4
AAACCCGAACGAAATC-1_V12D07-335_B1,1,2,0,0,0,3
TTGAGCAGCCCACGGT-1_V12D07-335_B1,0,3,0,0,0,3
CGCCTTTAGCATGCTC-1_V12D07-335_B1,0,2,0,0,0,2
TGTGGCTCCCACCAAC-1_V12D07-335_B1,0,2,0,1,0,3
CCGCCGTTGAGGATAA-1_V12D07-335_B1,0,3,1,0,0,4
CAATACGAGAGTCTGA-1_V12D07-335_B1,2,2,1,0,0,5
CATCTAGTGAAGGGAA-1_V12D07-335_B1,1,2,0,0,0,3
GGTGGAGGTTGATACG-1_V12D07-335_B1,0,0,1,1,0,2
CCGCACACGAACGTGT-1_V12D07-335_B1,0,2,1,0,0,3
AGAACCCAGCGTGACA-1_V12D07-335_B1,0,2,1,0,0,3
GCGCTCGATCACCTGT-1_V12D07-335_B1,0,0,1,0,0,1
ATCATGGACTACCGAC-1_V12D07-335_B1,0,5,1,4,0,10
TACGCCGCCTCAGAAG-1_V12D07-335_B1,0,0,5,0,0,5
CGACCTACTAGACAAT-1_V12D07-335_B1,0,1,1,1,0,3
GAGTCTTGTAAAGGAC-1_V12D07-335_B1,0,1,0,0,0,1
AATATCCTAGCAAACT-1_V12D07-335_B1,0,0,0,0,0,0
CCCTAGGCAACAAGAG-1_V12D07-335_B1,1,1,0,0,0,2
ACAAAGAAGGTAGGCC-1_V12D07-335_B1,2,1,0,0,1,4
CCCTGGCTGTTCCTTC-1_V12D07-335_B1,1,0,0,0,0,1
TCGCCGCACCGCGTGA-1_V12D07-335_B1,1,1,0,0,0,2
TATAGCGCACGTTATC-1_V12D07-335_B1,2,2,1,0,0,5
TTATCTGACATTAGGA-1_V12D07-335_B1,2,0,0,2,2,6
AGTGGTGTTACCCGTG-1_V12D07-335_B1,2,0,0,0,0,2
GCCAAGAATACTTCTG-1_V12D07-335_B1,1,0,0,0,1,2
CCGGCGTGAGACTCTG-1_V12D07-335_B1,0,0,0,0,0,0
TTCCCGGCGCCAATAG-1_V12D07-335_B1,1,1,0,0,0,2
AAACAGGGTCTATATT-1_V12D07-335_B1,0,4,0,0,0,4
ACAGTAATACAACTTG-1_V12D07-335_B1,0,2,1,0,0,3
CGAACGGCCGGACAAC-1_V12D07-335_B1,1,1,1,2,0,5
GCAACACACTAGAACT-1_V12D07-335_B1,0,2,0,0,0,2
ACTCCCATTCCTAAAG-1_V12D07-335_B1,0,3,0,1,1,5
ACCTGCGTGTCATGTT-1_V12D07-335_B1,4,1,0,0,0,5
TACTTTCCGCACGCCA-1_V12D07-335_B1,1,1,0,0,0,2
AGGTCAGGTGAGAGTG-1_V12D07-335_B1,0,1,0,0,0,1
TCCTCCTAAGACATTC-1_V12D07-335_B1,0,5,0,0,0,5
ATGTGAAAGCCTAATG-1_V12D07-335_B1,1,0,0,0,0,1
AGTCGGCTCAACTTTA-1_V12D07-335_B1,0,2,1,0,0,3
CGATCTGTTGGAGGAC-1_V12D07-335_B1,2,0,0,0,0,2
ACGGGAGTGTCGGCCC-1_V12D07-335_B1,1,3,0,3,0,7
TTAACTTCAGGTAGGA-1_V12D07-335_B1,0,0,0,0,0,0
CCACGGAGCCATAAGA-1_V12D07-335_B1,0,0,0,0,0,0
CTTCTATGTTGAAGTA-1_V12D07-335_B1,1,1,0,0,0,2
CACCGTTGCGCGATAT-1_V12D07-335_B1,2,1,1,1,0,5
TCTAGCAATCTCCGCC-1_V12D07-335_B1,7,0,0,0,0,7
AGTTTGGCCAGACCTA-1_V12D07-335_B1,0,1,0,0,0,1
TTGTAAGGACCTAAGT-1_V12D07-335_B1,0,2,0,0,0,2
AAATTTGCGGGTGTGG-1_V12D07-335_B1,6,0,0,0,0,6
AAGTTCGGCCAACAGG-1_V12D07-335_B1,1,2,0,0,0,3
CCGCTTACCTCACTCT-1_V12D07-335_B1,1,0,0,0,0,1
ATCACGTGCTAATTAA-1_V12D07-335_B1,0,0,0,0,0,0
GGTGAAGTACAGGGAT-1_V12D07-335_B1,0,5,0,0,0,5
GCTGTATTACTGGCCC-1_V12D07-335_B1,0,0,0,1,0,1
AACGGCCATCTCCGGT-1_V12D07-335_B1,0,2,0,0,0,2
TAAGTAACATCTTGAC-1_V12D07-335_B1,0,3,0,0,0,3
TTCTTGAGCCGCGCTA-1_V12D07-335_B1,0,0,0,1,0,1
AGTGCGTAGCTCGTAA-1_V12D07-335_B1,1,1,0,0,0,2
GGGATGGTCGTAACCG-1_V12D07-335_B1,5,0,0,0,0,5
GTCTGGGCGGTCGAGA-1_V12D07-335_B1,0,0,1,0,0,1
CGGAACGTAAACATAG-1_V12D07-335_B1,1,0,0,0,0,1
TGCGACACCCTAGTGC-1_V12D07-335_B1,0,1,0,0,0,1
CAAACGAGTATCGCAG-1_V12D07-335_B1,0,2,0,0,0,2
TCAGTAGGGACTATAA-1_V12D07-335_B1,0,2,0,0,0,2
GCGGTTCCCTATCATG-1_V12D07-335_B1,1,1,0,0,0,2
GTGACTTCAGTAGTGC-1_V12D07-335_B1,0,3,0,0,0,3
CGTCACGTCCATTGGT-1_V12D07-335_B1,0,0,0,1,0,1
ATAAGTTACCGCGACG-1_V12D07-335_B1,1,2,0,1,0,4
CTGAATCCGAGACCTC-1_V12D07-335_B1,1,0,0,0,0,1
TACGACGCTTGCTGCG-1_V12D07-335_B1,2,1,0,0,0,3
GAATTCACCCGGGTGT-1_V12D07-335_B1,0,1,1,0,0,2
GGGTGACACCTTAACT-1_V12D07-335_B1,0,3,0,1,0,4
TGAGTAAATTAGCGTA-1_V12D07-335_B1,2,0,0,0,0,2
GAGTCCGCTTACCGGA-1_V12D07-335_B1,0,1,0,0,0,1
GGCGCGTTCGAGTTTA-1_V12D07-335_B1,0,3,0,1,0,4
ATTCATATACTGTCCA-1_V12D07-335_B1,0,2,0,0,0,2
ATAAACGGACCCGTAA-1_V12D07-335_B1,0,1,0,1,0,2
GTCGTACCATCTCGGG-1_V12D07-335_B1,0,1,1,1,0,3
ATAATAGCTGTTGAAT-1_V12D07-335_B1,2,0,0,0,0,2
TTCCGCGTGAGGCGAT-1_V12D07-335_B1,1,1,0,0,0,2
TACCGGCTCACTGCCC-1_V12D07-335_B1,1,0,0,0,0,1
GTATCTTTCATAACCA-1_V12D07-335_B1,0,5,0,0,0,5
GTTACCTACAACTTGC-1_V12D07-335_B1,0,2,0,0,0,2
TGACTATAATCCTTTC-1_V12D07-335_B1,1,0,2,0,0,3
AAATACCTATAAGCAT-1_V12D07-335_B1,0,2,0,0,0,2
TTATTAGAGCGTGTTC-1_V12D07-335_B1,0,2,0,0,0,2
ATGTGGACATCTTGAT-1_V12D07-335_B1,1,0,6,2,0,9
GTACGCTTCATTGCAC-1_V12D07-335_B1,0,1,0,0,0,1
CACATATTAGCAGGAT-1_V12D07-335_B1,0,2,0,0,0,2
CAAGAGGGCGGAGTAC-1_V12D07-335_B1,0,0,0,0,0,0
TCGCAAAGATGCATTT-1_V12D07-335_B1,1,2,0,0,0,3
GTCGTTATTCGCTTAT-1_V12D07-335_B1,1,1,0,1,0,3
TCGTGTACTATGGATG-1_V12D07-335_B1,0,3,3,0,0,6
GCGGAGAGGGAGAACG-1_V12D07-335_B1,0,1,0,0,0,1
TCACAGGGAATCGCAA-1_V12D07-335_B1,0,0,7,0,0,7
GACTGCACCAGCCCAG-1_V12D07-335_B1,0,3,0,0,0,3
TCCGCTGTCATCCCGG-1_V12D07-335_B1,1,1,1,0,0,3
AGATACTCAAGATCGA-1_V12D07-335_B1,2,2,2,0,0,6
ACTGAATGGCGAAAGT-1_V12D07-335_B1,0,4,1,0,0,5
TCCTACATCCACGGCC-1_V12D07-335_B1,1,1,1,0,0,3
TTCAGCCCTGGTCCAC-1_V12D07-335_B1,0,5,1,0,0,6
TTAGAGTTTAGAAGGA-1_V12D07-335_B1,0,5,0,0,0,5
GGTTAGCTATATGTCT-1_V12D07-335_B1,1,2,2,0,0,5
CTGGTTTCGAGCAAGA-1_V12D07-335_B1,0,2,0,0,0,2
TGGGCCCATACTAATT-1_V12D07-335_B1,0,2,0,0,0,2
ACTTATTTATGTGCCA-1_V12D07-335_B1,0,5,0,0,0,5
TTAGTTATTCGTGGCA-1_V12D07-335_B1,0,3,0,0,0,3
AACCGCTAAGGGATGC-1_V12D07-335_B1,0,5,1,0,0,6
ATACGTCCACTCCTGT-1_V12D07-335_B1,1,0,4,0,0,5
CGACACGCTCCGACAG-1_V12D07-335_B1,0,5,1,0,0,6
TCTGAACTCGTACCCG-1_V12D07-335_B1,0,2,1,0,0,3
AGGATATAGGGATTTA-1_V12D07-335_B1,0,2,0,0,0,2
GTGATCACTAACGCCT-1_V12D07-335_B1,0,1,1,0,0,2
ACCGGGCCTTTGTTGA-1_V12D07-335_B1,2,4,0,0,0,6
TTGACAGGAGCTCCCG-1_V12D07-335_B1,1,3,0,0,0,4
CTCTTCTATTGACTGG-1_V12D07-335_B1,0,0,0,0,0,0
CGTGGCCGAATATCTA-1_V12D07-335_B1,4,0,0,0,0,4
GGTTTAGCCTTTCTTG-1_V12D07-335_B1,1,1,1,0,0,3
TCAAGGTTACTACACC-1_V12D07-335_B1,0,1,0,0,0,1
TTGACTATTGTCCGGC-1_V12D07-335_B1,0,1,1,0,0,2
CGGGAATATAGTATAC-1_V12D07-335_B1,1,2,0,0,0,3
GCAACAGCAGTATGCG-1_V12D07-335_B1,0,3,4,0,0,7
ATCAAACACTGTTCCA-1_V12D07-335_B1,2,2,1,0,0,5
TGGGCAATAGTTGGGT-1_V12D07-335_B1,0,5,0,0,0,5
TGAATGTCAGCCGGCC-1_V12D07-335_B1,2,3,0,0,0,5
CGGCTCTAAAGCTGCA-1_V12D07-335_B1,0,3,0,0,0,3
GGACACAAGTTTACAC-1_V12D07-335_B1,2,3,0,0,0,5
CCGAGAAGTCGCATAA-1_V12D07-335_B1,0,1,0,0,0,1
AACTACCCGTTTGTCA-1_V12D07-335_B1,1,1,3,0,0,5
GCACAAACGAGGCGTG-1_V12D07-335_B1,2,0,2,0,0,4
CACACAGCTTGCGCTC-1_V12D07-335_B1,2,1,1,0,0,4
GTGCTTACATCAGCGC-1_V12D07-335_B1,0,2,2,0,0,4
GCAAACGTCGCCAGGT-1_V12D07-335_B1,0,2,1,0,0,3
GAATAGCATTTAGGGT-1_V12D07-335_B1,1,3,0,0,0,4
TACTGTTTCTCTGGTA-1_V12D07-335_B1,1,1,0,0,0,2
TCCTATCATAGGTAAC-1_V12D07-335_B1,0,2,4,0,0,6
TTCGGTGGAGACGCCC-1_V12D07-335_B1,2,2,0,0,0,4
TGTTGCCGTCGTCCCA-1_V12D07-335_B1,0,1,0,0,0,1
CCAACTTGATAGATCC-1_V12D07-335_B1,3,1,0,0,0,4
CAAAGGTCATCTGAAA-1_V12D07-335_B1,0,1,1,0,0,2
CTAGCTTAATGGTCCC-1_V12D07-335_B1,0,2,0,0,0,2
AGGCCACATTGGTTAC-1_V12D07-335_B1,0,4,3,0,0,7
TTAGGATGGGAGGGTA-1_V12D07-335_B1,0,6,4,5,0,15
TATGACCTTGCGCTGG-1_V12D07-335_B1,2,2,1,2,0,7
ATATACATGTATGGTA-1_V12D07-335_B1,0,1,1,0,0,2
TGTGTGACCATGAATC-1_V12D07-335_B1,0,5,0,0,0,5
CCCACTCCACGGTATC-1_V12D07-335_B1,0,0,0,0,0,0
GGGCAGACGTCACTGC-1_V12D07-335_B1,1,3,0,0,0,4
TCAAAGAGCTATCTGT-1_V12D07-335_B1,0,0,0,0,0,0
AGATGCATCCTGTGTC-1_V12D07-335_B1,0,0,0,0,0,0
GTGAAGTCACGACTCG-1_V12D07-335_B1,0,0,0,1,0,1
TGATTCAGGTCCCGCG-1_V12D07-335_B1,0,0,0,1,0,1
CGCCACAGGTCGCGAT-1_V12D07-335_B1,0,0,0,2,0,2
TTGAATCGTTGTATAA-1_V12D07-335_B1,1,0,0,0,0,1
TGGCCAATTTGGTACT-1_V12D07-335_B1,0,1,0,0,0,1
CGACCCTTAACGCCGG-1_V12D07-335_B1,0,1,0,0,0,1
TCGGCGTACTGCACAA-1_V12D07-335_B1,1,3,0,1,0,5
GAGTAAGGCCACGGGA-1_V12D07-335_B1,0,0,1,0,0,1
ATCAGCTCGTCCACTA-1_V12D07-335_B1,0,0,0,0,0,0
AGGATCACGCGATCTG-1_V12D07-335_B1,0,1,0,0,0,1
AAATGGCCCGTGCCCT-1_V12D07-335_B1,4,1,0,0,0,5
CAGTACCAGTTTACGT-1_V12D07-335_B1,0,5,0,0,0,5
GGTCGTAAGCTCGCAC-1_V12D07-335_B1,2,1,0,1,0,4
CGTTCATGGTGCGCGT-1_V12D07-335_B1,0,5,0,0,0,5
GACTACAAAGCGGTGG-1_V12D07-335_B1,1,0,0,2,0,3
CAGCTGGCGTAACCGT-1_V12D07-335_B1,1,0,0,1,0,2
ACTCGTAACCCGTCCT-1_V12D07-335_B1,0,0,0,0,0,0
CATATGTCAGGCTACG-1_V12D07-335_B1,1,1,0,1,0,3
GCCCGACTTCTTCCCG-1_V12D07-335_B1,1,1,0,0,0,2
CTGGCATCCGAATGAG-1_V12D07-335_B1,0,0,0,0,0,0
AAGTGCGTTAGAATCT-1_V12D07-335_B1,2,2,1,0,0,5
AGAAGTGATTCGTGAT-1_V12D07-335_B1,2,0,0,1,0,3
TACCTTAAGATTTCCC-1_V12D07-335_B1,0,2,0,1,0,3
AATGACAGCAATGTCT-1_V12D07-335_B1,0,1,0,0,0,1
TCAACGCAGGAAATAA-1_V12D07-335_B1,1,1,0,0,0,2
TATTCCTCCGCCCACT-1_V12D07-335_B1,0,2,0,0,0,2
ATCAAACGAAGGTTTG-1_V12D07-335_B1,2,1,1,0,0,4
TTGATTAGCTGTTTCT-1_V12D07-335_B1,0,4,0,0,0,4
CTGCTGAGGCCACGAA-1_V12D07-335_B1,0,1,0,1,0,2
CCGTGTTAAATTCCAT-1_V12D07-335_B1,0,0,0,1,0,1
CACGTCGGCAACCTCT-1_V12D07-335_B1,1,0,0,1,0,2
GTATTCTGAGAAACGA-1_V12D07-335_B1,0,3,0,1,0,4
CGGTGCGCGTTGGTCC-1_V12D07-335_B1,0,1,1,0,0,2
GTGATTCGCCGCTCAA-1_V12D07-335_B1,1,1,0,0,0,2
GCCCGCGCGTAAACGG-1_V12D07-335_B1,1,1,1,0,0,3
AACGTACTGTGGGTAC-1_V12D07-335_B1,0,0,0,0,0,0
GAGTATGCCCGCCTTG-1_V12D07-335_B1,0,0,0,0,0,0
TGATTCTGTCGCCGGT-1_V12D07-335_B1,1,0,0,0,0,1
GGGCGGCAAATGAATT-1_V12D07-335_B1,1,2,0,0,0,3
TTCCAATCTGGCTATC-1_V12D07-335_B1,1,1,0,0,0,2
GGAACCGTGTAAATTG-1_V12D07-335_B1,2,0,0,0,0,2
TTGGTCACACTCGTAA-1_V12D07-335_B1,0,3,0,0,0,3
CGAACCCGCATGCGTC-1_V12D07-335_B1,3,1,0,1,0,5
GGGCGTCACCACGTAA-1_V12D07-335_B1,3,0,0,0,0,3
TACCAGAAGTAGGTTC-1_V12D07-335_B1,0,3,0,1,0,4
TTGGATATCGTCTACG-1_V12D07-335_B1,0,0,1,0,1,2
TAGATATGGACTGGAA-1_V12D07-335_B1,2,1,1,1,0,5
GCGACGATAGTTGTAC-1_V12D07-335_B1,0,0,0,0,0,0
CTGGATTTACACTTGA-1_V12D07-335_B1,0,0,0,0,0,0
GTTATATTATCTCCCT-1_V12D07-335_B1,1,0,0,0,0,1
TATTCCACTCAGCTCG-1_V12D07-335_B1,3,1,0,0,0,4
CTGTTACCCAATCTAG-1_V12D07-335_B1,1,1,0,1,0,3
ACGCGAAGTCAGACGA-1_V12D07-335_B1,0,0,0,1,0,1
GATAGGTAACGTTGAC-1_V12D07-335_B1,2,1,0,0,0,3
TGTTCGTATTGCGGTG-1_V12D07-335_B1,2,0,0,0,0,2
GGTCAGTGGGTCCCAC-1_V12D07-335_B1,1,1,0,0,0,2
AATTCTAGAGTTAGGC-1_V12D07-335_B1,0,3,2,0,0,5
GTTTACGTTCCATCTG-1_V12D07-335_B1,0,1,0,0,0,1
AGACCCACCGCTGATC-1_V12D07-335_B1,2,0,0,0,0,2
TCTAGCATGCCCAGAA-1_V12D07-335_B1,0,1,0,0,0,1
CCCGCAGCGCGAACTA-1_V12D07-335_B1,0,1,0,1,0,2
CTCTATTTGGCTGCAG-1_V12D07-335_B1,0,0,0,0,0,0
TTCTGCCGCGCCTAGA-1_V12D07-335_B1,0,1,0,0,0,1
ACTCCCTAGAATAGTA-1_V12D07-335_B1,2,0,0,0,0,2
CCGAACCTTCCCGGCC-1_V12D07-335_B1,1,1,0,0,0,2
TCAGACGCTATAGAAG-1_V12D07-335_B1,1,2,1,0,0,4
CAGGCGCCATGCTAGG-1_V12D07-335_B1,3,0,0,0,0,3
CACTCGAGCTGAACAA-1_V12D07-335_B1,2,4,0,0,0,6
ACAAGGAAATCCGCCC-1_V12D07-335_B1,0,5,0,0,0,5
ACCACGTGCAGCTATA-1_V12D07-335_B1,2,2,0,0,0,4
ACGGCGACGATGGGAA-1_V12D07-335_B1,1,2,1,0,0,4
TTACTAAAGGACTTTA-1_V12D07-335_B1,0,1,0,0,0,1
GGCTGAAATAGCAAAG-1_V12D07-335_B1,0,2,0,0,0,2
TTAGACGAGTCACCTC-1_V12D07-335_B1,0,0,0,0,0,0
GTAGTCGCGGGAATCA-1_V12D07-335_B1,0,3,0,0,0,3
GCAAACCCTACATTAT-1_V12D07-335_B1,0,1,5,0,0,6
GTTAAAGTAGGACTGG-1_V12D07-335_B1,0,1,4,0,0,5
ACCCTCCCTTGCTATT-1_V12D07-335_B1,0,0,1,0,0,1
CATGTCTCATTTATGG-1_V12D07-335_B1,0,0,0,0,0,0
AATAGAATCTGTTTCA-1_V12D07-335_B1,0,2,1,0,0,3
TCTCATGAGATAGGGT-1_V12D07-335_B1,0,6,1,0,0,7
ATGACTATGCGACATT-1_V12D07-335_B1,1,1,0,0,0,2
CCTAACCCAAACAAGT-1_V12D07-335_B1,0,1,0,0,0,1
AGTCAAGATGACACTT-1_V12D07-335_B1,1,4,1,0,0,6
CGGGAGCTTCAGTGTA-1_V12D07-335_B1,0,3,1,0,0,4
CCACAGTACCCATCCT-1_V12D07-335_B1,0,2,0,0,0,2
GAGCGCGCACGAGTAG-1_V12D07-335_B1,0,7,0,0,0,7
ACCAGTGCGGGAGACG-1_V12D07-335_B1,2,3,0,0,0,5
TCCTTACGACGGTCCG-1_V12D07-335_B1,0,3,0,0,0,3
TAGTCGATCACGGGTT-1_V12D07-335_B1,3,0,0,0,0,3
AGACGAAGTGCCGGTC-1_V12D07-335_B1,0,0,0,0,0,0
CGCTGGTGACTACCCT-1_V12D07-335_B1,1,2,1,0,0,4
AGGCATTGTCGTAGGG-1_V12D07-335_B1,0,1,1,0,0,2
TGGTAGAATATATGGG-1_V12D07-335_B1,0,3,1,0,0,4
TTCTTATCCGCTGGGT-1_V12D07-335_B1,0,1,1,0,0,2
AGTTTGGCACGGGTTG-1_V12D07-335_B1,0,5,0,0,0,5
GCATCGGCCGTGTAGG-1_V12D07-335_B1,0,2,0,0,0,2
ATGCGAGTCCCACCAC-1_V12D07-335_B1,0,2,0,0,0,2
TCGGCGAACCCAAACC-1_V12D07-335_B1,0,1,0,0,0,1
AGAGTAAACTTCACTA-1_V12D07-335_B1,2,0,0,0,0,2
AAGCCGAAGCGGTTTA-1_V12D07-335_B1,0,3,0,0,0,3
CCCGAGTTTCTCCGTA-1_V12D07-335_B1,0,0,0,0,0,0
AATATCGAATCAATGC-1_V12D07-335_B1,0,4,0,0,0,4
GCGCCTCCCACTCCGA-1_V12D07-335_B1,1,4,0,0,0,5
CGTTAAACTAGTTAGG-1_V12D07-335_B1,0,3,0,0,0,3
TGAGTTAAAGACATTC-1_V12D07-335_B1,0,4,0,0,0,4
AACAGGTAGTATGGAT-1_V12D07-335_B1,0,8,1,0,0,9
GAACGCGGGTCACACG-1_V12D07-335_B1,0,2,0,0,0,2
TGTTTGAGATCGTCAG-1_V12D07-335_B1,0,2,1,0,0,3
ATCTCGTGAGCGAAAC-1_V12D07-335_B1,0,2,1,0,0,3
CTGAGAAAGTTCGGCG-1_V12D07-335_B1,2,0,0,0,0,2
ATTACCACACTGCCTG-1_V12D07-335_B1,0,4,0,0,0,4
CTGCTGTCTAACGAGC-1_V12D07-335_B1,0,2,1,0,0,3
CGTGGAAGCCTCGTAC-1_V12D07-335_B1,0,2,0,0,0,2
GGACTCACAAATTAGG-1_V12D07-335_B1,0,3,1,0,0,4
CTTTGCTGTCATGGAT-1_V12D07-335_B1,0,1,1,0,0,2
GGTGTTGGGCGTCTTA-1_V12D07-335_B1,0,3,1,0,0,4
TACCATGTATTGATTT-1_V12D07-335_B1,1,0,3,0,0,4
GGTCTCCAAGTAGTGC-1_V12D07-335_B1,0,1,1,0,0,2
ATCCTTCTGAAAGAAC-1_V12D07-335_B1,0,3,1,0,0,4
CCGGAAGTTATCAGTC-1_V12D07-335_B1,0,5,3,2,0,10
TTAGAGGGATATACAG-1_V12D07-335_B1,0,3,0,0,0,3
TTGTACACCTCGAACA-1_V12D07-335_B1,1,1,0,0,0,2
GTGGGTACTGAGCGTA-1_V12D07-335_B1,0,0,0,0,0,0
CTTAAGCAGCGAGCCG-1_V12D07-335_B1,0,0,0,0,0,0
GCATTGACTTGCGGAA-1_V12D07-335_B1,0,0,0,0,0,0
CCATAACCTGTGCAGT-1_V12D07-335_B1,2,3,0,0,0,5
GGGCTACTATTTCGTG-1_V12D07-335_B1,0,1,0,1,0,2
GGCGAGCGAAACGGCA-1_V12D07-335_B1,2,2,0,1,0,5
GGAGACCATCTACATA-1_V12D07-335_B1,1,1,0,0,0,2
AGACCAAACCACACCT-1_V12D07-335_B1,0,1,0,1,0,2
CGACGCATCCGTACCT-1_V12D07-335_B1,1,1,0,1,0,3
CCTAGGTAAAGGTAGC-1_V12D07-335_B1,1,0,0,0,0,1
AGCGGCGGTTAGCGGT-1_V12D07-335_B1,1,1,0,0,0,2
CTGGACGCAGTCCGGC-1_V12D07-335_B1,1,2,0,1,0,4
AGCCTAATACCCACGT-1_V12D07-335_B1,0,0,0,0,0,0
AATCTGGCTTTCTAGT-1_V12D07-335_B1,1,1,0,2,0,4
CACCCTTGGTGAGACC-1_V12D07-335_B1,0,0,0,0,0,0
GGATCTTGACTCAACC-1_V12D07-335_B1,2,4,0,0,0,6
ACGAGGATACCACTCT-1_V12D07-335_B1,2,0,0,0,0,2
GAGTTGATGGCAATTT-1_V12D07-335_B1,1,1,0,1,0,3
GTGGCAAACAGCGGCA-1_V12D07-335_B1,0,0,0,0,0,0
GATGTAACGAACCACC-1_V12D07-335_B1,1,0,0,0,0,1
AGCCGTGGCTAAATGT-1_V12D07-335_B1,1,2,1,2,0,6
CTCCCTCCTTTCGATC-1_V12D07-335_B1,0,0,1,2,0,3
TTGGAAGAATACAGTC-1_V12D07-335_B1,3,1,0,1,0,5
AGTTAAGTCAACCGCT-1_V12D07-335_B1,0,0,0,0,0,0
CTCATGGTAATTTGCG-1_V12D07-335_B1,2,6,0,0,0,8
AAAGTAGCATTGCTCA-1_V12D07-335_B1,0,1,0,2,0,3
TTGTGGTAGGAGGGAT-1_V12D07-335_B1,0,1,0,0,0,1
AGTCGTGGGCATTACG-1_V12D07-335_B1,1,1,0,0,0,2
ACCTAAGTACCTTTCA-1_V12D07-335_B1,1,1,0,0,0,2
GTAGAGGGAGACAAGT-1_V12D07-335_B1,3,3,0,0,0,6
GATCCTCGACACTGGC-1_V12D07-335_B1,0,0,0,0,0,0
CCTACATTCACAGACG-1_V12D07-335_B1,0,3,0,0,0,3
TTGACCGTGTTAATGA-1_V12D07-335_B1,2,1,0,0,0,3
TCTGTTACCCAGCATA-1_V12D07-335_B1,2,0,0,0,0,2
CTAACTGGTCCGGTTC-1_V12D07-335_B1,1,0,0,0,0,1
AGCGACAGGAACGGTC-1_V12D07-335_B1,0,2,0,0,0,2
TAATAGAACAGAGTTA-1_V12D07-335_B1,0,0,0,0,0,0
ACAGGTGGAGGTGAGG-1_V12D07-335_B1,1,1,0,0,0,2
TGCGAGAATATTACCC-1_V12D07-335_B1,1,0,0,0,0,1
TTGCGTCGGCCAACCG-1_V12D07-335_B1,1,0,0,0,0,1
AGGCTTCCCGAAGAAG-1_V12D07-335_B1,1,2,0,0,0,3
GCGGACCGCGTTGTGG-1_V12D07-335_B1,6,0,0,0,0,6
GTAATCTGATTCTTCG-1_V12D07-335_B1,1,0,1,1,0,3
CCGCGGAATGCGTCAC-1_V12D07-335_B1,1,2,0,0,0,3
TTCCACACAGATTTGA-1_V12D07-335_B1,0,0,1,0,0,1
CTTCTATTAATGCTAG-1_V12D07-335_B1,1,1,0,0,0,2
CATTTGAGTGGTACGT-1_V12D07-335_B1,0,0,0,0,0,0
TCACAGCAAACTCGAA-1_V12D07-335_B1,1,1,0,0,0,2
CAGACGAACCTGATAC-1_V12D07-335_B1,2,1,0,0,0,3
TAGCTAGAAGGCATGA-1_V12D07-335_B1,3,0,1,0,0,4
ATCCAGAGCAACAACC-1_V12D07-335_B1,1,0,0,0,0,1
TCCGGTTCGTCCGGTC-1_V12D07-335_B1,2,0,0,0,0,2
CGCGCATGTTTGATTG-1_V12D07-335_B1,2,1,0,0,0,3
TGGCGATCAAGTTATG-1_V12D07-335_B1,4,2,0,0,0,6
CCCTTTGACAGGTCTT-1_V12D07-335_B1,1,0,0,0,0,1
CAGAGACGGTCACCCA-1_V12D07-335_B1,2,0,1,0,0,3
TAGCTCGCCTGATAAC-1_V12D07-335_B1,1,0,0,0,0,1
TTGTGTTTCCCGAAAG-1_V12D07-335_B1,0,0,0,0,0,0
TATACACAGACGCCTT-1_V12D07-335_B1,1,1,0,0,0,2
ACATTAGTTTATATCC-1_V12D07-335_B1,2,2,0,0,0,4
CCATCGCAGTTAAACT-1_V12D07-335_B1,2,0,0,0,0,2
AATTAGCGCTGCAGCG-1_V12D07-335_B1,3,1,0,0,0,4
TCCGCTTATCCCATTA-1_V12D07-335_B1,0,0,0,0,0,0
GTTTGGGCTTGTGAGC-1_V12D07-335_B1,1,0,1,1,0,3
CTTGTCAACATTCGAG-1_V12D07-335_B1,2,1,0,1,0,4
GGACCAACAGGATAAC-1_V12D07-335_B1,2,1,0,0,0,3
AAGCTAGATCGAGTAA-1_V12D07-335_B1,3,1,0,0,0,4
TACCGTGCCTCGGACC-1_V12D07-335_B1,1,0,1,0,0,2
GTAGCCAAACATGGGA-1_V12D07-335_B1,0,0,0,0,0,0
TGCCAGTACGTGGAGA-1_V12D07-335_B1,1,0,0,0,0,1
ATAAGGTGGAGAACAT-1_V12D07-335_B1,0,2,0,0,0,2
CTTTAATATTGGTCGA-1_V12D07-335_B1,0,2,0,0,0,2
TGGTTCAACGGGTAAT-1_V12D07-335_B1,0,0,0,0,0,0
GCTGCTACTGCGTAGC-1_V12D07-335_B1,0,0,0,0,0,0
CTGCACAACTACATAT-1_V12D07-335_B1,0,3,0,0,0,3
ATATTCCACATAGTGA-1_V12D07-335_B1,1,0,1,0,0,2
TGGCAAACTAAATTAC-1_V12D07-335_B1,0,2,3,0,0,5
ACCGCAATAACTGCCT-1_V12D07-335_B1,0,2,0,0,0,2
TCGCACCAGGAGGCAG-1_V12D07-335_B1,0,1,0,0,0,1
ACTTCAGGCTGATCCC-1_V12D07-335_B1,0,4,0,0,0,4
ACAAATCGCACCGAAT-1_V12D07-335_B1,2,0,0,0,0,2
TCTGATGTATTCTGTC-1_V12D07-335_B1,0,2,0,0,0,2
CTTTACCGAATAGTAG-1_V12D07-335_B1,0,2,2,0,0,4
GCAGATCCATAAGACT-1_V12D07-335_B1,0,2,0,0,0,2
TTCCTCGGACTAACCA-1_V12D07-335_B1,2,2,0,0,0,4
TTATCCGGGATCTATA-1_V12D07-335_B1,1,2,1,0,0,4
CTGGAAGACACGGTGG-1_V12D07-335_B1,0,1,0,0,0,1
GTTCGTCTAAAGAACT-1_V12D07-335_B1,0,3,0,0,0,3
GTCTATTGGTTCCGGT-1_V12D07-335_B1,0,1,0,0,0,1
CTAGGCGCCCTATCAG-1_V12D07-335_B1,0,4,0,0,0,4
AACGGACGTACGTATA-1_V12D07-335_B1,0,2,0,0,0,2
AACACACGCTCGCCGC-1_V12D07-335_B1,0,3,3,0,0,6
GCTACTATAGTAGAGT-1_V12D07-335_B1,0,2,1,0,0,3
AGCATATCAATATGCT-1_V12D07-335_B1,1,2,0,0,0,3
CGAACAGTATGGGCGT-1_V12D07-335_B1,3,2,0,0,0,5
ACAATTGTGTCTCTTT-1_V12D07-335_B1,1,3,0,0,0,4
GATCGCTACCCGATTT-1_V12D07-335_B1,2,1,0,0,0,3
ATTGCGATCAGTAACT-1_V12D07-335_B1,2,1,0,0,0,3
CAGCAGTCCAGACTAT-1_V12D07-335_B1,2,1,0,0,0,3
AGAGGCTTCGGAAACC-1_V12D07-335_B1,1,2,0,0,0,3
AAACAAGTATCTCCCA-1_V12D07-335_B1,0,4,0,0,0,4
GGCAGCAAACCTATGC-1_V12D07-335_B1,0,1,0,0,0,1
ACTAGTTGCGATCGTC-1_V12D07-335_B1,1,0,0,0,0,1
TTGGACCATCTGGCAA-1_V12D07-335_B1,1,0,0,0,0,1
CCCTCCTCGCTCGTAT-1_V12D07-335_B1,0,0,1,0,0,1
GAGCGCAAATACTCCG-1_V12D07-335_B1,1,1,0,0,0,2
ATTACATGTCAGTCTT-1_V12D07-335_B1,0,3,1,0,0,4
TTGGGACGTAAGAGTT-1_V12D07-335_B1,1,2,1,0,0,4
CTTCGGCCAATTGTTT-1_V12D07-335_B1,1,0,0,0,0,1
AGACCGCTCCGCGGTT-1_V12D07-335_B1,1,2,1,0,0,4
GACCGCGTCTGACGTG-1_V12D07-335_B1,1,3,0,0,0,4
CCAAATAACAAGATTC-1_V12D07-335_B1,0,4,1,0,0,5
TCTTTAGAGTCTAACA-1_V12D07-335_B1,0,3,2,0,0,5
CTCCCAATGAGTCGCG-1_V12D07-335_B1,0,2,1,0,0,3
TAGTCTTTCCGAATTG-1_V12D07-335_B1,0,6,0,0,0,6
GAGTAAACCGGAAAGT-1_V12D07-335_B1,1,2,0,0,0,3
GATCTCGACGCTGTGG-1_V12D07-335_B1,0,2,0,0,0,2
CTGACATAGAAATAGA-1_V12D07-335_B1,0,2,0,0,0,2
TATACCGAGTGCCACA-1_V12D07-335_B1,0,4,1,0,0,5
TCCGAACGTTGCCGCT-1_V12D07-335_B1,0,4,0,0,0,4
GCAGAAGGTAATCTCC-1_V12D07-335_B1,1,1,1,0,0,3
GGTACTAAGTGCTTTG-1_V12D07-335_B1,3,3,0,0,0,6
CAGAATATTCGTTATC-1_V12D07-335_B1,2,3,0,0,0,5
TAATCAACCAAATGGG-1_V12D07-335_B1,1,4,0,0,0,5
TCTGCTTAGAACAAGC-1_V12D07-335_B1,0,1,1,0,0,2
AACTGAGTTATACTGA-1_V12D07-335_B1,0,3,3,1,0,7
CCTCAACGATCGCTGT-1_V12D07-335_B1,1,0,0,0,0,1
CGGTACGGCAAACCCA-1_V12D07-335_B1,0,0,0,0,0,0
CAGATGTTTGTCCCAA-1_V12D07-335_B1,1,0,0,0,0,1
GTTTGTTAGCCAAGTA-1_V12D07-335_B1,0,0,0,0,0,0
ACGTGACAAAGTAAGT-1_V12D07-335_B1,0,0,0,0,1,1
TTGTCACCGCGGTATC-1_V12D07-335_B1,1,0,0,0,0,1
GATCTAACCGTATTCA-1_V12D07-335_B1,0,0,0,0,0,0
ATGGAAATTTAAGGAG-1_V12D07-335_B1,1,0,0,0,0,1
ATTGATCACCACATTT-1_V12D07-335_B1,2,0,0,0,0,2
ACTGCTCGGAAGGATG-1_V12D07-335_B1,0,0,0,0,0,0
TCTAAAGAACAGTCTC-1_V12D07-335_B1,0,0,0,0,0,0
CTGGGTTGAGTTAAAG-1_V12D07-335_B1,0,1,0,1,0,2
CCCAGTAAACTTGGGA-1_V12D07-335_B1,0,1,0,0,0,1
AGATTCACAACCGATA-1_V12D07-335_B1,0,0,0,0,0,0
AGAAGGTACACTTCAC-1_V12D07-335_B1,1,0,0,0,0,1
GCAGGAACTTAGATCT-1_V12D07-335_B1,0,2,0,2,1,5
AATCTAGGTTTACTTG-1_V12D07-335_B1,2,0,0,0,0,2
CCCGGTGTATCGGAAT-1_V12D07-335_B1,0,0,1,0,0,1
TTATCCTCAAGGAATA-1_V12D07-335_B1,3,1,0,0,0,4
AGCATCATTTCGAAAG-1_V12D07-335_B1,1,1,0,0,0,2
CGCGAGTCTGCCGGGT-1_V12D07-335_B1,2,1,0,0,0,3
TGCGTCATGACTGAGC-1_V12D07-335_B1,0,0,0,0,0,0
GTATGAAATTTCACTC-1_V12D07-335_B1,3,0,0,0,0,3
TTGGTTGCGGTGCGCG-1_V12D07-335_B1,0,0,0,0,0,0
ACAGAACTGAGAACAA-1_V12D07-335_B1,1,1,0,0,0,2
CTACTATCATAGGTTT-1_V12D07-335_B1,1,2,0,0,0,3
CCTCTATCGATTAGCA-1_V12D07-335_B1,2,1,1,0,0,4
CCGTATCTCGTCGTAG-1_V12D07-335_B1,2,0,0,0,0,2
TCACGATGTCCGTGGA-1_V12D07-335_B1,1,0,0,1,0,2
TCAACAAAGATAATTC-1_V12D07-335_B1,1,0,1,0,0,2
ATGACGCGTTCTATCC-1_V12D07-335_B1,0,0,0,0,0,0
ATTTGCGCGAGTAGCT-1_V12D07-335_B1,3,1,0,0,0,4
TTCTTGGACGATCTGC-1_V12D07-335_B1,2,0,0,0,0,2
AGACGACGATGCCGCT-1_V12D07-335_B1,2,1,0,0,0,3
GGTCTCTGAATGGACT-1_V12D07-335_B1,0,0,0,0,0,0
GCTCAATCCGTTTATT-1_V12D07-335_B1,3,4,0,0,0,7
CCAGAAAGCAACTCAT-1_V12D07-335_B1,1,0,0,0,0,1
CACCGTTAGGGATCAC-1_V12D07-335_B1,1,0,1,0,0,2
AATAACACTAGAACAA-1_V12D07-335_B1,1,0,0,0,0,1
CACCCGGTTTGTGACT-1_V12D07-335_B1,1,0,0,0,0,1
CCACCAACTTTACTGT-1_V12D07-335_B1,0,2,0,1,0,3
AACTCTCAGTGTGCTC-1_V12D07-335_B1,0,0,0,0,0,0
AAACCGTTCGTCCAGG-1_V12D07-335_B1,1,0,0,1,0,2
CAGCGATTCCCTTCAA-1_V12D07-335_B1,0,3,0,0,0,3
GCTAGCTTGAATAGCT-1_V12D07-335_B1,0,1,0,0,0,1
TTGCGGCATCAGAAAG-1_V12D07-335_B1,0,0,1,0,0,1
AATAGAACAGAGTGGC-1_V12D07-335_B1,2,0,0,0,0,2
GCCATCGAGCTGCGTG-1_V12D07-335_B1,1,0,0,0,0,1
ACACTGATCAAGGTGT-1_V12D07-335_B1,0,0,0,0,0,0
ACCAACGCTTATTTAT-1_V12D07-335_B1,0,0,0,0,0,0
GACATCGATTTATAAC-1_V12D07-335_B1,2,2,0,0,0,4
CAGACACCGATCGCTG-1_V12D07-335_B1,1,0,0,0,0,1
CCAAGAAAGTGGGCGA-1_V12D07-335_B1,0,3,0,0,0,3
GGTAGACCGTTGGGCG-1_V12D07-335_B1,1,0,0,0,0,1
TCGTTAGGAGTCCCTA-1_V12D07-335_B1,2,2,0,1,0,5
ACGGCCAACATGGACT-1_V12D07-335_B1,0,0,0,0,0,0
GTGAGTGGTACAACGC-1_V12D07-335_B1,0,0,0,0,0,0
GAGACTTCGCGACCGA-1_V12D07-335_B1,0,0,0,0,0,0
GAAGTCAGTTGCACTA-1_V12D07-335_B1,0,1,0,0,0,1
GTTTGGTAGGGTCAAC-1_V12D07-335_B1,1,0,0,0,0,1
ACGGCACTTGCTTGGG-1_V12D07-335_B1,1,0,0,0,0,1
CCTCTGTACTATTCTA-1_V12D07-335_B1,3,0,0,0,0,3
CTATTCATGTGTCCCA-1_V12D07-335_B1,3,1,0,0,0,4
GCCCGATCTGTGGTCG-1_V12D07-335_B1,1,0,0,0,0,1
TTAGAAGAACATGACT-1_V12D07-335_B1,0,0,0,0,0,0
AGGATAAAGTCGGGAT-1_V12D07-335_B1,0,1,1,0,0,2
CGGCAAACATCGTGCG-1_V12D07-335_B1,0,4,0,0,0,4
CTAGTTACAACCCGGT-1_V12D07-335_B1,1,0,0,0,0,1
TTCGACAGAGCCCGTG-1_V12D07-335_B1,0,0,0,0,0,0
AAGCATACTCTCCTGA-1_V12D07-335_B1,1,0,0,0,0,1
GACGACGATCCGCGTT-1_V12D07-335_B1,4,2,1,0,0,7
GGTAGAAGACCGCCTG-1_V12D07-335_B1,2,1,0,0,0,3
GAGATGGGAGTCGACA-1_V12D07-335_B1,0,1,0,0,0,1
AACGATAATGCCGTAG-1_V12D07-335_B1,1,2,0,0,0,3
TGGTCCCACGCTACGG-1_V12D07-335_B1,0,1,0,0,0,1
CTGCTTGGCGATAGCT-1_V12D07-335_B1,0,1,0,0,0,1
ATCGGAGACAGACGGC-1_V12D07-335_B1,0,1,0,0,0,1
TAGCGTCCGGTGTGGT-1_V12D07-335_B1,0,1,0,0,0,1
GTTGAGTCCCGCCGGT-1_V12D07-335_B1,0,1,0,0,0,1
AAATAGGGTGCTATTG-1_V12D07-335_B1,0,1,0,0,0,1
AAGTGTTTGGAGACGG-1_V12D07-335_B1,1,3,0,0,0,4
AGCACTACCTCACCAG-1_V12D07-335_B1,2,2,0,0,0,4
TGCCTTGGCCAGGCAA-1_V12D07-335_B1,1,2,1,1,0,5
TCGTCTTAGGCGTTAA-1_V12D07-335_B1,1,1,0,0,0,2
TTCTGACCGGGCTCAA-1_V12D07-335_B1,2,2,0,0,0,4
CAGAACTTAGCCCTCT-1_V12D07-335_B1,0,2,0,0,0,2
AGCTCCTTCGCACATC-1_V12D07-335_B1,0,0,0,0,0,0
ACAGGCTTGCCCGACT-1_V12D07-335_B1,0,2,0,0,0,2
GCTATACGTCTCGGAC-1_V12D07-335_B1,1,4,0,0,0,5
GAGCCAGCTACCTGTG-1_V12D07-335_B1,0,4,1,0,0,5
TGCTAAGTGTCTATTT-1_V12D07-335_B1,0,2,1,0,0,3
GTCCTACGAATAGTCT-1_V12D07-335_B1,3,0,0,0,0,3
CAGTGTCGGCTGGCCC-1_V12D07-335_B1,0,2,0,0,0,2
CTATCGACGAAATACA-1_V12D07-335_B1,0,6,0,0,0,6
CATCATTACCCTGAGG-1_V12D07-335_B1,0,2,1,0,0,3
TAAGTTGCGACGTAGG-1_V12D07-335_B1,0,3,0,0,0,3
AGTGCACGCTTAAGAA-1_V12D07-335_B1,0,1,0,0,0,1
TGTGCCGGTGCCGGAA-1_V12D07-335_B1,3,4,0,0,0,7
AGGAGGCCTTCGCGCG-1_V12D07-335_B1,0,1,2,0,0,3
TCCGCGGCCCAATGAA-1_V12D07-335_B1,4,2,1,0,0,7
TCCGTTAAGCTAATAT-1_V12D07-335_B1,1,1,2,0,0,4
AAATCTAGCCCTGCTA-1_V12D07-335_B1,0,2,0,0,0,2
CGCAGGCGATCCAAAC-1_V12D07-335_B1,0,0,0,0,0,0
CCATATGGAAACTATA-1_V12D07-335_B1,1,2,0,0,0,3
CACCGTATCCCATCCG-1_V12D07-335_B1,1,1,0,0,0,2
GGTCAAGACTACTTCG-1_V12D07-335_B1,1,1,0,0,0,2
CCCGTTTCGCAGATGT-1_V12D07-335_B1,0,1,0,0,0,1
GTTATAATACGGTGAA-1_V12D07-335_B1,2,1,0,0,0,3
ACTTGTGGATGGAACG-1_V12D07-335_B1,0,1,0,0,0,1
GTTCGCTGAGACGTCT-1_V12D07-335_B1,2,3,0,0,0,5
GACACTGGAACCCGAT-1_V12D07-335_B1,2,1,1,0,0,4
CCCAGGTCTGAAGGCT-1_V12D07-335_B1,4,1,0,0,0,5
TCTCGAGGAGGTTCGC-1_V12D07-335_B1,0,1,0,0,0,1
ACTATCTGCCCGCGTA-1_V12D07-335_B1,2,2,0,0,0,4
CCTAAATTGTATCCTA-1_V12D07-335_B1,0,1,1,0,0,2
AGAAATTATGACTCGC-1_V12D07-335_B1,2,1,0,0,0,3
TCCAGCGCTATAAGCG-1_V12D07-335_B1,1,1,0,0,0,2
TCGTGTATTGGTCACG-1_V12D07-335_B1,1,3,0,0,0,4
CCACATACTGCACCCA-1_V12D07-335_B1,1,1,0,0,0,2
GTTGCGGACGGTCAGG-1_V12D07-335_B1,1,1,0,0,0,2
GTATTTAATGGCATAA-1_V12D07-335_B1,1,2,1,0,0,4
GTCGATAGGTGACTTT-1_V12D07-335_B1,0,1,0,0,0,1
AATAATCTTCGTATCG-1_V12D07-335_B1,1,1,0,0,0,2
ATTGTTCAACGATCCG-1_V12D07-335_B1,0,2,1,0,0,3
GTGCAGCGTAGAGTAG-1_V12D07-335_B1,0,0,0,0,0,0
TGTGGTAGGGTGCCTT-1_V12D07-335_B1,0,3,1,0,0,4
TGTGGACTATCTACGT-1_V12D07-335_B1,0,3,1,0,0,4
GGCGGGCTCTAAGAGT-1_V12D07-335_B1,0,2,0,0,0,2
TGTGCCAGAGGCAAAG-1_V12D07-335_B1,0,2,0,1,0,3
TGGCTTATGTATAATG-1_V12D07-335_B1,1,0,0,0,0,1
GCAAGCTGGAAACCGC-1_V12D07-335_B1,0,1,0,0,0,1
GATATCAAGCAGGAGC-1_V12D07-335_B1,2,0,0,0,0,2
CACCAATCATCCGTCT-1_V12D07-335_B1,0,3,0,0,0,3
CCACATGGCTCTTTAT-1_V12D07-335_B1,1,1,0,0,0,2
GTCCTACTCTACGGGC-1_V12D07-335_B1,2,1,0,0,0,3
CTCGAGACATACGATA-1_V12D07-335_B1,2,0,0,0,0,2
TATCAGTGGCGTAGTC-1_V12D07-335_B1,2,2,0,2,0,6
TGACAGGACAAGTCCA-1_V12D07-335_B1,0,1,0,0,0,1
TATTAACACCAAAGCA-1_V12D07-335_B1,0,1,0,0,0,1
TAGGCGATGAGGTCTC-1_V12D07-335_B1,2,1,0,1,0,4
CCGCCGGAACTTCTCG-1_V12D07-335_B1,1,2,0,0,0,3
GCCATTAGCCTCAAAC-1_V12D07-335_B1,1,1,0,0,0,2
GTTAGGCTACCCGTTT-1_V12D07-335_B1,1,1,1,0,0,3
GGGTATTCTAGCAAAC-1_V12D07-335_B1,0,0,0,0,0,0
GCCCTAGCCGTCGCGA-1_V12D07-335_B1,1,3,1,1,0,6
CAGATCCTGGTTTGAA-1_V12D07-335_B1,2,2,0,1,0,5
CTTCAGTGGTCGCCTA-1_V12D07-335_B1,0,2,0,0,0,2
GGGCAACCGCACGTGC-1_V12D07-335_B1,1,1,0,0,0,2
GACCCAATTATGATAC-1_V12D07-335_B1,1,4,0,0,0,5
GAAGCTCGGACCCGTC-1_V12D07-335_B1,2,0,0,0,0,2
CGTCGGGTCTAAGCGC-1_V12D07-335_B1,3,1,0,0,0,4
GAGGCCCGACTCCGCA-1_V12D07-335_B1,1,1,0,0,0,2
TTGCCATAGCCCGCTC-1_V12D07-335_B1,3,3,0,0,0,6
TAACATACACGCGATC-1_V12D07-335_B1,2,1,0,0,0,3
CCGACGGGCATGAGGT-1_V12D07-335_B1,2,0,1,0,0,3
AATGTGCCCGAGGTGT-1_V12D07-335_B1,3,2,0,1,0,6
AGCTGTAACCTCAATC-1_V12D07-335_B1,3,0,1,0,0,4
CGAGTGAAGGTACCAG-1_V12D07-335_B1,2,2,0,0,0,4
AGTCTCACAAGACTAC-1_V12D07-335_B1,0,1,0,0,0,1
AAATTGATAGTCCTTT-1_V12D07-335_B1,1,0,0,0,0,1
TAAGTCGCCGAGTATC-1_V12D07-335_B1,0,0,0,0,0,0
GCGGAGAAACTTCGCA-1_V12D07-335_B1,3,0,0,0,0,3
GGCAAAGGCGCCAATA-1_V12D07-335_B1,1,1,0,0,0,2
ATTTCCGGGTTCTGCG-1_V12D07-335_B1,1,3,0,0,0,4
TAAACCCAGGAGGGCA-1_V12D07-335_B1,1,0,0,0,0,1
TTCGGGCGCTAGTCTT-1_V12D07-335_B1,2,0,0,0,0,2
GTGGAGTCGGCGGTTG-1_V12D07-335_B1,1,0,0,0,0,1
GCACGCCTACTTAGAT-1_V12D07-335_B1,2,0,0,0,0,2
CAATATTCTTGACCTA-1_V12D07-335_B1,2,0,0,0,0,2
CGTTTGTGTAGAGGGT-1_V12D07-335_B1,0,0,0,0,0,0
CATAGCGTTGCCCACC-1_V12D07-335_B1,3,0,0,0,0,3
TGATACATTTAGCCGT-1_V12D07-335_B1,1,1,0,0,0,2
TTCCGGCCTTGAGGCT-1_V12D07-335_B1,0,0,0,0,0,0
CCTATACCGTCCTGTC-1_V12D07-335_B1,1,1,0,0,0,2
TCGTTGCTATCCGGTC-1_V12D07-335_B1,2,0,0,0,0,2
TGGCGACTGCTCCAAA-1_V12D07-335_B1,4,0,0,1,0,5
CAGAGGCGATGCATGA-1_V12D07-335_B1,0,2,0,0,0,2
TCACAGGAGAATAAGA-1_V12D07-335_B1,1,1,0,0,0,2
GGGTTAACATTTGAGT-1_V12D07-335_B1,1,1,0,0,0,2
GCGGGCGAGCCTTACC-1_V12D07-335_B1,1,0,0,0,0,1
TGCCAATGGGTACTCT-1_V12D07-335_B1,0,0,0,0,0,0
AGGGACTCTACGCGAC-1_V12D07-335_B1,1,0,0,0,0,1
GACGCCGTAAAGGCTA-1_V12D07-335_B1,0,0,0,0,0,0
AAAGGCTCTCGCGCCG-1_V12D07-335_B1,0,0,0,0,0,0
CTGGCTGGTTGTCAGT-1_V12D07-335_B1,0,0,0,0,0,0
ACATCCCGGCCATACG-1_V12D07-335_B1,3,1,1,0,0,5
CTCTTGTCCCGCTTGG-1_V12D07-335_B1,0,3,0,0,0,3
TACGCCTCCATTCCGA-1_V12D07-335_B1,0,0,0,0,0,0
CGGAGCAATTTAATCG-1_V12D07-335_B1,0,0,0,0,0,0
AACTAGGCTTGGGTGT-1_V12D07-335_B1,2,1,1,0,0,4
GCGTCGCCAGGGTGAT-1_V12D07-335_B1,2,0,0,0,0,2
GTTGGTCATGCTATCC-1_V12D07-335_B1,1,0,0,0,0,1
GCTGGCGGCGCATGCT-1_V12D07-335_B1,1,2,0,0,0,3
TGAGCGGAAAGTGTTC-1_V12D07-335_B1,0,0,1,0,0,1
CTTTCTGTGCGGGCTT-1_V12D07-335_B1,1,3,0,0,0,4
ATCTAATATCCTACGG-1_V12D07-335_B1,1,0,0,0,0,1
AACCTTTAAATACGGT-1_V12D07-335_B1,2,0,0,1,0,3
TTCACTCGAGCACCTA-1_V12D07-335_B1,0,1,0,0,0,1
CTGCACTCCAGTACAG-1_V12D07-335_B1,4,1,0,0,0,5
CCATTTCTACCTATTA-1_V12D07-335_B1,1,0,1,0,0,2
CAAGCGGCACATAATT-1_V12D07-335_B1,0,1,0,0,0,1
GTTAACATCACTTAAA-1_V12D07-335_B1,2,0,0,0,0,2
ATATAAATGTAGCTGC-1_V12D07-335_B1,0,1,0,0,0,1
GCCTCTATACATAGCA-1_V12D07-335_B1,3,0,0,0,1,4
GTGTCGTATAGCGTTC-1_V12D07-335_B1,0,2,0,0,0,2
ATACGTACTTAGCCAC-1_V12D07-335_B1,0,0,0,0,0,0
GCTATCATACTCATGG-1_V12D07-335_B1,1,1,0,0,0,2
TATCCAATTGGTTATC-1_V12D07-335_B1,2,1,1,1,0,5
TCTCCCTGGGCAGCGT-1_V12D07-335_B1,1,5,0,0,0,6
CCTATAATGAGTGCCC-1_V12D07-335_B1,0,0,0,0,0,0
CAATGCGAGAAGTATC-1_V12D07-335_B1,0,0,5,0,0,5
TACCAATAAAGTACCA-1_V12D07-335_B1,0,0,0,0,0,0
GCTAGGCACCACGGAG-1_V12D07-335_B1,2,1,0,0,0,3
GGTGGACTGCTCTGGC-1_V12D07-335_B1,0,1,1,0,0,2
TATTCCGAGCTGTTAT-1_V12D07-335_B1,0,2,3,0,0,5
TTGAGAAGTTTAGCAT-1_V12D07-335_B1,1,0,0,0,0,1
GTCCGGACCTGAAATT-1_V12D07-335_B1,0,1,0,0,0,1
CTGTGGTCGGGAGATA-1_V12D07-335_B1,1,4,0,0,0,5
CATGTAAGAGACATTT-1_V12D07-335_B1,2,2,1,0,0,5
CACGTTTCGTACACAC-1_V12D07-335_B1,0,2,0,0,0,2
CATCCTCTCAAAGATC-1_V12D07-335_B1,0,4,0,0,0,4
GATTAACCGAAAGCCC-1_V12D07-335_B1,1,4,0,0,0,5
AACGCTGTTGCTGAAA-1_V12D07-335_B1,0,1,1,0,0,2
TTCAGCTGGCGTGCCC-1_V12D07-335_B1,0,3,0,0,0,3
TAGAGGTTCTACTTGT-1_V12D07-335_B1,0,2,0,0,0,2
GTATCAAACGTTAGCT-1_V12D07-335_B1,0,3,0,0,0,3
AATCATGTAAAGACTC-1_V12D07-335_B1,1,2,2,0,0,5
AGTCACTAGCTCTCGA-1_V12D07-335_B1,0,2,0,0,0,2
GCGAAACGATCGGGAG-1_V12D07-335_B1,4,2,0,0,0,6
CATGGATTGTCTTCCG-1_V12D07-335_B1,0,2,0,0,0,2
ATTGGATTACAGCGTA-1_V12D07-335_B1,1,3,0,0,0,4
CACACACGCTAACGAG-1_V12D07-335_B1,1,0,0,0,0,1
CTATGGGAAGCGGAAT-1_V12D07-335_B1,0,1,0,0,0,1
TGCCTAATTGAAGATT-1_V12D07-335_B1,1,5,0,0,0,6
TGGCAATGGGACGGCG-1_V12D07-335_B1,0,2,0,0,0,2
ACCTCCGCCCTCGCTG-1_V12D07-335_B1,0,0,0,0,0,0
CGGCAATAAGATCGCC-1_V12D07-335_B1,0,1,0,0,0,1
CCTTGACCACTTTATT-1_V12D07-335_B1,0,0,0,0,1,1
TCATTTAGAAGTGTGA-1_V12D07-335_B1,2,0,0,0,0,2
CAGAATAACACACGGA-1_V12D07-335_B1,2,0,0,0,0,2
TCTGAGCAATTGACTG-1_V12D07-335_B1,0,0,0,0,0,0
CAACGTGGTGGAGTCT-1_V12D07-335_B1,2,0,2,0,0,4
CACAGTTCGCTTCCCA-1_V12D07-335_B1,0,0,1,0,0,1
TCTCTCGCCGCACATA-1_V12D07-335_B1,0,0,0,0,0,0
TGGGCAGGCCACCGCA-1_V12D07-335_B1,0,0,0,0,0,0
CTCCTGTTCAAGGCAG-1_V12D07-335_B1,1,2,0,0,0,3
TATTTGATTTGCACAG-1_V12D07-335_B1,0,2,1,0,0,3
GCCACTCCTTACGGTA-1_V12D07-335_B1,0,2,0,0,0,2
ACCGATATTTAATCAT-1_V12D07-335_B1,1,1,1,0,0,3
TTATTATCTGGAAGGC-1_V12D07-335_B1,1,2,1,0,0,4
TACATGCCGGAATTGT-1_V12D07-335_B1,1,1,1,0,0,3
GGCACTCAGCCGACCC-1_V12D07-335_B1,0,1,0,0,0,1
AAACCGGAAATGTTAA-1_V12D07-335_B1,1,2,0,0,0,3
AGACAGGCATCTCAGC-1_V12D07-335_B1,2,2,1,0,0,5
GTGGTGATGGTTTGTG-1_V12D07-335_B1,0,3,0,0,0,3
CCGATATGACGTAAGG-1_V12D07-335_B1,0,2,1,0,0,3
CATACACAAAGTCAGC-1_V12D07-335_B1,2,2,1,0,1,6
TGCCGTTCTTAATCGG-1_V12D07-335_B1,1,0,0,0,0,1
TCGAGTCTACGATTCG-1_V12D07-335_B1,2,0,0,0,0,2
ACTTCCAGTGGAAGCT-1_V12D07-335_B1,1,2,0,0,0,3
CAATTGGGCCGCACTC-1_V12D07-335_B1,1,0,0,1,0,2
AAATCGCGGAAGGAGT-1_V12D07-335_B1,0,4,0,1,0,5
ATATCAATTCCAGCCT-1_V12D07-335_B1,0,3,0,1,0,4
CTTTGTCGAATGCTCC-1_V12D07-335_B1,0,1,0,0,0,1
TGAGGCATGTACTGTG-1_V12D07-335_B1,1,0,0,0,0,1
TTCGCCGCTCGCGCTA-1_V12D07-335_B1,2,1,0,0,0,3
GACTCCTTCCAATTGA-1_V12D07-335_B1,1,2,0,0,0,3
ACCGAAGAGTCTGGTT-1_V12D07-335_B1,0,2,0,0,0,2
TGGCATGAAGTTTGGG-1_V12D07-335_B1,1,4,0,0,0,5
ACGAGGTTTACAACGT-1_V12D07-335_B1,1,0,0,0,0,1
AACCCATCCCATGATC-1_V12D07-335_B1,1,1,0,0,0,2
TCGACAACTGAACCCG-1_V12D07-335_B1,1,1,0,0,0,2
TATCTTGCAATACAAC-1_V12D07-335_B1,0,3,0,0,0,3
TATTATGTTTGCCTGC-1_V12D07-335_B1,1,0,0,0,0,1
GTCAAAGAAGTGGTGT-1_V12D07-335_B1,2,2,0,0,0,4
GGGACAGAGTTACTCC-1_V12D07-335_B1,2,0,0,1,0,3
AGCAACCGAAAGTAAT-1_V12D07-335_B1,2,2,0,0,0,4
CTCTCTAACTGCCTAG-1_V12D07-335_B1,2,0,0,0,0,2
ATACGGAACGTCGTTT-1_V12D07-335_B1,2,0,0,0,0,2
TCGGTCCCGACAATAG-1_V12D07-335_B1,2,2,1,0,0,5
CGCGCAAATGTCCAGA-1_V12D07-335_B1,1,0,0,0,0,1
TCTAATACTGCCTCAG-1_V12D07-335_B1,1,1,0,0,0,2
CTCGGTTGTCGGCCCT-1_V12D07-335_B1,0,1,0,0,0,1
GGTAACCGGGAGGATA-1_V12D07-335_B1,2,0,0,0,0,2
CAGGCGCACGGTGGTC-1_V12D07-335_B1,2,0,0,0,0,2
TCATCGATGGTCCCAA-1_V12D07-335_B1,5,1,0,0,0,6
CAAAGATTATTGGGCC-1_V12D07-335_B1,1,0,0,0,0,1
ACAATGAATACGGAGA-1_V12D07-335_B1,3,0,0,0,0,3
GCTCCTGACATACTGG-1_V12D07-335_B1,1,0,0,0,0,1
GATGACAAGTAGGGCA-1_V12D07-335_B1,4,0,1,0,0,5
TACGCCGAGGGTACCC-1_V12D07-335_B1,4,0,0,0,0,4
AAGCGTCCCTCATCGA-1_V12D07-335_B1,3,1,0,1,0,5
CACTCCTATGTAAGAT-1_V12D07-335_B1,3,0,0,0,0,3
TCGAGCCAGGCAGGCC-1_V12D07-335_B1,2,0,0,0,0,2
TCGTCAAGTACGCGCA-1_V12D07-335_B1,3,1,0,1,0,5
CCCGTAGCTGGGAAGA-1_V12D07-335_B1,3,1,1,0,0,5
ACCCTATGCCATATCG-1_V12D07-335_B1,0,0,0,1,0,1
GTGGTATAGTCTGCCG-1_V12D07-335_B1,1,1,0,0,0,2
CCGGTTTGTAATTGTG-1_V12D07-335_B1,0,1,0,0,0,1
GTCGCCGTTGTGTGTT-1_V12D07-335_B1,1,0,0,0,0,1
TACTGAACAGATTTAG-1_V12D07-335_B1,0,1,0,0,0,1
TATTAACCTGACCGCG-1_V12D07-335_B1,0,0,0,0,0,0
CTGTAGCCATCTCACT-1_V12D07-335_B1,0,1,0,0,0,1
TACTATGGTTCCTCAG-1_V12D07-335_B1,0,1,0,0,0,1
GAGTCAGACCAGAATC-1_V12D07-335_B1,2,1,0,0,0,3
TAAGGCATAACATCAA-1_V12D07-335_B1,0,0,0,0,0,0
CTTCCGCTCCGTGAAG-1_V12D07-335_B1,1,0,0,0,0,1
GGGCTATGATCGATGG-1_V12D07-335_B1,0,2,1,0,2,5
GGTCGGTCGTCCACAG-1_V12D07-335_B1,1,0,0,0,0,1
GGGACCCGTATATCTT-1_V12D07-335_B1,1,0,0,0,0,1
GAAAGCAGTGCACTTT-1_V12D07-335_B1,0,0,0,0,0,0
AGCGCATAATGAATCG-1_V12D07-335_B1,0,0,0,0,0,0
GCTGCTAAGTAGTCGA-1_V12D07-335_B1,0,0,0,0,0,0
AATAGTCCGTCCCGAC-1_V12D07-335_B1,3,3,0,1,0,7
AGCAGCCAGATGAATA-1_V12D07-335_B1,0,0,0,0,0,0
CCTCGCGCTGTGCGAT-1_V12D07-335_B1,1,0,0,0,0,1
TTGTGTATGCCACCAA-1_V12D07-335_B1,0,0,1,0,0,1
TGCTCGGCGAAACCCA-1_V12D07-335_B1,1,0,0,0,0,1
CGATTAAATATCTCCT-1_V12D07-335_B1,1,0,0,0,0,1
TGCCGTGGATCGTCCT-1_V12D07-335_B1,3,0,0,0,0,3
GTGGACGCATTTGTCC-1_V12D07-335_B1,0,0,0,0,0,0
ACCCGGAAACTCCCAG-1_V12D07-335_B1,1,0,0,0,0,1
CCGCATGTGGTACGAT-1_V12D07-335_B1,0,1,0,0,0,1
GCAAACCTTGGCCATA-1_V12D07-335_B1,0,0,0,0,0,0
ATTCACTGATGTTGGA-1_V12D07-335_B1,0,0,0,0,0,0
ACTCCCTAATGCTAAA-1_V12D07-335_B1,1,0,0,0,0,1
TCCTAAATTGGGAAGC-1_V12D07-335_B1,3,0,0,0,0,3
GAACAGATTACTAAAT-1_V12D07-335_B1,0,0,0,0,0,0
ATACAGGCCCTCCAAT-1_V12D07-335_B1,1,3,0,1,0,5
CGATTCGCCTGGCTGC-1_V12D07-335_B1,0,0,0,0,0,0
TCCGCCTGTCTACAAG-1_V12D07-335_B1,1,0,0,0,0,1
CACATCTCACCGACGA-1_V12D07-335_B1,0,0,0,0,0,0
CGTCGTCCTTCGCGAA-1_V12D07-335_B1,2,0,0,0,0,2
CGTTGAATACCGCGCT-1_V12D07-335_B1,2,1,0,0,0,3
ACCAATATGCAAGTTA-1_V12D07-335_B1,0,0,0,0,0,0
ACGGATGGTGCGGATA-1_V12D07-335_B1,1,0,0,0,0,1
CACCCTAACAAGATCT-1_V12D07-335_B1,2,0,1,0,0,3
AAGCTCTTTCATGGTG-1_V12D07-335_B1,0,1,0,0,0,1
CATGGGTATGCCTTAT-1_V12D07-335_B1,1,1,0,0,0,2
GCGCGTCATTGGTACA-1_V12D07-335_B1,2,1,0,0,0,3
TCTGAAGCACGTGGTC-1_V12D07-335_B1,1,0,0,0,0,1
AAGTTCACTCCAAGCT-1_V12D07-335_B1,0,1,0,0,0,1
TTGGACCTATAACAGT-1_V12D07-335_B1,0,2,0,0,0,2
ATCAGCCTCATGCTGC-1_V12D07-335_B1,1,0,0,0,0,1
AGTACTCTTATGCCCA-1_V12D07-335_B1,0,3,0,0,0,3
GCGCTTAAATAATTGG-1_V12D07-335_B1,1,1,1,0,0,3
TTGTGAACCTAATCCG-1_V12D07-335_B1,1,2,0,0,0,3
AGTCGTCGACCACCAA-1_V12D07-335_B1,1,1,0,0,0,2
TCCTTTAAATCCGCTT-1_V12D07-335_B1,1,3,1,0,0,5
ACTGAAACGCCGTTAG-1_V12D07-335_B1,0,7,2,0,0,9
GCACACACTGGTAGCC-1_V12D07-335_B1,1,3,1,0,0,5
TAAGGGCCTGTCCGAT-1_V12D07-335_B1,0,0,1,0,0,1
GCTAGAGTAGAGATGT-1_V12D07-335_B1,0,0,1,0,0,1
CACAGGGCCATATAGT-1_V12D07-335_B1,0,5,0,0,0,5
CCATGCCCTAGATTTC-1_V12D07-335_B1,1,1,0,0,0,2
TCGCGTAGCAGTGTCC-1_V12D07-335_B1,0,3,0,0,0,3
GACGAGGCTAATAAAC-1_V12D07-335_B1,3,0,0,0,0,3
CTACACTCGCAGATGG-1_V12D07-335_B1,4,1,0,0,0,5
ACGCATACGTTTACTA-1_V12D07-335_B1,0,3,0,0,0,3
GGAGCAACATTTCAAG-1_V12D07-335_B1,2,2,0,0,0,4
CGAGAGGGTAGCCGCG-1_V12D07-335_B1,2,0,1,0,0,3
TCGTGTTCGACCACAA-1_V12D07-335_B1,0,0,0,0,2,2
TCTACCCAATAGAGAG-1_V12D07-335_B1,1,1,0,0,2,4
ATAAACGTTGCACCAC-1_V12D07-335_B1,0,1,0,0,0,1
TCAACTGCAGAGTCAG-1_V12D07-335_B1,0,3,1,0,1,5
AGCTCCATATATGTTC-1_V12D07-335_B1,0,1,0,0,0,1
GTAACATCTAAGATAA-1_V12D07-335_B1,2,2,0,0,0,4
CCGACAATAGGCCGCC-1_V12D07-335_B1,0,4,0,0,0,4
ATGCTTAGGAGTTGAT-1_V12D07-335_B1,1,0,0,0,0,1
AACCCGAGCAGAATCG-1_V12D07-335_B1,1,1,0,0,0,2
CGGGTTTGTTAGGGCT-1_V12D07-335_B1,1,2,0,1,0,4
AGGCACGTGACTGTCC-1_V12D07-335_B1,1,0,0,0,0,1
GACAAGAGATGAGATT-1_V12D07-335_B1,2,2,0,0,0,4
AGCCCTTGGACATCCC-1_V12D07-335_B1,2,0,0,0,0,2
GCAGTTCGATCCGAGC-1_V12D07-335_B1,1,0,0,0,0,1
TCGAGGGCAACAGACG-1_V12D07-335_B1,0,1,0,0,0,1
ACTTTGTCGACGCACT-1_V12D07-335_B1,0,3,0,0,0,3
GAGTATCAAAGTTACA-1_V12D07-335_B1,1,2,0,0,0,3
CCAGGCTGGCGTCTGA-1_V12D07-335_B1,1,3,0,0,0,4
GGACTCTTCCGGTTGA-1_V12D07-335_B1,0,1,0,0,0,1
TCCCAGCACACGACAT-1_V12D07-335_B1,0,3,1,0,0,4
GCTCCATGAGTGCAGA-1_V12D07-335_B1,1,2,1,0,0,4
GCAGTGCGGGCGGATG-1_V12D07-335_B1,0,1,3,1,0,5
GCGTTCTGACTAAGCG-1_V12D07-335_B1,0,4,0,0,0,4
ATTTGGAGATTGCGGT-1_V12D07-335_B1,2,0,0,0,0,2
AAGGGTTTGATTTCAG-1_V12D07-335_B1,1,1,0,1,0,3
CCGGCCGCGAGCATAT-1_V12D07-335_B1,0,0,0,0,0,0
GAGTTCTGTGGGTGCT-1_V12D07-335_B1,2,0,0,1,0,3
AAACGAAGATGGAGTA-1_V12D07-335_B1,1,1,0,0,0,2
AATTACGAGACCCATC-1_V12D07-335_B1,0,0,1,0,0,1
CCTTTGAATTATGGCT-1_V12D07-335_B1,1,3,1,1,0,6
CATGGTATTAGTTTGT-1_V12D07-335_B1,7,1,0,0,0,8
AACGAAAGTCGTCCCA-1_V12D07-335_B1,1,0,0,1,0,2
ACATAAGTCGTGGTGA-1_V12D07-335_B1,3,0,0,0,0,3
GCACAACCTCGGGCGT-1_V12D07-335_B1,5,2,0,0,0,7
ATGCACGCGCTGTTCA-1_V12D07-335_B1,1,1,0,0,0,2
CGATGTTGTTATCTAC-1_V12D07-335_B1,2,1,0,0,0,3
GTCTCCTGCCAGTATG-1_V12D07-335_B1,2,0,1,0,0,3
GATGCCTTCTGCGGCA-1_V12D07-335_B1,3,0,0,0,0,3
ACCGGTCAGGTACACC-1_V12D07-335_B1,1,1,0,0,0,2
GTGGAGCGTTTACCGA-1_V12D07-335_B1,2,0,0,0,0,2
AGGCGGTTTGTCCCGC-1_V12D07-335_B1,1,0,0,0,0,1
TCCCTGGCGTATTAAC-1_V12D07-335_B1,0,1,0,0,1,2
AAACACCAATAACTGC-1_V12D07-335_B1,1,0,0,0,0,1
TGGACGCAATCCAGCC-1_V12D07-335_B1,1,0,0,0,0,1
GGAACCTTGACTCTGC-1_V12D07-335_B1,0,0,0,0,0,0
GTATCTCAGTCTTGAC-1_V12D07-335_B1,2,1,0,0,0,3
GCTGAATCTTCCAATC-1_V12D07-335_B1,0,1,0,0,0,1
AGATGCAAGACGTGCA-1_V12D07-335_B1,2,0,0,0,0,2
TTAAGGCCCGTACTTT-1_V12D07-335_B1,0,0,0,0,0,0
AGTATGCTGGAGACCA-1_V12D07-335_B1,2,0,0,0,0,2
GCGGCAAAGTATTGCC-1_V12D07-335_B1,2,1,0,0,0,3
GCGCAAATATATTCAA-1_V12D07-335_B1,1,0,0,1,0,2
GAAGAAACGATATTGT-1_V12D07-335_B1,0,1,0,1,0,2
GGACCTCTAGGCCGCC-1_V12D07-335_B1,1,0,0,0,0,1
AACAGCTGTGTGGCAA-1_V12D07-335_B1,0,0,0,0,0,0
TCGAATATCCCGCAGG-1_V12D07-335_B1,1,0,0,0,0,1
GCGACCCAACCATCTG-1_V12D07-335_B1,0,0,0,1,0,1
AGAGAAGGAGTACAAT-1_V12D07-335_B1,0,0,0,0,0,0
GGCTCCTCCACCTGTT-1_V12D07-335_B1,0,1,0,0,0,1
TCAGTGTATACGTCAT-1_V12D07-335_B1,1,0,0,0,0,1
ATTATTATGTCCGTCA-1_V12D07-335_B1,1,2,0,1,0,4
TTAGGTCATAACCGAC-1_V12D07-335_B1,1,0,0,0,0,1
AAGATGGCACCGGACC-1_V12D07-335_B1,0,0,0,0,0,0
CTACAAGAAATAACCC-1_V12D07-335_B1,3,2,0,0,0,5
ACTATTTCCGGGCCCA-1_V12D07-335_B1,1,1,0,0,0,2
TTGTTTCACATCCAGG-1_V12D07-335_B1,0,0,0,1,0,1
CGCTGTGTGGATGTTG-1_V12D07-335_B1,1,1,0,0,0,2
TCAACATAGCGCCCTA-1_V12D07-335_B1,0,0,0,0,0,0
GGCCGTTTGGGTTTCA-1_V12D07-335_B1,0,2,0,0,0,2
TACTCTTTCGTCTTCA-1_V12D07-335_B1,0,0,0,0,0,0
TTCGCGCGCCATACGA-1_V12D07-335_B1,0,2,0,0,0,2
CGGAAAGAATCAAACG-1_V12D07-335_B1,2,3,0,0,0,5
AGGCAGGGAGCGTACT-1_V12D07-335_B1,2,0,0,0,0,2
CCTTTAAGGGAGCACT-1_V12D07-335_B1,0,0,0,0,1,1
CGCCCAGCACGCCTAG-1_V12D07-335_B1,1,2,0,0,0,3
AGTATTTGGCACGACC-1_V12D07-335_B1,1,0,0,1,0,2
TATCCGCACCGTCGGG-1_V12D07-335_B1,1,0,0,0,0,1
ACCCGTGTCATCAGTA-1_V12D07-335_B1,0,1,0,1,0,2
CAACTGCTCATCCGAT-1_V12D07-335_B1,0,0,0,0,0,0
CCGGAGCGTACTTTCT-1_V12D07-335_B1,1,0,0,0,0,1
TACCGTAGGTTAACTA-1_V12D07-335_B1,0,0,0,0,0,0
TGAGGAGTGCCAGCTT-1_V12D07-335_B1,0,0,0,0,0,0
CCAGTCTTGTCATAGA-1_V12D07-335_B1,0,0,0,0,0,0
GGGCAGAGCAATCGTT-1_V12D07-335_B1,1,1,0,0,0,2
TACCAAATAGCCCAGA-1_V12D07-335_B1,0,1,0,0,0,1
TACCTACTCCCAGTAT-1_V12D07-335_B1,2,0,0,1,0,3
TGTGAGACTAGCCCAA-1_V12D07-335_B1,2,1,0,1,0,4
ATACCTAACCAAGAAA-1_V12D07-335_B1,1,0,0,0,0,1
GTCGGGAAGCAGAAAC-1_V12D07-335_B1,1,2,1,0,0,4
AATTAACGGATTTCCA-1_V12D07-335_B1,0,0,0,0,0,0
GAACCCTCTGTGTTCT-1_V12D07-335_B1,0,0,0,0,0,0
ATATAAAGCGCTCGTG-1_V12D07-335_B1,1,1,0,0,0,2
CCTGGTCGAATGTGGG-1_V12D07-335_B1,2,0,0,0,0,2
CTAGGTTCGGACGTGA-1_V12D07-335_B1,2,0,0,0,0,2
TCGGGAGACAGCGTAC-1_V12D07-335_B1,0,0,0,0,0,0
CATAAGAAGCTTGGCT-1_V12D07-335_B1,0,1,0,0,0,1
AAGCACCCTGCGTATC-1_V12D07-335_B1,0,0,1,0,0,1
AGTTTGCACCTGCCTC-1_V12D07-335_B1,1,1,0,0,0,2
GACTGCAAATCGAGCT-1_V12D07-335_B1,1,0,0,0,0,1
GTGTATATCAGCGGGC-1_V12D07-335_B1,1,0,0,1,0,2
CTTCAACTCCACTTGG-1_V12D07-335_B1,0,1,0,0,0,1
ACTTACGCATCCACGC-1_V12D07-335_B1,0,0,0,1,0,1
CATGAGATGCACTCTC-1_V12D07-335_B1,2,0,2,0,0,4
GAGCACCTGTGTCCAG-1_V12D07-335_B1,0,1,0,0,0,1
CGCGACCGCGACAGAT-1_V12D07-335_B1,1,0,0,0,0,1
GTCCCGCGACGTTATG-1_V12D07-335_B1,2,1,0,0,0,3
GCAGTGTGGCTATAGG-1_V12D07-335_B1,0,0,0,0,0,0
ATACTGCCTTACACCG-1_V12D07-335_B1,0,0,1,0,0,1
TACAGAAACGGTGGGC-1_V12D07-335_B1,2,1,0,0,0,3
GGCGCGGAGATCTTTC-1_V12D07-335_B1,1,2,1,0,0,4
CGTTAATGTCCCGACG-1_V12D07-335_B1,0,0,0,0,0,0
GCTAACTGAAGTCTGA-1_V12D07-335_B1,1,1,0,0,0,2
AGTGATAACCTGCGCG-1_V12D07-335_B1,2,1,0,0,0,3
TATGATCTTCTCTTTA-1_V12D07-335_B1,1,3,0,0,0,4
TGTACCTACACGAGGG-1_V12D07-335_B1,0,5,0,0,0,5
ATATCGTTCCTCGAAC-1_V12D07-335_B1,0,3,1,0,0,4
CGGCGCCATCAATCCC-1_V12D07-335_B1,0,5,0,0,0,5
CCTGTTTGAAGACACG-1_V12D07-335_B1,1,1,1,0,0,3
GCCACTCAGAGCGCGA-1_V12D07-335_B1,0,2,2,0,0,4
TCGGCTTGTATCGACG-1_V12D07-335_B1,0,4,1,0,0,5
TAGATGGTTCCTTACT-1_V12D07-335_B1,0,1,0,0,0,1
ATCGTTAGCTAGCGGA-1_V12D07-335_B1,0,3,0,0,0,3
ACAGCGACATTCTCAT-1_V12D07-335_B1,0,4,0,0,0,4
ATTCAACCATTTAAGG-1_V12D07-335_B1,0,2,1,0,0,3
CACTCTTCTGCTAGCC-1_V12D07-335_B1,1,1,2,0,1,5
CTAACTGATAATCGCC-1_V12D07-335_B1,1,0,0,0,1,2
TGATGTCAATTAAGTG-1_V12D07-335_B1,1,1,0,0,2,4
CGCCGTTCAGCATAGT-1_V12D07-335_B1,0,1,0,0,1,2
ATACTACCCGTACCAC-1_V12D07-335_B1,0,2,0,0,0,2
CCACTGTTTGGATTAA-1_V12D07-335_B1,1,1,0,0,0,2
CACTACGGGAGCTGCC-1_V12D07-335_B1,0,0,0,0,0,0
GACCAAACGTTGACTG-1_V12D07-335_B1,2,1,0,0,0,3
AAGAGGCCCTTTGGAA-1_V12D07-335_B1,0,0,0,0,0,0
ACACGTAGGCCACAAG-1_V12D07-335_B1,2,0,0,0,0,2
TACTCTTACTTTACTG-1_V12D07-335_B1,1,3,0,0,0,4
AGAGCCGCCGAGATTT-1_V12D07-335_B1,2,0,0,0,0,2
GGCCTGCTTCTCCCGA-1_V12D07-335_B1,0,1,0,0,0,1
TCAAGCGCGGACGGTA-1_V12D07-335_B1,1,1,0,0,0,2
ACACTGGGACAGTCGT-1_V12D07-335_B1,0,3,0,0,0,3
TGTGTAGTAGCACGTG-1_V12D07-335_B1,1,4,0,0,0,5
CTAGCCACAGGCGAGC-1_V12D07-335_B1,1,0,0,0,0,1
CTATCGCGTAGAGAAC-1_V12D07-335_B1,2,0,0,0,0,2
GTTCCCGTAAACATAT-1_V12D07-335_B1,1,0,0,0,0,1
TCTTTCCTTCGAGATA-1_V12D07-335_B1,0,2,0,0,0,2
ATATTGGAGAGGCCTT-1_V12D07-335_B1,1,0,0,0,0,1
AGGCGATAACTGGCGT-1_V12D07-335_B1,0,2,0,0,0,2
ACCCGGAGCACCACAA-1_V12D07-335_B1,1,0,0,0,0,1
TGAGCTCAACTGTATA-1_V12D07-335_B1,0,0,0,0,0,0
ACGACCCATGAGTTGC-1_V12D07-335_B1,1,2,0,0,0,3
CGGTCAGTCCATATTT-1_V12D07-335_B1,0,2,0,0,0,2
TCCGGCTGTCGGGTCG-1_V12D07-335_B1,2,1,0,0,0,3
ATTCCCGAAGGTACAG-1_V12D07-335_B1,1,2,0,0,0,3
CTAACAGCACAATAAC-1_V12D07-335_B1,0,3,0,3,0,6
TTGTGCGGAAGCGGAT-1_V12D07-335_B1,1,1,0,0,0,2
GGGCACTATTGACCAT-1_V12D07-335_B1,2,0,1,0,0,3
CCATAGAGGCTGCCAG-1_V12D07-335_B1,0,1,0,0,0,1
CCGAAGCATTGACCAA-1_V12D07-335_B1,3,0,0,0,0,3
TACTGAGGGAAGAAAG-1_V12D07-335_B1,1,4,0,0,0,5
TATGTAGAAACCCGGC-1_V12D07-335_B1,3,0,0,0,0,3
TGGTTAACTTACATTT-1_V12D07-335_B1,12,1,0,0,1,14
AGAACCCTCAATTGGG-1_V12D07-335_B1,2,0,0,0,0,2
CCTATATCGTGTCACG-1_V12D07-335_B1,1,1,0,0,0,2
ACGGCTGGATGTAGAA-1_V12D07-335_B1,1,1,0,0,0,2
CTCGCATTGCATAGCC-1_V12D07-335_B1,3,0,0,0,0,3
ACTTTGGTCGTGCTCC-1_V12D07-335_B1,1,0,0,0,0,1
GCTGGTTTAGGCCATA-1_V12D07-335_B1,5,0,0,0,0,5
TGTCGTTATCACATAT-1_V12D07-335_B1,0,3,0,0,0,3
ACACATGATCAAATCT-1_V12D07-335_B1,1,0,0,0,0,1
TATCCATCTCGGTTAG-1_V12D07-335_B1,2,0,0,0,0,2
CTCGTCGAGGGCTCAT-1_V12D07-335_B1,0,0,0,0,0,0
ATCAATGCCGTGGCTG-1_V12D07-335_B1,2,0,0,0,0,2
GAAACATAGGAAACAG-1_V12D07-335_B1,0,2,0,0,0,2
TAATAGGTCACCAGAA-1_V12D07-335_B1,2,0,0,0,0,2
CACCAGTCAGCATGCA-1_V12D07-335_B1,2,1,0,0,0,3
GAGCGCTGTTAGGTAA-1_V12D07-335_B1,2,0,0,0,0,2
CCCTATGTAGAGCAGA-1_V12D07-335_B1,2,0,0,0,0,2
GATCGCTATATCTCAG-1_V12D07-335_B1,1,2,0,1,0,4
AAGGGACTATGCATTC-1_V12D07-335_B1,1,3,0,0,0,4
CTCGGGTTCTCTGGCC-1_V12D07-335_B1,0,0,0,0,0,0
TATATATCGAGAAATG-1_V12D07-335_B1,1,1,0,0,2,4
ACCCGAGCGAAATTAC-1_V12D07-335_B1,0,1,0,0,0,1
TTGTTTCATTAGTCTA-1_V12D07-335_B1,1,0,0,0,0,1
ATGGGACCTGCTGAAC-1_V12D07-335_B1,0,2,0,1,0,3
TGCGACGGCCGAACGT-1_V12D07-335_B1,2,0,0,0,0,2
AGCTAACAAGCAATGT-1_V12D07-335_B1,0,1,0,0,0,1
CGTGTCTCGTTACGAC-1_V12D07-335_B1,0,2,0,1,0,3
CTAAATCCGGTGTACA-1_V12D07-335_B1,1,1,0,0,0,2
GAATAGTGCTCGATTA-1_V12D07-335_B1,0,0,0,0,0,0
AACAATACATTGTCGA-1_V12D07-335_B1,0,0,0,0,0,0
CACATCGTGCACGCGC-1_V12D07-335_B1,1,0,0,0,0,1
ACCGTGACCACGTGGG-1_V12D07-335_B1,1,0,0,0,0,1
CCCAATGAGATTTGCA-1_V12D07-335_B1,3,1,0,0,0,4
TCAGCAGTAGGCCCTG-1_V12D07-335_B1,1,1,0,1,0,3
CTACTCAAGGTATAGT-1_V12D07-335_B1,2,0,0,0,0,2
TAGTAGCTTATACCAG-1_V12D07-335_B1,0,2,0,1,0,3
ACGTTCGTTCAGGAAA-1_V12D07-335_B1,1,1,0,0,0,2
TTAGAATAAGGGTCGG-1_V12D07-335_B1,0,0,0,1,0,1
TTCTAGAAAGTCTTAT-1_V12D07-335_B1,0,1,0,0,0,1
CCTTCAGTTAAAGTGA-1_V12D07-335_B1,1,1,0,0,0,2
TAGCTAGTGATGATGG-1_V12D07-335_B1,0,2,0,1,0,3
AGCCCGGTAGCCTGTA-1_V12D07-335_B1,1,0,0,0,0,1
TACCTCAGTTGTCTGT-1_V12D07-335_B1,0,1,0,0,0,1
GACGGGTTGGCCCGTA-1_V12D07-335_B1,0,0,0,0,0,0
GAAACCTATACAAATG-1_V12D07-335_B1,0,0,0,0,0,0
TCCACCTCTAGCCTTT-1_V12D07-335_B1,0,0,0,0,0,0
AAGACCCAACTGAACA-1_V12D07-335_B1,2,0,0,0,0,2
CATACACGGTTCCCAC-1_V12D07-335_B1,0,2,0,0,0,2
ACTACGCGTTAGAATT-1_V12D07-335_B1,2,1,0,0,0,3
CTTGGCCAAGCTGGGA-1_V12D07-335_B1,0,1,0,0,0,1
TTACCCTAGGGATTGG-1_V12D07-335_B1,0,1,0,0,0,1
TTCGCACTGTACGACA-1_V12D07-335_B1,0,0,0,1,0,1
TAGGTGTTCCACAGAT-1_V12D07-335_B1,0,0,0,0,0,0
GAAGCCTGCACATTCC-1_V12D07-335_B1,2,0,0,0,0,2
GGCTTTCAATAAGGGT-1_V12D07-335_B1,0,0,0,0,0,0
TCCAGGGTATATACGA-1_V12D07-335_B1,0,1,0,0,0,1
CTCGCCGAATGTAGGG-1_V12D07-335_B1,0,0,0,0,0,0
AGGAAGCTGTCCGCCG-1_V12D07-335_B1,0,0,0,0,0,0
GTCTCAAGGCCCGGCT-1_V12D07-335_B1,0,0,0,0,0,0
ACCGACACATCTCCCA-1_V12D07-335_B1,1,1,0,1,0,3
TATACGCGTCATCACT-1_V12D07-335_B1,0,1,0,0,0,1
ATCTGGGCTGTTCTTG-1_V12D07-335_B1,1,0,0,0,0,1
TCAAATTTGAGACTCA-1_V12D07-335_B1,1,0,0,0,0,1
GTTAAGGGTGCGATGT-1_V12D07-335_B1,2,1,0,0,0,3
AGCAAAGGCCGCTAGT-1_V12D07-335_B1,2,0,0,0,0,2
TTATAGGTAATTGTCT-1_V12D07-335_B1,0,0,0,0,0,0
TTGTGCAGCCACGTCA-1_V12D07-335_B1,1,2,1,1,0,5
ACGGACTCTCAAAGCG-1_V12D07-335_B1,0,0,0,0,0,0
ATGCTCTGGCGCGGTA-1_V12D07-335_B1,0,0,0,0,0,0
ATAATCTTGGAGAACC-1_V12D07-335_B1,6,0,0,0,0,6
CTCATTGCTCTAACAA-1_V12D07-335_B1,0,0,1,0,0,1
TAGGTGACGATAACCT-1_V12D07-335_B1,3,0,0,0,0,3
CGGATCCTCAAGGACT-1_V12D07-335_B1,1,0,0,0,0,1
GGGCGTGGTTTCCCAG-1_V12D07-335_B1,2,3,1,1,0,7
TGGCTATGTGACATAC-1_V12D07-335_B1,0,1,0,1,0,2
CTTAGTGTAGTAGCAT-1_V12D07-335_B1,0,0,0,0,0,0
GGATTGCTGTGACTCC-1_V12D07-335_B1,0,2,0,0,0,2
ACTTCCATGCGGGACA-1_V12D07-335_B1,0,1,0,0,0,1
ACTCAAGTGCAAGGCT-1_V12D07-335_B1,1,0,0,0,0,1
ACAAGGATGCTTTAGG-1_V12D07-335_B1,2,1,1,0,0,4
TTGAACGACGTGCTGA-1_V12D07-335_B1,1,3,0,0,0,4
ATTCATCGTTGAGGCA-1_V12D07-335_B1,1,0,0,0,0,1
TGCAACCCATCTGCGG-1_V12D07-335_B1,0,2,0,0,0,2
AGTGCTAAACACAGCA-1_V12D07-335_B1,0,2,1,0,0,3
AACTCCAGAGCGTGTT-1_V12D07-335_B1,2,3,1,0,0,6
TCTCCACAAGTTGAAT-1_V12D07-335_B1,1,4,0,0,0,5
CTTTGCATCGCTCTTG-1_V12D07-335_B1,4,2,4,0,0,10
TCACAAACCGAGGTAC-1_V12D07-335_B1,0,2,1,0,0,3
CCGTAGGAAATCCCTG-1_V12D07-335_B1,0,0,1,0,0,1
AAACATTTCCCGGATT-1_V12D07-335_B1,2,1,0,0,0,3
GCCTCCGACAATTCAC-1_V12D07-335_B1,2,1,1,0,0,4
TCTGCATACCTTGCTT-1_V12D07-335_B1,0,1,0,0,0,1
ACCCATTTGTCCCTCT-1_V12D07-335_B1,1,2,1,0,0,4
CTGCAGAGAATCAGAG-1_V12D07-335_B1,0,5,1,0,0,6
GGAAACTAAATGGGCC-1_V12D07-335_B1,2,2,0,0,0,4
CAACCTACCGAGCAGT-1_V12D07-335_B1,0,2,0,0,0,2
CCGTAGGGTTGTTTAC-1_V12D07-335_B1,2,1,0,0,0,3
GGTTTGTGACCTGAGG-1_V12D07-335_B1,2,4,1,0,0,7
TAACCTAGGGAGTCCA-1_V12D07-335_B1,3,1,1,0,0,5
TTCCATCGACAGCGTG-1_V12D07-335_B1,0,1,0,0,0,1
ATCTCCCACGGAATAT-1_V12D07-335_B1,0,0,0,0,0,0
GTTTCAAACGAGTTGT-1_V12D07-335_B1,0,0,0,0,0,0
GGAACTTTGGCGATTA-1_V12D07-335_B1,1,2,0,0,0,3
CTGCAAGCACGTTCCG-1_V12D07-335_B1,2,0,0,0,0,2
CACAGTCCCGCTTCGC-1_V12D07-335_B1,2,0,0,0,0,2
TACGCTCGGTATTGGA-1_V12D07-335_B1,2,4,0,0,0,6
CTGGTAAAGTGTGGGC-1_V12D07-335_B1,0,1,0,0,0,1
CAACCAGTGGCCTACC-1_V12D07-335_B1,0,0,0,0,0,0
TCTTCGCGGTGAGAGG-1_V12D07-335_B1,2,0,0,0,0,2
TTCGGGTTGCCACGGG-1_V12D07-335_B1,0,0,0,0,0,0
ACCGATAGGCATAACC-1_V12D07-335_B1,0,0,0,0,0,0
CTTATAGATGGCTGTT-1_V12D07-335_B1,0,2,0,0,0,2
AGACGCCCACTTCGCC-1_V12D07-335_B1,0,0,0,0,0,0
AGGTCGCCTCCCAACA-1_V12D07-335_B1,1,2,0,0,0,3
CCTCACGTCAGCTAAT-1_V12D07-335_B1,0,0,1,0,0,1
CCACCTGTATGGAATA-1_V12D07-335_B1,0,1,0,0,0,1
GGACTCGAAGCTTTCA-1_V12D07-335_B1,1,0,0,0,0,1
AAGCCGGAGAGCAGGA-1_V12D07-335_B1,0,1,2,0,0,3
GCCTATCAGGTAAGAT-1_V12D07-335_B1,0,0,0,0,0,0
TCAGAGTGTGAGCATG-1_V12D07-335_B1,0,2,0,0,0,2
AAACATGGTGAGAGGA-1_V12D07-335_B1,2,0,0,1,0,3
ATCATTGTACCGCATT-1_V12D07-335_B1,2,1,1,0,0,4
TCAGCTTGAGCTTTCG-1_V12D07-335_B1,4,0,0,0,1,5
CCGCGCAAGATACCCA-1_V12D07-335_B1,0,2,0,2,0,4
CTATACTTAAAGCGAG-1_V12D07-335_B1,1,2,0,2,0,5
ACCGTCCACTGGGCCC-1_V12D07-335_B1,2,2,0,0,0,4
AAGACCAAATAACTCA-1_V12D07-335_B1,4,1,0,0,0,5
TGTTTCTGAAGCGTGC-1_V12D07-335_B1,0,0,0,0,0,0
TTCTCTTACAGGTGAT-1_V12D07-335_B1,1,0,0,0,0,1
AATTCATTGTCATGCA-1_V12D07-335_B1,4,1,0,0,0,5
GCCCGAGAGTCTAAAT-1_V12D07-335_B1,3,0,0,0,0,3
ATATAGAGTATTGGTC-1_V12D07-335_B1,1,0,0,0,0,1
TTGAAGGATGGGCGCC-1_V12D07-335_B1,0,0,0,0,0,0
TAGTACCACAACTTTC-1_V12D07-335_B1,4,0,0,0,0,4
ATCCCATCCACAGCGC-1_V12D07-335_B1,4,4,0,0,0,8
CTTAGGTATAGACCAG-1_V12D07-335_B1,1,0,0,0,0,1
TGACTCCGAATCATAC-1_V12D07-335_B1,2,1,0,0,0,3
ACTACATCCCGACAAG-1_V12D07-335_B1,1,0,0,0,0,1
TTGCCGCAGACCTACA-1_V12D07-335_B1,1,0,0,0,0,1
TAAGAGGGACAGGGAC-1_V12D07-335_B1,2,0,0,0,0,2
CGAATGAAGTCATTGC-1_V12D07-335_B1,0,0,0,0,0,0
AAGGGAACGACTGGCT-1_V12D07-335_B1,1,0,0,0,0,1
CGAATCTGCTCGACGC-1_V12D07-335_B1,2,2,0,0,0,4
ATCGTGGAAAGTCTGG-1_V12D07-335_B1,0,0,0,0,0,0
CCTATGGCTCCTAGTG-1_V12D07-335_B1,3,0,0,0,0,3
CGTCGCTTGGTTATAC-1_V12D07-335_B1,0,3,0,0,0,3
TGCTTAGAGAGAATGC-1_V12D07-335_B1,2,1,0,0,0,3
GATTGCTCCAGTTGCA-1_V12D07-335_B1,0,2,0,0,0,2
CGTGCTTCTACCTAAA-1_V12D07-335_B1,1,0,0,0,0,1
ACTCCAATATCATCAT-1_V12D07-335_B1,0,2,0,0,0,2
GCCGACCCACGACTGC-1_V12D07-335_B1,0,0,0,0,0,0
GAGGGTAGTAACAAAG-1_V12D07-335_B1,0,1,0,0,1,2
GGCCGAGACTCTGGTG-1_V12D07-335_B1,3,2,0,0,0,5
TATATAGGGCTTTACG-1_V12D07-335_B1,1,0,0,0,0,1
TGCCGGATGTACGAGC-1_V12D07-335_B1,0,4,0,0,0,4
AGGTAGATCGAGATAT-1_V12D07-335_B1,0,2,0,0,0,2
GATCAACATAAAGGGA-1_V12D07-335_B1,1,2,0,0,0,3
TAACAGCGTTTGTGCT-1_V12D07-335_B1,0,6,0,0,0,6
CTATAGGCGTTGATGT-1_V12D07-335_B1,0,2,0,0,1,3
GGTTTAATTACCATCG-1_V12D07-335_B1,0,0,0,0,0,0
CTCTTCTGGAAGTTAG-1_V12D07-335_B1,3,0,0,0,0,3
ATCTGACATGGAAGGA-1_V12D07-335_B1,1,0,0,0,0,1
TACGTACTAGTGCTGA-1_V12D07-335_B1,0,0,1,0,0,1
ATGACTATCAGCTGTG-1_V12D07-335_B1,0,2,0,0,1,3
CTTTGGGATTGTTGCA-1_V12D07-335_B1,2,0,0,0,0,2
AGACTGTTACCGGGTC-1_V12D07-335_B1,1,1,0,0,0,2
TCCTAACCGTCGGGCA-1_V12D07-335_B1,1,0,0,0,0,1
ACGCAAACTAATAGAT-1_V12D07-335_B1,1,1,0,0,0,2
AAGTGAGTCGGGTTTA-1_V12D07-335_B1,1,0,1,0,0,2
TAAAGCGGTATTTCCA-1_V12D07-335_B1,0,2,0,0,0,2
CTCCTCCAGCTCACAC-1_V12D07-335_B1,2,0,0,0,0,2
CGGTCCGTCGCAAGCC-1_V12D07-335_B1,2,2,0,0,0,4
CCTATATTTGTCCTGG-1_V12D07-335_B1,1,0,0,0,0,1
TCCAATAAAGGCTACC-1_V12D07-335_B1,0,0,0,0,0,0
AAAGGCTACGGACCAT-1_V12D07-335_B1,0,0,0,1,0,1
CGTGACCAGTCCTCTG-1_V12D07-335_B1,1,0,0,0,0,1
GATCTGCTATCTAAGG-1_V12D07-335_B1,0,3,0,0,0,3
CGAATGACGCATAATG-1_V12D07-335_B1,1,2,0,0,0,3
GCTCAATGTAATACCG-1_V12D07-335_B1,1,1,0,0,0,2
CTATGCCCGAATGCAA-1_V12D07-335_B1,0,1,0,0,0,1
CACAGGGCCGTTGTCA-1_V12D07-335_B1,0,0,0,0,0,0
TCAATACGCCGTCATG-1_V12D07-335_B1,0,0,0,0,0,0
AGCGGACACTTCGTAG-1_V12D07-335_B1,0,0,0,0,0,0
ATACGTTATGCACGGA-1_V12D07-335_B1,0,1,0,0,0,1
GAGTAGATACTAGTTG-1_V12D07-335_B1,0,0,0,0,0,0
CCAGCTCGAACGCATT-1_V12D07-335_B1,1,0,0,0,0,1
TGCTTCCCAAGCAGTA-1_V12D07-335_B1,4,0,3,0,0,7
GTAGACACGCCTGACT-1_V12D07-335_B1,0,0,0,0,0,0
CTCACATTTACTAAAT-1_V12D07-335_B1,0,2,0,0,0,2
GAATGCGAATCGGTTC-1_V12D07-335_B1,0,1,0,0,0,1
TAAGGCCCGTCACCCT-1_V12D07-335_B1,2,0,0,0,0,2
GAGTATGCGCGTGCAT-1_V12D07-335_B1,0,0,0,0,0,0
ATCCACATCGACAGAA-1_V12D07-335_B1,0,0,0,0,0,0
TAGACGAAACGCCAAT-1_V12D07-335_B1,2,0,0,0,0,2
CAGCAGTCTGTGCTGC-1_V12D07-335_B1,0,1,1,0,0,2
CTCACTGTGATACTTA-1_V12D07-335_B1,2,3,0,0,0,5
TTAATTGCTTTGGGTG-1_V12D07-335_B1,2,0,0,0,0,2
GTAGTCTACGATATTG-1_V12D07-335_B1,0,0,0,0,0,0
TTGCCGCTTTCTAGTA-1_V12D07-335_B1,2,0,0,0,0,2
GAACCTTTAACGATCC-1_V12D07-335_B1,0,0,0,0,0,0
TGGACCAATCTAAGAT-1_V12D07-335_B1,0,0,0,0,0,0
CTAGTAGAAAGGGATT-1_V12D07-335_B1,0,1,0,0,0,1
AACCTCGCTTTAGCCC-1_V12D07-335_B1,1,0,0,0,0,1
GAGTGTCAACCAGAAA-1_V12D07-335_B1,2,0,0,0,0,2
GTGATCCTTGTCATGA-1_V12D07-335_B1,2,0,0,0,0,2
CTCAACTAACCCGGAT-1_V12D07-335_B1,1,0,0,0,0,1
AGTGGCGTCTGAAGGT-1_V12D07-335_B1,1,1,0,0,0,2
GGGAAGGGCTTTCTCA-1_V12D07-335_B1,0,0,0,0,0,0
AGGCCTGAGAATCTCG-1_V12D07-335_B1,0,0,1,0,1,2
AGCCACAGGTTACCCG-1_V12D07-335_B1,0,1,0,0,0,1
TGCAATCTAACACGGT-1_V12D07-335_B1,2,0,0,0,0,2
GTTTGGGTTTCGCCCG-1_V12D07-335_B1,1,0,0,0,0,1
CCTATGTCCACTCCAC-1_V12D07-335_B1,1,1,3,0,0,5
CTGCCTTTCTAGTAAA-1_V12D07-335_B1,1,5,0,0,0,6
TTAGTAAACCTGCTCT-1_V12D07-335_B1,1,5,2,0,0,8
TTGTGGTGGTACTAAG-1_V12D07-335_B1,2,2,0,0,0,4
CCTCCTGTTGTGTCGT-1_V12D07-335_B1,1,1,0,0,0,2
ACAAAGCATGACCTAG-1_V12D07-335_B1,0,4,0,0,0,4
ATAGCAACTAGGGAAG-1_V12D07-335_B1,1,1,0,0,0,2
CCGCTCTTCCGAACTA-1_V12D07-335_B1,2,2,1,0,0,5
TAGAATAGCCGATGAA-1_V12D07-335_B1,0,4,0,0,0,4
GGTCTCCGTCCAGGTT-1_V12D07-335_B1,0,1,4,0,0,5
TAATTACGTCAGTAGA-1_V12D07-335_B1,3,3,0,0,0,6
TACGTAAAGCGGAGTG-1_V12D07-335_B1,0,2,0,0,0,2
GCTACAATCGAGGATA-1_V12D07-335_B1,2,1,1,0,0,4
TCAGCCAATCCGTAAA-1_V12D07-335_B1,1,1,0,0,0,2
ATCATAGCCCTATGTA-1_V12D07-335_B1,0,1,0,0,0,1
GAGGCCTGTTGATACA-1_V12D07-335_B1,1,1,0,0,0,2
ATATACGCTCGTGACG-1_V12D07-335_B1,0,0,0,0,0,0
CCCTTTAATGGAGTTC-1_V12D07-335_B1,2,0,0,0,0,2
TTACACGATCTGCGAC-1_V12D07-335_B1,0,3,0,0,0,3
TCGCATAAAGGGCGCA-1_V12D07-335_B1,0,0,0,0,0,0
TGTAGCCATCCCATTC-1_V12D07-335_B1,1,0,0,0,0,1
GGGTCTATCGCTTTCC-1_V12D07-335_B1,2,2,0,0,0,4
GGAGGGTCAAGTAAGA-1_V12D07-335_B1,0,1,0,0,0,1
TACGGCATGGACGCTA-1_V12D07-335_B1,0,1,0,0,0,1
CACGTCAATCAATGGA-1_V12D07-335_B1,0,0,0,0,0,0
CGCTTGGACGGATAGA-1_V12D07-335_B1,1,1,0,0,0,2
CGCGGTACGGTATACA-1_V12D07-335_B1,0,0,0,0,0,0
CCTACTCAACACGATT-1_V12D07-335_B1,1,3,0,0,0,4
CGTTTGGTGTTGTGGG-1_V12D07-335_B1,2,1,0,0,0,3
GTTGTTGCAAGATGGC-1_V12D07-335_B1,0,0,0,0,0,0
CATTCGTCGTAGCGGT-1_V12D07-335_B1,0,2,0,0,0,2
CAGCCTCGATAGCGGT-1_V12D07-335_B1,1,1,0,0,0,2
TCATAAGTCCAAGAAG-1_V12D07-335_B1,1,2,0,0,0,3
AAAGTGCCATCAATTA-1_V12D07-335_B1,1,1,0,0,0,2
GTTGCAGTCGACAACA-1_V12D07-335_B1,0,1,0,0,0,1
TAAATGGGCTACTGAG-1_V12D07-335_B1,0,1,0,0,0,1
GGACAAGCCATGATCG-1_V12D07-335_B1,1,1,0,0,0,2
TCCAATGCGTCGCCGC-1_V12D07-335_B1,2,0,0,0,0,2
AAAGAATGACCTTAGA-1_V12D07-335_B1,1,0,0,0,0,1
CCTATTATTCCGGCCG-1_V12D07-335_B1,2,0,0,0,0,2
CAGTAAGGGACGTCTC-1_V12D07-335_B1,0,2,0,1,0,3
GGGATGGACCCGCGTC-1_V12D07-335_B1,2,0,0,0,0,2
GACGCATACCCGTCGG-1_V12D07-335_B1,1,0,0,0,1,2
GGGCAGGATTTCTGTG-1_V12D07-335_B1,1,1,0,0,0,2
TATCTGAGCCGATATT-1_V12D07-335_B1,1,0,0,0,0,1
AATGTATGGCACTGTA-1_V12D07-335_B1,1,0,0,0,0,1
GCCTTTGTCAGTGGAC-1_V12D07-335_B1,3,1,0,0,0,4
AACCATAGGGTTGAAC-1_V12D07-335_B1,1,0,0,0,0,1
AAACTTAATTGCACGC-1_V12D07-335_B1,2,1,1,0,1,5
TAGGCGGCTGCAAAGA-1_V12D07-335_B1,2,0,0,0,0,2
TCCATCAATACTAATC-1_V12D07-335_B1,1,0,0,1,0,2
ACCTCGAACTTATGCT-1_V12D07-335_B1,1,3,0,0,0,4
ACAAACCATGCGTCCT-1_V12D07-335_B1,0,0,0,0,0,0
ACACCGGTCTGACCGC-1_V12D07-335_B1,0,1,0,0,0,1
ATGGCAGCATTACGAT-1_V12D07-335_B1,0,0,0,0,0,0
CTGGTGAATGGGCCTA-1_V12D07-335_B1,1,0,0,0,0,1
CACAGAGACGAGGACG-1_V12D07-335_B1,0,0,0,0,0,0
GCACAAACCCTAGATG-1_V12D07-335_B1,0,0,0,1,0,1
ACTATGTCCAGCTGCC-1_V12D07-335_B1,1,1,0,1,0,3
AAGCCGCCGTGAAATC-1_V12D07-335_B1,0,4,0,0,0,4
ATGGGTGTATACCTCC-1_V12D07-335_B1,0,0,0,0,0,0
TAAGCGCGAATCAAAT-1_V12D07-335_B1,3,2,1,0,0,6
AGCCCGGCATTAGAGG-1_V12D07-335_B1,0,0,0,0,0,0
GTGATCAAGCGTGCAC-1_V12D07-335_B1,0,1,0,0,0,1
CTGCCTTTAATACCTT-1_V12D07-335_B1,0,0,0,0,0,0
TACCTCCACACCAATG-1_V12D07-335_B1,1,0,0,0,0,1
GAGCATCAACAACTTG-1_V12D07-335_B1,3,1,0,0,0,4
CATACGAACTAGCTGG-1_V12D07-335_B1,3,0,0,0,0,3
GGGAACGGTTTCAGAT-1_V12D07-335_B1,0,1,0,0,0,1
AGGGTGCCGTTCTTTA-1_V12D07-335_B1,1,0,0,1,0,2
ACGACTGGTCATACTC-1_V12D07-335_B1,0,0,1,1,0,2
GGATCTTACTGCCCTT-1_V12D07-335_B1,0,1,0,0,0,1
TACTCCTCTAGTTGAC-1_V12D07-335_B1,4,1,0,0,1,6
GTAGCTCCGGGAGGCT-1_V12D07-335_B1,2,2,0,0,0,4
GGACTCGTGAGTGGTC-1_V12D07-335_B1,0,2,0,0,0,2
GTAGTTCGAAGGCGAA-1_V12D07-335_B1,1,1,0,0,0,2
CTCAAACCACTGCCCG-1_V12D07-335_B1,0,1,0,0,0,1
GAGGGAGTCAGATCGC-1_V12D07-335_B1,1,2,0,0,2,5
GCGTCCCTAAGACATA-1_V12D07-335_B1,1,1,0,0,0,2
TCTCTTACCGCGAACC-1_V12D07-335_B1,0,4,0,0,3,7
GGCTACTATACACTCC-1_V12D07-335_B1,5,0,0,0,3,8
CGTTGCCCGCGTGGGA-1_V12D07-335_B1,4,2,1,0,1,8
TATAGAGTCGCTTGAA-1_V12D07-335_B1,0,0,1,0,0,1
ATGTTGTAGTCTGTTT-1_V12D07-335_B1,2,1,0,0,0,3
AGTATACACAGCGACA-1_V12D07-335_B1,2,1,0,0,0,3
TGTGGTTGCTAAAGCT-1_V12D07-335_B1,0,0,0,0,0,0
TGATTCCCGGTTACCT-1_V12D07-335_B1,1,0,0,0,0,1
CACTGACGATTGTGGA-1_V12D07-335_B1,4,1,0,1,0,6
AACATTGTGACTCGAG-1_V12D07-335_B1,0,0,0,0,0,0
GTCCAATATTTAGCCT-1_V12D07-335_B1,1,0,1,0,0,2
GCTCTTTCCGCTAGTG-1_V12D07-335_B1,0,3,0,0,0,3
GGGTCAGGAGCTAGAT-1_V12D07-335_B1,2,1,0,0,0,3
AGGTGGTGACCTTCGC-1_V12D07-335_B1,0,1,0,0,0,1
CCCGGGTCGTTCAGGG-1_V12D07-335_B1,1,0,0,0,0,1
AGCCAAGCTTTGTGTC-1_V12D07-335_B1,2,1,1,0,0,4
TGTGGCGGGCTTCTGG-1_V12D07-335_B1,0,1,0,1,0,2
CGAGGGTATCCAGGTG-1_V12D07-335_B1,0,0,1,0,0,1
CGTTCAGACCCGCGAA-1_V12D07-335_B1,2,0,0,1,0,3
TCATATGAGCTTTGTT-1_V12D07-335_B1,2,0,0,0,0,2
AGTTGACGGTCCTTGC-1_V12D07-335_B1,0,1,0,0,0,1
ATAATTAGCTAAGTAG-1_V12D07-335_B1,2,0,0,0,1,3
GGTCTTGAGCGCTCTT-1_V12D07-335_B1,1,1,0,0,0,2
CGTTGTCGGCAATTGA-1_V12D07-335_B1,0,0,0,0,0,0
TCTTGCTCCCGATACT-1_V12D07-335_B1,0,0,0,0,0,0
AGCAGAAGGAGAAAGA-1_V12D07-335_B1,0,0,0,0,0,0
GAAGCCACTGATTATG-1_V12D07-335_B1,1,0,0,0,0,1
TGCTCTTGAGAGTTTG-1_V12D07-335_B1,2,0,0,0,0,2
GACATCCGTCGAACTG-1_V12D07-335_B1,4,1,0,0,0,5
AGATATAATACGACTA-1_V12D07-335_B1,1,0,0,0,0,1
TCGCTACTGGCTTTGA-1_V12D07-335_B1,0,0,0,1,0,1
GTGACAGCTTCCCACT-1_V12D07-335_B1,0,0,0,0,0,0
GTGACGCAGGTTTCAT-1_V12D07-335_B1,2,0,0,0,0,2
GGGAAGACGGTCTGTC-1_V12D07-335_B1,2,0,0,0,0,2
CGTCGCATGTGAGCCA-1_V12D07-335_B1,0,0,1,0,0,1
AGAAGGTTGTAGGTCG-1_V12D07-335_B1,3,0,0,0,0,3
GGCCGGCGTCTGCTAT-1_V12D07-335_B1,0,0,0,0,0,0
TTGACCAGGAACAACT-1_V12D07-335_B1,0,0,0,0,0,0
AGTCGTATAAAGCAGA-1_V12D07-335_B1,0,2,0,0,0,2
GGCGTAGGGAAAGCTG-1_V12D07-335_B1,0,0,0,0,0,0
AAACCTAAGCAGCCGG-1_V12D07-335_B1,1,0,0,0,0,1
ATTGCCTTTATGTTTG-1_V12D07-335_B1,0,1,1,0,0,2
CAGGCAGTCTTACCAG-1_V12D07-335_B1,1,0,2,0,0,3
AGCTAAGTACGCAGGC-1_V12D07-335_B1,0,1,0,0,0,1
AAATCCGATACACGCC-1_V12D07-335_B1,1,1,0,0,0,2
CGAGAGCTTTCACTAC-1_V12D07-335_B1,2,1,0,0,0,3
CGCCCAGCGTTTCACG-1_V12D07-335_B1,1,3,0,0,0,4
TTAAGTATTGTTATCC-1_V12D07-335_B1,1,0,0,0,0,1
AAACGGGCGTACGGGT-1_V12D07-335_B1,0,1,1,0,0,2
GTATCCTTTGGTAACC-1_V12D07-335_B1,0,2,0,0,0,2
CATAGTCAAATACATA-1_V12D07-335_B1,6,2,0,0,0,8
TCTATGCTATAACGAC-1_V12D07-335_B1,0,4,1,0,0,5
ACGTTCTGTACAAGTC-1_V12D07-335_B1,1,3,2,0,0,6
CGCGAAGTGGCATACT-1_V12D07-335_B1,0,1,0,0,0,1
ACCAACCGCACTCCAC-1_V12D07-335_B1,0,4,1,0,0,5
GTCATGCGCGAGGGCT-1_V12D07-335_B1,1,3,1,0,0,5
TAGGCTAAAGTGGCAC-1_V12D07-335_B1,0,1,1,0,0,2
TGGCTACACTCTACCT-1_V12D07-335_B1,2,1,0,0,0,3
TGTCCACGGCTCAACT-1_V12D07-335_B1,1,3,0,0,0,4
AATTGCAGCAATCGAC-1_V12D07-335_B1,1,0,0,0,0,1
GTCAACCAGGCCTATA-1_V12D07-335_B1,0,2,0,0,0,2
ATCTTATCGCACACCC-1_V12D07-335_B1,0,2,0,0,0,2
GTCTATTGCATGCTCG-1_V12D07-335_B1,2,4,0,0,0,6
GCACGTGGTTTACTTA-1_V12D07-335_B1,1,2,0,0,0,3
ATTCGCGCCTTGAGAG-1_V12D07-335_B1,1,3,1,0,0,5
AGCGATGCGCCTAATA-1_V12D07-335_B1,0,0,0,0,0,0
TCTATAGGTGGGTAAT-1_V12D07-335_B1,0,0,0,0,0,0
AGATACCAATAGAACC-1_V12D07-335_B1,0,0,0,0,0,0
CGTGTATGGGAGCTGA-1_V12D07-335_B1,0,2,0,0,0,2
ATGTACATGCGGTGAG-1_V12D07-335_B1,1,0,0,0,0,1
TTGGCTCAATATGTGT-1_V12D07-335_B1,0,3,0,0,0,3
GTTCGGAGCACTCAAC-1_V12D07-335_B1,1,2,0,0,0,3
TCCCTCTTCTCAAGGG-1_V12D07-335_B1,1,2,0,0,0,3
TTACGTATCTATGACA-1_V12D07-335_B1,0,2,0,0,0,2
CCCATATAGGTCGATT-1_V12D07-335_B1,0,1,0,0,0,1
GTCCACGTCGCATTCG-1_V12D07-335_B1,0,3,0,0,1,4
AATTGTGGTTGCCAAA-1_V12D07-335_B1,0,0,0,0,0,0
AGGAACGAACGACTTC-1_V12D07-335_B1,2,0,0,0,0,2
TAATTCCAATGCTTCA-1_V12D07-335_B1,2,1,0,0,0,3
AGGGCCCTAATGTTCT-1_V12D07-335_B1,1,3,0,0,0,4
AGGTGTTGCCGACCAC-1_V12D07-335_B1,0,0,0,0,0,0
CTGAGAGTAGAAATAC-1_V12D07-335_B1,3,1,0,1,0,5
TAGAAGAAGGGTTACA-1_V12D07-335_B1,1,3,0,0,0,4
GGTGACTGATAGAGAG-1_V12D07-335_B1,1,0,0,0,0,1
TACCCTCGGTAACCCT-1_V12D07-335_B1,2,0,0,0,0,2
TGTAAGACTGATAAGA-1_V12D07-335_B1,0,1,0,0,0,1
GTCACTCATGAGCGAT-1_V12D07-335_B1,1,0,0,0,0,1
CGGTTTACTGAACATT-1_V12D07-335_B1,2,1,0,0,1,4
GAGATCGATCTTACTC-1_V12D07-335_B1,3,0,0,1,0,4
TCTTTCATCCGTCCTT-1_V12D07-335_B1,1,2,0,1,0,4
TCGGATCTGGATGACC-1_V12D07-335_B1,1,1,0,1,0,3
GTCCTAGGATACCTTA-1_V12D07-335_B1,2,0,1,1,0,4
TGTACCCGACCCTAAT-1_V12D07-335_B1,0,0,0,0,0,0
AGGTTCTCCTTTCCGG-1_V12D07-335_B1,0,0,0,0,0,0
AATTGCGTGGATTACA-1_V12D07-335_B1,0,0,0,0,0,0
CGATAGCGATACAGTG-1_V12D07-335_B1,3,2,0,0,0,5
CGCCCTAATTGTTCAA-1_V12D07-335_B1,0,0,0,0,2,2
ATTATGAGACCCAATT-1_V12D07-335_B1,0,0,0,0,0,0
CCTCCTAGCTAGAGTC-1_V12D07-335_B1,2,0,0,0,0,2
CGAAGGGTTTCAGATT-1_V12D07-335_B1,0,1,0,0,0,1
CACAAGCTAAGAAAGG-1_V12D07-335_B1,1,0,0,0,0,1
CACCGGTAGAGACATT-1_V12D07-335_B1,2,0,0,0,0,2
ACTCATGGCAGCCTTC-1_V12D07-335_B1,1,0,0,0,0,1
CATCCAATATAGTTTG-1_V12D07-335_B1,2,3,0,0,0,5
CAGATATGAAGATGAC-1_V12D07-335_B1,2,0,0,0,0,2
GCAAAGGGCGTTAGCC-1_V12D07-335_B1,2,0,0,0,0,2
CTGTTGTTCAGTCGTA-1_V12D07-335_B1,1,2,0,0,1,4
AAAGGCCCTATAATAC-1_V12D07-335_B1,1,2,0,0,0,3
AACATTGAAGTTGATC-1_V12D07-335_B1,1,1,0,0,0,2
GCTAGCGATAGGTCTT-1_V12D07-335_B1,0,2,0,0,0,2
ATTGCCTATTAGACCG-1_V12D07-335_B1,2,4,0,0,0,6
GGGCGTTTACATTCAT-1_V12D07-335_B1,1,1,0,0,0,2
CCTCTACAAGGATTGG-1_V12D07-335_B1,0,1,0,0,0,1
AGTGACTGTGACACAA-1_V12D07-335_B1,1,1,1,0,0,3
AGCCCTCCCTGGTGGC-1_V12D07-335_B1,2,0,0,1,0,3
CGGTTGAGTATCCTTC-1_V12D07-335_B1,0,0,0,0,0,0
CATTATCCCATTAACG-1_V12D07-335_B1,1,0,0,0,0,1
AATGTGCTAATCTGAG-1_V12D07-335_B1,1,3,0,0,0,4
CTTAGTTGAGGAATCG-1_V12D07-335_B1,1,3,0,0,0,4
CTTCTGGGCGTACCTA-1_V12D07-335_B1,1,3,1,0,0,5
AGTCAAATGATGTGAT-1_V12D07-335_B1,2,4,0,0,0,6
TGAACAAGCAGGGACT-1_V12D07-335_B1,0,2,0,0,0,2
AATACCGGAGGGCTGT-1_V12D07-335_B1,1,2,0,0,1,4
GTTTGGTGATCGGTGC-1_V12D07-335_B1,0,0,0,0,0,0
GACTGCTGGTGAGAAA-1_V12D07-335_B1,0,1,0,0,1,2
CGATCCTCGCAACATA-1_V12D07-335_B1,1,1,0,0,3,5
CCAACCTTATGTAACT-1_V12D07-335_B1,1,2,0,0,0,3
CGTGGTACCCAAAGGC-1_V12D07-335_B1,1,2,0,0,1,4
AACCCGACAACCCGTG-1_V12D07-335_B1,2,2,0,1,0,5
TATGTAAAGTGCTTAA-1_V12D07-335_B1,0,0,0,0,2,2
GCAAGTGTAAAGCATG-1_V12D07-335_B1,0,1,0,0,3,4
GTAACTGCCCAAGGAG-1_V12D07-335_B1,0,0,0,0,3,3
GGTGCATAAATGATTA-1_V12D07-335_B1,1,5,0,1,3,10
TAGTCCCGGAGACCAC-1_V12D07-335_B1,0,2,0,0,2,4
CGGCCAGAGCGACCAT-1_V12D07-335_B1,1,1,0,0,1,3
TGAATGAGTGTTTCCC-1_V12D07-335_B1,0,1,0,1,1,3
TTCACTTCCTAGAACG-1_V12D07-335_B1,0,1,0,0,1,2
CGCTTAGTATTGATAC-1_V12D07-335_B1,1,2,0,0,0,3
AACGCGACCTTGGGCG-1_V12D07-335_B1,1,1,0,0,0,2
GTGCACCAGCTTCAAC-1_V12D07-335_B1,1,0,0,0,0,1
TTCTATTAAACGCAGC-1_V12D07-335_B1,1,0,0,0,0,1
TGGCAAGCACAAGTCG-1_V12D07-335_B1,1,1,0,0,0,2
ATCTGCTGTTATCGCC-1_V12D07-335_B1,0,2,1,0,0,3
AATTCCAAGCATGTAC-1_V12D07-335_B1,2,1,0,0,0,3
AAACGGTTGCGAACTG-1_V12D07-335_B1,0,0,0,0,0,0
GAAGGAGTCGAGTGCG-1_V12D07-335_B1,0,0,0,0,0,0
GGCAAGCCCATAGTGG-1_V12D07-335_B1,2,0,0,1,0,3
TGACCAAATCTTAAAC-1_V12D07-335_B1,3,3,0,0,0,6
TTCGGTACTGTAGAGG-1_V12D07-335_B1,0,3,0,0,0,3
ATGTACGATGACGTCG-1_V12D07-335_B1,2,2,0,1,0,5
ATCTAGCTTGTGAGGG-1_V12D07-335_B1,0,2,0,0,0,2
AGCGGGTCTGACACTC-1_V12D07-335_B1,1,0,0,1,0,2
GAGGTACGCGTGTCCC-1_V12D07-335_B1,0,0,0,0,0,0
GCACTGCCTACCTTTA-1_V12D07-335_B1,0,1,0,0,0,1
GGAGCGAGGCCTACTT-1_V12D07-335_B1,1,0,0,0,0,1
AAACTCGGTTCGCAAT-1_V12D07-335_B1,2,1,0,1,0,4
GGCGCTTCATTCCCTG-1_V12D07-335_B1,1,0,0,0,0,1
TGCTCGGTGGGTCACC-1_V12D07-335_B1,1,0,0,0,0,1
AAGCGCAGGGCTTTGA-1_V12D07-335_B1,0,0,1,0,0,1
GACCTTCCACGTCTAC-1_V12D07-335_B1,0,0,0,0,0,0
GTTAGCCCATGACATC-1_V12D07-335_B1,2,0,0,0,0,2
AATTCGATTCGAGGAT-1_V12D07-335_B1,2,0,0,0,0,2
AGTCTTTAAAGTGTCC-1_V12D07-335_B1,1,0,0,0,0,1
GACTAGGCCGTTAGGT-1_V12D07-335_B1,0,0,0,0,0,0
TCCAAGCCTAGACACA-1_V12D07-335_B1,0,0,0,0,0,0
GATTGGGAAAGGTTGT-1_V12D07-335_B1,0,0,0,0,0,0
GATGAGGAACCTTCGG-1_V12D07-335_B1,2,0,0,0,0,2
TGAATACCGACGCGTA-1_V12D07-335_B1,0,1,0,0,0,1
AATCGTGAGCCGAGCA-1_V12D07-335_B1,0,0,0,0,0,0
GCGAAGAATCTGACGG-1_V12D07-335_B1,2,0,0,0,0,2
GAACAACTGGGATGAA-1_V12D07-335_B1,1,0,0,0,0,1
TCGCCGACATATTCGC-1_V12D07-335_B1,3,1,0,0,0,4
CGTAGAGAGTAATTAT-1_V12D07-335_B1,0,1,0,0,0,1
CGATAGTCGTACTGCA-1_V12D07-335_B1,1,1,0,0,0,2
CGCATGCCGAATGCGT-1_V12D07-335_B1,0,1,0,0,0,1
CTCTAGCCCTCGGAAA-1_V12D07-335_B1,2,0,0,0,0,2
TCCAACTCAGCTATCT-1_V12D07-335_B1,2,1,0,0,0,3
GTCTAGTGAGCCGCTT-1_V12D07-335_B1,3,1,0,0,0,4
TACCGAATAATTGTAA-1_V12D07-335_B1,4,2,1,0,0,7
ATATAACACGGGCGCA-1_V12D07-335_B1,1,5,2,0,0,8
GCATGCTAATAACGAT-1_V12D07-335_B1,1,4,0,1,0,6
TCCGGGCTTGACGGGA-1_V12D07-335_B1,0,4,0,0,0,4
ATTATTCAGAGTCACT-1_V12D07-335_B1,0,1,0,0,0,1
TAGCAGTATGACTAAA-1_V12D07-335_B1,1,5,0,0,0,6
TATGAAGAATTAAGGT-1_V12D07-335_B1,0,1,0,0,0,1
CAAGGCCAGTGGTGCA-1_V12D07-335_B1,1,0,1,0,0,2
TGCGTACGGCTAATTG-1_V12D07-335_B1,0,2,0,0,0,2
CAGATAATGGGCGGGT-1_V12D07-335_B1,0,1,1,0,0,2
GAGAACGGTTCTGACT-1_V12D07-335_B1,1,3,0,0,0,4
CGCTTCGGTCTAAGAC-1_V12D07-335_B1,0,3,0,0,0,3
AGCATTACGAGGCAAG-1_V12D07-335_B1,0,1,0,0,0,1
AAGTTGTGATGTTATA-1_V12D07-335_B1,1,0,0,0,0,1
TTGCTCATAGTACGTG-1_V12D07-335_B1,0,1,0,0,0,1
TACTTAAACATGTACA-1_V12D07-335_B1,4,3,0,0,0,7
AGTGAGTCGAATTAAC-1_V12D07-335_B1,0,1,1,0,0,2
TAGGCCTATATAGTCT-1_V12D07-335_B1,2,2,0,0,0,4
ACTCGCCGTTCGATAA-1_V12D07-335_B1,1,2,0,0,0,3
GGTACGTTGCGGCCGG-1_V12D07-335_B1,0,0,0,0,0,0
TATTGCCGGGCTTGTA-1_V12D07-335_B1,0,1,0,0,0,1
GGTAAACTCTGCGCTG-1_V12D07-335_B1,1,1,0,0,0,2
TCCCTTGTCTGAAACT-1_V12D07-335_B1,2,2,0,0,0,4
CATGATCGCTTTGAGA-1_V12D07-335_B1,1,0,0,0,0,1
GAGAGGCCTATGTGTA-1_V12D07-335_B1,0,0,0,0,0,0
CGTATCTAGAACTAAG-1_V12D07-335_B1,1,3,0,0,0,4
GCACCTTCCCGAAGGT-1_V12D07-335_B1,2,2,0,0,0,4
TACCTCTTTACCATCC-1_V12D07-335_B1,0,1,1,0,0,2
TGACTCTAACTGGTAA-1_V12D07-335_B1,0,4,0,0,0,4
GAGAAACTGGATCCCA-1_V12D07-335_B1,1,0,0,0,0,1
ATCCGGACCAGCCTGA-1_V12D07-335_B1,0,0,0,0,0,0
TTATTTAGGTTCCTTA-1_V12D07-335_B1,0,4,0,0,0,4
CGAATTCCCGGTTCAA-1_V12D07-335_B1,1,4,0,0,0,5
TAGTTTGATCGGTCGC-1_V12D07-335_B1,1,0,0,0,0,1
AGTCGAAACGATTCAG-1_V12D07-335_B1,0,3,0,0,0,3
ACGTCGGGCAACTCGG-1_V12D07-335_B1,0,2,0,1,0,3
ACTTGCTCTATCTACC-1_V12D07-335_B1,0,0,0,0,0,0
ATTACGGGCTACGGTT-1_V12D07-335_B1,2,2,1,1,0,6
GCAAACGTAAGCGACC-1_V12D07-335_B1,1,1,0,0,0,2
TTCGGACTGGGCATGG-1_V12D07-335_B1,1,3,0,0,0,4
GGGCCATTCGTGCTGG-1_V12D07-335_B1,0,1,1,0,0,2
GAGTTGTCACCAGTCT-1_V12D07-335_B1,1,1,0,0,2,4
AGTAATTTGCAAGCGT-1_V12D07-335_B1,1,4,0,1,0,6
GTGGCCGGTTTCTCGG-1_V12D07-335_B1,2,0,0,0,0,2
ATCTTAGGGCATTAAT-1_V12D07-335_B1,1,1,0,0,1,3
CTACATATCGCGGGAC-1_V12D07-335_B1,3,2,0,1,1,7
ATGGTATTTACTGATT-1_V12D07-335_B1,0,0,0,0,0,0
CCGTCAACCTCTGGCG-1_V12D07-335_B1,2,0,0,0,0,2
GCTTCGACGTTCAATC-1_V12D07-335_B1,0,0,0,0,0,0
GACCGATTAAATATGT-1_V12D07-335_B1,4,2,0,1,0,7
GTCGAATTTGGGCGCT-1_V12D07-335_B1,3,0,0,0,0,3
TCACGGCCCAAGAGAG-1_V12D07-335_B1,2,0,0,0,0,2
CTACGATCCTATCCTA-1_V12D07-335_B1,1,1,0,0,0,2
TGCAGTGGTAGGGAAC-1_V12D07-335_B1,0,0,0,2,0,2
TTGCCTAATCCAAAGT-1_V12D07-335_B1,0,1,0,0,0,1
AGCGAGACGTGAAGGC-1_V12D07-335_B1,0,1,0,0,0,1
TTCTACCTCAATCGGT-1_V12D07-335_B1,1,2,0,1,0,4
TACGCTGCTGTGTTAA-1_V12D07-335_B1,1,0,0,0,0,1
TAGTCCTGCACTAAGC-1_V12D07-335_B1,1,1,0,0,0,2
AGCACACGTTTAGACT-1_V12D07-335_B1,0,2,0,0,0,2
GTTCGACAATTGTATA-1_V12D07-335_B1,2,2,0,0,0,4
CCATGTTCATCTATAT-1_V12D07-335_B1,0,1,0,0,0,1
CCCTCGATAATACACA-1_V12D07-335_B1,0,0,0,0,1,1
ACTGCCCGCCATTCTC-1_V12D07-335_B1,3,0,1,0,0,4
CTATATCCAGCCTGGC-1_V12D07-335_B1,1,3,0,2,2,8
CGCACGTCTGTTTATG-1_V12D07-335_B1,0,6,0,0,1,7
AATCAGGTTTCATTTA-1_V12D07-335_B1,2,2,0,0,0,4
AGAGAAACACCAGAAA-1_V12D07-335_B1,1,0,0,0,0,1
ACCCGATTGGTTCCGA-1_V12D07-335_B1,0,1,0,0,0,1
TACCAGGAATCCCGTC-1_V12D07-335_B1,2,3,0,0,1,6
AAGTGCTTCTCTATTG-1_V12D07-335_B1,1,3,0,0,0,4
TGCATGTGACCCATAG-1_V12D07-335_B1,0,2,0,0,0,2
TAGATTCAAAGTGCGG-1_V12D07-335_B1,1,2,0,1,0,4
AGGGTCAGAGCACTCG-1_V12D07-335_B1,0,1,0,2,0,3
GTGAGATAACCTTATA-1_V12D07-335_B1,2,3,1,0,0,6
GTGTCAGTGTACGTGG-1_V12D07-335_B1,0,2,0,0,1,3
CTGTAGTGAGGATCGA-1_V12D07-335_B1,1,4,0,0,1,6
GATAGTGCGAGTAAGT-1_V12D07-335_B1,1,2,0,0,1,4
AGGGTTCAGACGGTCC-1_V12D07-335_B1,2,3,0,1,1,7
GGACTCGACAGCGCAT-1_V12D07-335_B1,2,2,0,0,2,6
CACTCTCAAGCATCGA-1_V12D07-335_B1,3,1,0,0,1,5
GAGCGGAATGCGGTGT-1_V12D07-335_B1,2,0,0,1,2,5
CAGTTCGAGGACCCGA-1_V12D07-335_B1,0,0,0,0,3,3
CGTAACTTCGACACTT-1_V12D07-335_B1,3,3,0,0,0,6
TGATCACCACACTGAC-1_V12D07-335_B1,0,1,0,0,0,1
CATACTTCTTTCTCCG-1_V12D07-335_B1,2,0,0,0,1,3
CAAGTAAGTGATAGAC-1_V12D07-335_B1,0,0,0,0,2,2
AGCCCGCAACAAGCAG-1_V12D07-335_B1,5,0,0,0,0,5
GCTCCATGCAAAGCAA-1_V12D07-335_B1,0,3,0,0,0,3
TCGTACCGACGTCAAG-1_V12D07-335_B1,1,1,0,0,0,2
ATTATCGGAATGTACG-1_V12D07-335_B1,2,1,0,1,0,4
ACCTACTATAAATCTA-1_V12D07-335_B1,2,1,0,0,0,3
TATCCTATCAACTGGT-1_V12D07-335_B1,4,2,0,0,1,7
GCGCGGTCTAGTAACT-1_V12D07-335_B1,5,4,0,1,0,10
CCTTCGTATAGAATCC-1_V12D07-335_B1,1,1,0,0,0,2
TGGGCGATACAATAAG-1_V12D07-335_B1,0,0,0,0,0,0
TGACATGTAACGTGAC-1_V12D07-335_B1,0,1,0,0,0,1
TTGGGAAGACGAGCCG-1_V12D07-335_B1,2,0,0,0,0,2
GGTGTAAATCGATTGT-1_V12D07-335_B1,1,1,0,0,0,2
GAACTGTGGAGAGACA-1_V12D07-335_B1,0,1,0,2,0,3
TCCACATCGTATATTG-1_V12D07-335_B1,2,0,0,0,0,2
CCTATGGTCAAAGCTG-1_V12D07-335_B1,0,1,0,0,0,1
TCCTTGTCCTTTAATT-1_V12D07-335_B1,0,0,0,0,0,0
AAGTTTATGGGCCCAA-1_V12D07-335_B1,1,0,0,0,0,1
GTCCGGGTTCACATTA-1_V12D07-335_B1,1,0,1,0,0,2
ATGTAGCGCGCGTAGG-1_V12D07-335_B1,2,0,1,1,0,4
TACGGAAGCCAAACCA-1_V12D07-335_B1,1,0,1,0,0,2
GCCCTGAGGATGGGCT-1_V12D07-335_B1,2,0,0,0,0,2
CGGGCGATGGATCACG-1_V12D07-335_B1,1,0,1,0,0,2
TGCGGACTTGACTCCG-1_V12D07-335_B1,1,0,0,0,0,1
TAATACTAGAACAGAC-1_V12D07-335_B1,0,0,0,0,0,0
TCGCTGCCAATGCTGT-1_V12D07-335_B1,0,0,0,0,0,0
TACGTGGGCCCAGGGC-1_V12D07-335_B1,0,0,0,0,0,0
GCCTACGTTCTGTGCA-1_V12D07-335_B1,1,0,0,0,0,1
TTGCGTGTGTAGGCAT-1_V12D07-335_B1,1,0,0,0,0,1
TCCTAAAGATTCAGAC-1_V12D07-335_B1,2,0,0,0,0,2
TGGGTGCACAAGCCAT-1_V12D07-335_B1,0,0,1,0,0,1
GGGAGCGACCGTAGTG-1_V12D07-335_B1,1,0,0,1,0,2
CATAGAGGAGATACTA-1_V12D07-335_B1,1,2,0,0,0,3
CTTCGATTGCGCAAGC-1_V12D07-335_B1,1,1,0,0,0,2
GTGCCTGAGACCAAAC-1_V12D07-335_B1,6,0,0,0,0,6
TCATCCTCAGCTGCTT-1_V12D07-335_B1,1,0,0,0,0,1
TGCAACTACTGGTTGA-1_V12D07-335_B1,2,0,0,0,0,2
ATGTTGATTAGAGACT-1_V12D07-335_B1,1,3,0,0,0,4
GTTTCTAGAGGCGCGG-1_V12D07-335_B1,1,1,0,0,0,2
TACAAGGGCTTCTTTA-1_V12D07-335_B1,1,0,0,0,0,1
ACAGGCACGGATCCTT-1_V12D07-335_B1,1,0,0,0,0,1
CCCAAGTCATTACACT-1_V12D07-335_B1,0,4,1,0,0,5
ACTCTGACCTAATAGA-1_V12D07-335_B1,2,1,0,0,0,3
GGATGGCTTGAAGTAT-1_V12D07-335_B1,0,1,1,0,0,2
ACCCTCCCGTCAGGGC-1_V12D07-335_B1,1,2,0,0,0,3
AGCTTCTTCTCGAGCA-1_V12D07-335_B1,0,2,0,0,0,2
TTGCGCTTGATCAATA-1_V12D07-335_B1,0,3,1,0,0,4
TGGGTGTAATAGATTT-1_V12D07-335_B1,1,2,0,0,0,3
CATGGTTTATTAATCA-1_V12D07-335_B1,1,0,0,0,0,1
TTGCCTTCTCGCCGGG-1_V12D07-335_B1,2,0,0,0,0,2
TTAAAGTAAGTCGCCA-1_V12D07-335_B1,2,4,0,0,0,6
AGTTGGCAAGGCTAGA-1_V12D07-335_B1,2,0,0,0,0,2
CCGCACTTGCAATGAC-1_V12D07-335_B1,0,2,0,0,0,2
AATGTTGTCGTGAGAC-1_V12D07-335_B1,1,0,0,0,0,1
CCAAGGTTGCCCTTTC-1_V12D07-335_B1,1,2,0,0,0,3
TGTGACTAGAGTTTGC-1_V12D07-335_B1,2,0,0,0,0,2
TTGTGATCTGTTCAGT-1_V12D07-335_B1,1,6,0,0,0,7
GGAGTTGATTCTGTGT-1_V12D07-335_B1,0,0,0,0,0,0
GTAGTGAGCAACCTCA-1_V12D07-335_B1,0,0,0,0,0,0
AAGACATACGTGGTTT-1_V12D07-335_B1,2,3,0,0,0,5
CATCCCGAGATTCATA-1_V12D07-335_B1,0,4,0,0,0,4
GGCCGCAGGAACCGCA-1_V12D07-335_B1,2,3,0,0,0,5
AGGACATCGGCACACT-1_V12D07-335_B1,1,1,1,0,0,3
GACAAGACGCCCGTGC-1_V12D07-335_B1,0,2,0,0,0,2
GAGTAAATTAAGAACC-1_V12D07-335_B1,1,0,0,0,0,1
TAAGTCGGTGAGCTAG-1_V12D07-335_B1,0,4,0,0,0,4
CTTACTGACTCCTCTG-1_V12D07-335_B1,1,2,0,3,0,6
TTAACTGATCGTTTGG-1_V12D07-335_B1,0,1,0,0,1,2
GGGCGATCCATAGGCC-1_V12D07-335_B1,1,1,0,0,0,2
CGTATTGTTTGGCGCC-1_V12D07-335_B1,0,4,0,0,1,5
CGCGTGGGCCTGTGTT-1_V12D07-335_B1,0,6,0,0,0,6
AAATCTGCCCGCGTCC-1_V12D07-335_B1,2,3,0,2,0,7
GCTGAAGGGTTCTTGG-1_V12D07-335_B1,0,0,0,0,0,0
TAATTGCGCTGATTAC-1_V12D07-335_B1,0,1,0,3,0,4
TCGCGCGTTTACATGA-1_V12D07-335_B1,4,0,0,0,0,4
TAACTGAAATACGCCT-1_V12D07-335_B1,2,2,0,0,0,4
CCTGTCGTGTATGAAG-1_V12D07-335_B1,0,1,0,0,0,1
CGGGAACGCCCTGCAT-1_V12D07-335_B1,1,0,0,0,0,1
AGTTGCGGTCCTCAAC-1_V12D07-335_B1,1,0,0,0,0,1
GGGTCCTTGGAAGAAG-1_V12D07-335_B1,2,1,0,0,0,3
CGGGAAGTACCGTGGC-1_V12D07-335_B1,2,1,0,0,0,3
ACGGTCACCGAGAACA-1_V12D07-335_B1,1,1,0,0,0,2
TAGACTCAGTTGGCCT-1_V12D07-335_B1,0,0,0,0,1,1
CCTTCCGCAACGCTGC-1_V12D07-335_B1,3,1,0,0,0,4
CAGTGTTAATCTCTCA-1_V12D07-335_B1,1,0,1,0,0,2
CAGGCCAGTACCACCT-1_V12D07-335_B1,0,0,0,0,0,0
GATCGCTGTGGTGCGT-1_V12D07-335_B1,1,0,0,0,0,1
GTATCTCGGGCGCTTT-1_V12D07-335_B1,1,0,0,0,0,1
CCGGGCTAAGAATTTC-1_V12D07-335_B1,2,1,0,0,1,4
CTTCACGCCCTGGTAC-1_V12D07-335_B1,0,1,0,0,0,1
CGGATGAATGCTGTGA-1_V12D07-335_B1,3,2,0,1,0,6
CTCTGCAGGCATTCTT-1_V12D07-335_B1,3,1,0,0,0,4
TCAAAGTCACGGCGTC-1_V12D07-335_B1,0,0,0,0,0,0
TGGGTTTCGGGCGTAC-1_V12D07-335_B1,1,1,0,0,0,2
TGCTATGGCAAAGGGA-1_V12D07-335_B1,1,0,0,0,0,1
TTCACGGTCGTCACGT-1_V12D07-335_B1,2,1,0,0,0,3
CGTAAAGCAAGAAATC-1_V12D07-335_B1,0,1,0,0,0,1
CTGATCCCTTTATGCA-1_V12D07-335_B1,1,1,0,0,0,2
GAGTATACCCTAATCA-1_V12D07-335_B1,1,0,0,0,0,1
CCACGGCAGGTGTAGG-1_V12D07-335_B1,1,2,0,0,0,3
ACGTACTTTGGCACGG-1_V12D07-335_B1,0,3,0,0,0,3
CCTGAGAATAAATGCA-1_V12D07-335_B1,1,2,0,0,1,4
TTGATGCCGCTCGTCG-1_V12D07-335_B1,0,0,0,0,1,1
GCCAGGAAAGAACACT-1_V12D07-335_B1,0,1,0,0,1,2
TCCGACCGCTAATCAA-1_V12D07-335_B1,0,2,0,1,0,3
TATATCAAAGTGATCT-1_V12D07-335_B1,1,1,0,0,0,2
CCTCGGTTTCCTTGCC-1_V12D07-335_B1,1,1,0,0,3,5
TAAATTTAGTAACACC-1_V12D07-335_B1,2,0,0,1,0,3
CTCGTTACGGCTACCA-1_V12D07-335_B1,0,3,0,0,0,3
GCCGTCGGTTTCGGGC-1_V12D07-335_B1,1,1,0,1,0,3
GTTCCGTCCGCCTGCA-1_V12D07-335_B1,2,0,0,1,0,3
CTAGGGATAGGGACAA-1_V12D07-335_B1,1,0,0,0,0,1
GTCCAGGCACGTGTGC-1_V12D07-335_B1,3,3,0,0,0,6
GAGGAATATCTCTTTG-1_V12D07-335_B1,2,1,0,0,0,3
CGTTCAAGGAAACGGA-1_V12D07-335_B1,0,1,0,0,3,4
GTGGGAACAAACCGGG-1_V12D07-335_B1,2,6,0,0,0,8
GGGCACGTAGTACTGT-1_V12D07-335_B1,0,3,0,0,1,4
ACTACAAAGAGAGGTG-1_V12D07-335_B1,2,4,1,1,1,9
GGTGTAGGTAAGTAAA-1_V12D07-335_B1,1,2,0,0,2,5
CCTGTTCAACCTCGGG-1_V12D07-335_B1,2,1,0,0,0,3
TGAGGTGTGTGGCGGA-1_V12D07-335_B1,1,0,0,0,1,2
ATTGTCTGTTTCATGT-1_V12D07-335_B1,1,0,0,1,0,2
GCCGGTCGTATCTCTC-1_V12D07-335_B1,1,1,0,0,0,2
ATATGGGATAGCAACT-1_V12D07-335_B1,0,2,0,0,1,3
GATAGAACCCGCTAGG-1_V12D07-335_B1,1,3,0,1,0,5
ATCCCATTTCCGTGGG-1_V12D07-335_B1,0,3,0,0,0,3
GATGCTACCTTCGATG-1_V12D07-335_B1,0,0,0,0,0,0
TGCAAAGTTCGTCTGT-1_V12D07-335_B1,2,1,0,0,0,3
GTTCAGTCGCCAAATG-1_V12D07-335_B1,2,2,3,0,1,8
GTCTCCGCCTCAATAC-1_V12D07-335_B1,1,1,0,1,0,3
AGTAGAAGGCGCCTCA-1_V12D07-335_B1,2,0,0,0,0,2
GTTGTAGATTTATGAG-1_V12D07-335_B1,3,1,0,0,0,4
CTATTTGCTTGGAGGA-1_V12D07-335_B1,2,1,0,0,0,3
AGCCATATAGTATGTG-1_V12D07-335_B1,0,1,0,0,0,1
TGTTCCGGCCTGAGCT-1_V12D07-335_B1,1,0,0,0,0,1
TGCCGTGGGACCCAAT-1_V12D07-335_B1,0,0,0,0,0,0
TTGCAAGAAGACTCCT-1_V12D07-335_B1,1,1,0,0,0,2
CCGCTCCAGGGCGATC-1_V12D07-335_B1,1,0,0,0,0,1
CAAACCCTCCGGCGGG-1_V12D07-335_B1,3,1,0,0,0,4
CGGACCTTTACGTCCC-1_V12D07-335_B1,1,0,0,0,0,1
ACGTAGGAGAGTCGCT-1_V12D07-335_B1,0,0,0,1,0,1
CTGCGACCTCGCCGAA-1_V12D07-335_B1,1,1,0,0,0,2
GGCCCAGCTGGTTTGC-1_V12D07-335_B1,0,0,0,0,0,0
GGATTAATCATGGACC-1_V12D07-335_B1,1,0,0,0,0,1
GAGATGGCTTTAATCA-1_V12D07-335_B1,0,0,0,0,0,0
AGTACAGAAGCTTATA-1_V12D07-335_B1,0,1,0,0,0,1
GCGGCTTTAGCAAGTT-1_V12D07-335_B1,1,1,0,0,0,2
ACCGAGTCTCCTTATT-1_V12D07-335_B1,3,0,0,0,0,3
CTCGTCTGTGCCTTCG-1_V12D07-335_B1,1,0,0,0,0,1
GGACTCTTTGACTAAG-1_V12D07-335_B1,1,0,0,1,0,2
TCATCGACGACCGTCG-1_V12D07-335_B1,2,0,0,0,0,2
TACTACGTGCAATGCG-1_V12D07-335_B1,0,0,0,0,0,0
CCCTACTTGAACAATG-1_V12D07-335_B1,2,0,0,0,0,2
GCAGCTGTCAACGCAT-1_V12D07-335_B1,0,0,1,0,0,1
ATCTACCATCTGCTCC-1_V12D07-335_B1,1,0,0,0,0,1
TCTCAAATCAATCGGG-1_V12D07-335_B1,0,0,0,0,0,0
ACTCCGGCCGACCACT-1_V12D07-335_B1,1,0,0,0,0,1
TACACCTCTTCGAATC-1_V12D07-335_B1,0,0,0,0,0,0
GTGGCTGTTTCTGTTC-1_V12D07-335_B1,0,0,1,1,0,2
ACGACTCTAGGGCCGA-1_V12D07-335_B1,3,0,0,0,0,3
TCGTTTACGCGACCCT-1_V12D07-335_B1,2,1,0,0,0,3
AGGATATCCGACTGCA-1_V12D07-335_B1,0,2,0,0,0,2
GACACTTCCAATTACC-1_V12D07-335_B1,1,3,0,1,0,5
ACGGTACAGTTCAATG-1_V12D07-335_B1,1,3,0,0,0,4
CTTGATGACCATCCAG-1_V12D07-335_B1,0,5,0,0,0,5
CTGGTAAAGACTTACA-1_V12D07-335_B1,0,3,1,0,0,4
CTTGCCCACCCACGCA-1_V12D07-335_B1,0,1,0,0,0,1
CATTACGCAGGAAGGG-1_V12D07-335_B1,0,1,0,0,0,1
GGACAACCATGAAGCC-1_V12D07-335_B1,2,4,1,0,0,7
GTTATCAAGCTATCGA-1_V12D07-335_B1,0,1,2,0,0,3
AGGTGCACGTCCACAT-1_V12D07-335_B1,0,1,1,0,0,2
AAAGAATGTGGACTAA-1_V12D07-335_B1,2,5,0,0,0,7
ACCAAGTCATCGGCAG-1_V12D07-335_B1,2,2,0,0,0,4
AGTAACTATAGCAGCC-1_V12D07-335_B1,0,2,0,0,0,2
GGGAAAGAATGCCAAC-1_V12D07-335_B1,0,0,0,0,0,0
AATCGGTATAGCCCTC-1_V12D07-335_B1,3,2,0,0,0,5
GGCACTGCGGTGGTTT-1_V12D07-335_B1,2,2,0,0,0,4
CGTCCTCATCGCGTGC-1_V12D07-335_B1,3,1,0,0,0,4
CTTAACTTACAGTATA-1_V12D07-335_B1,0,1,0,0,0,1
GTGAGTCGACTAATAG-1_V12D07-335_B1,0,2,0,0,0,2
TGTACTTCCGGGCATG-1_V12D07-335_B1,0,4,0,0,0,4
CACAAACCGCAGAACT-1_V12D07-335_B1,0,1,0,0,0,1
GCTTTACACAACTGGG-1_V12D07-335_B1,1,3,0,0,0,4
CAGAGCGATGGATGCT-1_V12D07-335_B1,0,2,0,0,0,2
CATAGTGGGCACGCCT-1_V12D07-335_B1,0,1,0,0,1,2
AAACGCTGGGCACGAC-1_V12D07-335_B1,0,1,0,0,2,3
TGTTCTCATACTATAG-1_V12D07-335_B1,0,2,0,0,0,2
TCCGCTGGGTCGATCG-1_V12D07-335_B1,1,2,0,1,0,4
TTAGCATCCCTCACGT-1_V12D07-335_B1,0,0,1,0,0,1
AGCCTTGTCACTGATA-1_V12D07-335_B1,1,0,0,0,0,1
GTTTCTTGTTAGAGCT-1_V12D07-335_B1,0,2,0,0,2,4
TCGGAGTCCTGGTTGC-1_V12D07-335_B1,1,0,0,0,1,2
ACGGGTTGTGACCTGT-1_V12D07-335_B1,0,1,0,0,0,1
TGACAGAAATCTTGCT-1_V12D07-335_B1,1,0,0,1,0,2
TAGCCATGATTGCCTA-1_V12D07-335_B1,1,0,1,0,1,3
CGAAGCCACAGCATGG-1_V12D07-335_B1,1,5,0,0,0,6
ACCCGTAGCAGAGAAT-1_V12D07-335_B1,1,0,0,0,0,1
AGCTTGATCAGGGTAG-1_V12D07-335_B1,1,0,0,0,0,1
CTATAAGTAGGGTTTG-1_V12D07-335_B1,1,1,0,0,1,3
TATAGTTAGGTGTACT-1_V12D07-335_B1,1,0,0,0,0,1
TACGCTGATAGTTGTA-1_V12D07-335_B1,2,2,0,0,0,4
TTCTCAATTGCTACAA-1_V12D07-335_B1,1,0,0,0,0,1
GTTGCCCTAACGGGTG-1_V12D07-335_B1,0,0,0,0,0,0
GACATTTCGCCCAGCC-1_V12D07-335_B1,3,0,0,0,0,3
GTAACTACGTAGACCT-1_V12D07-335_B1,0,0,0,0,0,0
CCAGTGTACAGACCGA-1_V12D07-335_B1,0,0,0,0,0,0
GCCCGATGCCCAGTTC-1_V12D07-335_B1,1,0,0,0,0,1
CGAACCTCTTTCCTAG-1_V12D07-335_B1,2,1,0,0,0,3
CATGCACATGAGAGGC-1_V12D07-335_B1,0,0,0,1,0,1
CCAAATCAAAGGGCAA-1_V12D07-335_B1,0,1,0,0,0,1
GTAGTTTAAGCACACG-1_V12D07-335_B1,1,2,0,0,0,3
TAAGTGAATAGTCTAC-1_V12D07-335_B1,0,2,0,0,0,2
GGTCCACGTCTATTTG-1_V12D07-335_B1,9,1,2,0,0,12
CCCTCAGATCGAGAAC-1_V12D07-335_B1,1,1,0,0,0,2
ACATTCGCGCGGAATA-1_V12D07-335_B1,0,1,0,0,0,1
CTATGAACACCTTGCC-1_V12D07-335_B1,1,1,0,0,0,2
CGAATGGTAGGTCGTC-1_V12D07-335_B1,3,0,0,0,1,4
TCGACATAGCGTAGCG-1_V12D07-335_B1,3,1,0,0,0,4
GACGTTGCTCGGCGGC-1_V12D07-335_B1,0,1,0,0,0,1
CTCGAGGCAAGTTTCA-1_V12D07-335_B1,1,1,0,0,0,2
GCTGGGAGCGCGTCAA-1_V12D07-335_B1,1,0,0,0,2,3
GACGATATCACTGGGT-1_V12D07-335_B1,2,0,0,0,0,2
CAGCTCTGGGCTCACT-1_V12D07-335_B1,1,1,0,0,1,3
TAGTCTGCGGCACATT-1_V12D07-335_B1,2,3,0,0,0,5
TGGTCGATATACCTCT-1_V12D07-335_B1,1,0,0,0,4,5
TTCAGTTCAAGAGGAG-1_V12D07-335_B1,0,1,0,0,0,1
GTCTGTAGGTTGAACA-1_V12D07-335_B1,0,0,0,0,0,0
GAGAGTCTCGGGAGAG-1_V12D07-335_B1,0,5,0,0,0,5
TTGTTTGTATTACACG-1_V12D07-335_B1,1,0,0,1,1,3
GCACAGCACGGGCCGA-1_V12D07-335_B1,3,4,0,0,0,7
AAACAGTGTTCCTGGG-1_V12D07-335_B1,1,1,0,0,0,2
TGGAGAATAATCGTCC-1_V12D07-335_B1,1,2,1,0,0,4
CGCCGCGTTCTGAACG-1_V12D07-335_B1,3,2,0,0,0,5
CATGCGTTGAGAGGAG-1_V12D07-335_B1,2,3,0,1,0,6
TACGCTCCTAGAACTG-1_V12D07-335_B1,2,2,0,0,0,4
CCTTGTGAACGTGGTT-1_V12D07-335_B1,2,7,0,0,0,9
TTAAAGGCGATGCTCG-1_V12D07-335_B1,0,2,0,0,1,3
TAAAGTGCACGTCTCG-1_V12D07-335_B1,1,0,0,0,3,4
TGTCCGCAAACAATTC-1_V12D07-335_B1,1,0,0,0,0,1
AGGCCTATCATACCAA-1_V12D07-335_B1,0,1,0,0,0,1
ACTGGGATGCCAGTGC-1_V12D07-335_B1,1,0,0,0,1,2
CGATCCACCATTGTTG-1_V12D07-335_B1,1,2,0,0,1,4
GGGCATGCATGTCGAG-1_V12D07-335_B1,2,2,0,0,0,4
TCCAGGCAGGACGATC-1_V12D07-335_B1,1,2,0,0,0,3
CAATGACCCTTAATTT-1_V12D07-335_B1,1,2,0,0,0,3
ATCAAGATCCCAGGAC-1_V12D07-335_B1,3,1,0,0,0,4
CTCAGAGCTAATGTCG-1_V12D07-335_B1,1,0,0,0,0,1
CTGCGATTTCGAGATT-1_V12D07-335_B1,0,0,0,0,0,0
ATGGTATTGGGAACCG-1_V12D07-335_B1,4,3,0,0,0,7
TAGGTTCTGCTGAGAA-1_V12D07-335_B1,2,0,0,0,0,2
GCCTGTCCCGGTGCAT-1_V12D07-335_B1,0,0,0,0,0,0
GGCCTGCTCTGATGTT-1_V12D07-335_B1,0,0,1,0,0,1
TAGAGGGAGTTTATCT-1_V12D07-335_B1,2,0,0,0,0,2
CTCTACATCCTGCGTG-1_V12D07-335_B1,1,2,0,0,0,3
ACACATTTCCGTAGAC-1_V12D07-335_B1,1,0,0,0,0,1
TGGGTGTTAAGTAGAA-1_V12D07-335_B1,0,0,0,0,0,0
GAGCTCAACATGAGCG-1_V12D07-335_B1,0,0,0,0,0,0
GCACACAGCTATTACC-1_V12D07-335_B1,0,0,0,0,0,0
GCGACGGTAGTCTCCT-1_V12D07-335_B1,0,0,0,0,0,0
GTATCAAGGTACTTCC-1_V12D07-335_B1,1,0,0,0,0,1
GGAAAGGGAATTGAGC-1_V12D07-335_B1,1,0,0,0,0,1
TACACAGCCGTGGTGC-1_V12D07-335_B1,0,1,0,1,0,2
CGGTTGGGCAGGGTCC-1_V12D07-335_B1,1,1,0,0,0,2
GCACGCCGATTCCCGC-1_V12D07-335_B1,1,0,0,0,0,1
CGCTTTCCGCCAAGGT-1_V12D07-335_B1,3,0,0,0,0,3
TGCCCGATAGTTAGAA-1_V12D07-335_B1,1,0,0,0,0,1
TCAGAACGGCGGTAAT-1_V12D07-335_B1,1,0,0,0,0,1
GGAAGGACACCGTATA-1_V12D07-335_B1,4,1,0,0,0,5
CGCGGGAATTCCTTTC-1_V12D07-335_B1,2,1,0,0,0,3
TCTATCCGATTGCACA-1_V12D07-335_B1,2,0,0,0,0,2
TACTCGTTTGAATCAA-1_V12D07-335_B1,1,0,0,0,0,1
GTCTGCCGACTCGACG-1_V12D07-335_B1,0,0,0,0,0,0
TACGGGTAATAACATA-1_V12D07-335_B1,0,0,0,0,0,0
CCAGTTCGGTAACTCA-1_V12D07-335_B1,1,0,0,0,0,1
CGTGCACACCACTGTA-1_V12D07-335_B1,2,0,2,0,0,4
CTTCAGTTGGACAACG-1_V12D07-335_B1,1,0,0,0,0,1
TGATCTATCACACTCT-1_V12D07-335_B1,1,0,0,0,0,1
TAGCAGATACTTAGGG-1_V12D07-335_B1,1,0,0,0,0,1
CACCGGGCATCACAAG-1_V12D07-335_B1,3,0,0,2,0,5
AGTGGCCCGCAAATGG-1_V12D07-335_B1,0,0,0,0,0,0
CTCGCTAGGTAAGCGA-1_V12D07-335_B1,1,0,1,0,0,2
GATAGATAGTACAGTC-1_V12D07-335_B1,2,0,0,0,0,2
CGAGACTACTGCTGCT-1_V12D07-335_B1,0,5,1,0,0,6
ACATTTGAAACCTAAC-1_V12D07-335_B1,0,2,0,0,0,2
GACACAGCCGGGACTG-1_V12D07-335_B1,0,1,1,0,0,2
ACGGAACACGAGTGCC-1_V12D07-335_B1,0,3,0,0,0,3
ACGCCAGTGCGTTTGC-1_V12D07-335_B1,0,0,0,0,0,0
GCACCTAGGCGAGTCC-1_V12D07-335_B1,0,5,1,0,0,6
TCACTATCCCTTCGGT-1_V12D07-335_B1,0,4,1,0,0,5
TGAGTGTAACAACGGG-1_V12D07-335_B1,0,7,0,0,0,7
ATTGGTTGTGCATTAC-1_V12D07-335_B1,0,2,0,0,0,2
CTGGCGATTTACATGT-1_V12D07-335_B1,0,4,0,0,0,4
TCCACCAAGACATAGG-1_V12D07-335_B1,1,0,0,0,0,1
AACGTCGCTGCACTTC-1_V12D07-335_B1,1,1,0,0,0,2
GTCTCCCGAGTCCCGT-1_V12D07-335_B1,0,0,0,0,0,0
AGCCCGCACTACAATG-1_V12D07-335_B1,0,2,0,0,0,2
GGCACGCTGCTACAGT-1_V12D07-335_B1,0,3,0,0,0,3
GCTTGAGTGACCTCTG-1_V12D07-335_B1,0,1,0,0,0,1
ATAGCCATAACAGTCA-1_V12D07-335_B1,0,1,0,0,0,1
TAGGAGGCTCGAGAAC-1_V12D07-335_B1,1,4,0,0,0,5
GTCGGGTGAAGTACCG-1_V12D07-335_B1,4,0,0,0,0,4
CACCCGCGTTTGACAC-1_V12D07-335_B1,1,1,0,0,0,2
ATCGCCGTGGTTCATG-1_V12D07-335_B1,1,3,0,0,0,4
CTGCTCTCAACACACC-1_V12D07-335_B1,1,3,0,0,0,4
GCATGACACAAAGGAA-1_V12D07-335_B1,0,0,0,0,0,0
CAACGATCGATCCAAT-1_V12D07-335_B1,1,2,0,0,0,3
ATACAGCGTCCACTGA-1_V12D07-335_B1,0,0,0,0,0,0
TCACGATTAATACGTT-1_V12D07-335_B1,3,0,0,2,0,5
CGTGAACTGACCCGAT-1_V12D07-335_B1,1,2,0,0,0,3
TCGATGTTACGGCCGT-1_V12D07-335_B1,1,1,0,1,0,3
GACCGGTGATACTCTC-1_V12D07-335_B1,0,1,0,0,0,1
TCTGTTTAGATTGTTC-1_V12D07-335_B1,3,0,0,0,0,3
GCTACTCGGACGCAGA-1_V12D07-335_B1,3,1,0,0,0,4
AAGAAAGTTTGATGGG-1_V12D07-335_B1,2,0,0,0,0,2
CGCCAGTAGTACCTTG-1_V12D07-335_B1,2,2,3,0,0,7
CTCCCTTGTATCAAGG-1_V12D07-335_B1,0,3,1,0,0,4
ACTTTATACACCACTT-1_V12D07-335_B1,2,3,0,0,0,5
AGATCTGGAGAGGATA-1_V12D07-335_B1,2,0,0,0,0,2
TCATCCATCTGATCAC-1_V12D07-335_B1,3,1,0,0,0,4
AGAACACGGCGATGGT-1_V12D07-335_B1,0,3,1,0,0,4
CCGCTCCGGATAAGCT-1_V12D07-335_B1,3,0,0,0,1,4
TGGTCGGGTACAGGGC-1_V12D07-335_B1,1,3,0,0,0,4
ACGGACGCAGCGACAA-1_V12D07-335_B1,0,0,0,0,0,0
ACATGCTTACGGCAGC-1_V12D07-335_B1,4,0,0,0,0,4
CAGGGAGATAGGCCAG-1_V12D07-335_B1,0,0,0,0,0,0
TCGCCACCCGGATTAC-1_V12D07-335_B1,1,1,0,0,0,2
TCTTGGTCAATGATAC-1_V12D07-335_B1,3,1,0,0,0,4
CATAGGGACACTTGTG-1_V12D07-335_B1,1,1,0,0,0,2
CACGAGCAAACCAGAC-1_V12D07-335_B1,0,0,0,0,0,0
GGGATATTGATCGCCA-1_V12D07-335_B1,0,0,0,0,0,0
TAATGTCGGTTCATGG-1_V12D07-335_B1,2,0,0,0,0,2
CGATTTGTCATTAATG-1_V12D07-335_B1,0,0,0,0,0,0
TTAAGATACCCAGAGA-1_V12D07-335_B1,0,3,0,1,0,4
CGACCGTTGGTATTCG-1_V12D07-335_B1,0,0,0,0,0,0
ACTACCATCCGAGGGC-1_V12D07-335_B1,0,2,0,0,0,2
TCTACGCACGATCTCC-1_V12D07-335_B1,1,0,0,0,0,1
AAGCCACTTGCAGGTA-1_V12D07-335_B1,1,0,1,1,1,4
ACGTTGTCGTTGAAAG-1_V12D07-335_B1,1,0,0,0,0,1
ACCGCTAGTCATTGGT-1_V12D07-335_B1,0,0,0,0,0,0
CATGAGTCCATCACGG-1_V12D07-335_B1,0,1,0,0,0,1
ATGTCTTGTTTGACTC-1_V12D07-335_B1,1,0,0,1,1,3
TCCCAAACATCCTCTA-1_V12D07-335_B1,1,1,0,0,0,2
CAACGCGATGAGCCAA-1_V12D07-335_B1,0,0,0,0,0,0
GACACCCAAAGACGCG-1_V12D07-335_B1,1,3,0,0,3,7
ACGTTCACTATGCCGC-1_V12D07-335_B1,0,3,0,0,1,4
ATGGACTGCTTAGTTG-1_V12D07-335_B1,1,2,0,0,0,3
CCATGGCAAACGCTCA-1_V12D07-335_B1,0,4,0,0,0,4
TTGTCTCGGCAAGATG-1_V12D07-335_B1,4,2,0,1,0,7
TTCGAACGAAACATGC-1_V12D07-335_B1,2,3,0,0,0,5
GGAAAGTCTTGATTGT-1_V12D07-335_B1,0,2,0,0,0,2
ATCATAGATCGACGAG-1_V12D07-335_B1,0,2,0,0,0,2
GATTAGAAACAAGCGT-1_V12D07-335_B1,6,1,0,0,1,8
GCTGCGAAGAATTATT-1_V12D07-335_B1,1,2,0,0,1,4
TTCCAGTGGGTTTCGT-1_V12D07-335_B1,2,4,0,0,0,6
GCTCATTGATCATATC-1_V12D07-335_B1,4,0,0,0,0,4
ATACGAGGTTTGTAAG-1_V12D07-335_B1,3,4,2,0,0,9
GTCTATACACGCATGG-1_V12D07-335_B1,1,2,0,0,0,3
GATTTGCGCTAACACC-1_V12D07-335_B1,4,0,0,0,1,5
TGGTGCCCTGCCTTAC-1_V12D07-335_B1,0,4,0,0,0,4
TCGAATCGCAGGGTAG-1_V12D07-335_B1,2,2,0,0,1,5
GGTAGGCCAATATCAC-1_V12D07-335_B1,2,2,0,0,2,6
CGTAAATAACAAAGGG-1_V12D07-335_B1,2,0,0,1,0,3
GACTCTAGAGTTCCAA-1_V12D07-335_B1,1,1,0,1,2,5
ACTTGTTACCGGATCA-1_V12D07-335_B1,0,0,0,1,2,3
GGCATTGAACATCTCA-1_V12D07-335_B1,2,0,1,0,0,3
AACCCGCTGTATTCCA-1_V12D07-335_B1,0,2,0,0,2,4
TAACAGGTTCCCTTAG-1_V12D07-335_B1,1,1,0,0,1,3
GTTCTTGTAACTCAAT-1_V12D07-335_B1,2,1,0,0,2,5
GATTCTGTTAATGAGT-1_V12D07-335_B1,2,2,0,1,0,5
GGACACCTCGGTGTTG-1_V12D07-335_B1,1,2,2,0,0,5
CGATCGAGAAGCACCA-1_V12D07-335_B1,1,0,0,1,0,2
CTGCTCTGACGGCAAA-1_V12D07-335_B1,1,0,1,0,0,2
CCCAGGAAGAATTCGA-1_V12D07-335_B1,0,0,0,0,0,0
TGTCGTGGGTATAGGC-1_V12D07-335_B1,2,1,0,0,0,3
ATATGTCTAGAGCGTG-1_V12D07-335_B1,1,0,1,0,0,2
GCGGGCAGACGGGTGA-1_V12D07-335_B1,1,0,0,1,0,2
CGAAGATCAGTTTCAT-1_V12D07-335_B1,0,0,0,0,0,0
ACGCCACTCGAAACAG-1_V12D07-335_B1,2,0,0,0,0,2
CTTAGATGTTTCATCC-1_V12D07-335_B1,1,1,0,0,0,2
GCGAATGGACTAGCGA-1_V12D07-335_B1,3,0,0,0,0,3
TAAATTGTGGGTAAAG-1_V12D07-335_B1,2,0,0,0,0,2
ATTTATACTGGTAAAG-1_V12D07-335_B1,1,0,0,0,0,1
GCGTCGTAACATGGTC-1_V12D07-335_B1,0,0,0,1,0,1
CGGTATGGGCACTCTG-1_V12D07-335_B1,2,0,0,0,0,2
CTATCACAACGCTGGA-1_V12D07-335_B1,1,0,1,0,0,2
ACCACACGGTTGATGG-1_V12D07-335_B1,2,0,0,0,0,2
AATGTTAAGACCCTGA-1_V12D07-335_B1,2,1,0,0,0,3
AACATAGCGTGTATCG-1_V12D07-335_B1,1,0,0,0,0,1
AGCAGTCGAAGCATGC-1_V12D07-335_B1,0,0,0,0,0,0
GTACTACGGCCTCGTT-1_V12D07-335_B1,0,0,0,1,0,1
TTGGCCAAATTGTATC-1_V12D07-335_B1,1,0,1,0,0,2
TCAGAGGACGCGTTAG-1_V12D07-335_B1,1,0,0,0,0,1
AGTAATCTAAGGGTGG-1_V12D07-335_B1,0,0,0,0,0,0
AATTATACCCAGCAAG-1_V12D07-335_B1,1,0,0,0,0,1
CCCTACCCACACCCAG-1_V12D07-335_B1,1,0,0,0,0,1
CTCTGTCCATGCACCA-1_V12D07-335_B1,1,0,0,0,0,1
TCGCCTCCTTCGGCTC-1_V12D07-335_B1,3,0,0,0,0,3
CCTGATTCGCGAAGAA-1_V12D07-335_B1,0,0,0,0,0,0
GACTTCAACGCATCAA-1_V12D07-335_B1,4,0,0,0,0,4
GCTTCCCGTAAGCTCC-1_V12D07-335_B1,1,0,0,0,0,1
AGAACTGTACTTTGTA-1_V12D07-335_B1,1,2,1,1,0,5
CCTTAAGTACGCAATT-1_V12D07-335_B1,1,0,0,0,0,1
GGCCAATTGTATAGAC-1_V12D07-335_B1,1,3,1,0,0,5
AGAATACAGGCTATCC-1_V12D07-335_B1,1,3,0,0,0,4
AATACCTGATGTGAAC-1_V12D07-335_B1,1,4,0,0,0,5
TAGAGTGTTCCGGGTA-1_V12D07-335_B1,0,5,1,0,0,6
GCTTCCATGTAACCGC-1_V12D07-335_B1,0,0,0,0,0,0
GGTTCGCATTTGCCGT-1_V12D07-335_B1,0,2,1,0,0,3
TCAATCCGGGAAGTTT-1_V12D07-335_B1,0,6,1,0,0,7
CCGGAAGTGCAATATG-1_V12D07-335_B1,1,0,0,0,0,1
CTCATAAATGTGTATA-1_V12D07-335_B1,0,1,0,0,0,1
GACGGGCATCGAATTT-1_V12D07-335_B1,2,2,0,0,0,4
GCTAAGCCCAGTATGC-1_V12D07-335_B1,0,2,0,0,0,2
GCTATAAGGGCCAGGA-1_V12D07-335_B1,0,5,1,0,0,6
GCGGATTACTTGTTCT-1_V12D07-335_B1,2,1,0,0,0,3
TACAACAGCGCATACA-1_V12D07-335_B1,1,0,0,0,0,1
TCTAACCTAGCCTGCG-1_V12D07-335_B1,2,1,0,0,0,3
TCTACCCGCATCATTT-1_V12D07-335_B1,0,2,0,0,0,2
GTCTTACCACGCCAAG-1_V12D07-335_B1,0,2,0,0,0,2
AATAACGTCGCGCCCA-1_V12D07-335_B1,1,1,0,0,0,2
CGTTTCGGTTATATGC-1_V12D07-335_B1,0,1,0,0,0,1
TACGCTGCACGGTCGT-1_V12D07-335_B1,1,1,0,0,0,2
GCCCGTCAAGCCCAAT-1_V12D07-335_B1,2,0,0,0,0,2
ATTCGTCCCGAGGTTA-1_V12D07-335_B1,0,0,0,0,0,0
TCAAATTATGTTCGAC-1_V12D07-335_B1,2,1,0,0,0,3
AACGTTCTACCATTGT-1_V12D07-335_B1,0,0,0,0,0,0
CTGTCCTGCGCACTAC-1_V12D07-335_B1,1,0,0,0,1,2
GCCCAGCGACACAAAG-1_V12D07-335_B1,0,0,0,1,0,1
TATAGCTATTATCTCT-1_V12D07-335_B1,0,2,0,1,0,3
AAGCTATGGATTGACC-1_V12D07-335_B1,0,0,0,0,0,0
CCGAAACACGACCTCT-1_V12D07-335_B1,1,1,0,1,0,3
ATCAGAAGCTGGTTGC-1_V12D07-335_B1,3,1,0,0,0,4
TGAACCTGAATGTGAG-1_V12D07-335_B1,1,0,0,0,0,1
TCAGAGCATGTCAACG-1_V12D07-335_B1,5,1,0,0,0,6
ATACCCTCCCGGCCAA-1_V12D07-335_B1,2,1,0,0,0,3
GCCACCTTATTCGCGA-1_V12D07-335_B1,1,0,0,0,0,1
CAACGAGCTTATTATG-1_V12D07-335_B1,1,0,0,0,0,1
GATCCAACCTTTAAAC-1_V12D07-335_B1,0,0,0,0,0,0
TTGTGGAGACAGCCGG-1_V12D07-335_B1,0,0,0,0,0,0
AGATAATCACACCTAT-1_V12D07-335_B1,1,1,1,0,0,3
GGTTAGGGATGCTAAT-1_V12D07-335_B1,3,0,0,0,0,3
TCATGAAGCGCTGCAT-1_V12D07-335_B1,1,0,0,0,0,1
CCAGGCGAGATGGTCT-1_V12D07-335_B1,0,1,0,0,0,1
CGACTTGCCGGGAAAT-1_V12D07-335_B1,1,1,0,0,0,2
GTGCCAAACGTTTCGA-1_V12D07-335_B1,1,0,0,1,0,2
TGCTCAAAGGATGCAC-1_V12D07-335_B1,1,2,0,0,0,3
GCCTCAGGTACCGGTC-1_V12D07-335_B1,0,0,0,0,0,0
ACAAGTAATTGTAAGG-1_V12D07-335_B1,0,0,0,0,0,0
TTAGAGTATTGTCGAG-1_V12D07-335_B1,0,0,1,0,0,1
GTCATCCCAAACTCAC-1_V12D07-335_B1,0,2,1,0,0,3
CTCCTAGTAATCGTGA-1_V12D07-335_B1,1,2,1,0,0,4
CCCTCATCACAGAGTA-1_V12D07-335_B1,0,0,1,0,0,1
GGAAACAGAGCTTGGG-1_V12D07-335_B1,1,0,0,0,0,1
ACATCGCAATATTCGG-1_V12D07-335_B1,0,2,0,0,0,2
TTAGCCATAGGGCTCG-1_V12D07-335_B1,1,0,0,1,0,2
CGGATTCTGCCTTATG-1_V12D07-335_B1,2,0,0,0,0,2
TTGTTGGCAATGACTG-1_V12D07-335_B1,1,0,0,0,0,1
GGATCTACCGTTCGTC-1_V12D07-335_B1,0,0,0,0,0,0
GGTGGGATTAGGTCCC-1_V12D07-335_B1,2,2,0,0,0,4
AATAGGCACGACCCTT-1_V12D07-335_B1,1,3,0,0,0,4
GAGGTCCGTTCGCTGT-1_V12D07-335_B1,1,1,0,0,0,2
TGACAACTTAAAGGTG-1_V12D07-335_B1,1,3,0,0,0,4
AGCTAAGCTCCGTCCG-1_V12D07-335_B1,0,2,0,0,1,3
CTAGCCCGGGAGACGA-1_V12D07-335_B1,2,1,0,0,0,3
CCCAGATTCCCGTGAC-1_V12D07-335_B1,4,3,1,1,0,9
GCCCGTTCACACAATT-1_V12D07-335_B1,1,1,0,0,0,2
ACAAACTCCATCAGAG-1_V12D07-335_B1,3,2,0,1,1,7
GGTTCCGTACGACTAA-1_V12D07-335_B1,1,3,0,0,0,4
TTGCGGAAAGCTGCCC-1_V12D07-335_B1,3,2,0,0,1,6
GGAACTCGTGAATACG-1_V12D07-335_B1,2,4,0,0,0,6
GGTTACCGCTCCCTAC-1_V12D07-335_B1,2,2,1,0,0,5
AGCGACTTTGAAGACA-1_V12D07-335_B1,1,2,0,0,0,3
CCGTTTCCTTTCCGTG-1_V12D07-335_B1,4,2,0,0,2,8
TGGATGGCATCTTGGA-1_V12D07-335_B1,5,3,0,1,0,9
CAAGTCGTTGAAATCT-1_V12D07-335_B1,2,2,0,0,0,4
TGCAAACGTACTAGTT-1_V12D07-335_B1,2,2,1,1,0,6
GGCTGTCCTACTGCGG-1_V12D07-335_B1,0,4,0,0,0,4
TACTGCATGATTAAAT-1_V12D07-335_B1,3,5,1,0,0,9
CGGACCTCTGTAGTTA-1_V12D07-335_B1,2,4,0,0,1,7
CCCTAGCTCTAAGGTC-1_V12D07-335_B1,1,7,0,1,0,9
GTAACAGGTTAACGGC-1_V12D07-335_B1,2,1,0,0,0,3
CCCGCAAATAATCATC-1_V12D07-335_B1,1,2,0,0,0,3
AATCCCGCTCAGAGCC-1_V12D07-335_B1,2,0,1,0,1,4
AACGTCATCCGGCTTG-1_V12D07-335_B1,6,1,1,0,1,9
CTCGTGGCACTGAAAG-1_V12D07-335_B1,3,1,4,0,3,11
CTTTATCCGACGCATG-1_V12D07-335_B1,0,0,0,0,0,0
AAATGACTGATCAAAC-1_V12D07-335_B1,0,0,0,0,1,1
TTCGTGCATGTTATAG-1_V12D07-335_B1,0,0,0,0,1,1
ATCAAAGAGCCGTGGT-1_V12D07-335_B1,0,0,0,0,0,0
ATGTCATAATAAACGA-1_V12D07-335_B1,0,0,0,1,0,1
CTTAATCGACTTAGTA-1_V12D07-335_B1,0,0,0,0,2,2
CTAAAGGATGAGATAC-1_V12D07-335_B1,1,1,0,0,0,2
GTGCTATCCAGCTGGA-1_V12D07-335_B1,3,2,0,1,0,6
GACAGAGGTCTTCAGT-1_V12D07-335_B1,0,0,0,0,0,0
TCGATTTACGAAACGA-1_V12D07-335_B1,0,0,0,0,0,0
AGGCTTAAGTTGCACA-1_V12D07-335_B1,1,0,0,0,0,1
TAGGATCTTAACCGCA-1_V12D07-335_B1,0,0,1,0,0,1
GACTTTCGAGCGGTTC-1_V12D07-335_B1,1,0,0,0,0,1
CCCTGGGAGGGATCCT-1_V12D07-335_B1,0,0,0,0,0,0
TAGTAGTTGCCGGACA-1_V12D07-335_B1,0,0,0,1,0,1
GCCCTAAGTGCAGGAT-1_V12D07-335_B1,1,0,0,1,0,2
ACTTGGGCTTTCGCCA-1_V12D07-335_B1,1,0,0,0,0,1
CATGATACGGTGAAAC-1_V12D07-335_B1,0,1,0,0,0,1
TCCTGCAGCCGCCAAT-1_V12D07-335_B1,0,0,0,0,0,0
GTCCGTTAGAGGGCCT-1_V12D07-335_B1,1,0,0,0,0,1
GCTTTATTAAGTTACC-1_V12D07-335_B1,1,0,1,0,0,2
AATCGAGGTCTCAAGG-1_V12D07-335_B1,1,0,0,0,0,1
GTGCTGTTAGAACATA-1_V12D07-335_B1,1,0,0,0,0,1
GGCTTCTCGTGGGTGG-1_V12D07-335_B1,1,0,1,0,0,2
CCTACAGTTGAGGGAG-1_V12D07-335_B1,1,0,1,0,0,2
CTCTAACACCGGCAGC-1_V12D07-335_B1,1,0,0,0,0,1
CTTCATCACCAGGGCT-1_V12D07-335_B1,1,0,0,0,0,1
GGCTGGCAATCCCACG-1_V12D07-335_B1,1,0,0,0,0,1
CAAACCATAAGCGTAT-1_V12D07-335_B1,1,0,0,0,0,1
CATGTGGGCTCATCAC-1_V12D07-335_B1,2,0,0,0,0,2
CCCGTGACAGTGCCTT-1_V12D07-335_B1,0,0,0,0,0,0
GATTATCTTGCATTAT-1_V12D07-335_B1,3,0,0,0,0,3
GAGTCCACCAGGTTTA-1_V12D07-335_B1,1,0,1,0,0,2
TGTACTATCGCTCGTT-1_V12D07-335_B1,1,0,1,1,0,3
TTAGCGAATAGATAGG-1_V12D07-335_B1,1,0,0,0,0,1
ACATACAATCAAGCGG-1_V12D07-335_B1,1,3,0,0,0,4
ATTCGTGTACCCATTC-1_V12D07-335_B1,2,1,0,0,0,3
GCTAGCAACGCACCTA-1_V12D07-335_B1,3,4,1,0,0,8
ACCTCAGCGAGGCGCA-1_V12D07-335_B1,2,0,0,0,0,2
TCCGGGCCACTAACGG-1_V12D07-335_B1,0,4,0,0,0,4
TCCCAATATCGACGAC-1_V12D07-335_B1,4,4,1,0,0,9
GGATTGAAGTAGCCTC-1_V12D07-335_B1,0,4,0,0,0,4
GGCGCACAGTTTACCT-1_V12D07-335_B1,0,4,0,0,0,4
CCCGGCACGTGTCAGG-1_V12D07-335_B1,1,3,0,0,0,4
AGTAAGGGACAGAATC-1_V12D07-335_B1,0,3,1,0,0,4
TTGCGCACAACCACGT-1_V12D07-335_B1,1,1,0,0,0,2
CCTGCTACAACCATAC-1_V12D07-335_B1,0,3,1,0,0,4
CTGGGCTACTGGAGAG-1_V12D07-335_B1,0,1,0,0,0,1
AGCTACGAATGGTGGT-1_V12D07-335_B1,0,4,0,0,0,4
ATTCGTTTATCGTATT-1_V12D07-335_B1,2,1,0,0,0,3
GGCATTCCCTCCCTCG-1_V12D07-335_B1,0,4,0,0,0,4
AGTTATTCAGACTGTG-1_V12D07-335_B1,2,1,0,0,0,3
CCACTTTCCTTCTAGG-1_V12D07-335_B1,2,0,0,0,0,2
CGCAGTTCTATCTTTC-1_V12D07-335_B1,0,0,0,0,0,0
AGGAGCGTTTATTATC-1_V12D07-335_B1,0,0,0,0,0,0
GACAGGTAATCCGTGT-1_V12D07-335_B1,1,4,0,0,0,5
TTCCCAAAGTACTGAT-1_V12D07-335_B1,0,1,0,0,0,1
ATTGAATTCCCTGTAG-1_V12D07-335_B1,0,0,0,0,0,0
TACCTCACCAATTGTA-1_V12D07-335_B1,1,0,0,0,0,1
AGTCGAATTAGCGTAA-1_V12D07-335_B1,0,0,0,0,0,0
TTGAAGTGCATCTACA-1_V12D07-335_B1,0,0,0,0,0,0
