key,other,microglia,oligo,neuron,astrocyte,n_cells
AGGCAATACGGAGGAC-1_V12D07-335_B1,0,0,0,0,0,0
ATCTATCGATGATCAA-1_V12D07-335_B1,0,0,0,0,0,0
TCGCCGGAGAGTCTTA-1_V12D07-335_B1,0,0,0,0,0,0
TTAGGTGTGACTGGTC-1_V12D07-335_B1,3,0,1,0,0,4
CCCGTGGGTTAATTGA-1_V12D07-335_B1,0,0,2,0,0,2
GGTATCAAGCATAGAA-1_V12D07-335_B1,1,0,2,0,0,3
AATTCCAACTTGGTGA-1_V12D07-335_B1,0,0,2,0,0,2
GCTGGGTCCGCTGTTA-1_V12D07-335_B1,0,0,0,0,0,0
AACATTGGTCAGCCGT-1_V12D07-335_B1,0,1,2,0,1,4
CATCGAATGGATCTCT-1_V12D07-335_B1,1,0,2,0,0,3
CGGGTTGTAGCTTTGG-1_V12D07-335_B1,0,1,1,0,0,2
TCTGTGACTGACCGTT-1_V12D07-335_B1,1,2,5,0,0,8
AGGGTGTGCTACACGC-1_V12D07-335_B1,2,0,0,0,0,2
AATGGCCGCCAATGCG-1_V12D07-335_B1,1,0,0,0,0,1
GGGTCACTGAGTAGTG-1_V12D07-335_B1,3,0,0,0,0,3
GATCTTAGTGAACGTG-1_V12D07-335_B1,2,0,3,0,1,6
CTAATGCGCCCAACAA-1_V12D07-335_B1,0,0,0,0,0,0
GCCACCCATTCCACTT-1_V12D07-335_B1,0,0,0,0,0,0
TACTCACAACGTAGTA-1_V12D07-335_B1,0,0,0,0,0,0
GTTCGGTGTGGATTTA-1_V12D07-335_B1,0,0,0,0,0,0
TCTTTCGGCGGGACAC-1_V12D07-335_B1,0,0,0,0,0,0
GGAGACATTCACGGGC-1_V12D07-335_B1,0,0,0,0,0,0
GGGATTATCTCACAAC-1_V12D07-335_B1,1,0,0,0,0,1
TAGAACGCCAGTAACG-1_V12D07-335_B1,0,1,1,0,0,2
ACGAGTCGCCGGCGTT-1_V12D07-335_B1,0,0,1,0,0,1
TGATGGGACTAAGTCA-1_V12D07-335_B1,0,0,1,0,0,1
TGCGAGAAACGTTACG-1_V12D07-335_B1,0,0,1,0,0,1
TCGCCTCGACCTGTTG-1_V12D07-335_B1,0,3,1,0,0,4
AACTCGATAAACACGT-1_V12D07-335_B1,0,1,0,0,0,1
AGGAAAGCCTCTGATG-1_V12D07-335_B1,0,0,2,0,0,2
GAAGGACTAAATTGAA-1_V12D07-335_B1,0,4,2,0,0,6
GTATCGGGACGAGCTG-1_V12D07-335_B1,1,2,5,1,0,9
CCTGTGCATAGGAGAC-1_V12D07-335_B1,0,1,0,0,0,1
CATACGGGTGCATGAT-1_V12D07-335_B1,1,0,0,0,0,1
CCACTAAACTGAATCG-1_V12D07-335_B1,0,0,1,0,0,1
AAATTGCGGCGGTTCT-1_V12D07-335_B1,2,2,0,0,0,4
AGTCCAGCGGGTACGT-1_V12D07-335_B1,0,0,4,0,0,4
CATTCAGGTCAGTGCG-1_V12D07-335_B1,0,1,0,0,0,1
CTAAAGTCCGAAGCTA-1_V12D07-335_B1,0,1,2,0,0,3
AATCAGACTGCAGGAC-1_V12D07-335_B1,0,2,2,0,0,4
AGTATCCATAATAACG-1_V12D07-335_B1,0,1,2,0,0,3
CTGGCTGCTAACGTAA-1_V12D07-335_B1,0,0,9,0,0,9
GTTCCAAGACAGCGAC-1_V12D07-335_B1,0,2,1,0,0,3
AAGACTAACCCGTTGT-1_V12D07-335_B1,0,0,0,0,0,0
GATTAATCCTGGCTCA-1_V12D07-335_B1,0,2,3,0,0,5
CGCGCAAGGAACTACA-1_V12D07-335_B1,0,0,1,0,0,1
CAGTAGCGAGGTAGTA-1_V12D07-335_B1,1,0,1,0,0,2
ACGGCGGGTTGCCCTG-1_V12D07-335_B1,1,1,4,0,0,6
CTAGGCGGCAGAGAAT-1_V12D07-335_B1,0,1,1,1,0,3
GTGCGCAGCTTGCTCC-1_V12D07-335_B1,0,0,1,0,0,1
TCACTATCGTGCAATC-1_V12D07-335_B1,0,0,1,0,0,1
TATGATTCTGCTTGGT-1_V12D07-335_B1,0,0,0,0,0,0
TAAGATTTAGCGGGAG-1_V12D07-335_B1,2,0,3,0,0,5
TTACGGTGTCACCGAG-1_V12D07-335_B1,1,0,0,0,0,1
CTACACTAGCTTGTTC-1_V12D07-335_B1,0,1,5,0,0,6
TGAGCAGTCGTGAAGT-1_V12D07-335_B1,1,0,5,0,0,6
CGCTGAGGACGTCCAA-1_V12D07-335_B1,1,0,0,0,0,1
GTGTATGACTTTAAAG-1_V12D07-335_B1,0,0,1,0,0,1
CTAAACGGGTGTAATC-1_V12D07-335_B1,0,0,0,0,0,0
TGTACTGTGCCAAAGT-1_V12D07-335_B1,2,0,4,0,0,6
GGCCACAAGCGATGGC-1_V12D07-335_B1,1,1,0,0,0,2
GTCAATTGTACTGAAG-1_V12D07-335_B1,2,3,1,0,0,6
AGGGACAGCACGGCGG-1_V12D07-335_B1,3,3,0,0,0,6
AGCTTATAGAGACCTG-1_V12D07-335_B1,4,0,0,0,0,4
AACTAGCGTATCGCAC-1_V12D07-335_B1,3,1,2,0,1,7
AACTTTAGCTGCTGAG-1_V12D07-335_B1,1,1,0,0,0,2
CCCAAGACAGAGTATG-1_V12D07-335_B1,0,1,1,0,0,2
GGCATCAACGAGCACG-1_V12D07-335_B1,1,1,0,0,0,2
ATGCATTCCGTGATGG-1_V12D07-335_B1,2,0,0,0,0,2
TTATAGATGCACATTA-1_V12D07-335_B1,0,1,0,0,0,1
GAACCATCTGGGAGAC-1_V12D07-335_B1,2,2,0,0,0,4
TGCTATACAAACGGAC-1_V12D07-335_B1,1,0,0,0,0,1
ACTTGCCATATTGTAC-1_V12D07-335_B1,4,0,1,0,0,5
TATTCCGGCAGTCCTA-1_V12D07-335_B1,1,1,0,0,0,2
GACGGACCGCGTTCCT-1_V12D07-335_B1,0,0,0,0,1,1
ATGTGTAGTTTAGTCA-1_V12D07-335_B1,1,1,1,0,0,3
ATACCAGCAAATTGCT-1_V12D07-335_B1,1,0,2,0,0,3
AAGTTTACTAATGGCA-1_V12D07-335_B1,2,2,1,0,0,5
CTCTCGATGTGCGCCT-1_V12D07-335_B1,4,0,0,0,1,5
GATTGACACTCTGCTC-1_V12D07-335_B1,4,1,3,0,0,8
TATCACAGCACGGGCA-1_V12D07-335_B1,2,2,0,0,0,4
ACCGTTCCCGCTCTGA-1_V12D07-335_B1,2,0,3,0,0,5
CCGCCACCACAATCCA-1_V12D07-335_B1,8,3,0,0,0,11
CATTCACTGACAGCTA-1_V12D07-335_B1,0,0,4,0,0,4
CGGCTGCAAGATTAAG-1_V12D07-335_B1,0,0,0,0,1,1
CATGAACCTCTTATCA-1_V12D07-335_B1,0,0,3,0,0,3
TTAATGCGAGGTAACT-1_V12D07-335_B1,0,0,1,1,0,2
AATAAGTCCTCGAGAC-1_V12D07-335_B1,0,0,2,0,0,2
ACCAGCCCGGTCTTTG-1_V12D07-335_B1,0,0,1,0,0,1
CTACGAACTAGGTCGA-1_V12D07-335_B1,1,0,1,0,0,2
ACATCTCAACGCGTAA-1_V12D07-335_B1,1,0,3,0,0,4
CACTACTCAGTTCTGT-1_V12D07-335_B1,0,0,4,0,0,4
CCGACTCGCATAGTCT-1_V12D07-335_B1,1,0,4,1,0,6
CATTTATCGTTCAAGA-1_V12D07-335_B1,0,0,2,0,0,2
CAAACGTGGTCTTGCG-1_V12D07-335_B1,0,3,3,0,0,6
TAGAAACCACTAAGTA-1_V12D07-335_B1,3,1,0,0,0,4
ACTGATTTAGTGATTC-1_V12D07-335_B1,1,1,1,0,1,4
TCGTATTTCGTCCGGA-1_V12D07-335_B1,1,0,0,0,0,1
CGGAAATTTCACATCC-1_V12D07-335_B1,5,0,0,0,1,6
ATCCACGCTAAATGTT-1_V12D07-335_B1,0,0,6,0,1,7
GTTCAATCTATGTCAA-1_V12D07-335_B1,2,0,1,0,0,3
ATAAAGGTCAAGTACG-1_V12D07-335_B1,0,1,0,1,0,2
CAACTCCAACGTTTAG-1_V12D07-335_B1,0,0,1,1,0,2
TAGGAACAGCCTCCAG-1_V12D07-335_B1,0,0,1,0,0,1
ATGGGAACGGAAGCGG-1_V12D07-335_B1,1,0,0,1,0,2
CACACGTTTCAATGGG-1_V12D07-335_B1,2,0,0,0,0,2
GGTGTTCTGTTTCTAC-1_V12D07-335_B1,0,0,4,1,0,5
AGTAACGTTCATCCTG-1_V12D07-335_B1,0,0,0,0,0,0
GTATAGTGGCCCATGT-1_V12D07-335_B1,0,0,0,0,0,0
TCTACACGTTCATGCA-1_V12D07-335_B1,0,0,0,0,0,0
AATCTGGGTAGACCCT-1_V12D07-335_B1,0,0,0,0,0,0
TCGGTTAGCCATGTAG-1_V12D07-335_B1,3,0,0,0,0,3
TGCCATGGCTTATAAG-1_V12D07-335_B1,0,0,1,1,0,2
TAAGTAAATGTGCCGC-1_V12D07-335_B1,3,1,4,1,0,9
GTGTCCGATAAGGCAT-1_V12D07-335_B1,0,0,2,0,0,2
TGGCACGAGCTCGAGT-1_V12D07-335_B1,0,0,1,1,0,2
ACCGGTCTGAGTACGG-1_V12D07-335_B1,1,0,1,0,0,2
GAACTTAGCGCCCGGT-1_V12D07-335_B1,1,0,0,0,0,1
AGTAGCTAGACGCCGA-1_V12D07-335_B1,2,0,1,1,0,4
ATAGGAATCTAAGCTT-1_V12D07-335_B1,4,0,1,0,0,5
CTTCCTGCATATTTAC-1_V12D07-335_B1,3,0,1,0,0,4
CAATATGTAGATTTAC-1_V12D07-335_B1,0,0,2,0,0,2
ACAAGGCCTACCAGCC-1_V12D07-335_B1,0,0,0,0,0,0
TTATAGTCCAAGGTGC-1_V12D07-335_B1,1,0,0,0,0,1
AAACGCCCGAGATCGG-1_V12D07-335_B1,1,0,0,0,0,1
CCTCGTTACGCCTGTT-1_V12D07-335_B1,0,0,2,0,0,2
GAACGGTGTAAAGCAG-1_V12D07-335_B1,2,0,0,0,0,2
ACGCATAAATGACATG-1_V12D07-335_B1,3,0,0,0,0,3
GGTTCGATGCTGAGTT-1_V12D07-335_B1,7,0,0,0,0,7
CTTTGGCAGACAGAGT-1_V12D07-335_B1,2,0,0,0,0,2
TTCGTGGGCTGGAAGC-1_V12D07-335_B1,1,0,0,0,0,1
CAAAGGTTAAATTCAG-1_V12D07-335_B1,1,0,0,0,0,1
GTTTGGCGTCAGGCAC-1_V12D07-335_B1,1,0,2,0,1,4
GCTTTCTATCTCAACT-1_V12D07-335_B1,1,0,2,0,0,3
TGCATCTCCGGATCTT-1_V12D07-335_B1,2,0,2,0,0,4
CTGAAACGGCCCTCAG-1_V12D07-335_B1,0,0,0,0,2,2
TAGCAGTAAATACGCG-1_V12D07-335_B1,3,0,2,0,0,5
CGGGCTACTTAAATTG-1_V12D07-335_B1,0,0,0,0,0,0
ATTATGCTCAGTATTG-1_V12D07-335_B1,1,0,4,1,0,6
TGATGCTCACGTAGTC-1_V12D07-335_B1,0,0,1,0,0,1
GTCTAAGATGCCCAGC-1_V12D07-335_B1,1,0,0,0,0,1
AACCCGATAGGGCTTC-1_V12D07-335_B1,2,0,0,0,0,2
CGCTATCGTGGCTTTA-1_V12D07-335_B1,2,0,0,0,0,2
CGTCTCTCGCCGAGGC-1_V12D07-335_B1,2,0,0,0,0,2
AGTGGGAGTATACACG-1_V12D07-335_B1,0,0,0,0,0,0
GGTCTTGGTGTTAACT-1_V12D07-335_B1,0,0,0,0,0,0
GGCTGGCAGCTTTATG-1_V12D07-335_B1,0,0,0,0,0,0
CGCCAATTATTGCGTT-1_V12D07-335_B1,0,0,0,0,0,0
GGTAACCGGCAAAGGT-1_V12D07-335_B1,0,0,0,0,0,0
TGGGACCATTGGGAGT-1_V12D07-335_B1,0,0,0,0,0,0
CTGCAGGTGCTCGGCC-1_V12D07-335_B1,0,0,0,0,0,0
CCGGTGCGAGTGATAG-1_V12D07-335_B1,2,1,2,0,0,5
GGGTACACTCTGGAGG-1_V12D07-335_B1,1,1,3,0,0,5
TAGCCAGAGGGTCCGG-1_V12D07-335_B1,0,1,2,0,0,3
CTTGTGAGGACAGCGG-1_V12D07-335_B1,0,1,1,0,0,2
GAAGGGCATAACCATG-1_V12D07-335_B1,0,0,1,0,0,1
CAACATGGCCTGATAA-1_V12D07-335_B1,0,1,6,0,0,7
CAATTTGACCGGGAAG-1_V12D07-335_B1,0,1,4,0,0,5
TCTGACTGTAATGGTT-1_V12D07-335_B1,0,2,0,0,0,2
TTCATAGCCTTGTAAC-1_V12D07-335_B1,0,3,2,0,0,5
TGGAAACGGAGTGAAC-1_V12D07-335_B1,0,3,1,0,0,4
ATCGCACGATTGTTCA-1_V12D07-335_B1,0,0,3,0,0,3
CGCCACCCGCATTAAC-1_V12D07-335_B1,1,0,2,0,0,3
TGGACCACGGCGTTGA-1_V12D07-335_B1,2,0,2,0,0,4
GTATATGTTACGGCGG-1_V12D07-335_B1,0,1,4,0,0,5
GTATTCTTACCGTGCT-1_V12D07-335_B1,0,5,0,0,0,5
TTCAGAGTAACCTGAC-1_V12D07-335_B1,0,0,0,0,0,0
GCGGTAACCCAAATGA-1_V12D07-335_B1,0,0,3,0,0,3
CTACGTGTTGCCACCA-1_V12D07-335_B1,0,1,3,0,0,4
CTAGATAAACTCCTCG-1_V12D07-335_B1,0,0,1,0,0,1
TCCATTAGTTGGATAG-1_V12D07-335_B1,2,0,3,0,0,5
CTGGCTCCTGCGGGAT-1_V12D07-335_B1,2,0,1,0,0,3
CAGTCTCTCGGCTAAT-1_V12D07-335_B1,0,0,1,0,0,1
GTATGACGTGGGAAAC-1_V12D07-335_B1,1,2,1,0,0,4
AGTCACTCCGCCTCAT-1_V12D07-335_B1,1,0,2,0,0,3
GCAGCGGTGGGCATTA-1_V12D07-335_B1,1,0,1,0,0,2
TATGGAGTTTCTCGTT-1_V12D07-335_B1,0,0,3,0,0,3
ACTCAACGAATGTATT-1_V12D07-335_B1,0,0,6,0,0,6
AACACGCGGCCGCGAA-1_V12D07-335_B1,1,0,0,0,0,1
CGATATTAGCCGCAGG-1_V12D07-335_B1,0,0,0,0,0,0
AGCGTCTGAACCCGCA-1_V12D07-335_B1,1,1,2,0,0,4
GATGTCCGGATCACAT-1_V12D07-335_B1,0,1,3,0,0,4
GGTCACGTTAGATTCA-1_V12D07-335_B1,1,1,1,0,0,3
TTAAGGATACGGAGGT-1_V12D07-335_B1,1,1,1,0,0,3
GTGCGGGACCATCGGC-1_V12D07-335_B1,0,1,1,0,0,2
CCATCTTGTTCACAAT-1_V12D07-335_B1,2,1,2,0,0,5
TCCGAGAAGGCTAAGC-1_V12D07-335_B1,0,0,1,0,0,1
TGGCGGTGTGCGATTG-1_V12D07-335_B1,1,1,4,0,0,6
ATCCTGCTGCAGATAG-1_V12D07-335_B1,3,0,0,0,0,3
TTATGCGTCCCGGTCC-1_V12D07-335_B1,3,0,1,0,0,4
CATAATGAGCGGGCGA-1_V12D07-335_B1,3,2,2,0,0,7
AGACATAGATCCTTCC-1_V12D07-335_B1,3,1,0,0,0,4
GGTGAAACCGGGAATG-1_V12D07-335_B1,0,4,0,0,0,4
AACTGGTGTGGGCCTT-1_V12D07-335_B1,2,0,1,0,0,3
GTAGCGCTGTTGTAGT-1_V12D07-335_B1,3,0,0,0,0,3
TTGTTTGTGTAAATTC-1_V12D07-335_B1,1,0,0,0,0,1
GGATCAAAGGACGAGG-1_V12D07-335_B1,1,0,2,0,0,3
CGTAGCGCCGACGTTG-1_V12D07-335_B1,2,0,0,0,0,2
CAAGTGAACTTTGGTT-1_V12D07-335_B1,3,0,0,0,0,3
GTAGACAACCGATGAA-1_V12D07-335_B1,1,0,0,0,0,1
CAATGGTCGGCCTGGG-1_V12D07-335_B1,1,1,0,0,0,2
ACAGATTAGGTTAGTG-1_V12D07-335_B1,1,0,0,0,0,1
GTTATCACCTTCTGAA-1_V12D07-335_B1,0,0,2,0,0,2
TGGTATCGGTCTGTAT-1_V12D07-335_B1,2,0,1,0,0,3
GGAATAACCTCAAGAA-1_V12D07-335_B1,0,0,2,0,0,2
ATTATCTCGACAGATC-1_V12D07-335_B1,1,1,5,0,0,7
CCGAGGGATGTTAGGC-1_V12D07-335_B1,1,1,1,0,0,3
TGAGATCAAATACTCA-1_V12D07-335_B1,0,0,0,1,0,1
AAACGAAGAACATACC-1_V12D07-335_B1,2,0,2,0,0,4
CTGGTCCTAACTTGGC-1_V12D07-335_B1,0,0,2,0,0,2
TGCACGAGTCGGCAGC-1_V12D07-335_B1,0,1,3,0,0,4
ATAGTCTTTGACGTGC-1_V12D07-335_B1,1,0,3,0,0,4
TGGAGCTAAAGTTCCC-1_V12D07-335_B1,1,1,1,0,0,3
GGGTGGTCCAGCCTGT-1_V12D07-335_B1,0,0,0,0,0,0
CATGCATGGAGACCCT-1_V12D07-335_B1,2,0,1,1,0,4
ACACGGCACTATGCAT-1_V12D07-335_B1,0,0,0,0,0,0
CCCTGGTATGGGCGGC-1_V12D07-335_B1,0,0,4,0,0,4
GGAGGATTGAAAGGAG-1_V12D07-335_B1,0,0,2,0,0,2
CCGCTGGTGCCATTCA-1_V12D07-335_B1,0,0,1,0,0,1
GTTAGAGTGTGCCGCT-1_V12D07-335_B1,1,0,3,0,0,4
TCGGAATGACCATCAA-1_V12D07-335_B1,2,0,1,0,0,3
TTCAATTAGCCATAAT-1_V12D07-335_B1,1,0,0,0,0,1
GATGTGTTGTCACAAG-1_V12D07-335_B1,0,0,0,0,0,0
TCTTTCTCTTAAGGAG-1_V12D07-335_B1,1,1,1,0,0,3
ACCCTTTAGTTCTCCA-1_V12D07-335_B1,2,0,0,0,0,2
ACCACAACTCAGAACA-1_V12D07-335_B1,2,0,1,0,0,3
TATGATAAATCTAACG-1_V12D07-335_B1,2,0,1,0,0,3
GATCCTCTTGCGCTTA-1_V12D07-335_B1,2,0,2,0,0,4
TTCTACCTTTATGTTG-1_V12D07-335_B1,0,0,1,0,0,1
GAAATACCTGCTGGCT-1_V12D07-335_B1,1,1,0,0,0,2
ATTCTGAGTATGAACT-1_V12D07-335_B1,0,0,0,0,0,0
GGATTAAGCTAAGGTC-1_V12D07-335_B1,0,0,0,0,0,0
AGTACGTGGCCTGTCT-1_V12D07-335_B1,0,0,0,0,0,0
TCAGGGTGCACGAAAC-1_V12D07-335_B1,0,0,0,0,0,0
AAATTTACCGAAATCC-1_V12D07-335_B1,2,0,1,0,0,3
TTGAGGCATTTAACTC-1_V12D07-335_B1,1,1,1,0,0,3
AACCAGTATCACTCTT-1_V12D07-335_B1,0,0,1,0,0,1
CACCGGAGATATCTCC-1_V12D07-335_B1,2,0,0,0,0,2
GACTGGGCGCCGCAAC-1_V12D07-335_B1,1,0,0,0,0,1
CACGTCTATGATGTGG-1_V12D07-335_B1,1,0,1,2,0,4
TTAAGACGAACGAACC-1_V12D07-335_B1,4,0,2,1,0,7
TGACCAGCTTCAAAGT-1_V12D07-335_B1,0,0,1,0,0,1
AGAGTTAGAGACCGAT-1_V12D07-335_B1,2,0,4,0,0,6
TTCGGACTGATGCCTT-1_V12D07-335_B1,2,0,1,0,0,3
CTCGAATGGAACGTAT-1_V12D07-335_B1,1,0,3,0,0,4
GGACGGCTTGCGCAAC-1_V12D07-335_B1,0,0,1,0,0,1
CTAAGTACAGGGCTAC-1_V12D07-335_B1,3,0,1,0,0,4
ACAAATTCAGATCTGA-1_V12D07-335_B1,3,0,0,0,0,3
CATGGAAATGGGACCA-1_V12D07-335_B1,1,0,1,0,0,2
GGTGGACCACGTGTTA-1_V12D07-335_B1,1,0,4,0,0,5
CACGACGTAATAGTAA-1_V12D07-335_B1,1,0,0,0,0,1
CGGGTTCGGCACGTAT-1_V12D07-335_B1,4,0,0,0,0,4
CTGGGCTATCCTTTGG-1_V12D07-335_B1,2,0,1,0,0,3
GTATTAGGGTTCGCGT-1_V12D07-335_B1,1,0,2,0,0,3
TCATTCGTATAATTTG-1_V12D07-335_B1,0,0,1,0,0,1
AATAGCAAGCCTCCTG-1_V12D07-335_B1,1,0,0,0,0,1
CATCTACCCGAGAACG-1_V12D07-335_B1,1,0,3,0,0,4
GCTTCAGTGGGATTAC-1_V12D07-335_B1,0,0,1,0,0,1
TCTGTGATGGAGGTTG-1_V12D07-335_B1,2,0,2,0,0,4
ATCCACTTTCAGACTA-1_V12D07-335_B1,1,0,2,0,0,3
ATGGTTACGAAACATG-1_V12D07-335_B1,0,0,0,0,0,0
GGCCCAATCTAGAGGG-1_V12D07-335_B1,0,0,2,0,0,2
GATGGTGAAATAACCC-1_V12D07-335_B1,1,0,1,0,0,2
AGAGGGACAATTGTCC-1_V12D07-335_B1,0,0,0,1,0,1
CGCGTACATTCTGGAA-1_V12D07-335_B1,4,0,1,0,1,6
CAAGAAACCCTAAACT-1_V12D07-335_B1,1,0,2,0,0,3
TTGGTGCGGTGTTGAA-1_V12D07-335_B1,0,0,0,0,0,0
GGTTCCCTAGTGTCTC-1_V12D07-335_B1,0,0,1,0,0,1
CGATAACCAATTTGAG-1_V12D07-335_B1,1,0,0,0,0,1
GCCCACTGGTCCACAA-1_V12D07-335_B1,2,0,2,0,0,4
GAGGGCCGGCAGAGTC-1_V12D07-335_B1,4,0,1,0,0,5
CGACACGGATGCCCAC-1_V12D07-335_B1,1,0,0,0,0,1
CTGTCTGTGGCTGGCT-1_V12D07-335_B1,0,0,0,0,0,0
ATATTATCCCGTATTT-1_V12D07-335_B1,0,0,0,0,0,0
GCGCTGGCGGAAAGTC-1_V12D07-335_B1,0,0,0,0,0,0
ATCTAACGTCCCTATG-1_V12D07-335_B1,0,0,0,0,0,0
GTCAGACAGCGTTGGA-1_V12D07-335_B1,0,0,0,0,0,0
GCCAGGCTTAGTGGTA-1_V12D07-335_B1,0,0,0,0,0,0
ATTCAAAGTACCTGTT-1_V12D07-335_B1,0,0,0,0,0,0
TGGACGTAGGCGAATC-1_V12D07-335_B1,0,0,0,0,0,0
ACACATTGACGCAACA-1_V12D07-335_B1,0,0,2,0,0,2
GATATCAGTATGTATC-1_V12D07-335_B1,2,1,1,0,0,4
TGGGCCTTGCCTGCAT-1_V12D07-335_B1,0,0,1,0,0,1
CAAAGTCAGGTTAGCT-1_V12D07-335_B1,0,0,0,0,0,0
GGATCCCTACCAGCTA-1_V12D07-335_B1,0,0,0,0,0,0
ATCGTCCAATCGAGTC-1_V12D07-335_B1,1,0,2,0,0,3
ACATGGCTCAATTTAG-1_V12D07-335_B1,0,0,0,0,0,0
AGGCCCAGTGACTGGT-1_V12D07-335_B1,1,0,7,0,0,8
GCTTCCAGCTTAGATT-1_V12D07-335_B1,0,1,2,0,0,3
TGCTTGAAACCATGCA-1_V12D07-335_B1,1,0,3,0,0,4
CAATATTGGACTAGTG-1_V12D07-335_B1,0,0,5,0,0,5
CGTGCTGGCCTAGTCG-1_V12D07-335_B1,2,1,3,0,0,6
CCTGCGATAGAACTGT-1_V12D07-335_B1,0,0,1,0,0,1
GGGTAATGCTGTGTTT-1_V12D07-335_B1,0,0,2,0,0,2
AACGCGAACGGCAACA-1_V12D07-335_B1,1,0,6,0,0,7
TGTCGGCATGGTGGAA-1_V12D07-335_B1,0,3,1,0,0,4
AGCGTACGAGAGCTAG-1_V12D07-335_B1,2,0,2,0,0,4
ATACTCTCGCCACTCT-1_V12D07-335_B1,0,0,0,0,0,0
AATCCATGCAAGGGTG-1_V12D07-335_B1,1,2,0,0,0,3
TTAAACAGAGTCCCGC-1_V12D07-335_B1,1,0,3,0,0,4
CCACAGCTGAAATCAT-1_V12D07-335_B1,0,2,2,0,0,4
CGGTTCCGGCTTCTTG-1_V12D07-335_B1,0,2,4,0,0,6
GACGTGAGACTCCATG-1_V12D07-335_B1,0,0,4,0,0,4
TCGTTGGCTCGTCAAT-1_V12D07-335_B1,0,3,1,0,0,4
GGTGAACGGGCTAGCC-1_V12D07-335_B1,0,0,1,0,0,1
GCACTGTGCAAATGTA-1_V12D07-335_B1,0,1,3,0,0,4
ACGAGAACCCATCACG-1_V12D07-335_B1,0,1,4,0,0,5
CCAGCTACGCCTCATA-1_V12D07-335_B1,0,2,2,0,0,4
TCCCGGTCAGGAATTT-1_V12D07-335_B1,1,3,0,0,0,4
TCGCATTCAATGACTT-1_V12D07-335_B1,2,0,2,0,0,4
CTGGTTCAACGCATCA-1_V12D07-335_B1,1,0,1,0,0,2
GGTGATTTCATCTTGT-1_V12D07-335_B1,2,0,4,0,0,6
CACCCTTTCCTCGCTC-1_V12D07-335_B1,0,1,2,0,0,3
CAACTTGTAGTGGGCA-1_V12D07-335_B1,2,0,1,0,0,3
AATATCAAGGTCGGAT-1_V12D07-335_B1,1,0,1,0,0,2
ACTCAGACCTGCTTCT-1_V12D07-335_B1,3,0,2,0,0,5
TTGGAGTCTCCCTTCT-1_V12D07-335_B1,0,1,1,0,0,2
GGATACTCATGAATTG-1_V12D07-335_B1,3,5,1,0,0,9
TGGGCACAAACAGAAC-1_V12D07-335_B1,2,2,0,0,0,4
GAGCCACGGTAGTAGG-1_V12D07-335_B1,2,0,0,0,0,2
TCGATAGGCTAGTCGC-1_V12D07-335_B1,3,6,0,0,0,9
TAACCGCCCGCAGTGC-1_V12D07-335_B1,5,0,0,0,0,5
GCCTATTTGCTACACA-1_V12D07-335_B1,2,1,0,0,0,3
TTGACGATTCAGCACG-1_V12D07-335_B1,2,3,0,0,0,5
TTAAACCGGTAGCGAC-1_V12D07-335_B1,4,0,1,0,0,5
ACCGAAAGGGCCCTGC-1_V12D07-335_B1,2,0,2,0,0,4
ACGTTCCGCGCTCCGT-1_V12D07-335_B1,1,1,0,0,0,2
ATACCAGGCTAATAGA-1_V12D07-335_B1,2,0,1,0,0,3
CGGCTTTGTATGATAA-1_V12D07-335_B1,4,1,1,0,0,6
CTTGACCCGAAAGATA-1_V12D07-335_B1,1,1,2,0,0,4
CGCAGAAACATTTGCG-1_V12D07-335_B1,3,0,1,0,0,4
GACCCGTCGCCGGCTA-1_V12D07-335_B1,4,0,2,0,0,6
AATCGGGACACTACGA-1_V12D07-335_B1,1,0,1,0,0,2
GTCACAAAGTTTCCAA-1_V12D07-335_B1,3,0,4,0,0,7
TATATTCGCGTCGATA-1_V12D07-335_B1,0,0,5,0,0,5
CCTCCCGACAATCCCT-1_V12D07-335_B1,3,0,1,0,0,4
CGACATGCGATCTTCT-1_V12D07-335_B1,2,2,2,0,0,6
AACACGACTGTACTGA-1_V12D07-335_B1,0,1,2,0,0,3
CCCAACCACACTAACA-1_V12D07-335_B1,1,0,2,0,0,3
CACCGCCGACCAGCGA-1_V12D07-335_B1,0,0,1,0,0,1
TGGTATCGCATCCCAA-1_V12D07-335_B1,0,0,3,0,0,3
CAGAGTGATTTAACGT-1_V12D07-335_B1,0,2,4,0,0,6
AACCCTGGTGGAACCA-1_V12D07-335_B1,1,0,1,0,0,2
GTCAGTTGTGCTCGTT-1_V12D07-335_B1,0,0,2,0,0,2
ATTGACGTAACTCGGT-1_V12D07-335_B1,0,0,4,0,0,4
GATGTCGGTCAACTGC-1_V12D07-335_B1,1,0,4,0,0,5
AGGGCAGCGGCGTGGT-1_V12D07-335_B1,3,0,3,0,0,6
ACATCGTTAACCTAGT-1_V12D07-335_B1,0,1,5,0,0,6
TCCATTGTGACCTCGT-1_V12D07-335_B1,1,1,2,0,0,4
TGTTTAATACTTCATC-1_V12D07-335_B1,1,0,2,0,0,3
TTGCTGGCCGGGCTTC-1_V12D07-335_B1,0,0,2,0,0,2
CATATTATTTGCCCTA-1_V12D07-335_B1,2,0,1,0,0,3
CTGCCTAGCCACCAAG-1_V12D07-335_B1,0,0,1,0,0,1
ACGAGATATTTGCTTA-1_V12D07-335_B1,1,0,3,0,0,4
GACTACAATTGCTCGT-1_V12D07-335_B1,0,0,3,0,0,3
AACGTGATGAAGGACA-1_V12D07-335_B1,2,0,0,0,0,2
ACTCTCTTATACACGA-1_V12D07-335_B1,2,2,1,2,0,7
CGCATCATGGCTTCAG-1_V12D07-335_B1,0,0,0,0,0,0
CGGCTCTTCGTCGAAC-1_V12D07-335_B1,0,0,2,0,0,2
ATTCTTCGTACTTATG-1_V12D07-335_B1,2,0,0,0,0,2
AGTGAGGGTTTCTGAC-1_V12D07-335_B1,1,0,2,0,0,3
GCCAGGCGTTCGCATG-1_V12D07-335_B1,4,0,0,1,0,5
GACTAACACAGCACCT-1_V12D07-335_B1,1,0,6,1,0,8
CAATGGAATCTACATA-1_V12D07-335_B1,1,0,3,0,0,4
GTGGTCAGCGAAGTAT-1_V12D07-335_B1,2,0,0,0,0,2
ATGGCTGGAAATGGCC-1_V12D07-335_B1,4,0,2,1,0,7
ATCAGGTCGCCATTGC-1_V12D07-335_B1,0,0,3,1,0,4
TATCACCATGTAAAGT-1_V12D07-335_B1,0,0,0,0,0,0
AGCGCTTATGGGCAAG-1_V12D07-335_B1,1,1,4,1,0,7
AAGCGGCGTCATGGGT-1_V12D07-335_B1,1,0,6,0,0,7
ACTAATACGTCAGGCG-1_V12D07-335_B1,0,0,2,0,0,2
GGCTGAGCATCGTAAG-1_V12D07-335_B1,1,0,1,0,0,2
CGGTTGGGTTCAAGTT-1_V12D07-335_B1,1,0,5,0,0,6
GACTGATTGGTCACAA-1_V12D07-335_B1,0,0,0,0,0,0
AGACGGGCCGATTTAA-1_V12D07-335_B1,0,0,0,0,0,0
ACCAGTGCCCGGTCAA-1_V12D07-335_B1,0,0,1,0,0,1
GTCCTTTAATGACTTC-1_V12D07-335_B1,2,0,1,0,0,3
CCTACAAGTCCGGAAT-1_V12D07-335_B1,1,0,2,0,0,3
GCCTGCTACACTGAGA-1_V12D07-335_B1,2,0,0,0,0,2
GACTCGGTCGGCGGAT-1_V12D07-335_B1,1,0,0,0,0,1
CTAGACATATATGTAG-1_V12D07-335_B1,2,1,3,0,0,6
TCGCCCAACTGACTCC-1_V12D07-335_B1,2,0,1,0,0,3
AAACTAACGTGGCGAC-1_V12D07-335_B1,2,0,1,0,0,3
AACTGAGGTCAGCGTC-1_V12D07-335_B1,0,0,0,0,0,0
ACAATGATTCTTCTAC-1_V12D07-335_B1,1,0,0,0,0,1
ATAAGTACCCGATTGT-1_V12D07-335_B1,1,0,0,0,0,1
ATTGGGAGTTCTGTAA-1_V12D07-335_B1,2,1,2,0,0,5
CGAACATAGTCAGAAA-1_V12D07-335_B1,2,0,0,0,0,2
TAGCTCAGATCCTAGT-1_V12D07-335_B1,0,0,2,0,0,2
GTGTCGTATTCACCTT-1_V12D07-335_B1,2,0,4,0,0,6
CTCACCGATCCAAACT-1_V12D07-335_B1,0,0,0,0,0,0
ATATGTGCACAAACCA-1_V12D07-335_B1,3,0,0,1,0,4
CAGTCCAACGCCTTCT-1_V12D07-335_B1,2,0,4,1,0,7
TCGTCCGGGTACACTC-1_V12D07-335_B1,1,0,0,0,0,1
GCAGAAACGTAATCCA-1_V12D07-335_B1,3,0,0,0,0,3
TTCGAGCCGGCGCTAC-1_V12D07-335_B1,1,0,0,0,0,1
GGAAGATAAGACTGTA-1_V12D07-335_B1,1,0,1,1,0,3
ATAAGCAAACACCGAG-1_V12D07-335_B1,1,0,0,0,0,1
GCATAAATTGAACGCC-1_V12D07-335_B1,1,0,1,0,0,2
CGCCGGTGTCGCAGTA-1_V12D07-335_B1,4,0,1,0,0,5
GACCTGGTCTGGGCGT-1_V12D07-335_B1,0,0,0,0,0,0
AGCCGCTTGATTAGCG-1_V12D07-335_B1,0,0,0,0,0,0
CCCGGCTAGGTGAGAA-1_V12D07-335_B1,0,0,0,0,0,0
CGAGCCGAGCACTCGA-1_V12D07-335_B1,0,0,0,0,0,0
TAGTGCTTGAATCCTT-1_V12D07-335_B1,0,0,0,0,0,0
CAACCGCACCTAGACA-1_V12D07-335_B1,0,0,0,0,0,0
ACCACTGTTCAAGAAG-1_V12D07-335_B1,0,0,0,0,0,0
AGATGCTATAACGAGC-1_V12D07-335_B1,0,0,0,0,0,0
AATTACTCGTACGCTC-1_V12D07-335_B1,1,1,2,0,0,4
CGTCAATCTTTAACAT-1_V12D07-335_B1,0,0,5,0,0,5
CCAAAGCAGTTGGTTG-1_V12D07-335_B1,0,1,5,0,0,6
CCATATTGGATCATGA-1_V12D07-335_B1,2,2,3,0,0,7
CGTACCGAAAGTCTAG-1_V12D07-335_B1,0,0,1,0,0,1
CTCGAGATCCAAAGCA-1_V12D07-335_B1,0,0,0,0,0,0
TGGATAGAGTAACAGA-1_V12D07-335_B1,0,0,3,0,0,3
TCACAGATCCTCAAAC-1_V12D07-335_B1,0,0,1,0,0,1
AGAGCTACGAAAGCAT-1_V12D07-335_B1,0,1,1,0,0,2
TGCGTGATTGGGTGTC-1_V12D07-335_B1,2,0,2,0,0,4
CACATGTTTGGACATG-1_V12D07-335_B1,1,0,3,0,0,4
TTCGCATCCGGAAGCA-1_V12D07-335_B1,0,2,3,0,0,5
CCCTAGTGTCAGGTGT-1_V12D07-335_B1,2,1,1,0,0,4
TTACCGCCTTAGGGAA-1_V12D07-335_B1,1,0,4,0,0,5
CCAGTCCATTATTCGA-1_V12D07-335_B1,0,0,1,0,0,1
CGTAAACGCTTGAGTG-1_V12D07-335_B1,1,1,2,0,0,4
ATTCCTTCCAGGCGGT-1_V12D07-335_B1,0,5,0,0,0,5
TTCCTTTCTGTGTTGC-1_V12D07-335_B1,1,2,6,0,0,9
AGTTGACATCGGCTGG-1_V12D07-335_B1,0,0,2,0,0,2
AACTCGATGGCGCAGT-1_V12D07-335_B1,2,3,0,0,0,5
GATAAGGCAGATGCAA-1_V12D07-335_B1,0,3,1,0,0,4
GGCTGGCTAGCTTAAA-1_V12D07-335_B1,3,0,1,0,0,4
CCTCATGCAGCTACGA-1_V12D07-335_B1,0,0,1,0,0,1
GACGCCTGTTGCAGGG-1_V12D07-335_B1,0,0,5,0,0,5
TAATTAGATGGATATG-1_V12D07-335_B1,0,0,1,0,0,1
GAGGGCATCGCGTATC-1_V12D07-335_B1,1,1,0,0,0,2
CTTGTGAGTCTTTGAC-1_V12D07-335_B1,4,0,2,0,0,6
TCAACACATTGGGTAA-1_V12D07-335_B1,1,0,2,0,0,3
ACTGTATACGCGAGCA-1_V12D07-335_B1,0,0,1,0,0,1
GTGAAACGTGCTCCAC-1_V12D07-335_B1,0,0,1,0,0,1
CGAGTGCTATAGTTCG-1_V12D07-335_B1,1,1,1,0,0,3
GTACTGCATGAAGCGT-1_V12D07-335_B1,1,0,3,0,0,4
GTAACTTGCGGCAGTC-1_V12D07-335_B1,0,1,4,0,0,5
GAATCGCCGGACACGG-1_V12D07-335_B1,1,0,1,0,0,2
GGGAGTAATGGCTGGC-1_V12D07-335_B1,2,0,0,0,0,2
CATGAACCGACATTTG-1_V12D07-335_B1,0,1,2,0,0,3
TCTGTCATACAAGAGC-1_V12D07-335_B1,2,2,0,0,0,4
GTCGTCAATTATAAGG-1_V12D07-335_B1,0,1,0,0,0,1
TAAAGAGCCCGAAACC-1_V12D07-335_B1,4,1,0,0,0,5
GTACTGAGGTCGTAAC-1_V12D07-335_B1,2,2,0,0,0,4
AAAGACCCAAGTCGCG-1_V12D07-335_B1,0,1,1,0,0,2
CGTCAGTGCGCACAAG-1_V12D07-335_B1,3,3,1,0,0,7
TGTATCCTTATTCCAT-1_V12D07-335_B1,3,0,3,0,0,6
ATTCTCGTCTCTTTAG-1_V12D07-335_B1,3,1,0,0,0,4
AAAGTCACTGATGTAA-1_V12D07-335_B1,3,1,0,0,0,4
TGTCTACAGTTTCTGT-1_V12D07-335_B1,2,2,2,0,0,6
TTAACGTCGCAAGACC-1_V12D07-335_B1,3,1,2,0,0,6
CTATGTCTATTGAAAC-1_V12D07-335_B1,1,2,2,0,0,5
TCGGGTGAAACTGCTA-1_V12D07-335_B1,2,0,0,0,0,2
TGTCCCGACATAGCAC-1_V12D07-335_B1,1,0,0,0,0,1
ACAGCATAGAGCCAGT-1_V12D07-335_B1,1,0,0,0,0,1
ATATTCCCACAGGTCA-1_V12D07-335_B1,1,1,0,0,0,2
TTGGATCGACTTCTGG-1_V12D07-335_B1,1,0,1,0,0,2
CACCATCGGAGGAGAC-1_V12D07-335_B1,2,1,0,0,0,3
TCGTTCGTTATTATGT-1_V12D07-335_B1,1,3,3,0,0,7
CTTAACTTCGAAGTAC-1_V12D07-335_B1,0,0,4,0,0,4
GCACAAGTGTCGGAAG-1_V12D07-335_B1,2,1,4,0,0,7
TACCAGCTAGGTTTAA-1_V12D07-335_B1,0,0,3,0,0,3
ACGTACAGATTTCTCT-1_V12D07-335_B1,0,0,3,0,0,3
AATTTGGTTCCAAAGA-1_V12D07-335_B1,0,0,1,0,0,1
GTAAGGATTTGTCGGA-1_V12D07-335_B1,1,0,2,0,0,3
CATCATCTACCCGGAC-1_V12D07-335_B1,0,0,4,0,0,4
ACGATGGATCCGATGC-1_V12D07-335_B1,0,1,1,0,0,2
CACTCAGCTCTTGAGG-1_V12D07-335_B1,0,1,5,0,0,6
TAGATCCGAAGTCGCA-1_V12D07-335_B1,1,1,6,0,0,8
TGAAACTTATGCAAGC-1_V12D07-335_B1,1,1,3,0,0,5
GCGATTCTGGAAGCAG-1_V12D07-335_B1,0,1,2,0,0,3
CAAACTATTGAGCTTC-1_V12D07-335_B1,0,0,1,0,0,1
TAGAATTAAGGGCAAC-1_V12D07-335_B1,0,0,6,0,0,6
CGAAACATAGATGGCA-1_V12D07-335_B1,0,1,4,0,0,5
GATGGTGCCCTAGGCA-1_V12D07-335_B1,0,0,1,0,0,1
CCCGCAGGGCCCAAAG-1_V12D07-335_B1,0,0,5,0,0,5
ACAGCGCACCCGCAGC-1_V12D07-335_B1,1,0,0,2,0,3
GGTAAATGTGCGTTAC-1_V12D07-335_B1,0,0,3,2,0,5
GTCCTTCTAGTGGGTT-1_V12D07-335_B1,0,0,0,0,0,0
GGAAGCTCGCTTACAG-1_V12D07-335_B1,1,0,1,0,0,2
CACCGATACACCGAGC-1_V12D07-335_B1,1,0,0,0,0,1
CAGCCGGGCCCTCTAT-1_V12D07-335_B1,0,0,1,0,0,1
CGGAGCTTATAACACC-1_V12D07-335_B1,1,0,0,0,0,1
ATTACAACTACCGGCC-1_V12D07-335_B1,1,0,0,0,0,1
TCCTCTGGCCCATTAG-1_V12D07-335_B1,2,0,2,0,0,4
CGGCACCGTTAGCGCC-1_V12D07-335_B1,2,0,2,1,0,5
TCGGTCCCTGACTCCA-1_V12D07-335_B1,1,0,3,0,0,4
TGGTTGGAGGATCCTG-1_V12D07-335_B1,2,0,0,0,0,2
CTGCGGTAGTCACGTG-1_V12D07-335_B1,2,0,0,0,0,2
GTGCCTCAGTGTACGG-1_V12D07-335_B1,0,0,2,0,0,2
ATCGTTCACTTTCGCC-1_V12D07-335_B1,0,0,0,0,0,0
ACTTACCGGGCGCGCA-1_V12D07-335_B1,0,0,0,0,0,0
CTAGACTGCATTTCGT-1_V12D07-335_B1,1,0,4,0,0,5
TTGCCGGTGATCCCTC-1_V12D07-335_B1,2,0,1,0,0,3
CTGTCACGCCAGGCGC-1_V12D07-335_B1,2,1,0,0,0,3
CGGTATAGGTATTAGC-1_V12D07-335_B1,2,0,1,0,0,3
CCAACGCTTGCCAGGG-1_V12D07-335_B1,0,0,0,0,0,0
CGTTGAGTAATTGCGT-1_V12D07-335_B1,2,0,0,0,0,2
TGTATTTACCTAATGC-1_V12D07-335_B1,0,0,0,0,0,0
TAAATGCCGTCTCATG-1_V12D07-335_B1,1,0,0,0,0,1
CGGTTTATGAAGGAAC-1_V12D07-335_B1,1,0,0,0,0,1
GCAAGATGTGTTCGCG-1_V12D07-335_B1,1,0,2,0,0,3
AAAGGTAAGCTGTACC-1_V12D07-335_B1,0,0,0,0,0,0
GTACGTCACGTATTAA-1_V12D07-335_B1,2,0,1,0,0,3
AGTACCTTCGAGTGCT-1_V12D07-335_B1,1,0,0,0,0,1
ATTGTGACTTCGCTGC-1_V12D07-335_B1,3,0,1,0,0,4
TGTATCAGACTGAAGC-1_V12D07-335_B1,1,0,2,1,0,4
GAGACCCTGCAACGCC-1_V12D07-335_B1,1,0,0,0,0,1
TGGGTGGGATGTCATT-1_V12D07-335_B1,0,0,0,0,0,0
GGCTAATGATTGAAAT-1_V12D07-335_B1,3,0,0,1,0,4
ATAACGTTACCTCCAC-1_V12D07-335_B1,1,0,0,0,0,1
TGCGAGATGGCGGCCA-1_V12D07-335_B1,0,0,0,1,0,1
CACACTTGTATTGCGA-1_V12D07-335_B1,1,0,0,0,0,1
GCTGGTGACTCGTAGT-1_V12D07-335_B1,2,0,0,0,1,3
CGACACCGCTTAAGGA-1_V12D07-335_B1,1,0,2,1,0,4
GTAACAACTGACCTTG-1_V12D07-335_B1,1,0,1,0,2,4
CAACTGAGGGTATGAC-1_V12D07-335_B1,1,0,0,1,0,2
CTAATTATGAAGCGTA-1_V12D07-335_B1,0,0,0,0,0,0
CCGATCTTAAGAGGCT-1_V12D07-335_B1,1,0,2,0,0,3
CGACTCGGTACACGGT-1_V12D07-335_B1,0,0,0,0,0,0
TGCTGCGTCAGAGTTA-1_V12D07-335_B1,0,0,0,0,0,0
AGAGTTGCAGGCCTCC-1_V12D07-335_B1,1,0,2,0,0,3
ACTGGCGAACCTGCGT-1_V12D07-335_B1,1,0,0,0,0,1
ACTAAGGACGCACACC-1_V12D07-335_B1,3,0,2,0,0,5
CGTCCAGATGGCTCCA-1_V12D07-335_B1,0,0,0,0,0,0
ACTATCGCCGGCTAAA-1_V12D07-335_B1,0,0,0,0,0,0
GATAGCGTACCACGCG-1_V12D07-335_B1,0,0,0,0,0,0
AGGACTTATAGGAGAA-1_V12D07-335_B1,0,0,0,0,0,0
TAGTCGGGATTCTTCG-1_V12D07-335_B1,0,0,0,0,0,0
ACCATTAAGGGTGTCA-1_V12D07-335_B1,0,0,0,0,0,0
TTAATGTGTTTGCAGG-1_V12D07-335_B1,0,0,0,0,0,0
TCCGCAGCCACCTAGC-1_V12D07-335_B1,1,0,0,0,0,1
GAGGAGATCCTCATGC-1_V12D07-335_B1,2,1,1,0,0,4
GGTCCTTCATACGACT-1_V12D07-335_B1,1,0,1,0,0,2
CCCTGTTGGCAAAGAC-1_V12D07-335_B1,0,2,0,0,0,2
GTGCCTAGCTATGCTT-1_V12D07-335_B1,1,0,5,0,0,6
GTCATCTCCTACAGCT-1_V12D07-335_B1,1,0,2,0,0,3
GCGAGAAACGGGAGTT-1_V12D07-335_B1,3,0,2,0,0,5
CGTCGCGGCGGGATTT-1_V12D07-335_B1,1,0,0,0,0,1
CATTGTGTGCTAGATC-1_V12D07-335_B1,1,0,1,0,0,2
CGCGGCAGTATTACGG-1_V12D07-335_B1,1,1,3,0,0,5
GAAATGGGATGTAAAC-1_V12D07-335_B1,0,1,3,0,0,4
CATTCCCTAAGTACAA-1_V12D07-335_B1,0,0,2,0,0,2
AGTTCTGCGTTGTATC-1_V12D07-335_B1,0,0,1,0,0,1
ACCCTATAGGACTGAG-1_V12D07-335_B1,0,0,0,0,0,0
TTAGATAGGTCGATAC-1_V12D07-335_B1,1,1,6,0,0,8
ATTGATAGCAACGAGA-1_V12D07-335_B1,0,2,1,0,0,3
TCTCGGCTCCAGGACT-1_V12D07-335_B1,1,0,3,0,0,4
CTTGAGGTTATCCCGA-1_V12D07-335_B1,0,0,3,0,0,3
AAGAAGGATCAGTTAG-1_V12D07-335_B1,2,0,2,0,0,4
GTACGACGGCGCTGCG-1_V12D07-335_B1,2,0,2,0,0,4
CTTATGTTGACTACCA-1_V12D07-335_B1,1,0,1,0,0,2
CGGCACTCAAGAAAGT-1_V12D07-335_B1,0,0,0,0,0,0
GTCAAAGTTTACATAG-1_V12D07-335_B1,1,1,0,0,0,2
CTCCTAAGTTATGTCT-1_V12D07-335_B1,0,2,1,0,0,3
ACTGTGCTAGTAGATC-1_V12D07-335_B1,1,1,1,0,0,3
GTTTGGCCGCTCAGCG-1_V12D07-335_B1,0,1,0,0,0,1
TTATCCAATCGAACTC-1_V12D07-335_B1,2,1,4,0,0,7
CCGTACCCAAGCGCCA-1_V12D07-335_B1,2,0,1,0,0,3
CATACAAAGCCGAACC-1_V12D07-335_B1,1,1,3,0,0,5
GGTCGGTAATTAGACA-1_V12D07-335_B1,1,0,2,0,0,3
AGCGGGAAGGGTCCAT-1_V12D07-335_B1,2,1,3,0,0,6
GCCCACCAAGGCTGTC-1_V12D07-335_B1,0,0,2,1,0,3
GTAGACGTCGTTACAT-1_V12D07-335_B1,2,0,3,0,0,5
GAGCATCATCCCTGGG-1_V12D07-335_B1,0,0,5,0,0,5
AGGTAACCTCCTATTC-1_V12D07-335_B1,0,0,1,0,0,1
GGTTTGAGTGCTGGAA-1_V12D07-335_B1,0,1,3,0,0,4
GCACTAGTCGCGCTAT-1_V12D07-335_B1,1,1,3,0,0,5
GGTAACTATGTATCTG-1_V12D07-335_B1,1,0,0,0,0,1
GCGGTCCCTAGACGCA-1_V12D07-335_B1,2,1,0,0,0,3
CGAGCGTTGATCAGCC-1_V12D07-335_B1,0,1,5,0,0,6
AATCCAAGGGCCTGAG-1_V12D07-335_B1,0,1,2,0,0,3
CCGTGCCCATGACGGC-1_V12D07-335_B1,3,0,1,0,0,4
GAAATTCACATCGCTG-1_V12D07-335_B1,0,1,3,0,0,4
CTCTGCGAAGCAAGCA-1_V12D07-335_B1,0,4,3,0,0,7
AGTAGGTAACATACAT-1_V12D07-335_B1,0,1,3,0,0,4
ATTGGGAATATCTTGG-1_V12D07-335_B1,0,1,3,0,0,4
TAGAGCTACGAAGAAC-1_V12D07-335_B1,0,0,1,0,0,1
TGCGGCATAGTTCAAC-1_V12D07-335_B1,1,3,0,0,0,4
CCGCCGGTCAACACAC-1_V12D07-335_B1,0,2,3,0,0,5
TCGTATAGTGCAATTA-1_V12D07-335_B1,5,0,0,0,0,5
TAGTTTATTCTTGCTT-1_V12D07-335_B1,0,1,2,0,0,3
GATATCTCATGCAATA-1_V12D07-335_B1,1,0,1,0,0,2
CGTTTAAGCGGAGCAC-1_V12D07-335_B1,0,0,1,0,0,1
CATGCTGGCTCCAATT-1_V12D07-335_B1,1,0,3,0,0,4
GAAACAGCCATGCAGT-1_V12D07-335_B1,0,0,2,0,0,2
AGTTTCGCAGGTCGGA-1_V12D07-335_B1,0,0,2,0,0,2
CTCATGGCTCACAATC-1_V12D07-335_B1,1,1,0,0,0,2
AACCGTTGTGTTTGCT-1_V12D07-335_B1,1,0,2,0,0,3
ACCCTTCATCTGCGAA-1_V12D07-335_B1,0,0,5,0,0,5
TGCGGTGAAATTTCAT-1_V12D07-335_B1,1,0,3,0,0,4
CAAATTGTCAGCAAGC-1_V12D07-335_B1,1,1,3,0,0,5
GAGGTACATCCATCTT-1_V12D07-335_B1,0,1,1,0,0,2
AAATGGCATGTCTTGT-1_V12D07-335_B1,0,0,1,0,0,1
TCATCCCAGAGGGTGG-1_V12D07-335_B1,0,0,5,0,0,5
CGTAGCGAATTGTCAG-1_V12D07-335_B1,2,1,2,0,0,5
CCTAGTTAGTCGCATG-1_V12D07-335_B1,0,0,1,0,0,1
GAAACTCTAATGAAGG-1_V12D07-335_B1,2,1,2,0,0,5
TTGTATCACACAGAAT-1_V12D07-335_B1,2,0,2,0,0,4
TTCAAGCCGAGCTGAG-1_V12D07-335_B1,0,0,0,0,0,0
AGGTACGATATTGCCA-1_V12D07-335_B1,1,0,2,0,0,3
TTAAGCCGACAACTTC-1_V12D07-335_B1,5,1,1,0,0,7
GTCTTAGTACAGCCGG-1_V12D07-335_B1,2,0,2,0,0,4
TGGGTAAGGTTCCCGC-1_V12D07-335_B1,3,0,2,0,0,5
CTACGCCATTTCCGAT-1_V12D07-335_B1,1,0,1,0,0,2
GACCGTCAGGTCGTGA-1_V12D07-335_B1,1,0,3,0,0,4
TAGTTAAGATAGGATA-1_V12D07-335_B1,2,0,1,1,0,4
GAATATTCGGAGTCCC-1_V12D07-335_B1,4,0,2,0,0,6
CAAACTACGATAGAGA-1_V12D07-335_B1,0,1,2,0,0,3
CAGGAAGACTTTATAT-1_V12D07-335_B1,1,0,1,0,0,2
TTCGTAATCCCAGCGG-1_V12D07-335_B1,0,0,4,0,0,4
GTGAGGAGCGGTTGAG-1_V12D07-335_B1,1,0,4,0,0,5
CAATCCCTATACCAGC-1_V12D07-335_B1,1,0,1,0,0,2
AGGGAAACGAGGTACT-1_V12D07-335_B1,1,0,1,0,0,2
TCCTGCCAACTGGAGA-1_V12D07-335_B1,1,1,3,1,0,6
AATTTGGGACATAGTA-1_V12D07-335_B1,1,0,1,0,0,2
AACTCCTAATCCCATG-1_V12D07-335_B1,2,0,0,1,0,3
GCTCATTACTGCATGT-1_V12D07-335_B1,2,0,2,0,0,4
TCTCGAACGAGGTCAC-1_V12D07-335_B1,2,0,0,0,0,2
TCACTACGACCAATGC-1_V12D07-335_B1,2,1,2,0,0,5
GTGATGCACAACATCT-1_V12D07-335_B1,3,0,2,0,0,5
CCGACGTAAACACAAC-1_V12D07-335_B1,2,0,0,0,0,2
TGGGATGCACTCATTC-1_V12D07-335_B1,2,0,0,0,0,2
TTCCATCATGCGGTGA-1_V12D07-335_B1,1,0,0,0,0,1
TGCACAGTGAAGTTAT-1_V12D07-335_B1,0,0,1,0,0,1
CTATTGTGTTTGGTCA-1_V12D07-335_B1,1,0,0,0,0,1
TGCGAGCCCTTCCGCG-1_V12D07-335_B1,2,0,0,0,0,2
TTGAAAGGTGTAAAGG-1_V12D07-335_B1,3,0,0,0,0,3
GGTGCAGAGCCTATCG-1_V12D07-335_B1,0,0,1,0,0,1
ACTATATGCTGTGTTC-1_V12D07-335_B1,0,0,2,0,0,2
TCCTGGCGCTGCCTGG-1_V12D07-335_B1,0,0,2,0,0,2
GAGCCGAGCGTTTATT-1_V12D07-335_B1,1,0,2,1,0,4
AGAATGCGGGTTCGGA-1_V12D07-335_B1,2,0,1,0,0,3
ATGCGACAATTGGTCC-1_V12D07-335_B1,2,0,3,0,0,5
TTCCGGCTCGACTTCT-1_V12D07-335_B1,2,0,2,0,0,4
TGATTATGGCACGCAG-1_V12D07-335_B1,0,0,0,0,0,0
GGTTTGACAAGAAGCT-1_V12D07-335_B1,0,0,0,0,0,0
GCAGCTATGGACAGGT-1_V12D07-335_B1,1,0,0,0,0,1
CACCATGATCGCAAAG-1_V12D07-335_B1,0,0,1,0,0,1
GTCGGAAGGATACCAG-1_V12D07-335_B1,1,2,2,0,0,5
GGCCCAGTTATCAGCA-1_V12D07-335_B1,1,0,2,1,1,5
GGGCCTATTTAAGTAT-1_V12D07-335_B1,0,0,3,0,0,3
GTTGTTACATTGCGCT-1_V12D07-335_B1,2,0,1,0,0,3
CAACTCCGTAACTTGC-1_V12D07-335_B1,2,0,4,0,0,6
GATCTTTGCTCAAAGA-1_V12D07-335_B1,0,0,1,0,0,1
TCGCTTAATTACGAAG-1_V12D07-335_B1,0,0,0,0,0,0
CGATCATTAGAGGCAC-1_V12D07-335_B1,1,0,3,1,0,5
TGTTCTCTACTCCCTA-1_V12D07-335_B1,3,0,1,0,0,4
GCTTAGGGAAGCGGTA-1_V12D07-335_B1,3,0,1,0,0,4
CAGGTTTAGTACTACA-1_V12D07-335_B1,0,0,2,0,0,2
AAGCGGAGTGCGCGCA-1_V12D07-335_B1,3,0,1,0,0,4
TCAGATGGAGACGTAG-1_V12D07-335_B1,0,0,1,0,0,1
TCGCACTAACGTTTGT-1_V12D07-335_B1,0,0,0,0,0,0
CACGTCGGGTTCTAGA-1_V12D07-335_B1,0,0,0,0,0,0
GGAGTACACATGAGCT-1_V12D07-335_B1,0,0,0,0,0,0
GTGTGTCGACGTCGCT-1_V12D07-335_B1,0,0,0,0,0,0
GAAGCTCTTTGCTTAG-1_V12D07-335_B1,0,0,0,0,0,0
ACACCGAGCGCTCTTT-1_V12D07-335_B1,0,0,0,0,0,0
CGTAATAATTACGAGT-1_V12D07-335_B1,0,0,0,0,0,0
CATCAACACCTACTAA-1_V12D07-335_B1,0,0,0,0,0,0
CCAAGTTTCTACAGAT-1_V12D07-335_B1,1,1,1,0,0,3
ACGGGTCATGTGACTT-1_V12D07-335_B1,0,4,4,0,0,8
AGTGTGCTAAGATCGC-1_V12D07-335_B1,0,0,1,0,0,1
GGCGGTTTGCCGGTGC-1_V12D07-335_B1,1,1,4,0,0,6
GTATAATCTCCCGGAT-1_V12D07-335_B1,0,1,3,0,0,4
TAGTCCGTATGCATAA-1_V12D07-335_B1,0,0,5,0,0,5
CACTTCGTCTTATCTC-1_V12D07-335_B1,2,0,6,0,0,8
CATCCGCAGGCCCGAA-1_V12D07-335_B1,0,4,0,0,0,4
CCCTGATGTAACTCGT-1_V12D07-335_B1,0,0,4,0,0,4
CCATAGTCAGTAACCC-1_V12D07-335_B1,0,1,0,0,0,1
CGGGCCATAGCCGCAC-1_V12D07-335_B1,2,0,2,0,0,4
CTCCGGCTTGTAGACA-1_V12D07-335_B1,0,0,1,0,0,1
AACTTGCGTTCTCGCG-1_V12D07-335_B1,1,1,3,0,0,5
AATGAGTTCGCATATG-1_V12D07-335_B1,1,0,2,0,0,3
CGAGGCCAGGCATTGG-1_V12D07-335_B1,0,3,3,0,0,6
TCTGCGTCCGGTTTCT-1_V12D07-335_B1,1,0,1,0,0,2
CAATCCTGCCGTGGAG-1_V12D07-335_B1,2,0,1,0,0,3
CTGAGCAAGTAACAAG-1_V12D07-335_B1,0,5,5,0,0,10
GGGTACCCACGGTCCT-1_V12D07-335_B1,1,0,3,0,0,4
ACGGAATTTAGCAAAT-1_V12D07-335_B1,1,1,0,0,0,2
GGGCGGTCCTATTGTC-1_V12D07-335_B1,2,0,0,0,0,2
ATGTTACGAGCAATAC-1_V12D07-335_B1,0,1,2,0,0,3
AACCATGGGATCGCTA-1_V12D07-335_B1,2,1,1,0,0,4
TCGCATCCCTAAGTGT-1_V12D07-335_B1,0,1,1,0,0,2
ACTTAGTACGACAAGA-1_V12D07-335_B1,0,0,1,0,0,1
GAGCTCTCGGACCTAA-1_V12D07-335_B1,1,0,0,0,0,1
TCTATTACGCTGGCGA-1_V12D07-335_B1,0,0,0,0,0,0
AGATACGACTTCATAT-1_V12D07-335_B1,1,0,2,0,0,3
CGCTATACCGCCCACT-1_V12D07-335_B1,5,0,2,0,0,7
CAGTGTCCGCAGAATG-1_V12D07-335_B1,0,1,6,0,0,7
CCATCCATACCAAGTC-1_V12D07-335_B1,2,1,2,0,0,5
AACCCAGAGACGGAGA-1_V12D07-335_B1,0,0,1,0,0,1
GAAGAACGGTGCAGGT-1_V12D07-335_B1,1,0,3,0,0,4
GATAAATCGGTGGATG-1_V12D07-335_B1,1,0,0,0,0,1
CAGCTCGTGCTTGTGT-1_V12D07-335_B1,0,1,2,0,0,3
GAGTACGGGTATACAA-1_V12D07-335_B1,0,0,4,0,0,4
CATCGCCCGCGGCCAA-1_V12D07-335_B1,1,0,3,0,0,4
TCTTACAGAGGTACCG-1_V12D07-335_B1,1,1,0,0,0,2
TGGAAGACGAACACCA-1_V12D07-335_B1,1,1,3,0,0,5
GTTGTCGTGTTAGTTG-1_V12D07-335_B1,0,0,4,0,0,4
CCAAGGAACAGAGAGG-1_V12D07-335_B1,1,0,1,0,0,2
CTGCACCTGGAACCGC-1_V12D07-335_B1,0,0,0,0,0,0
CGCTTTCATACCGGTG-1_V12D07-335_B1,0,1,1,0,1,3
GTTCTTCCCTCGATGT-1_V12D07-335_B1,2,0,2,0,0,4
ATTTAACTCGTATTAC-1_V12D07-335_B1,0,1,3,0,0,4
AACGATAGAAGGGCCG-1_V12D07-335_B1,2,0,5,0,0,7
TATCCTGCATGGGAAT-1_V12D07-335_B1,0,2,2,0,0,4
AGGCCCATTGTACAGG-1_V12D07-335_B1,0,1,3,0,0,4
CCGGCGCATATTGGAT-1_V12D07-335_B1,2,0,0,0,0,2
ATCTGTAATTGTACCC-1_V12D07-335_B1,0,0,2,0,0,2
GAGCGAGGGAGTACCG-1_V12D07-335_B1,1,1,4,0,0,6
TTATTAGGGAAGCATC-1_V12D07-335_B1,1,0,1,0,0,2
CTTCTTACGTCGTATA-1_V12D07-335_B1,0,0,0,0,0,0
GAAGTGCTGGATAGCT-1_V12D07-335_B1,2,1,3,0,0,6
GTGCAACAAATGTGGC-1_V12D07-335_B1,0,0,3,0,0,3
CATGCGTTAGACAGAA-1_V12D07-335_B1,0,0,3,0,0,3
ACACACTTTCTACACG-1_V12D07-335_B1,1,0,3,0,0,4
AGCCCTAAGCGAAGTT-1_V12D07-335_B1,1,0,3,0,0,4
ATTAATTCGGTCACTC-1_V12D07-335_B1,1,0,1,0,0,2
AACAGGAAATCGAATA-1_V12D07-335_B1,0,1,2,0,0,3
ACGTTTAGTTGTGATC-1_V12D07-335_B1,1,0,3,0,0,4
TCCTTCAGTGGTCGAA-1_V12D07-335_B1,1,0,4,0,0,5
CGAACGCCCAGTGCCG-1_V12D07-335_B1,0,2,3,0,0,5
CCTCGAAGTGGACGGG-1_V12D07-335_B1,0,1,1,0,0,2
CTCTGTTTGAGGATTC-1_V12D07-335_B1,0,0,3,0,0,3
TGGGCACGTTCTATGG-1_V12D07-335_B1,1,0,1,0,0,2
ACTATTCGTCCGTGGT-1_V12D07-335_B1,0,1,0,0,0,1
CCTCTGGCCTAGACGG-1_V12D07-335_B1,0,0,0,0,0,0
CCATAAACAACCCGAC-1_V12D07-335_B1,1,1,0,0,0,2
CATAGTACATTGAGAG-1_V12D07-335_B1,2,1,2,1,0,6
ATTTCATTATTTCGCG-1_V12D07-335_B1,2,0,2,0,0,4
CAACTATATCGAATGC-1_V12D07-335_B1,3,0,0,1,0,4
CTAGTATTCGGAATTA-1_V12D07-335_B1,2,0,1,0,0,3
GTGGAACCTACATGCG-1_V12D07-335_B1,1,0,4,3,0,8
CCTAAAGGCTGACGCT-1_V12D07-335_B1,0,0,0,0,0,0
CGTGACATTGGGTCGT-1_V12D07-335_B1,1,0,1,0,0,2
CCAATCGGTAGATCGA-1_V12D07-335_B1,0,0,1,0,0,1
ATTGTCGCAATACCTT-1_V12D07-335_B1,4,0,0,0,0,4
AAATTACACGACTCTG-1_V12D07-335_B1,0,1,1,0,0,2
CACTCCTCTCGGTCGG-1_V12D07-335_B1,0,0,3,2,0,5
AAATAACCATACGGGA-1_V12D07-335_B1,1,0,0,0,0,1
AGTTACTCTATCGTGG-1_V12D07-335_B1,0,0,1,0,0,1
CGTTAGCTCACAACTG-1_V12D07-335_B1,1,0,1,0,0,2
GAATGTATGGCAGGTC-1_V12D07-335_B1,0,0,0,0,0,0
GCAACCACCAGACCGG-1_V12D07-335_B1,2,0,0,0,0,2
TCACTCGTGCAACGGC-1_V12D07-335_B1,0,1,1,0,0,2
AAACAGAGCGACTCCT-1_V12D07-335_B1,4,0,0,0,0,4
CAGCCTCTCCTCAAGA-1_V12D07-335_B1,1,0,2,0,0,3
TTGCGTGAACGCTTAG-1_V12D07-335_B1,2,1,0,0,0,3
CCGCCTGCGAATTGGT-1_V12D07-335_B1,4,0,1,0,0,5
AGATGAGGGTTGCGAT-1_V12D07-335_B1,3,0,1,0,0,4
CGGTGGGCTCCAGCCT-1_V12D07-335_B1,2,0,0,0,0,2
GGCAGCGGTAATCCTA-1_V12D07-335_B1,0,0,0,0,0,0
GCTAGCAGGGAGTGGG-1_V12D07-335_B1,0,0,0,0,0,0
CTCAAGACATTAGCGC-1_V12D07-335_B1,1,0,1,0,0,2
CACGGCGCGCCAAAGG-1_V12D07-335_B1,1,0,0,1,0,2
TGCAATTTGGGCACGG-1_V12D07-335_B1,2,0,0,0,0,2
ATGCCAATCGCTCTGC-1_V12D07-335_B1,1,0,0,0,0,1
GCTGGACCCAAAGTGG-1_V12D07-335_B1,2,0,3,0,0,5
ATTCCTAAGACGTGGA-1_V12D07-335_B1,0,0,2,0,2,4
TCCGGAGGAAGGGCTG-1_V12D07-335_B1,0,0,0,0,1,1
TCGGTGACCGCTCCGG-1_V12D07-335_B1,0,0,2,0,0,2
TCCGAAGTAGTCACCA-1_V12D07-335_B1,2,0,1,0,0,3
CATGTAGGAGCGCCAA-1_V12D07-335_B1,1,0,0,1,0,2
CACAAGAAAGATATTA-1_V12D07-335_B1,1,0,1,0,0,2
AGGGTCAGTAACCCTA-1_V12D07-335_B1,2,0,1,0,0,3
TAAGCCCTTACGACCA-1_V12D07-335_B1,0,0,0,0,0,0
ATACCGTCATCCATAA-1_V12D07-335_B1,2,0,1,0,0,3
GGACGTCCATAGTTGG-1_V12D07-335_B1,2,0,1,0,0,3
CATCAAACTGGCGCCC-1_V12D07-335_B1,2,1,1,0,0,4
AAACGTGTTCGCCCTA-1_V12D07-335_B1,1,0,0,0,0,1
AAATTGGTGAGAAGCA-1_V12D07-335_B1,1,0,1,0,0,2
GGTCATTGTAGTCATA-1_V12D07-335_B1,0,0,2,0,0,2
TGCAGTGAGGCTCGGG-1_V12D07-335_B1,2,0,2,0,1,5
GAACATTAGTATGTTA-1_V12D07-335_B1,2,0,0,0,0,2
GGTTTGCGAACACGTA-1_V12D07-335_B1,0,1,1,0,0,2
ACACAAATATTCCTAG-1_V12D07-335_B1,0,0,0,0,0,0
TTGGGTTTATTCAGCG-1_V12D07-335_B1,2,0,1,0,0,3
ATTCGCAGAGGACACT-1_V12D07-335_B1,2,0,2,1,0,5
GATTTAGTGCGTACTG-1_V12D07-335_B1,1,0,0,0,1,2
TAGAAACACAATAGTG-1_V12D07-335_B1,0,0,0,0,0,0
CAGTAGATGATGTCCG-1_V12D07-335_B1,0,0,0,0,0,0
TCTTAACTCGGATGTA-1_V12D07-335_B1,0,0,0,0,0,0
TACATCTTGTTTCTTG-1_V12D07-335_B1,0,0,0,0,0,0
TTCATAGGGTGTCCAT-1_V12D07-335_B1,0,0,0,0,0,0
TGAAGTAGCTTACGGA-1_V12D07-335_B1,0,0,0,0,0,0
GCACAAGTGGATCATA-1_V12D07-335_B1,0,0,0,0,0,0
GGGCGAATTTCTCCAC-1_V12D07-335_B1,0,0,0,0,0,0
ATGTTCCTGCCCACCT-1_V12D07-335_B1,0,0,1,0,0,1
GCTCAACCTCTTAGAG-1_V12D07-335_B1,0,1,3,0,0,4
ATAGCTGCTCTTGTTA-1_V12D07-335_B1,1,1,3,0,0,5
CGTCAGCTATTTACTC-1_V12D07-335_B1,0,2,1,0,0,3
ATCTGATAGTGTCTTA-1_V12D07-335_B1,1,0,2,0,0,3
TGCACTATGTGAGTGC-1_V12D07-335_B1,1,0,4,0,0,5
CCGACAAACACATGAG-1_V12D07-335_B1,1,1,1,0,0,3
GCCTTGTATATGCAGT-1_V12D07-335_B1,1,1,2,0,0,4
ATAATACCGTTAGCCG-1_V12D07-335_B1,0,0,8,0,0,8
ACACTCCAATGTCACT-1_V12D07-335_B1,1,0,5,0,0,6
AGTTGCTGACTGATAT-1_V12D07-335_B1,1,0,3,0,0,4
GGCGCTCCTCATCAAT-1_V12D07-335_B1,3,0,2,0,0,5
TGCCTGACATCGGTCA-1_V12D07-335_B1,2,1,4,0,0,7
TTGGCCATCTTGCGCT-1_V12D07-335_B1,0,0,1,0,0,1
CAGTGGTTGCACATGA-1_V12D07-335_B1,0,1,1,0,0,2
AGAATTGTTTGACATA-1_V12D07-335_B1,0,2,3,0,0,5
AAATGCTCGTTACGTT-1_V12D07-335_B1,1,1,2,0,0,4
CACCTAATAGAGTCGT-1_V12D07-335_B1,0,1,1,0,0,2
CATTTCTAGCAGACTA-1_V12D07-335_B1,0,0,1,0,0,1
CCGAAAGTGGTGAGCA-1_V12D07-335_B1,0,1,1,0,0,2
AGTCAGCCACCGCCTG-1_V12D07-335_B1,1,0,1,0,0,2
TCATCACTCGAGCTCG-1_V12D07-335_B1,0,1,1,0,0,2
CTCAGGACTCACCTGT-1_V12D07-335_B1,0,1,2,0,0,3
CGGTGTACTTGATCCC-1_V12D07-335_B1,0,0,0,0,0,0
CCTACGGCTCAGTCGA-1_V12D07-335_B1,0,1,1,0,0,2
GTACTTGGGCACTTCT-1_V12D07-335_B1,2,1,2,0,0,5
TGATTTCCTCCTGACG-1_V12D07-335_B1,0,0,1,0,0,1
CCTCACCAATCTTGAC-1_V12D07-335_B1,0,0,0,0,0,0
GGTGAGATGCAGATAA-1_V12D07-335_B1,0,1,2,0,0,3
GCTAGTTTCATTGAGG-1_V12D07-335_B1,1,0,1,0,0,2
AGGACATCGCACGTCG-1_V12D07-335_B1,0,0,1,0,0,1
GTGGACGTGCTGAGAC-1_V12D07-335_B1,2,1,1,0,0,4
TAAGGAACTTGTGGGA-1_V12D07-335_B1,2,0,0,0,0,2
TCGCTGTGCGTAAATC-1_V12D07-335_B1,0,1,0,0,0,1
GCATCCCTAACTTTGA-1_V12D07-335_B1,1,1,4,0,0,6
CACCCACACGTCACCC-1_V12D07-335_B1,0,1,4,0,0,5
CCCTCATTCTGGAATT-1_V12D07-335_B1,0,0,4,0,0,4
AGGGCGTGATCGGCTA-1_V12D07-335_B1,1,1,4,0,0,6
GGTGCGGATAAGTGGC-1_V12D07-335_B1,0,1,0,0,0,1
TAATATTGAAATTCGC-1_V12D07-335_B1,0,2,3,0,0,5
CTTACACTGGGAAATA-1_V12D07-335_B1,0,0,0,0,0,0
ACCAAGAACGCGTGTC-1_V12D07-335_B1,0,0,0,0,0,0
GCCTTCAGCCCTACCG-1_V12D07-335_B1,0,1,1,0,0,2
GATGCTACAAGCGCCT-1_V12D07-335_B1,0,0,3,0,0,3
CCGGGACCCGCAGAGA-1_V12D07-335_B1,0,0,0,0,0,0
GTTCCAGTCTGACCAT-1_V12D07-335_B1,1,0,1,0,0,2
ATGATCGGGAATAGAC-1_V12D07-335_B1,1,0,4,0,0,5
TTGGATTGGGTACCAC-1_V12D07-335_B1,1,0,0,0,0,1
TACCTCACGCTTGTAC-1_V12D07-335_B1,0,0,3,0,0,3
CATGGCAGGAAGATCG-1_V12D07-335_B1,0,0,1,0,0,1
ATGACGCCGGCTCTAA-1_V12D07-335_B1,0,0,1,0,0,1
AGCGACATCCCATTCA-1_V12D07-335_B1,1,0,1,0,0,2
AGTAATGTCTTGCCGC-1_V12D07-335_B1,0,0,3,0,0,3
TTCTTAGTGGCTCAGA-1_V12D07-335_B1,0,0,3,0,0,3
CGTCTGGAAGGGCCCG-1_V12D07-335_B1,4,0,1,0,0,5
ACGTGCGCCTCGTGCA-1_V12D07-335_B1,2,0,1,0,0,3
AGAGCGGGCTAATCAT-1_V12D07-335_B1,1,1,2,0,0,4
GCGTCGAAATGTCGGT-1_V12D07-335_B1,0,0,1,0,0,1
AACTGATATTAGGCCT-1_V12D07-335_B1,0,0,3,0,0,3
CGAGCTGGGCTTTAGG-1_V12D07-335_B1,0,2,3,0,0,5
GGGTGTTTCAGCTATG-1_V12D07-335_B1,1,0,6,0,0,7
TTAATTTCAGACGCGG-1_V12D07-335_B1,0,0,3,2,0,5
ACTGCCGTCGTAACTC-1_V12D07-335_B1,1,0,2,0,0,3
GTGCACGAAAGTGACT-1_V12D07-335_B1,2,0,3,0,0,5
ATCTCCCTGCAATCTA-1_V12D07-335_B1,1,0,1,0,0,2
ACGCCAGATGATTTCT-1_V12D07-335_B1,0,0,1,0,0,1
AGCTATTTAATCCAAC-1_V12D07-335_B1,0,0,5,1,0,6
CCACGAGAAGAGAATC-1_V12D07-335_B1,1,0,0,0,0,1
GATTCCGCGTTTCCGT-1_V12D07-335_B1,0,1,0,0,0,1
GTCGGATGTAGCGCGC-1_V12D07-335_B1,0,0,2,0,0,2
TATTTATACCGAGTAG-1_V12D07-335_B1,0,1,2,1,0,4
GTAGGTGATCCGTGTA-1_V12D07-335_B1,0,0,3,1,0,4
AGTTAAGCGGTCCCGG-1_V12D07-335_B1,2,0,1,1,0,4
CTGGCGACATAAGTCC-1_V12D07-335_B1,0,0,2,0,0,2
TTGGCCTAGAATTTCG-1_V12D07-335_B1,6,0,0,0,0,6
GGCATATCGGTTCTGC-1_V12D07-335_B1,1,0,1,0,0,2
GGGCGTCCACTGGCTC-1_V12D07-335_B1,0,0,0,0,0,0
TTACCCATTGCCGGGT-1_V12D07-335_B1,0,0,2,0,0,2
TTAGACACGATCGTTG-1_V12D07-335_B1,0,0,0,0,0,0
GCGCTGATCCAGACTC-1_V12D07-335_B1,1,0,1,1,0,3
TTCGGCAACCCGCTGA-1_V12D07-335_B1,1,0,0,0,0,1
GATATTTCCTACATGG-1_V12D07-335_B1,0,0,0,0,0,0
CTGCGTTACGATATAA-1_V12D07-335_B1,0,0,0,0,0,0
TAATAAACAAGGAGAT-1_V12D07-335_B1,1,0,1,0,0,2
AACCTTTACGACGTCT-1_V12D07-335_B1,2,0,0,0,0,2
AGTCCCGCCTTTAATT-1_V12D07-335_B1,2,0,0,0,0,2
TGAGATTAGGCCCTAA-1_V12D07-335_B1,1,0,1,0,0,2
AGTGTATTGCGCATTG-1_V12D07-335_B1,0,0,1,0,0,1
GTTGGATTCAGTGGCT-1_V12D07-335_B1,0,0,1,0,0,1
TAAAGCTGCAATAGGG-1_V12D07-335_B1,2,0,0,0,0,2
AGTAGGAAGGAAGTTG-1_V12D07-335_B1,0,0,0,0,0,0
TATCACTTCGAGTAAC-1_V12D07-335_B1,0,0,0,0,0,0
TGATCTACGCTGATCT-1_V12D07-335_B1,0,0,2,0,0,2
GGATCATCCCGTACGC-1_V12D07-335_B1,2,0,0,0,0,2
TGACACTTCTCTTTGC-1_V12D07-335_B1,1,0,1,0,0,2
AGCCCTTCTAATCCGA-1_V12D07-335_B1,1,0,0,0,0,1
CACCGCGTCCACTCTA-1_V12D07-335_B1,0,0,0,0,0,0
TAATTGGAATCGGGAA-1_V12D07-335_B1,1,0,1,0,0,2
TCGTAAGCTCCGAGGA-1_V12D07-335_B1,1,0,0,0,0,1
TATATTACAAATGTCG-1_V12D07-335_B1,1,0,0,0,0,1
CGCGAGAGGGACTTGT-1_V12D07-335_B1,1,0,0,0,0,1
GGACCTACGGTAACGT-1_V12D07-335_B1,0,0,0,0,0,0
GAAATATGCTTGAATG-1_V12D07-335_B1,0,0,0,0,0,0
CCGTATTAGCGCAGTT-1_V12D07-335_B1,0,0,0,0,1,1
AGGCGTCTATGGACGG-1_V12D07-335_B1,1,0,2,0,0,3
AACATCGATACGTCTA-1_V12D07-335_B1,0,0,0,0,0,0
TGAATATGCTATAAAC-1_V12D07-335_B1,3,1,0,0,0,4
ACCAAACACCCAGCGA-1_V12D07-335_B1,4,0,0,0,0,4
TGGCTTGTACAAGCTT-1_V12D07-335_B1,0,0,0,0,0,0
GAATGAAGGTCTTCAG-1_V12D07-335_B1,1,0,2,0,0,3
AGATACCAGCACTTCA-1_V12D07-335_B1,2,0,0,0,0,2
GCGGTCCCGGTGAAGG-1_V12D07-335_B1,0,0,0,0,0,0
GAGGCATTTGCAGCAG-1_V12D07-335_B1,2,2,0,0,0,4
GGCAAGCCAGGGATAG-1_V12D07-335_B1,1,0,1,0,0,2
TCTACGGGCTCAGTTG-1_V12D07-335_B1,1,0,0,0,0,1
TCTGCGAATCGTTCGC-1_V12D07-335_B1,0,0,1,1,0,2
AGCTCGTTGATGGAAA-1_V12D07-335_B1,1,0,1,1,0,3
TGAATGAGATACAGCA-1_V12D07-335_B1,1,0,3,0,0,4
ACCCTTGCCTGGGTCG-1_V12D07-335_B1,0,0,2,0,0,2
GGCGAACCGTTCTGAT-1_V12D07-335_B1,1,0,0,0,0,1
GCGATGTCTGTGCTTG-1_V12D07-335_B1,0,0,0,0,0,0
ATTAACACCTGAGATA-1_V12D07-335_B1,0,0,0,0,0,0
GAAATCTGACCAAGTT-1_V12D07-335_B1,0,0,0,0,0,0
CCTGACAAACTCGCGC-1_V12D07-335_B1,0,0,0,0,0,0
ATGTCATTTCCCATTG-1_V12D07-335_B1,0,0,0,0,0,0
GCGGTGCGGAGCATCG-1_V12D07-335_B1,0,0,0,0,0,0
CGGAAAGCAAATGTGC-1_V12D07-335_B1,0,0,0,0,0,0
GCTGAGCAACGGTTCT-1_V12D07-335_B1,0,0,0,0,0,0
TCACTCTTCGTCTGTC-1_V12D07-335_B1,0,0,0,0,0,0
GATCTTCATTGTCCTC-1_V12D07-335_B1,0,0,2,0,0,2
ACTCGATGTATTTCAT-1_V12D07-335_B1,1,2,1,0,0,4
TGAAGAGCGGTCCTAG-1_V12D07-335_B1,0,0,0,0,0,0
TAAACGTCGTCAATGA-1_V12D07-335_B1,1,0,4,0,0,5
ACGTTATTGGTCACTC-1_V12D07-335_B1,0,1,3,0,0,4
ATAGCCTCAGTACCCA-1_V12D07-335_B1,1,1,2,0,0,4
CGGGAGTATACCGCCG-1_V12D07-335_B1,1,1,5,0,0,7
GTCCTACAGGCGGCTC-1_V12D07-335_B1,1,2,1,0,0,4
CGGATAAGCGGACATG-1_V12D07-335_B1,1,1,3,0,0,5
AACTTCTGCGTCTATC-1_V12D07-335_B1,0,1,1,0,0,2
GGGTTCAGACGAACAA-1_V12D07-335_B1,1,0,1,0,0,2
AGTCTGGACATCCTTG-1_V12D07-335_B1,3,1,3,0,0,7
TTGAACGAATCCTTTG-1_V12D07-335_B1,0,0,0,0,0,0
GAAATACTAAACGTTT-1_V12D07-335_B1,1,0,0,0,0,1
CCCGCGCAATGCACCC-1_V12D07-335_B1,0,0,2,0,0,2
TTCGGCTAGAGATGGT-1_V12D07-335_B1,0,0,3,0,0,3
GACACGAGTTAGAGGA-1_V12D07-335_B1,0,0,1,0,0,1
GAGGTCCCAAAGATCT-1_V12D07-335_B1,1,0,4,0,0,5
TAACTCCATGGAGGCT-1_V12D07-335_B1,0,1,1,0,0,2
CTTGTTTATGTAGCCA-1_V12D07-335_B1,1,0,2,0,0,3
GATGGCGCACACATTA-1_V12D07-335_B1,0,1,1,0,0,2
ATAATAGTGTAGGGAC-1_V12D07-335_B1,0,1,0,0,0,1
CGCTATTCAATGTATG-1_V12D07-335_B1,0,1,2,0,0,3
ATATTGCTGTCAAAGT-1_V12D07-335_B1,3,0,2,0,0,5
GGATTCAGTACGGTGG-1_V12D07-335_B1,1,1,4,0,0,6
TTCTTAGTGAACGGTG-1_V12D07-335_B1,1,1,4,0,0,6
AATGGTTCTCACAAGC-1_V12D07-335_B1,0,0,1,0,0,1
TATACACGCAAAGTAT-1_V12D07-335_B1,2,0,3,0,0,5
CTTCATAGCTCAAGAA-1_V12D07-335_B1,1,0,1,0,0,2
CAACGGTTCTTGATAC-1_V12D07-335_B1,1,1,1,0,0,3
ACACCCGAGAAATCCG-1_V12D07-335_B1,0,3,1,0,0,4
TCTATCATGCAGTTAC-1_V12D07-335_B1,2,0,2,0,0,4
CCCGCCATGCTCCCGT-1_V12D07-335_B1,1,0,1,0,0,2
CGCTTCCACTGAAATC-1_V12D07-335_B1,0,4,2,0,0,6
CACTGTCCAAGTGAGA-1_V12D07-335_B1,0,0,1,0,0,1
ATTACTAGCCTCTTGC-1_V12D07-335_B1,0,2,4,0,0,6
CATAGTAGCATAGTAG-1_V12D07-335_B1,0,0,2,0,0,2
CAACTCCTTGATCCCG-1_V12D07-335_B1,0,1,3,0,0,4
AAGTAGAAGACCGGGT-1_V12D07-335_B1,0,0,0,0,0,0
GCGGGAACCAGGCCCT-1_V12D07-335_B1,2,1,1,0,0,4
ATTAGATTGATAGCGG-1_V12D07-335_B1,0,0,0,0,0,0
CTCGGTCCGTAGCCTG-1_V12D07-335_B1,1,1,0,0,0,2
TGGCTTTGGGTAGACA-1_V12D07-335_B1,2,0,1,0,0,3
TATCCATATCATGCGA-1_V12D07-335_B1,0,0,0,0,0,0
GGAGTGCCGCCCTGGA-1_V12D07-335_B1,0,0,2,0,0,2
TGAGAATGCTTTACCG-1_V12D07-335_B1,0,1,1,0,0,2
TTAACCAACCCTCCCT-1_V12D07-335_B1,1,0,4,0,0,5
TGTTTCGGTACTTCTC-1_V12D07-335_B1,0,0,6,0,0,6
TTGCTGAAGGAACCAC-1_V12D07-335_B1,0,0,1,0,0,1
TATTTAGTCTAGATCG-1_V12D07-335_B1,0,2,1,0,0,3
CTCCGGCCTAATATGC-1_V12D07-335_B1,1,0,0,0,0,1
TTGTGGCCCTGACAGT-1_V12D07-335_B1,0,0,1,0,0,1
TCGCCGGTCGATCCGT-1_V12D07-335_B1,0,0,0,0,0,0
CCATAGGTTGGCGTGG-1_V12D07-335_B1,0,0,2,0,0,2
GAACGACCGAATGATA-1_V12D07-335_B1,0,0,1,0,0,1
TCCGATAATTGCCATA-1_V12D07-335_B1,0,0,1,0,0,1
CATTACGTCGGCCCGT-1_V12D07-335_B1,1,0,1,0,0,2
CAAGCACCAAATGCCT-1_V12D07-335_B1,1,0,0,0,0,1
TGCATGGATCGGATCT-1_V12D07-335_B1,0,0,2,0,0,2
GAAATCGCGCGCAACT-1_V12D07-335_B1,0,0,2,0,0,2
CTGAAAGAGATCCGAC-1_V12D07-335_B1,0,0,1,0,0,1
CACCTCGATGGTGGAC-1_V12D07-335_B1,0,0,1,0,0,1
ATTTGTTCCAGGGCTC-1_V12D07-335_B1,0,0,5,0,0,5
TGGGCCACAAGAGCGC-1_V12D07-335_B1,1,0,1,0,0,2
CCTTCTTGATCCAGTG-1_V12D07-335_B1,3,0,0,0,0,3
CCTCGCCAGCAAATTA-1_V12D07-335_B1,0,0,2,0,0,2
TTCATGGCGCAACAGG-1_V12D07-335_B1,0,1,0,0,0,1
TTAATCAGTACGTCAG-1_V12D07-335_B1,0,0,0,0,0,0
CCTATCTATATCGGAA-1_V12D07-335_B1,2,1,3,0,0,6
ATTATACTTTGCTCGT-1_V12D07-335_B1,1,1,2,0,0,4
ATGGATCCGGCGTCCG-1_V12D07-335_B1,1,1,0,0,0,2
CGCCCGCTTCCGTACA-1_V12D07-335_B1,0,0,0,0,0,0
GGATTCCGCTATACCC-1_V12D07-335_B1,0,0,0,1,0,1
CGGTCTATCAACCCGT-1_V12D07-335_B1,0,0,1,0,0,1
ATGCCGGTTGATGGGA-1_V12D07-335_B1,0,0,0,0,0,0
TCATGCAGGTTCTCAT-1_V12D07-335_B1,8,0,0,0,0,8
TGAGCTTTAATGACGC-1_V12D07-335_B1,0,0,3,0,0,3
TCCCTTAGATTACTCG-1_V12D07-335_B1,0,0,4,0,0,4
ATATCTCCCTCGTTAA-1_V12D07-335_B1,0,0,0,1,0,1
AGCTCTTCCCAGTGCA-1_V12D07-335_B1,1,0,1,0,0,2
TCGCTAAACCGCTATC-1_V12D07-335_B1,2,0,0,0,0,2
CACATTCTTTCGATGG-1_V12D07-335_B1,1,0,2,0,0,3
GATATGCGGTAGCCAA-1_V12D07-335_B1,1,0,0,0,0,1
CGTTTCACTTCGGGCG-1_V12D07-335_B1,0,0,0,1,0,1
CCAATTACGGGTCGAG-1_V12D07-335_B1,1,0,1,0,0,2
GCAGGTAGAGTATGGT-1_V12D07-335_B1,0,0,1,0,0,1
GTCGTATTGGCGTACA-1_V12D07-335_B1,1,0,0,0,0,1
GAAATTAGCACGGATA-1_V12D07-335_B1,3,0,0,0,0,3
AATGCACCAAGCAATG-1_V12D07-335_B1,2,0,2,0,0,4
AGGACGCTCGATGTTG-1_V12D07-335_B1,2,0,0,0,0,2
GGCTAAAGGGCGGGTC-1_V12D07-335_B1,0,0,0,0,0,0
CATCTATCCCGTGTCT-1_V12D07-335_B1,2,0,0,0,0,2
CAGTAACTATTTATTG-1_V12D07-335_B1,3,0,1,1,0,5
CATATACTACTGATAA-1_V12D07-335_B1,1,0,1,1,0,3
GCGTTCGGAGACCGGG-1_V12D07-335_B1,2,0,0,0,0,2
AAGTTCAGTCTGCGTA-1_V12D07-335_B1,2,0,1,1,0,4
CGAAGCTATAAATTCA-1_V12D07-335_B1,0,0,1,0,0,1
CGCGGTCACAAACCAA-1_V12D07-335_B1,0,0,2,1,0,3
GGGAATGAGCCCTCAC-1_V12D07-335_B1,0,0,0,0,0,0
ACGGAGCGCAAATTAC-1_V12D07-335_B1,0,0,1,0,0,1
CGTTCTTCGCACACCT-1_V12D07-335_B1,0,0,0,0,0,0
GAATAGCCCTGCGGTC-1_V12D07-335_B1,0,0,0,0,0,0
AATAGCTACCGCGTGC-1_V12D07-335_B1,1,0,2,0,0,3
CCGAGCTGTGCTTGTC-1_V12D07-335_B1,0,0,2,0,1,3
GATGACGATGATCGCG-1_V12D07-335_B1,1,0,3,0,0,4
GCCTATGCTGGGCCTT-1_V12D07-335_B1,1,0,1,0,0,2
TTACTGTCTAGAGCTC-1_V12D07-335_B1,0,0,1,0,0,1
AGCGGTTGCCGCTCTG-1_V12D07-335_B1,1,1,3,1,0,6
GCTTGCAGCACAATTG-1_V12D07-335_B1,1,0,1,0,0,2
CCGGAGGTCTTATGGT-1_V12D07-335_B1,1,0,1,1,0,3
ACAGTATACCGTGGGA-1_V12D07-335_B1,3,0,3,0,0,6
GGGATCCCAATACAAA-1_V12D07-335_B1,0,0,1,0,0,1
ATTACGACTCCACAGT-1_V12D07-335_B1,0,0,0,0,0,0
CTCACACGCAAGCCTA-1_V12D07-335_B1,2,0,0,0,0,2
CCAGATGTAAATGGGT-1_V12D07-335_B1,0,0,2,0,0,2
GAACTTGTGCACGGGA-1_V12D07-335_B1,0,0,0,0,0,0
AAGCCGCTTTACCTTG-1_V12D07-335_B1,1,0,0,0,0,1
TCCATTCCCACTAGAG-1_V12D07-335_B1,0,0,2,0,0,2
AGAGCGCTTGTAACGG-1_V12D07-335_B1,0,0,1,0,0,1
TGGGTTCCCGGACGGA-1_V12D07-335_B1,0,0,0,0,0,0
GCTGCGCCTCCCACGT-1_V12D07-335_B1,0,0,0,0,0,0
CTGTTGGCTCTTCTGA-1_V12D07-335_B1,0,0,0,0,0,0
TTGTTCTAGATACGCT-1_V12D07-335_B1,0,0,0,0,0,0
CCCTCAAGCTCTTAGT-1_V12D07-335_B1,0,0,0,0,0,0
TGGTCTAGCTTACATG-1_V12D07-335_B1,0,0,0,0,0,0
ATGCACCTTCCTTAAT-1_V12D07-335_B1,0,0,0,0,0,0
GGGATACGGTAATAAT-1_V12D07-335_B1,0,0,0,0,0,0
AGTTCACCGGTTGGAC-1_V12D07-335_B1,0,0,2,0,0,2
GACATACTGTCGCAGA-1_V12D07-335_B1,1,0,0,0,0,1
TGGACACCGTTGCTTG-1_V12D07-335_B1,0,0,2,0,0,2
TGCGATGCTAATGGCT-1_V12D07-335_B1,0,1,4,0,0,5
TTCTGTTTCCTGTCGC-1_V12D07-335_B1,0,2,4,0,0,6
CGTTGTAAACGTCAGG-1_V12D07-335_B1,0,0,2,0,0,2
GATCGGCGATAAGTCG-1_V12D07-335_B1,0,0,3,0,0,3
AGCCTTAAAGCGGAAG-1_V12D07-335_B1,1,0,0,0,0,1
TCCGTAACCACAATCC-1_V12D07-335_B1,0,2,1,0,0,3
GAATGCCGAAATGACC-1_V12D07-335_B1,0,1,4,0,0,5
TATACTCATGCGGCAA-1_V12D07-335_B1,3,0,3,0,0,6
TAGTGTCAGAAACGGC-1_V12D07-335_B1,0,1,1,0,0,2
CGTCATACCATATCCA-1_V12D07-335_B1,0,0,0,0,0,0
TAGTACCTTAGTGGTC-1_V12D07-335_B1,0,1,3,0,0,4
CTGGCGGGAATAAGTA-1_V12D07-335_B1,0,1,3,0,0,4
AGTGTGGTCTATTGTG-1_V12D07-335_B1,0,0,4,0,0,4
GCTATCGCGGCGCAAC-1_V12D07-335_B1,0,1,4,0,0,5
CAGTAATCCCTCCCAG-1_V12D07-335_B1,0,2,0,0,0,2
GTATTAAGGCGTCTAA-1_V12D07-335_B1,0,0,4,1,0,5
CTAATTTCAACAACAC-1_V12D07-335_B1,1,1,5,0,0,7
TTAGCAACATGGATGT-1_V12D07-335_B1,1,1,0,0,0,2
ATGCTCAGTGTTGCAT-1_V12D07-335_B1,0,2,2,0,0,4
GATGTTTGTGCGAGAT-1_V12D07-335_B1,0,1,4,0,0,5
CACTTCGCCACAGGCT-1_V12D07-335_B1,0,3,2,0,0,5
CTGTATGGTGTAGAAA-1_V12D07-335_B1,1,0,1,0,0,2
TACGTGCACTATGCTG-1_V12D07-335_B1,1,1,2,0,0,4
GTATCAGCTTGGGTTC-1_V12D07-335_B1,0,0,6,0,0,6
TAACAAAGGGAGAAGC-1_V12D07-335_B1,0,1,1,0,0,2
TTACATCGTGGCCTGG-1_V12D07-335_B1,0,2,2,0,0,4
TCTGAACCGGTCGGCT-1_V12D07-335_B1,2,0,1,0,0,3
GGCTCGTGCCACCAGC-1_V12D07-335_B1,1,1,1,0,0,3
TATAAGTGAGGATAGC-1_V12D07-335_B1,0,0,1,0,0,1
GCCCGCGCGTTTGACA-1_V12D07-335_B1,1,0,2,0,0,3
TGCTGGTTGGACAATT-1_V12D07-335_B1,0,0,0,0,0,0
GCCTAGCGATCTGACC-1_V12D07-335_B1,3,1,2,0,0,6
CCATGCTCTGCAGGAA-1_V12D07-335_B1,0,2,3,0,0,5
TATAAATCCACAAGCT-1_V12D07-335_B1,1,0,1,0,0,2
CGCTCGACATAATGAT-1_V12D07-335_B1,0,0,2,0,0,2
CCAATTGAATGTTAAT-1_V12D07-335_B1,1,0,0,0,0,1
GCTAATACCGAATGCC-1_V12D07-335_B1,0,1,3,0,0,4
TTCAACGACCCGACCG-1_V12D07-335_B1,0,2,1,0,0,3
TTCCTCGAGGGTGTCT-1_V12D07-335_B1,0,3,0,0,0,3
CAACGACCCGTTTACA-1_V12D07-335_B1,1,2,0,0,0,3
CTTGTACTTGTTGACT-1_V12D07-335_B1,1,0,1,0,0,2
TCTCTAATAGCTGGTA-1_V12D07-335_B1,0,1,4,0,0,5
ATTATGCCATAGGGAG-1_V12D07-335_B1,0,1,1,0,0,2
GACAACGCAGCTTACG-1_V12D07-335_B1,0,1,0,0,0,1
AGATGACTCGCCCACG-1_V12D07-335_B1,0,1,0,0,0,1
GTGCGGGTCTCCAAAT-1_V12D07-335_B1,1,1,1,0,0,3
GTACGAGATTGCGACA-1_V12D07-335_B1,1,1,2,0,0,4
GTATAGGACTCAGTAG-1_V12D07-335_B1,1,1,1,0,0,3
TTGCACGGAGCAGCAC-1_V12D07-335_B1,1,0,0,0,0,1
CACAGCTAGGGAGTGA-1_V12D07-335_B1,2,0,4,0,0,6
ATACTAGCATGACCCT-1_V12D07-335_B1,0,1,7,0,0,8
CCAAGACTTCTGCGAA-1_V12D07-335_B1,0,0,2,0,0,2
ACATAATAAGGCGGTG-1_V12D07-335_B1,0,0,1,0,0,1
TAATACACAGTAGTAT-1_V12D07-335_B1,1,0,1,0,0,2
TCTTGGTAACACCAAA-1_V12D07-335_B1,3,0,1,0,0,4
AACTGGGTCCCGACGT-1_V12D07-335_B1,2,0,7,0,0,9
ATCACTTCATCCTCGC-1_V12D07-335_B1,0,2,1,0,0,3
TGGAAGGATAAAGATG-1_V12D07-335_B1,1,1,4,0,0,6
CATGATGCACAATTCT-1_V12D07-335_B1,0,0,3,0,0,3
TGCCTGATCAAACGAT-1_V12D07-335_B1,1,0,1,0,0,2
ATAGGGATATCCTTGA-1_V12D07-335_B1,0,0,2,0,0,2
CACCTAATCAGTTTAC-1_V12D07-335_B1,2,0,2,0,0,4
TGTGACTACGCCAGTC-1_V12D07-335_B1,0,0,1,0,0,1
CCCGACCATAGTCCGC-1_V12D07-335_B1,1,1,0,0,0,2
CGCGCCCGACTTAATA-1_V12D07-335_B1,2,0,0,0,0,2
TGCCACCTGGCGAAAC-1_V12D07-335_B1,0,0,0,0,0,0
CTGCCAAGGTTGGAAG-1_V12D07-335_B1,0,0,0,0,0,0
TCTCCAACGTAGGTTA-1_V12D07-335_B1,0,0,1,0,0,1
TTCTTGGAGTAATGAG-1_V12D07-335_B1,1,0,2,0,0,3
GTCTCGATCTGCTTTC-1_V12D07-335_B1,1,0,0,0,0,1
TACTCTCCGAACAAAT-1_V12D07-335_B1,0,0,3,0,0,3
ATCACATTAGAATATC-1_V12D07-335_B1,0,0,0,0,0,0
TACGGGATGCTAGCAG-1_V12D07-335_B1,0,0,1,0,0,1
AGCTGAAGTAAACCAA-1_V12D07-335_B1,0,0,4,0,0,4
CATGGGTCGGGTGTGG-1_V12D07-335_B1,2,0,4,1,0,7
CACCCACGAGGCAATT-1_V12D07-335_B1,0,1,2,0,0,3
TGCCATTACTAAAGAA-1_V12D07-335_B1,1,1,1,0,0,3
CCGTTACGTTAGAACA-1_V12D07-335_B1,2,0,5,0,0,7
GCCAGGAGTAACCGAT-1_V12D07-335_B1,0,0,1,0,0,1
GGAAAGTGCCCATGCC-1_V12D07-335_B1,0,0,1,0,0,1
TCTTACCGGAACTCGT-1_V12D07-335_B1,0,0,0,0,0,0
TATGTCAAGACCGACT-1_V12D07-335_B1,0,1,1,0,0,2
CCTAACTAAGGCTCTA-1_V12D07-335_B1,2,0,1,0,0,3
GCGGTGAACTGCGCTC-1_V12D07-335_B1,1,0,0,0,0,1
CCTCGCGCGATATAGG-1_V12D07-335_B1,1,0,0,0,0,1
ATCGGCAAGCAGTCCA-1_V12D07-335_B1,1,0,0,0,0,1
AGATCGTGCATAAGAT-1_V12D07-335_B1,2,0,1,0,0,3
ATTCAGGACCTATTTC-1_V12D07-335_B1,2,0,1,0,0,3
AGCTAGAAGCAGAAGT-1_V12D07-335_B1,1,0,1,0,0,2
TTCGCTATCTGACGTG-1_V12D07-335_B1,2,0,0,1,0,3
TTCCGCAGAGAAATAT-1_V12D07-335_B1,0,0,0,0,0,0
CAGTACATTCTCTAAA-1_V12D07-335_B1,1,0,0,0,0,1
GTGAAGATTTCAAGTG-1_V12D07-335_B1,3,0,0,0,0,3
AACGCATGATCTGGGT-1_V12D07-335_B1,1,0,2,0,0,3
CCCAGAGGAGGGCGTA-1_V12D07-335_B1,0,0,0,0,0,0
GGAAACCTTGTTGAAT-1_V12D07-335_B1,4,0,0,0,0,4
GTGAAGCCGTATAGTC-1_V12D07-335_B1,0,0,0,0,0,0
GAGCTGTCGTCTCGGA-1_V12D07-335_B1,0,0,0,0,0,0
TGTCATTTGTTGGGAA-1_V12D07-335_B1,0,0,0,0,1,1
ACCAACACCACACACT-1_V12D07-335_B1,1,0,3,0,0,4
AAATGATTCGATCAGC-1_V12D07-335_B1,0,1,0,0,0,1
CTGCTTTATGTCCGCG-1_V12D07-335_B1,0,0,3,0,0,3
GCGAGAGGCCATGTAA-1_V12D07-335_B1,0,0,3,0,0,3
ATTGACCGGCGATGAC-1_V12D07-335_B1,4,0,0,0,0,4
ACCCTGGTAACGCCCT-1_V12D07-335_B1,1,0,4,0,0,5
GTTGGACCGCATCAGG-1_V12D07-335_B1,0,1,0,0,1,2
CGTTTACAAGGCAGCT-1_V12D07-335_B1,0,0,0,0,0,0
CGGTCCATGAGACTCC-1_V12D07-335_B1,0,0,3,0,0,3
GTTCGTCTGGGTCCCT-1_V12D07-335_B1,1,0,0,0,0,1
TGTACTACTCTCACGG-1_V12D07-335_B1,1,0,3,1,0,5
AGTGAAGATGGTGTCC-1_V12D07-335_B1,1,0,1,0,1,3
GAGGGCCATAATATTA-1_V12D07-335_B1,1,0,3,0,0,4
ACTCCCGTAGACTAGG-1_V12D07-335_B1,0,0,0,0,1,1
CGTCAAATGGTCGCAG-1_V12D07-335_B1,1,0,0,0,1,2
AAGTCTAGTAGCTGCC-1_V12D07-335_B1,4,0,1,0,0,5
AAGAAATCACCAGATT-1_V12D07-335_B1,0,0,1,0,0,1
GAGTGCACGGACAACA-1_V12D07-335_B1,0,0,3,1,0,4
GTTCAAATCAGATGTC-1_V12D07-335_B1,0,0,0,0,0,0
CATGGCTCCCTATGTC-1_V12D07-335_B1,0,0,0,0,0,0
GGCCACACGAAAGCCT-1_V12D07-335_B1,0,0,0,0,0,0
GAAGCCGGGTAAGCTC-1_V12D07-335_B1,0,0,0,0,0,0
TTGCGCTCTCTCGCTT-1_V12D07-335_B1,0,0,0,0,0,0
TACATGACCTTATCCG-1_V12D07-335_B1,0,0,0,0,0,0
GTCCTTCTACAACCCA-1_V12D07-335_B1,0,0,0,0,0,0
TATATGCTGGGTTGCC-1_V12D07-335_B1,0,0,0,0,0,0
GTTTATGGGATTTAGA-1_V12D07-335_B1,0,0,1,0,0,1
GGAACCCGAACAAGAA-1_V12D07-335_B1,0,1,2,0,0,3
AACGTTATCAGCACCT-1_V12D07-335_B1,0,0,2,0,0,2
CATCGTCCGGTTACTA-1_V12D07-335_B1,0,1,1,0,0,2
AGACAGCTCAGAATCC-1_V12D07-335_B1,1,0,1,0,0,2
GCAGATCCTCGCAAAT-1_V12D07-335_B1,0,0,0,0,0,0
GGGTCATGCGTACCAT-1_V12D07-335_B1,0,0,4,0,0,4
CTGGTCATTCCAATCC-1_V12D07-335_B1,3,0,1,0,0,4
TCAGGGCGCAAACTCG-1_V12D07-335_B1,0,0,1,0,0,1
GATGCCAGCAGAAGGC-1_V12D07-335_B1,0,1,3,0,0,4
GTTATTAACGTGGGAG-1_V12D07-335_B1,0,0,2,0,0,2
AATACAATGTTTCAGG-1_V12D07-335_B1,0,2,1,0,0,3
TTGCTGCACCTATCCA-1_V12D07-335_B1,0,0,7,0,0,7
CCAGAGACAAAGCCGG-1_V12D07-335_B1,1,1,1,0,0,3
CCGAAGTATATTGTTC-1_V12D07-335_B1,0,1,1,0,0,2
GCTAAACCTGAGGTGA-1_V12D07-335_B1,1,1,1,0,0,3
TCATACTTACAGATCC-1_V12D07-335_B1,1,0,5,0,0,6
CGAGCACTTCAAGTTT-1_V12D07-335_B1,0,1,2,0,0,3
TAGCAACCTGTCACAA-1_V12D07-335_B1,1,0,2,0,0,3
TGGGAAATGCCTTTCC-1_V12D07-335_B1,1,1,4,0,0,6
AGACCATGGGATACAA-1_V12D07-335_B1,0,1,1,0,0,2
TAAATGAATCCGTTTC-1_V12D07-335_B1,1,0,0,0,0,1
ACAACGGTCCCTGCGA-1_V12D07-335_B1,1,0,1,0,0,2
GTCACTCTCCAAATCT-1_V12D07-335_B1,0,0,2,0,0,2
TTCTACTTGCGAGGGC-1_V12D07-335_B1,0,0,0,0,0,0
CGCAATTACTTTCGGT-1_V12D07-335_B1,3,0,0,0,0,3
CTGTTCATCTCACGGG-1_V12D07-335_B1,1,0,1,0,0,2
TTCTTGTAACCTAATG-1_V12D07-335_B1,3,0,0,0,0,3
GCTTGATGATAATCAG-1_V12D07-335_B1,1,0,1,0,0,2
TTGGCTCGCATGAGAC-1_V12D07-335_B1,0,1,3,0,0,4
GCCCAGTTGGTATGCC-1_V12D07-335_B1,0,0,3,0,0,3
ATTCCTCCGCCAGTGC-1_V12D07-335_B1,3,1,1,0,0,5
TCGTCCGCTGGCGTCT-1_V12D07-335_B1,2,1,1,0,0,4
GGAGAAGTCATTGGCA-1_V12D07-335_B1,0,1,0,0,0,1
TTGTTAGCAAATTCGA-1_V12D07-335_B1,0,0,1,0,0,1
TCTAGCATCTTCGATG-1_V12D07-335_B1,3,1,0,0,0,4
TTCTAGGCCAATTGTG-1_V12D07-335_B1,0,0,2,0,0,2
TCACGGTCATCGCACA-1_V12D07-335_B1,0,1,3,0,0,4
ATGAAGCCAAGGAGCC-1_V12D07-335_B1,0,2,5,0,0,7
AATGACTGTCAGCCGG-1_V12D07-335_B1,0,0,4,0,0,4
CCAAACAGAACCCTCG-1_V12D07-335_B1,1,0,2,0,0,3
TATCGATGATTAAACG-1_V12D07-335_B1,0,1,2,0,0,3
GAACACACATCAACCA-1_V12D07-335_B1,0,0,0,0,0,0
CCCGTCAGCGTCTGAC-1_V12D07-335_B1,0,1,0,0,0,1
AGCATCGTCGATAATT-1_V12D07-335_B1,0,1,1,0,0,2
GACTAAGATCATGCAC-1_V12D07-335_B1,0,1,0,0,0,1
TAGGGTGTTTCAAGAG-1_V12D07-335_B1,1,1,2,0,0,4
TGGTTCGTAGCAAAGG-1_V12D07-335_B1,1,0,1,0,0,2
CTGTTCACTGCCTGTG-1_V12D07-335_B1,0,0,0,0,0,0
ATGTGCATCCGACGCA-1_V12D07-335_B1,0,1,2,0,0,3
TTGTCGTTCAGTTACC-1_V12D07-335_B1,1,1,0,1,0,3
CGGGATCAATGTAAGA-1_V12D07-335_B1,0,1,1,0,0,2
TTATCTGTATCATAAC-1_V12D07-335_B1,1,0,2,0,0,3
ATCGACTCTTTCCGTT-1_V12D07-335_B1,1,0,1,0,0,2
CTCATTTGATGGGCGG-1_V12D07-335_B1,1,0,1,0,0,2
GTAAGCGGGCAGTCAG-1_V12D07-335_B1,1,1,1,0,0,3
TCTATCGGTCGCAACA-1_V12D07-335_B1,0,1,1,0,0,2
AACGCGGTCTCCAGCC-1_V12D07-335_B1,2,0,1,0,0,3
ATTAATACTACGCGGG-1_V12D07-335_B1,2,0,0,0,0,2
CTTTAACTTTCAAAGG-1_V12D07-335_B1,3,2,4,0,0,9
CGTACCTGATAGGCCT-1_V12D07-335_B1,1,0,1,0,0,2
GAATGTTGGGTAATCT-1_V12D07-335_B1,0,0,2,0,0,2
TGCGGAGTAAAGGTGC-1_V12D07-335_B1,0,0,2,0,0,2
CCTGAATATTTACATA-1_V12D07-335_B1,0,0,3,0,0,3
TTGCTCCCATACCGGA-1_V12D07-335_B1,1,0,3,0,0,4
CCTCTAATCTGCCAAG-1_V12D07-335_B1,0,0,1,0,0,1
AGGTTGAGGCACGCTT-1_V12D07-335_B1,1,0,3,0,0,4
TCCCGTCAGTCCCGCA-1_V12D07-335_B1,0,0,0,0,0,0
TCCGATGACTGAGCTC-1_V12D07-335_B1,0,1,1,0,0,2
CAGCCTCCTGCAGAGG-1_V12D07-335_B1,1,1,3,0,0,5
CTTAGCCTTCCACATG-1_V12D07-335_B1,0,0,0,3,0,3
ATTAATGAACCAGTCG-1_V12D07-335_B1,1,1,0,0,0,2
ACGATACATAGAACTA-1_V12D07-335_B1,1,0,0,1,0,2
AGCCACTCCCGTGCTT-1_V12D07-335_B1,0,0,0,0,0,0
ATACGGGTTTCGATTG-1_V12D07-335_B1,0,0,3,0,0,3
CTGTCAAATGGCTCGG-1_V12D07-335_B1,1,0,0,1,0,2
GCTCGGAATTTAAAGC-1_V12D07-335_B1,1,0,1,1,0,3
TAGGCATGTTACGCCA-1_V12D07-335_B1,0,0,1,0,0,1
TGGCAACTCGCGCGCC-1_V12D07-335_B1,1,0,2,0,0,3
ATCAGTAGGCAGGGAT-1_V12D07-335_B1,3,0,0,1,0,4
TATCGATCTATGCATA-1_V12D07-335_B1,0,0,0,0,0,0
CGACTCAGGATGTTAT-1_V12D07-335_B1,1,0,2,0,0,3
GCCATATTGCACACAG-1_V12D07-335_B1,1,0,0,0,0,1
AATTCATAAGGGATCT-1_V12D07-335_B1,1,0,1,0,0,2
CGGTAGAGGTGCAGGT-1_V12D07-335_B1,2,0,0,0,0,2
AATGATGATACGCTAT-1_V12D07-335_B1,0,0,0,1,0,1
CTTGTGCTCACCGATT-1_V12D07-335_B1,0,0,0,0,0,0
TTCCAATCAGAGCTAG-1_V12D07-335_B1,2,0,0,0,0,2
CGATGGACCCTACGCC-1_V12D07-335_B1,3,0,0,1,0,4
GGTCGGATAAACGGCG-1_V12D07-335_B1,3,0,0,0,0,3
TTAGCTAATACGATCT-1_V12D07-335_B1,0,0,1,0,0,1
CTCGATATTTGCGAGC-1_V12D07-335_B1,0,0,1,0,0,1
ATTACTTACTGGGCAT-1_V12D07-335_B1,0,0,0,0,0,0
CTAGCCGATGTTATGA-1_V12D07-335_B1,1,0,1,0,0,2
TACTGCAATCAATTAC-1_V12D07-335_B1,1,0,1,0,0,2
TAGTCTGTGACGTTGC-1_V12D07-335_B1,0,0,0,1,0,1
CTCGTTTCTAATGTTT-1_V12D07-335_B1,0,0,1,0,0,1
TTCGTTCAACGAAGTT-1_V12D07-335_B1,0,0,1,1,0,2
CTGAATTTATTGCCAG-1_V12D07-335_B1,3,0,1,0,0,4
TGGAATATCCTTGACC-1_V12D07-335_B1,6,0,0,0,0,6
CAGATCATTTAAAGTC-1_V12D07-335_B1,0,0,1,1,0,2
CTCCTTTACGCAAGTC-1_V12D07-335_B1,4,0,3,1,0,8
TCCCAAACAGACAACG-1_V12D07-335_B1,3,0,0,0,0,3
ATCGCTGCGTGCAGCA-1_V12D07-335_B1,2,0,0,0,0,2
TTAGTTCAAGTGTTCG-1_V12D07-335_B1,0,0,0,0,0,0
AAACTCGTGATATAAG-1_V12D07-335_B1,1,1,1,0,0,3
TTAACGAACAAGCAGT-1_V12D07-335_B1,2,0,2,0,0,4
GTTATATCAGGAGCCA-1_V12D07-335_B1,0,0,0,0,0,0
CAAATTGGATTATGCC-1_V12D07-335_B1,1,0,0,0,0,1
CGAGGAGCTTCCATAT-1_V12D07-335_B1,0,0,3,0,0,3
GGAGACCAATGTGCTT-1_V12D07-335_B1,0,0,3,0,0,3
CATTGATGAACACGCC-1_V12D07-335_B1,0,0,3,0,0,3
GTCAATGCTATAATTT-1_V12D07-335_B1,0,0,0,0,1,1
ACCACCCTCTCTTCTA-1_V12D07-335_B1,1,0,1,0,2,4
TGGAGGGAAACACCTC-1_V12D07-335_B1,0,0,1,0,1,2
CACGGACGTGGATGGC-1_V12D07-335_B1,2,0,0,1,0,3
AACTTTCTCGATCATG-1_V12D07-335_B1,0,0,0,0,0,0
CGTATTGTTTCCTAAT-1_V12D07-335_B1,2,0,2,0,0,4
CCTACTGCGGCGGCCA-1_V12D07-335_B1,3,0,1,1,0,5
CTTAGGTCCCAATCGT-1_V12D07-335_B1,1,0,5,0,0,6
CGCAATCGATCATTAG-1_V12D07-335_B1,0,0,0,0,0,0
TGGTTATGCTTGCGGT-1_V12D07-335_B1,0,0,0,0,0,0
GGCTTGGCTCTCACCT-1_V12D07-335_B1,0,0,0,0,0,0
ATTGGTAGGATCCGCT-1_V12D07-335_B1,0,0,0,0,0,0
TCAGGGCGACTTCCTT-1_V12D07-335_B1,0,0,0,0,0,0
TCTGCAGATTCGAGTC-1_V12D07-335_B1,0,0,0,0,0,0
CTCTCGCTGTACTATG-1_V12D07-335_B1,0,0,0,0,0,0
AATAGTCGCGAGTCGG-1_V12D07-335_B1,0,0,0,0,0,0
AGTTACCCTTAAGACT-1_V12D07-335_B1,0,0,0,1,0,1
CTTAAATAAGACCCAT-1_V12D07-335_B1,0,0,0,0,0,0
GGTTGTGCTCTTGTCC-1_V12D07-335_B1,1,0,3,0,0,4
GTGAGTCTAAGACGGA-1_V12D07-335_B1,1,0,1,0,0,2
CGCGACACTGCGCAGC-1_V12D07-335_B1,0,1,0,0,0,1
GCTCGCGGTTCCGCTC-1_V12D07-335_B1,0,0,1,0,0,1
TTAACTCACGCGTGGA-1_V12D07-335_B1,1,1,0,0,0,2
GGAACGGCCTGCAGCC-1_V12D07-335_B1,0,0,1,0,0,1
GTAGAAACGGGTGGAG-1_V12D07-335_B1,0,2,3,0,0,5
TAATGAAAGACCCTTG-1_V12D07-335_B1,0,0,2,0,0,2
AGGCTTGCTAGACACC-1_V12D07-335_B1,0,0,0,0,0,0
TTGCGTAGTTTGAGGA-1_V12D07-335_B1,0,0,1,0,0,1
CGCCCTTGAAGGCTGA-1_V12D07-335_B1,5,2,0,0,0,7
CCCGGTGGAAGAACCT-1_V12D07-335_B1,0,0,2,0,0,2
TTAACACCTCGAACAT-1_V12D07-335_B1,1,0,1,0,0,2
GATTCCTATACGGCGC-1_V12D07-335_B1,0,1,4,0,0,5
TTACCCTAACAGTCCT-1_V12D07-335_B1,1,1,1,0,0,3
ACCCACCTACATGCTC-1_V12D07-335_B1,0,1,0,0,0,1
AAAGGGCAGCTTGAAT-1_V12D07-335_B1,1,0,4,0,0,5
CACACAGGGATAGATT-1_V12D07-335_B1,2,1,2,0,0,5
AGAGCGTACAAGCTCG-1_V12D07-335_B1,1,0,1,0,0,2
TCTTACGGCATCCGAC-1_V12D07-335_B1,1,1,4,0,0,6
GCCTATTCCGATATAG-1_V12D07-335_B1,1,0,1,0,0,2
GAAAGTGACTAACTGC-1_V12D07-335_B1,1,0,2,0,0,3
CCGGAATGGTTTCAGT-1_V12D07-335_B1,0,1,4,0,0,5
AGTATAATACTAGGCA-1_V12D07-335_B1,0,0,3,0,0,3
TAACTATCGAAGGTCC-1_V12D07-335_B1,0,1,2,0,0,3
ATGAGGAGTGTTAATC-1_V12D07-335_B1,0,0,3,0,0,3
TGTGTCGCGAGTTGCA-1_V12D07-335_B1,1,0,2,0,0,3
ATCCAACGCAGTCATA-1_V12D07-335_B1,2,1,1,0,0,4
AAGGCGCGTAAAGCTT-1_V12D07-335_B1,3,0,0,0,0,3
AGTCGGCCCAAACGAC-1_V12D07-335_B1,0,0,2,0,0,2
AACGTCAGACTAGTGG-1_V12D07-335_B1,0,1,3,0,0,4
ACTACCAGCTCTCTGG-1_V12D07-335_B1,0,1,1,0,0,2
GCAAGTGCACAGAGAA-1_V12D07-335_B1,0,0,2,0,0,2
ACACCTTAAGTAGGGC-1_V12D07-335_B1,0,1,0,0,0,1
TTCGACGGGAAGGGCG-1_V12D07-335_B1,1,0,2,0,0,3
TTCGCACTCGCGTGCT-1_V12D07-335_B1,4,0,0,0,0,4
TATTTGTTACCCTTTA-1_V12D07-335_B1,0,2,0,0,0,2
CGCTGTGACGCCGCAC-1_V12D07-335_B1,2,0,1,0,0,3
GTTGCACGGAGTTTCG-1_V12D07-335_B1,0,0,2,0,0,2
GTTTCCTGGAGGGTGA-1_V12D07-335_B1,1,0,0,1,0,2
ACACCCAGCATGCAGC-1_V12D07-335_B1,0,0,1,0,0,1
TCAACCATGTTCGGGC-1_V12D07-335_B1,0,1,0,0,0,1
TTACAACTACGCATCC-1_V12D07-335_B1,0,1,3,0,0,4
TCCGATGGTGCGACAT-1_V12D07-335_B1,0,3,1,0,0,4
GGGCGTACATTTATAT-1_V12D07-335_B1,1,0,5,0,0,6
AGCGACCAACGATATT-1_V12D07-335_B1,0,0,1,0,0,1
ACACAAAGACGGGTGG-1_V12D07-335_B1,0,3,4,0,0,7
ATCGCACGCCGGGAGA-1_V12D07-335_B1,1,2,0,0,0,3
GCTCTAAACCCTGACG-1_V12D07-335_B1,0,2,2,0,0,4
AATGCAACCGGGTACC-1_V12D07-335_B1,0,0,2,0,0,2
TCAAACAACCGCGTCG-1_V12D07-335_B1,1,0,1,0,0,2
TATGCTCCCTACTTAC-1_V12D07-335_B1,0,3,1,0,0,4
AAAGGGATGTAGCAAG-1_V12D07-335_B1,2,1,0,0,0,3
ACGATCATACATAGAG-1_V12D07-335_B1,0,0,1,0,0,1
TTGTTCAGTGTGCTAC-1_V12D07-335_B1,0,1,2,0,0,3
ATGCATGATCCAGGAT-1_V12D07-335_B1,0,0,4,0,0,4
AGTCTTCTCCTCAAAT-1_V12D07-335_B1,0,0,2,0,0,2
GATTCCCTTGTCGCAG-1_V12D07-335_B1,1,0,1,0,2,4
CTCGCACCTATATAGT-1_V12D07-335_B1,0,0,0,0,0,0
ACTCAATAAAGGCACG-1_V12D07-335_B1,0,0,2,0,0,2
AACCGAGCTTGGTCAT-1_V12D07-335_B1,1,0,3,0,0,4
TAAGGCAACATAAGAT-1_V12D07-335_B1,0,0,2,0,0,2
CACGCACAGCGCAGCT-1_V12D07-335_B1,1,0,4,0,0,5
GGTTTACAATCTCAAT-1_V12D07-335_B1,2,1,5,0,0,8
TGCAGGATCGGCAAAG-1_V12D07-335_B1,1,0,0,0,0,1
ATAACGGAGTCCAACG-1_V12D07-335_B1,0,0,2,0,0,2
AACGATATGTCAACTG-1_V12D07-335_B1,1,0,3,0,0,4
GACAACGACCATTGAA-1_V12D07-335_B1,2,2,3,0,0,7
TTGACCATGTTCTCCG-1_V12D07-335_B1,1,0,2,0,0,3
AGTACGGGCACCTGGC-1_V12D07-335_B1,1,0,3,0,0,4
CGCCATCCGATTATGA-1_V12D07-335_B1,1,0,0,0,0,1
AAGGTATCCTAATATA-1_V12D07-335_B1,0,0,1,0,0,1
TGTTGTCAAGAAGTCT-1_V12D07-335_B1,0,1,0,0,0,1
CAGTGAATAAATGACT-1_V12D07-335_B1,1,0,1,0,0,2
CACCTTGCGAAACTCG-1_V12D07-335_B1,3,0,1,0,0,4
CATTTAGCGGACCATG-1_V12D07-335_B1,1,0,1,0,0,2
CCAGTCTAGACGGCGC-1_V12D07-335_B1,3,0,1,0,0,4
TCGCTTTAAACGTTTG-1_V12D07-335_B1,4,0,2,0,0,6
GTGAAACGGCGCCACC-1_V12D07-335_B1,3,0,1,0,0,4
GGGCTCATCGAACCCA-1_V12D07-335_B1,0,0,1,0,0,1
TTGATGTGTAGTCCCG-1_V12D07-335_B1,0,2,3,1,0,6
CAGTAGCCCACGCGGT-1_V12D07-335_B1,2,0,0,0,0,2
AGCGCGGGTGCCAATG-1_V12D07-335_B1,1,0,3,0,0,4
TAATCGATCCGTACGT-1_V12D07-335_B1,2,0,0,0,0,2
AGTGGCGGCAATTTGA-1_V12D07-335_B1,0,0,2,0,0,2
CCTTTCAATGAAGAAA-1_V12D07-335_B1,2,0,0,0,0,2
CTCAGTCACGACAAAT-1_V12D07-335_B1,0,0,0,0,0,0
ATAGGCTAGCTTCGCA-1_V12D07-335_B1,0,0,0,0,0,0
CGGTTCAAGTAGGTGT-1_V12D07-335_B1,0,1,1,0,0,2
CAGTCGAGGATGCAAT-1_V12D07-335_B1,0,0,0,0,0,0
TATCACCCAACCGACC-1_V12D07-335_B1,1,0,0,0,0,1
AATGATGCGACTCCTG-1_V12D07-335_B1,1,0,0,0,0,1
TGGAACCACTGACACA-1_V12D07-335_B1,0,0,1,0,0,1
GCCAATAGGGCATCTC-1_V12D07-335_B1,2,0,0,0,0,2
TTCTTTGGTCGCGACG-1_V12D07-335_B1,2,0,0,0,0,2
ATTAGATTCCTCAGCA-1_V12D07-335_B1,2,0,2,0,0,4
CCGTGGAACGATCCAA-1_V12D07-335_B1,0,0,1,0,0,1
GGGTCGTGGCAAGTGT-1_V12D07-335_B1,2,0,0,0,0,2
TCGCTCGGCACCAGCG-1_V12D07-335_B1,0,0,3,0,0,3
ACGCAATCACTACAGC-1_V12D07-335_B1,2,0,1,0,0,3
CTCTAATGCATTGATC-1_V12D07-335_B1,2,0,0,0,0,2
GTCTCGACTAAGTTTG-1_V12D07-335_B1,3,0,1,0,0,4
TGGTTTAAACGTGGGT-1_V12D07-335_B1,1,0,0,0,1,2
CGCAGATCTTCACCCG-1_V12D07-335_B1,1,0,1,0,0,2
TCCAGATGTACGCCAA-1_V12D07-335_B1,4,1,0,0,3,8
CATTGCGGGTCAATTC-1_V12D07-335_B1,2,0,3,0,1,6
GACGTTCGTAAATACA-1_V12D07-335_B1,0,0,0,0,1,1
TACACCGTCGTTAGTC-1_V12D07-335_B1,0,0,3,1,2,6
ACGGGCGTATGCGACA-1_V12D07-335_B1,0,0,2,1,2,5
GAAGGCTACCATTGTT-1_V12D07-335_B1,0,0,1,0,1,2
TAAATCTTTACACCTC-1_V12D07-335_B1,1,0,1,0,0,2
AGTTTATGTAAAGACA-1_V12D07-335_B1,1,0,3,0,1,5
AGGAGACATCCACAGT-1_V12D07-335_B1,0,0,3,0,1,4
CAACCTGAACCTGCCA-1_V12D07-335_B1,1,0,3,0,0,4
AGTCCCTCGCAGAAAG-1_V12D07-335_B1,1,0,1,0,0,2
TGTATACGGATGATGA-1_V12D07-335_B1,0,0,3,0,1,4
TTGTGGTATAGGTATG-1_V12D07-335_B1,0,0,1,0,0,1
TCTGCACCATTAGTAA-1_V12D07-335_B1,4,0,1,0,0,5
AAATGTATCTTATCCC-1_V12D07-335_B1,0,0,0,0,0,0
ACTCTAAACCTGGGAT-1_V12D07-335_B1,0,0,0,0,0,0
GCTGGCAGGTGCCGTG-1_V12D07-335_B1,0,0,0,0,0,0
CTCATTCGTGAACATC-1_V12D07-335_B1,0,0,0,0,0,0
TCGCCGGATGGGCAAG-1_V12D07-335_B1,0,0,0,0,0,0
GGACTAAGTCAGGAGT-1_V12D07-335_B1,0,0,0,0,0,0
TATCAAAGGTCTGTAA-1_V12D07-335_B1,0,0,0,0,0,0
TTCAGTTTGTGGCAGC-1_V12D07-335_B1,0,0,0,0,0,0
TGTTCATAAATGTGCT-1_V12D07-335_B1,0,0,0,0,0,0
CTTAGCCCGGATAGTG-1_V12D07-335_B1,3,0,0,0,0,3
GATGCGAATGGTATTA-1_V12D07-335_B1,1,0,1,0,0,2
TCTAACTGTATGTAAA-1_V12D07-335_B1,1,0,3,0,0,4
TTAAACCTGGTTCCTT-1_V12D07-335_B1,0,0,4,0,0,4
GCTAAGTAAAGGCGAT-1_V12D07-335_B1,0,2,2,0,0,4
AGTTACCGCACATGGT-1_V12D07-335_B1,1,0,5,0,0,6
GACTGCGGCACGTGTA-1_V12D07-335_B1,1,3,2,0,0,6
TGGTGATCGTATTTGT-1_V12D07-335_B1,1,0,6,0,0,7
TTATCGCCTGCGAAGC-1_V12D07-335_B1,0,0,4,0,0,4
TGGAATTAGACGCTTT-1_V12D07-335_B1,0,1,3,0,0,4
TCGTCACACTGTTAGC-1_V12D07-335_B1,0,0,3,0,0,3
TTATGTTTGCGATAGA-1_V12D07-335_B1,0,0,0,0,0,0
GGTGCTGATCACAAAG-1_V12D07-335_B1,0,0,4,0,0,4
CATAGCCGCCCGGGAT-1_V12D07-335_B1,0,0,4,0,0,4
GGTTAGTTACGGCGCC-1_V12D07-335_B1,2,1,0,0,0,3
ATTCCCACATAAACAA-1_V12D07-335_B1,1,1,1,0,0,3
ATTCAGTAGCAGGGTC-1_V12D07-335_B1,2,0,1,0,0,3
CAGTTCCGCGGGTCGA-1_V12D07-335_B1,0,1,2,0,0,3
AAGAGATGAATCGGTA-1_V12D07-335_B1,2,0,3,0,0,5
CGCAATTCTACAATAA-1_V12D07-335_B1,1,1,3,0,0,5
TAACGCTTTGAGAGCG-1_V12D07-335_B1,1,0,0,0,0,1
AGGCTATGGTTAGCTT-1_V12D07-335_B1,0,2,1,0,0,3
GAGGAATGGAGAGGTT-1_V12D07-335_B1,3,0,0,0,0,3
TCCTCTACGAGATGGC-1_V12D07-335_B1,0,0,4,0,0,4
TTGATTATGCAGATGA-1_V12D07-335_B1,0,1,1,0,0,2
TCAGTACTGACCCGCG-1_V12D07-335_B1,0,3,3,0,0,6
TTATGACAAACTGGAT-1_V12D07-335_B1,2,0,1,0,0,3
GTAAGTAGGGTATACC-1_V12D07-335_B1,0,1,0,0,0,1
CGCAAACACGAGTTAC-1_V12D07-335_B1,1,0,3,0,0,4
TGGCCGTATATTGACC-1_V12D07-335_B1,1,1,0,0,0,2
ACTGTAGCACTTTGGA-1_V12D07-335_B1,1,1,2,0,0,4
GCTCTATGTTACGTGC-1_V12D07-335_B1,0,0,1,0,0,1
TGCGCGATTAACGGAG-1_V12D07-335_B1,2,0,0,0,0,2
GAATCGACATGGTCAC-1_V12D07-335_B1,2,0,2,0,0,4
GACTAAGTAGGCTCAC-1_V12D07-335_B1,1,0,4,0,0,5
ATCTTGACCTGCAACG-1_V12D07-335_B1,2,1,3,0,0,6
ATGCACTACCGCATTG-1_V12D07-335_B1,1,0,0,0,0,1
CAGATACTAACATAGT-1_V12D07-335_B1,1,1,1,0,0,3
GATCGACACTATCTGA-1_V12D07-335_B1,1,1,3,0,0,5
ATAGAGTACTGGGACA-1_V12D07-335_B1,1,1,2,0,0,4
CCTACTGCTTACACTT-1_V12D07-335_B1,1,0,3,1,0,5
CCTGCTATTTGAGAAG-1_V12D07-335_B1,0,0,1,0,0,1
CGCGTTCATGAAATAC-1_V12D07-335_B1,1,2,1,0,0,4
CATTATGCTTGTTGTG-1_V12D07-335_B1,0,0,2,0,0,2
CCAGGGACGTGGCCTC-1_V12D07-335_B1,1,0,1,0,0,2
TATGGATGTGCTACGC-1_V12D07-335_B1,2,0,1,0,0,3
GTACTAAGATTTGGAG-1_V12D07-335_B1,3,0,0,0,0,3
AGACCCGCCCTCCTCG-1_V12D07-335_B1,1,1,1,0,0,3
CGCATTAGCTAATAGG-1_V12D07-335_B1,3,0,0,0,0,3
GCTCTCGGGTACCGAA-1_V12D07-335_B1,0,1,1,0,0,2
CACCGCCAGAAGGTTT-1_V12D07-335_B1,1,1,2,0,0,4
TCCCAAAGACGAAGGA-1_V12D07-335_B1,0,0,3,0,0,3
ATGGATTGACCAAACG-1_V12D07-335_B1,1,0,0,0,0,1
GTCATGGACATGACTA-1_V12D07-335_B1,3,0,2,0,0,5
CTACTGCCACCTGACC-1_V12D07-335_B1,2,1,3,0,0,6
TTATATTTGGCAATCC-1_V12D07-335_B1,0,0,1,0,0,1
AGCACCAGTACTCACG-1_V12D07-335_B1,0,1,1,0,0,2
CATGGTCTAGATACCG-1_V12D07-335_B1,1,0,1,0,0,2
TCTACCGTCCACAAGC-1_V12D07-335_B1,0,1,1,0,0,2
CTAGTTGGGCCCGGTA-1_V12D07-335_B1,1,0,0,0,0,1
TCCCGCGTACTCCTGG-1_V12D07-335_B1,1,0,4,0,0,5
CAGAGCATGAGCTTGC-1_V12D07-335_B1,0,0,1,0,0,1
ACACGGGAACTTAGGG-1_V12D07-335_B1,0,0,2,0,0,2
GGCTCTGCTCCAACGC-1_V12D07-335_B1,1,0,1,0,0,2
AGAACGTGGTACATTC-1_V12D07-335_B1,0,0,3,0,0,3
CAATAAACCTTGGCCC-1_V12D07-335_B1,0,0,1,0,0,1
ACTTCGCCATACGCAC-1_V12D07-335_B1,1,1,1,0,0,3
ATCTGGTTAAGACTGT-1_V12D07-335_B1,2,1,2,1,0,6
TCGTAAGACGACATTG-1_V12D07-335_B1,0,1,0,0,0,1
GTGTACCTTGGCTACG-1_V12D07-335_B1,0,0,1,0,0,1
GCCCGTAATACCTTCT-1_V12D07-335_B1,1,0,0,1,0,2
CGGTCAAGTGGGAACC-1_V12D07-335_B1,2,1,0,0,0,3
TTGTAAGGCCAGTTGG-1_V12D07-335_B1,0,0,1,0,0,1
GGAGCACCAAGAACTA-1_V12D07-335_B1,0,0,6,1,0,7
TAATAGTGACGACCAG-1_V12D07-335_B1,1,0,1,0,0,2
CTAAATCCTATTCCGG-1_V12D07-335_B1,0,0,1,0,0,1
CGAGTTCTGTCCCACC-1_V12D07-335_B1,1,0,1,0,0,2
AGGCAGATGCGTAAAC-1_V12D07-335_B1,2,0,1,0,0,3
AAGGATGAGGGACCTC-1_V12D07-335_B1,2,0,1,2,0,5
AGAGAACCGTCTAGGA-1_V12D07-335_B1,0,0,0,0,0,0
GAGGGCGCAGCTCTGC-1_V12D07-335_B1,1,0,0,1,0,2
AAGATTGGCGGAACGT-1_V12D07-335_B1,0,0,0,0,0,0
CCAGTAGTCTGATCCA-1_V12D07-335_B1,1,0,1,0,0,2
AAGGGACAGATTCTGT-1_V12D07-335_B1,2,0,1,0,0,3
ATAGAGTTATCAACTT-1_V12D07-335_B1,3,0,0,0,0,3
AAATTACCTATCGATG-1_V12D07-335_B1,3,0,1,0,0,4
GATCCTAAATCGGGAC-1_V12D07-335_B1,1,0,0,0,0,1
TTACAGACCTAAATGA-1_V12D07-335_B1,2,0,0,0,0,2
CCTCACCTTAGCATCG-1_V12D07-335_B1,1,0,1,0,0,2
CATGCGACCAGTTTAA-1_V12D07-335_B1,3,0,0,0,0,3
AACATATCAACTGGTG-1_V12D07-335_B1,2,1,1,1,0,5
CTATAAGAGCCAATCG-1_V12D07-335_B1,2,0,0,0,0,2
AATATCGAGGGTTCTC-1_V12D07-335_B1,0,0,0,0,0,0
GTACTCCTGGGTATGC-1_V12D07-335_B1,1,0,2,0,0,3
ATAAGTAGGATTCAGA-1_V12D07-335_B1,0,0,1,0,1,2
AGGTCGCGGAGTTACT-1_V12D07-335_B1,1,0,1,0,0,2
CTAATTCTCAGATATT-1_V12D07-335_B1,2,0,0,0,0,2
GCCAACCATTTCCGGA-1_V12D07-335_B1,0,0,2,1,0,3
TGATCCCAGCATTAGT-1_V12D07-335_B1,0,0,1,0,0,1
CGTTGTAAGATTGATT-1_V12D07-335_B1,0,1,1,0,0,2
GAAACCATGGTGCGCT-1_V12D07-335_B1,2,0,0,0,0,2
AATCTATGCCGGAGCC-1_V12D07-335_B1,3,0,0,0,0,3
GACTCCCAGAATAAGG-1_V12D07-335_B1,0,0,3,0,0,3
TATGATCCGGCACGCC-1_V12D07-335_B1,0,0,1,0,0,1
CCGCTTGCTGACATGG-1_V12D07-335_B1,0,0,0,0,0,0
TGGTTAAGGGCGCTGG-1_V12D07-335_B1,3,0,1,0,0,4
TTGATAGTCAATACAT-1_V12D07-335_B1,0,0,0,0,0,0
GGTTTAATTGAGCAGG-1_V12D07-335_B1,0,0,1,0,0,1
CATTACATAGATTGTG-1_V12D07-335_B1,1,1,1,0,1,4
GGTACACCAGATTTAT-1_V12D07-335_B1,1,0,2,1,2,6
GGCCCGTATACCATGC-1_V12D07-335_B1,1,0,0,0,1,2
ATCTTTCGTATAACCA-1_V12D07-335_B1,4,0,1,0,0,5
GAGATGACAATCCTTA-1_V12D07-335_B1,2,0,1,0,0,3
AAAGCTTGCCTACATA-1_V12D07-335_B1,2,0,1,0,1,4
GAACGATAAGTTAAAG-1_V12D07-335_B1,1,0,3,0,2,6
TAATAGCTAAATGATG-1_V12D07-335_B1,0,0,5,0,0,5
TATGGCTAGGCTAATT-1_V12D07-335_B1,3,1,5,1,1,11
AGGAGAGTCTGGCTAC-1_V12D07-335_B1,1,0,4,0,0,5
TGCTCTGCCGGTTCAC-1_V12D07-335_B1,2,1,5,0,0,8
CCAATAGATTTCATCT-1_V12D07-335_B1,0,0,0,0,0,0
GGGCACGAATTGGCCG-1_V12D07-335_B1,0,0,0,0,0,0
TCGTTGACAGGGTCCC-1_V12D07-335_B1,0,0,0,0,0,0
ATCGTATTCCGAGAAC-1_V12D07-335_B1,0,0,0,0,0,0
GGGAATTCTGTCCAGT-1_V12D07-335_B1,0,0,0,0,0,0
ACGCGTTTCTTAAGAG-1_V12D07-335_B1,0,0,0,0,0,0
GAGAGCGCAGTCCCTG-1_V12D07-335_B1,0,0,0,0,0,0
GTCCTATTGTTGTGGT-1_V12D07-335_B1,0,0,0,0,0,0
CATCTGCAGGATCATT-1_V12D07-335_B1,1,0,0,0,0,1
GAGTCGACAGACCCTC-1_V12D07-335_B1,0,0,2,0,0,2
AAGTGCAAAGGTAGAC-1_V12D07-335_B1,0,1,5,0,0,6
AGGGTGGATAGTGCAT-1_V12D07-335_B1,2,0,2,0,0,4
TGATAGCGGGATTCTA-1_V12D07-335_B1,0,0,1,0,0,1
GTCAGTTTGGTAGTCG-1_V12D07-335_B1,1,0,1,1,0,3
GCATTCGAAATGAACA-1_V12D07-335_B1,2,2,3,0,0,7
AAAGACTGGGCGCTTT-1_V12D07-335_B1,0,0,4,0,0,4
TAACAATATTTGTTGC-1_V12D07-335_B1,1,1,1,0,0,3
CCAGCTTCCGCCCGCA-1_V12D07-335_B1,0,0,5,1,0,6
GATATGGATTACGCGG-1_V12D07-335_B1,0,0,6,0,0,6
AGAGCAGTTATGAGAC-1_V12D07-335_B1,2,0,3,0,0,5
TCACATCTTATCTGAT-1_V12D07-335_B1,1,0,1,0,0,2
TATGAAGACAGGTGCG-1_V12D07-335_B1,0,0,3,0,0,3
TACCTGCTGCACTGTG-1_V12D07-335_B1,1,0,3,0,0,4
TAGGTCCAAGTAAGGA-1_V12D07-335_B1,1,0,3,0,0,4
GAAACTCGTGCGATGC-1_V12D07-335_B1,0,1,3,0,0,4
AACAATTACTCTACGC-1_V12D07-335_B1,1,0,2,0,0,3
CCGCACGTGACCTCGG-1_V12D07-335_B1,1,0,2,0,0,3
AACTTGCCCGTATGCA-1_V12D07-335_B1,1,3,4,0,0,8
GGGTATGTATGCACTT-1_V12D07-335_B1,0,0,0,0,0,0
TTCGTACTCCAGAACG-1_V12D07-335_B1,3,1,1,0,0,5
GAATTTCTCGCTGCAG-1_V12D07-335_B1,2,1,1,0,0,4
AACAGGATGGGCCGCG-1_V12D07-335_B1,0,0,2,0,0,2
GACGTGTAGGGATTAT-1_V12D07-335_B1,1,0,1,0,0,2
TAGGTGAGCCCTACTC-1_V12D07-335_B1,1,0,4,0,0,5
CTAATTCGCACGCGCT-1_V12D07-335_B1,0,0,0,0,0,0
GAAGCTTGCTGACCGC-1_V12D07-335_B1,0,0,3,0,0,3
GGTTAGGCTTGGAGAA-1_V12D07-335_B1,1,1,0,0,0,2
ACAAGGACAAGAGGTT-1_V12D07-335_B1,0,0,2,0,0,2
AGGCCACCCGTTATGA-1_V12D07-335_B1,0,0,1,0,0,1
GTGGGCTTAGACACAC-1_V12D07-335_B1,0,1,3,0,0,4
CGTGTCCCATTCGCGA-1_V12D07-335_B1,3,0,0,0,0,3
TGGAGTGATGCGATGA-1_V12D07-335_B1,2,0,3,0,0,5
AACAACTGGTAGTTGC-1_V12D07-335_B1,1,2,0,0,0,3
CCTGGCTAGACCCGCC-1_V12D07-335_B1,0,0,0,0,0,0
CGCAATTAGGGTAATA-1_V12D07-335_B1,3,0,1,0,0,4
TCGAAATTTAGGACCA-1_V12D07-335_B1,0,1,0,0,0,1
AGACTAGCCTTCCAGA-1_V12D07-335_B1,1,0,0,0,0,1
TTGATCTAACTTTGTC-1_V12D07-335_B1,0,0,2,0,0,2
AAGGAGCGGTTGGTGC-1_V12D07-335_B1,0,0,1,0,0,1
ACTTGGGACCCGGTGG-1_V12D07-335_B1,0,0,1,0,0,1
TGATCTCCGGCGCCAG-1_V12D07-335_B1,2,0,1,0,0,3
CAGTTCAAATTGACAC-1_V12D07-335_B1,0,0,1,0,0,1
GTCCGGCTGAATTGCG-1_V12D07-335_B1,1,0,3,0,0,4
CTGGAAATGGATGCTT-1_V12D07-335_B1,1,0,2,0,0,3
TGATCGGTTTGACCCT-1_V12D07-335_B1,0,0,2,0,0,2
TAGAGTCTAAGCGAAC-1_V12D07-335_B1,1,1,0,0,0,2
GAGACTGATGGGTAGA-1_V12D07-335_B1,1,0,1,0,0,2
TAGCTAAGTCCGGGAG-1_V12D07-335_B1,0,0,0,0,0,0
GGGCGATATGTGTGAA-1_V12D07-335_B1,2,1,0,0,0,3
CTCGAGGTCGAACAGT-1_V12D07-335_B1,0,0,1,0,0,1
GATCCCTTTATACTGC-1_V12D07-335_B1,1,0,1,0,0,2
GTCATGCACCTCCGTT-1_V12D07-335_B1,0,0,0,0,0,0
ACTTTCCTATAGCTTC-1_V12D07-335_B1,0,1,1,0,0,2
TCGCTCGATATATTCC-1_V12D07-335_B1,2,0,1,1,0,4
ATAGGTTGGGCAGATG-1_V12D07-335_B1,0,0,1,0,0,1
CAATTAAGGGTGATGA-1_V12D07-335_B1,0,2,1,0,0,3
ACCGACTGAGTCCCAC-1_V12D07-335_B1,2,0,1,0,0,3
CCTGTCACCCGGGCTC-1_V12D07-335_B1,1,1,4,0,0,6
GATCGGTGGCCATAAC-1_V12D07-335_B1,0,0,1,0,0,1
CCTATGGGTTACCGTC-1_V12D07-335_B1,0,0,2,0,0,2
TTGGGACACTGCCCGC-1_V12D07-335_B1,1,0,0,0,0,1
CGAGGCTAAATATGGC-1_V12D07-335_B1,1,0,2,0,0,3
TCAGGGTGTAACGTAA-1_V12D07-335_B1,0,1,1,0,0,2
CGAGAGATGTGAACCT-1_V12D07-335_B1,1,0,1,0,0,2
TCGCTGGGCGGATTGT-1_V12D07-335_B1,1,0,2,0,0,3
AGATCTCAGGTGTGAT-1_V12D07-335_B1,0,0,1,0,0,1
TGGCCAAACTGAAGTA-1_V12D07-335_B1,0,1,0,0,0,1
GCTTCCGTCCCTAGAC-1_V12D07-335_B1,0,0,0,0,0,0
CAGCAGCCCGTTCCTT-1_V12D07-335_B1,0,0,4,1,0,5
TGTATAACAGATCCTG-1_V12D07-335_B1,1,0,4,0,0,5
CGCGGGAATTAGGCAG-1_V12D07-335_B1,0,0,0,0,0,0
TGCATGTGGTAATCTA-1_V12D07-335_B1,0,0,0,1,0,1
ACAATTTGAGCAGTGG-1_V12D07-335_B1,2,0,0,0,0,2
GAGCTAAGGGCATATC-1_V12D07-335_B1,1,0,1,0,0,2
CCAGATAGTTGAGTGA-1_V12D07-335_B1,0,0,0,1,0,1
CCACAATGTACGTCTT-1_V12D07-335_B1,0,1,2,1,0,4
CAATGGATCTCTACCA-1_V12D07-335_B1,1,0,0,0,0,1
TGTGGCAAAGCGTATG-1_V12D07-335_B1,2,0,1,1,0,4
TAAAGCGTTAGGAGAA-1_V12D07-335_B1,1,0,0,0,0,1
TCCGTTTAGCCTTGAA-1_V12D07-335_B1,1,0,1,0,0,2
CAGCTCGACAAGTTAA-1_V12D07-335_B1,6,0,1,0,0,7
GCCTATAGTGTCAGGG-1_V12D07-335_B1,2,0,1,0,0,3
ATAGACAACGGGACCT-1_V12D07-335_B1,0,0,1,0,0,1
CTACTATCTTTCAGAG-1_V12D07-335_B1,2,0,1,0,0,3
GCGCTGCTTTGCATTT-1_V12D07-335_B1,0,0,0,0,0,0
GCGCATCCAGTCAGCA-1_V12D07-335_B1,1,0,0,0,0,1
GACTCGCGGGAATGAC-1_V12D07-335_B1,0,0,0,0,0,0
CTGGTAACGAGCTCTT-1_V12D07-335_B1,0,0,0,0,0,0
TCCGGCCTAGCGTACA-1_V12D07-335_B1,2,0,0,0,0,2
TCTAGGTGGCGACGCT-1_V12D07-335_B1,3,0,1,0,0,4
ACGCTAGTGATACACT-1_V12D07-335_B1,0,0,0,0,1,1
ATCTGCACCTCTGCGA-1_V12D07-335_B1,2,0,0,0,1,3
CCTCACCTGAGGGAGC-1_V12D07-335_B1,0,1,1,0,1,3
AGTGAGCCTCGCCGCC-1_V12D07-335_B1,0,0,0,1,0,1
ACGAGTACGGATGCCC-1_V12D07-335_B1,1,0,1,0,1,3
GGTACCATTAAGACGG-1_V12D07-335_B1,3,1,1,1,0,6
TTCTGCTAGACTCCAA-1_V12D07-335_B1,1,0,3,0,0,4
TAACTATTACGCCAAA-1_V12D07-335_B1,1,0,0,0,0,1
GCATTCAAGGCAACGC-1_V12D07-335_B1,0,0,0,0,0,0
AGTACATCATTTATCA-1_V12D07-335_B1,0,0,1,0,0,1
GTCGTGTCTGGTCATC-1_V12D07-335_B1,1,0,0,0,0,1
AGTCTAAAGTATACTC-1_V12D07-335_B1,0,0,0,0,0,0
CGGCCCAACCTGTAGT-1_V12D07-335_B1,1,0,0,0,0,1
AGGGAGACATACTTCG-1_V12D07-335_B1,1,0,0,0,0,1
TCCCTAGATCAATAGG-1_V12D07-335_B1,1,1,2,0,0,4
TCCCGTCGCGTCATAG-1_V12D07-335_B1,1,0,1,0,1,3
CGCATCCATCAGCCAG-1_V12D07-335_B1,1,0,0,0,1,2
CTGCACCTAGTCCACA-1_V12D07-335_B1,1,0,0,0,0,1
CGAGGATCGGGAACGA-1_V12D07-335_B1,0,0,1,0,1,2
CAATGAGGTTCGACTA-1_V12D07-335_B1,1,0,0,1,0,2
TCTGACGGGCTAACCC-1_V12D07-335_B1,0,0,1,0,1,2
TTCTATGCCTTTCGCA-1_V12D07-335_B1,4,1,0,0,1,6
AGAGTATAGTGTTACG-1_V12D07-335_B1,0,0,2,0,0,2
CCATTGTTTCCTCCAT-1_V12D07-335_B1,0,0,0,0,1,1
CTCATCACTTAGTGAT-1_V12D07-335_B1,1,0,0,0,0,1
CCGAAGGGCGTACCGC-1_V12D07-335_B1,0,0,3,1,1,5
TCAAGCTGCCTTGAAA-1_V12D07-335_B1,2,0,3,0,0,5
CTCATTAACGTTGCCC-1_V12D07-335_B1,0,0,1,0,0,1
GTCTTCCTCACCTAAG-1_V12D07-335_B1,0,0,0,0,0,0
GGTGATGAAGGAAGTG-1_V12D07-335_B1,0,0,0,0,0,0
TCAATACAATTGCTGC-1_V12D07-335_B1,0,0,0,0,0,0
GCAACCCAAGTTGTTT-1_V12D07-335_B1,0,0,0,0,0,0
ATGAAGTGGACCCAGC-1_V12D07-335_B1,0,0,0,0,0,0
GAGAATCTCACGATCA-1_V12D07-335_B1,0,0,0,0,0,0
TATATCATTGATCAGT-1_V12D07-335_B1,0,0,0,0,0,0
AACTTTACGGGAGCTT-1_V12D07-335_B1,0,0,0,0,0,0
TTCTTGTGTCCATCAG-1_V12D07-335_B1,0,0,0,0,0,0
ACAATTTAGGAGGCTC-1_V12D07-335_B1,0,0,1,0,0,1
ATACTTGTTCTCGAGC-1_V12D07-335_B1,0,1,4,0,0,5
CACGGGATTGAGGGTT-1_V12D07-335_B1,0,1,2,0,0,3
GTTAATGTCTATCTTA-1_V12D07-335_B1,1,1,6,0,0,8
GCGTTATATTTGGAAC-1_V12D07-335_B1,1,0,4,0,0,5
CGTCAAGGCTATAAAT-1_V12D07-335_B1,0,2,7,0,0,9
TTAGCTCTGTAATCCG-1_V12D07-335_B1,1,0,2,0,0,3
AATGGTCCACCGTTCA-1_V12D07-335_B1,2,0,3,0,0,5
GTCATTGCATTGACCC-1_V12D07-335_B1,2,0,7,0,0,9
TGTCCGTGGCGCCTTT-1_V12D07-335_B1,1,1,2,0,0,4
TCAACTAACGTATAAC-1_V12D07-335_B1,0,0,0,0,0,0
TCCTCTCCAGTTGTCC-1_V12D07-335_B1,0,0,3,0,0,3
TGTGTTCGTATCCAAG-1_V12D07-335_B1,1,0,0,0,0,1
CCGCGTAGGTAAGGGC-1_V12D07-335_B1,1,0,2,0,0,3
CTGCGGGTGAAATGTT-1_V12D07-335_B1,0,0,4,0,0,4
TATCTACAGAGGTAAT-1_V12D07-335_B1,1,1,1,1,0,4
CTACTCTAGGCCCGGC-1_V12D07-335_B1,1,0,3,0,0,4
ACAAGCAGTGCCTAGC-1_V12D07-335_B1,1,1,2,0,0,4
TACAAGTCTCGTGCAT-1_V12D07-335_B1,2,1,2,0,0,5
TCGGAATGCGCTCTGA-1_V12D07-335_B1,7,1,0,0,0,8
TCGCGTCCAGAAGGTC-1_V12D07-335_B1,0,0,1,0,0,1
TATGGCCCGGCCTCGC-1_V12D07-335_B1,0,0,2,0,0,2
GCTGGCATATTCACCT-1_V12D07-335_B1,0,1,1,0,0,2
GTCAGAATAGTCTATG-1_V12D07-335_B1,1,2,1,0,0,4
GGCGTCCTATCCGCTG-1_V12D07-335_B1,1,0,6,0,0,7
CGGAGTTTGAGAGACA-1_V12D07-335_B1,2,0,2,0,0,4
AGCACTTAAGGACGCC-1_V12D07-335_B1,1,0,0,0,0,1
TCCACAATGGTTTACG-1_V12D07-335_B1,1,0,1,0,0,2
CCAACGATGCACTGAT-1_V12D07-335_B1,0,2,1,0,0,3
ATTTACAGTTTACTGG-1_V12D07-335_B1,0,2,2,0,0,4
CCCTGAAATGAGTTGA-1_V12D07-335_B1,1,0,0,0,0,1
CAAACGGTCGCACTTT-1_V12D07-335_B1,2,0,2,0,0,4
TGATTCGTCTATCACT-1_V12D07-335_B1,1,1,2,0,0,4
TCAGGTTCTTTGAGAA-1_V12D07-335_B1,4,0,1,0,0,5
CACGCAGCGAGGCTTT-1_V12D07-335_B1,0,0,3,0,0,3
TTAAGCGCCTGACCCA-1_V12D07-335_B1,4,0,2,0,0,6
CTTACACGGTATTCCA-1_V12D07-335_B1,0,0,3,0,0,3
AAGGCTGTGCTCATCG-1_V12D07-335_B1,3,1,0,0,0,4
GACCAGAGCCCTGTAG-1_V12D07-335_B1,5,1,1,0,0,7
TCCCAGGCTTAGCTAA-1_V12D07-335_B1,1,0,2,0,0,3
ATTGAAGATCTTAGTG-1_V12D07-335_B1,1,1,2,0,0,4
AGTTCCTACAGAATTA-1_V12D07-335_B1,2,0,2,0,0,4
GGGCTGGTTAGTCGCG-1_V12D07-335_B1,2,0,1,0,0,3
GAAATGGCGGTGTTAG-1_V12D07-335_B1,0,0,1,0,0,1
TACGAACACGACTTCA-1_V12D07-335_B1,2,1,0,0,0,3
ACCACAAGTTTCTATC-1_V12D07-335_B1,2,0,2,0,0,4
ATATTTAACCCTCAAG-1_V12D07-335_B1,1,3,1,0,0,5
GATCATTCCAAACATT-1_V12D07-335_B1,1,0,0,0,0,1
TCCAGGCGAGTACGGT-1_V12D07-335_B1,2,0,2,0,0,4
GTTTGACCAAATCCTA-1_V12D07-335_B1,2,0,0,0,0,2
CACAGCACCCACGGCA-1_V12D07-335_B1,2,0,0,0,0,2
TGCAAGAATGACGTAA-1_V12D07-335_B1,1,2,2,0,0,5
GCGAAGCCATACCCGT-1_V12D07-335_B1,2,0,0,0,0,2
TCCTTTCTTACGCTTA-1_V12D07-335_B1,1,0,0,0,0,1
GCTGCTCTCCGGACAC-1_V12D07-335_B1,0,0,1,0,0,1
ACTGTCTTCTTTAGAA-1_V12D07-335_B1,1,0,0,0,0,1
TCAAACTTAGATTGTT-1_V12D07-335_B1,0,3,0,0,0,3
CTATGTCACTAGCCCA-1_V12D07-335_B1,2,1,0,0,0,3
TGCGCAAAGCATTTGG-1_V12D07-335_B1,0,0,0,0,0,0
TTAATGTAGACCAGGT-1_V12D07-335_B1,0,0,0,0,0,0
GGCGGTAGGATCATTG-1_V12D07-335_B1,1,1,0,0,0,2
GGCAATAGTCAATGAG-1_V12D07-335_B1,1,0,3,0,0,4
ACACGAGACTCCTTCT-1_V12D07-335_B1,1,1,0,0,0,2
GACACAAGGGAAGAAA-1_V12D07-335_B1,0,0,0,0,0,0
TCAGCAAATGCATCTC-1_V12D07-335_B1,1,1,3,0,0,5
GAGATCTGTCACTCCG-1_V12D07-335_B1,0,0,2,0,0,2
ATGCCGGTCTTGCATA-1_V12D07-335_B1,1,0,5,0,0,6
TTGGGCGGCGGTTGCC-1_V12D07-335_B1,1,0,4,0,0,5
TTGTTGTGTGTCAAGA-1_V12D07-335_B1,0,0,2,0,0,2
ACTGTACGATACACAT-1_V12D07-335_B1,1,0,0,0,0,1
TCCACTTTATCTAGGT-1_V12D07-335_B1,0,0,0,0,0,0
GGTCTGAGAATCTGGA-1_V12D07-335_B1,1,0,1,0,0,2
TAGAAAGGTGGCGCTA-1_V12D07-335_B1,0,0,2,0,0,2
TATGTCTCATTGTGCC-1_V12D07-335_B1,2,0,1,0,0,3
GGATTTCACTTCTATA-1_V12D07-335_B1,0,0,0,0,0,0
TGAGTGGTCCGTGACG-1_V12D07-335_B1,1,0,0,0,0,1
CGCTTTCTTGCATTCG-1_V12D07-335_B1,2,1,0,0,0,3
ACCCAACGCCCGTGGC-1_V12D07-335_B1,0,0,0,0,0,0
GAACGTCTCATGGTCG-1_V12D07-335_B1,0,0,1,0,0,1
AGGGTTCCCTTTGGTT-1_V12D07-335_B1,0,0,1,0,0,1
GTAGCTTCCTCTTGTT-1_V12D07-335_B1,1,0,0,0,0,1
GCATGAGGGACGCGGC-1_V12D07-335_B1,2,0,2,0,0,4
CTACCCTAAGGTCATA-1_V12D07-335_B1,0,0,0,0,0,0
TCACCGCTCGGCACTC-1_V12D07-335_B1,4,0,1,0,0,5
GGCTCGCGTTGAGGTA-1_V12D07-335_B1,3,0,0,0,0,3
CTAACGAAACTTGCTG-1_V12D07-335_B1,1,0,1,0,0,2
TTAAACTCGAATTCAT-1_V12D07-335_B1,1,0,1,0,0,2
TACTTTACTGAGCCGG-1_V12D07-335_B1,0,0,0,0,0,0
GCTTGGATCGATTAGG-1_V12D07-335_B1,0,0,0,0,0,0
CGGTTATCCAACAGTG-1_V12D07-335_B1,0,0,0,0,0,0
CAGACCTGTAAGTGTT-1_V12D07-335_B1,0,0,0,0,0,0
GACGGTCAATAGAAGC-1_V12D07-335_B1,0,0,0,0,0,0
CTGACTGCGCAGCTCG-1_V12D07-335_B1,2,0,0,0,0,2
CCATACCTTTACTTGT-1_V12D07-335_B1,0,0,0,0,0,0
GTAATAAAGGGCTCCC-1_V12D07-335_B1,1,0,1,0,0,2
GTGAACTCCCATTCGA-1_V12D07-335_B1,0,0,1,0,0,1
GTGGTTACTTCTTTCG-1_V12D07-335_B1,4,0,0,0,0,4
TCAGAACCTCCACAGG-1_V12D07-335_B1,1,0,0,0,0,1
TCCCACTCTCTTCCGG-1_V12D07-335_B1,1,0,2,0,0,3
ATCTTGACTTGTCCAA-1_V12D07-335_B1,0,0,2,0,0,2
TCGGGAACGTGCCTAG-1_V12D07-335_B1,0,1,1,0,0,2
GTTAGCCGTAAATCAA-1_V12D07-335_B1,1,0,0,1,0,2
ATTTACTAAGTCCATT-1_V12D07-335_B1,1,0,0,0,0,1
GGGTGCATATGAAAGC-1_V12D07-335_B1,2,0,1,0,0,3
TCCGAATGGTCCTGAG-1_V12D07-335_B1,0,0,1,1,0,2
TGATGGCTGTTTCTGA-1_V12D07-335_B1,0,0,3,0,0,3
AAATAAGGTAGTGCCC-1_V12D07-335_B1,0,0,1,0,0,1
CCACTATCCGGGTCAC-1_V12D07-335_B1,1,0,1,0,0,2
ACACCACATAATTAGC-1_V12D07-335_B1,1,0,1,0,0,2
CGCGGTAAGTCTAGCT-1_V12D07-335_B1,1,0,0,0,0,1
GCGGGCATTACGATGC-1_V12D07-335_B1,0,0,0,0,0,0
AGGATTGCTTACGACA-1_V12D07-335_B1,4,0,0,0,0,4
CTCGGGATAACACCTA-1_V12D07-335_B1,1,0,1,0,0,2
GTCGTCTGGTTGGCTA-1_V12D07-335_B1,0,0,2,0,0,2
GCAATTAGTCGCACCG-1_V12D07-335_B1,1,0,1,0,1,3
GTGACCTAAAGAATAA-1_V12D07-335_B1,2,0,2,0,0,4
CTGAGCGAGACTTATT-1_V12D07-335_B1,2,0,2,0,1,5
CAAGACTCAGAAGCGC-1_V12D07-335_B1,0,0,2,0,0,2
ACTTCGCTAGCGAGTG-1_V12D07-335_B1,1,0,2,0,0,3
CCATACTCGCCTCTCC-1_V12D07-335_B1,0,0,0,0,0,0
ACGATACCTATCCTGA-1_V12D07-335_B1,0,0,0,0,0,0
CTCACCAGTACAAGTG-1_V12D07-335_B1,0,0,0,0,0,0
CGAAGACGGTGAGTGC-1_V12D07-335_B1,0,0,0,0,0,0
AAATTAATAAGCGCGA-1_V12D07-335_B1,0,0,0,0,0,0
GGGCCCTTATCTATAC-1_V12D07-335_B1,0,0,0,0,0,0
CTGCCCACGAAGCGTT-1_V12D07-335_B1,0,0,0,0,0,0
GGACAAGTTGCAGTGA-1_V12D07-335_B1,0,0,0,0,0,0
GTCCGAGAGCAATCAT-1_V12D07-335_B1,0,0,0,0,0,0
ATGGCAGCCGAGAAAC-1_V12D07-335_B1,0,0,0,0,0,0
CCTCGGATGCTACCTG-1_V12D07-335_B1,1,0,3,0,0,4
ATACGGTGAAGATGCA-1_V12D07-335_B1,1,1,1,0,0,3
ACATCAGCTGGGACGC-1_V12D07-335_B1,1,1,0,0,0,2
GGTTGTGTAGCCTGGC-1_V12D07-335_B1,0,3,0,0,0,3
CCTGCGTTCTACGCTT-1_V12D07-335_B1,1,0,2,0,0,3
GAACGTTAGGAAGACG-1_V12D07-335_B1,1,0,3,0,0,4
CTGATAGTGTATCTCA-1_V12D07-335_B1,0,0,1,0,0,1
TTCTGCGAGCGCCCTT-1_V12D07-335_B1,1,0,4,0,0,5
CTTTGGCGCTTTATAC-1_V12D07-335_B1,0,0,4,0,0,4
TCCGAACTTGGCTTAC-1_V12D07-335_B1,0,1,2,0,0,3
TAGATTCCTGGTTATT-1_V12D07-335_B1,0,0,2,0,0,2
CCGACAAAGGGAGTGC-1_V12D07-335_B1,0,0,1,0,0,1
CCATGGCCCTTGTACC-1_V12D07-335_B1,1,1,4,0,0,6
GAAATATCACCATCAG-1_V12D07-335_B1,1,0,0,0,0,1
ACGAAATGGGCGGCAC-1_V12D07-335_B1,1,0,3,0,0,4
GTGAGCGTGCTGCACT-1_V12D07-335_B1,0,1,4,0,0,5
CCGCGGGTACGAAGAA-1_V12D07-335_B1,0,0,1,0,0,1
TCCCTGGCTCGCTGGA-1_V12D07-335_B1,1,0,2,0,0,3
CAGCTTAGTAGGTAGC-1_V12D07-335_B1,1,1,3,0,0,5
CACGAAAGTTAGTCCC-1_V12D07-335_B1,0,2,3,0,0,5
ACCTAATCGACTTCCT-1_V12D07-335_B1,1,0,3,0,0,4
AAGTAGTGACGCGAGG-1_V12D07-335_B1,2,0,3,0,0,5
TCCGATTACATTGCCG-1_V12D07-335_B1,0,0,4,0,0,4
CCTCCGACAATTCAAG-1_V12D07-335_B1,0,0,0,0,0,0
GTTCACAGGAGTCTAG-1_V12D07-335_B1,1,0,3,0,0,4
CGAAGTTGCTCTGTGT-1_V12D07-335_B1,0,0,0,0,0,0
GTCGGATATCTCAGAC-1_V12D07-335_B1,1,1,1,0,0,3
CGCTCTCCGTAGATTA-1_V12D07-335_B1,0,0,3,0,0,3
CAAGCAACGTCGGAGT-1_V12D07-335_B1,1,1,1,0,0,3
CCATTCCCTGCCCACA-1_V12D07-335_B1,0,0,1,0,0,1
CTTTGGCTTTAGTAAA-1_V12D07-335_B1,2,0,1,0,0,3
GGCTATTAAGTTGTAT-1_V12D07-335_B1,1,0,5,0,0,6
CCATTAGCGATAATCC-1_V12D07-335_B1,1,2,1,0,0,4
TGTTCTTCCATTGACT-1_V12D07-335_B1,2,1,2,0,0,5
AGATAACTTCAGGGCC-1_V12D07-335_B1,4,0,0,0,0,4
ATAGACGAAGAGAAAG-1_V12D07-335_B1,1,0,0,0,0,1
GGCGGAGTAATATTAG-1_V12D07-335_B1,2,0,0,0,0,2
TGACCCACGTTAGACA-1_V12D07-335_B1,1,0,3,0,0,4
TCACAGGTTATTGGGC-1_V12D07-335_B1,8,0,2,0,0,10
TCACGCATTGTAGATC-1_V12D07-335_B1,3,0,0,0,0,3
TTGAAGAATTCCCAGG-1_V12D07-335_B1,2,0,1,0,0,3
AAATGGTCAATGTGCC-1_V12D07-335_B1,1,1,1,0,0,3
TAGTGCCCTCCAGAGT-1_V12D07-335_B1,1,0,0,0,0,1
GGTATTGCCGAGTTTA-1_V12D07-335_B1,3,0,0,0,0,3
CGTATTAAGAGATCTA-1_V12D07-335_B1,0,1,0,0,0,1
ACTGTCCAGGATTATA-1_V12D07-335_B1,0,0,0,0,0,0
CGGGCAGCTAAACCGC-1_V12D07-335_B1,1,0,0,0,0,1
TTGCTGATCATGTTCG-1_V12D07-335_B1,1,0,0,0,0,1
TATGGGTACGTATCGT-1_V12D07-335_B1,1,0,0,0,0,1
CAGCTCACTGAGACAT-1_V12D07-335_B1,1,0,0,0,0,1
GGGACTGCATAGATAG-1_V12D07-335_B1,0,0,1,0,0,1
ACGCATTCGTGAGTAC-1_V12D07-335_B1,1,0,0,0,0,1
CTCTGGACGCCTGGTG-1_V12D07-335_B1,1,0,0,0,0,1
AGGGTTTAGTTCGGGA-1_V12D07-335_B1,3,0,0,0,0,3
GGGAGAACTCACAGTA-1_V12D07-335_B1,0,1,1,0,0,2
ATCAATCTGGGCTGCA-1_V12D07-335_B1,0,2,0,0,0,2
TCTTCGATACCAATAA-1_V12D07-335_B1,2,1,0,0,0,3
ACGTAGATTGCTGATG-1_V12D07-335_B1,2,0,2,0,0,4
TCTTGATGCGTAGCGA-1_V12D07-335_B1,4,0,0,0,0,4
GGGCTGCCTAGGGCGA-1_V12D07-335_B1,1,0,1,0,0,2
CTCTCACAATCGATGA-1_V12D07-335_B1,2,0,1,0,0,3
CCAAGCGTAACTCGTA-1_V12D07-335_B1,1,1,0,0,0,2
ACAACAGCATGAGCTA-1_V12D07-335_B1,1,0,1,0,0,2
GTCCCAACGTAAAGTA-1_V12D07-335_B1,1,1,2,0,0,4
TCGGAGTACATGAGTA-1_V12D07-335_B1,1,0,1,0,0,2
GGGAGTTAATGAGGCG-1_V12D07-335_B1,1,0,1,0,0,2
CCGGGCGGTCTCGTCA-1_V12D07-335_B1,0,0,1,0,0,1
CCGTAAGTTGGTCCCA-1_V12D07-335_B1,1,1,2,0,0,4
GGAGGGCTTGGTTGGC-1_V12D07-335_B1,3,0,1,0,0,4
TCGGACGCCCAGCCCA-1_V12D07-335_B1,3,0,0,0,0,3
TCTGTGCCATCATAGT-1_V12D07-335_B1,1,1,0,0,0,2
GTACTGGAGTTAGACC-1_V12D07-335_B1,2,1,1,0,0,4
GGAATGCGCTAGCGTG-1_V12D07-335_B1,0,0,1,0,0,1
GTGTGAATAACTTAGG-1_V12D07-335_B1,1,0,1,0,0,2
GGTCGGCCAGGAGCTT-1_V12D07-335_B1,0,1,0,0,0,1
TAGCCGGCGGTCAGCG-1_V12D07-335_B1,1,0,1,0,0,2
CGGGTGTACCCATTTA-1_V12D07-335_B1,1,0,0,0,0,1
AGTGATTCAAGCAGGA-1_V12D07-335_B1,0,0,0,1,0,1
GTTGGATTGAGAACAC-1_V12D07-335_B1,0,0,0,0,0,0
CACACGCGCTGTCTTA-1_V12D07-335_B1,0,0,0,0,0,0
TAGACGCCCGTACCGG-1_V12D07-335_B1,0,0,0,0,0,0
GGTTTCAATCGGTCAG-1_V12D07-335_B1,2,0,0,0,0,2
AATCTGCGTTGGGACG-1_V12D07-335_B1,1,0,1,0,0,2
TTACGGATGGTTCGAG-1_V12D07-335_B1,2,0,0,0,0,2
CGGCAGGGTCGGGTTG-1_V12D07-335_B1,1,1,0,0,0,2
GCTTTCAGAGGAGGTG-1_V12D07-335_B1,0,0,0,0,0,0
TCTTCCCATGGGCACA-1_V12D07-335_B1,1,0,2,0,0,3
TACCGCGGACTTGCAG-1_V12D07-335_B1,1,0,0,0,0,1
AGAATTATGGATTCGA-1_V12D07-335_B1,3,1,1,0,0,5
ATTGATGAGTCCTAAC-1_V12D07-335_B1,1,1,1,0,0,3
TAGGTCGCCGGAACTG-1_V12D07-335_B1,2,0,1,0,0,3
TAACCTACCGTCCGAG-1_V12D07-335_B1,1,0,0,0,0,1
CTTAGTAGGCCTACAG-1_V12D07-335_B1,1,0,1,2,0,4
CTAGATGTGAGTGTAA-1_V12D07-335_B1,0,0,0,0,0,0
ACTCCCGAATTCGTTT-1_V12D07-335_B1,0,0,0,0,0,0
GTTCATCGTTTGGCTG-1_V12D07-335_B1,0,0,0,0,0,0
ACTTTACCCTCATGAA-1_V12D07-335_B1,0,0,0,0,0,0
GCGAGAGTTGCGTCCA-1_V12D07-335_B1,0,0,1,0,0,1
GTTCGGGCGTACCATT-1_V12D07-335_B1,1,0,1,0,0,2
CGACTTTGTATAGCCT-1_V12D07-335_B1,0,0,0,0,0,0
GCCATCGATGCTGCAT-1_V12D07-335_B1,1,0,1,0,0,2
GCATTTCCAAGGCTCC-1_V12D07-335_B1,3,0,0,0,0,3
ATGTAAGGCTGCTCTT-1_V12D07-335_B1,1,0,1,0,0,2
ACGTTCGCAATCAATT-1_V12D07-335_B1,1,0,0,0,0,1
GTGACGAGGGTGACCC-1_V12D07-335_B1,3,0,1,0,0,4
ATTATAGCTACTTTAC-1_V12D07-335_B1,1,0,1,0,0,2
CGTGTGTTAAACCCTG-1_V12D07-335_B1,1,0,1,0,0,2
TTGGTATGGCTTGTGT-1_V12D07-335_B1,0,0,0,0,0,0
CATTCCCATTCCGTCG-1_V12D07-335_B1,0,1,0,0,0,1
TGCCGAAAGCGTATTC-1_V12D07-335_B1,1,0,0,0,0,1
CAACACATCTCCTGCC-1_V12D07-335_B1,2,0,0,0,0,2
CTGCCTCATATGCAAC-1_V12D07-335_B1,2,0,2,0,0,4
TCCCGCCTATGTGCGT-1_V12D07-335_B1,3,0,2,0,0,5
GGTTACCCGACACTTT-1_V12D07-335_B1,0,0,1,0,0,1
CCAGCGGGATCACCAG-1_V12D07-335_B1,1,0,0,0,0,1
ATGTTTCGGCCCGGAG-1_V12D07-335_B1,2,0,0,0,1,3
GCGTCTAACCTCCTAA-1_V12D07-335_B1,0,0,2,0,0,2
ATCAGGTAGCTGACAG-1_V12D07-335_B1,2,0,0,1,0,3
GGTATGAAAGAACTGA-1_V12D07-335_B1,0,0,0,0,0,0
GTGGCCTAATATCATT-1_V12D07-335_B1,0,0,0,0,0,0
CCTGTGAAACCGTAAC-1_V12D07-335_B1,0,0,0,0,0,0
GGCAGAGAGATCGGGA-1_V12D07-335_B1,0,0,0,0,0,0
TAGCGTCGAATATTGA-1_V12D07-335_B1,0,0,0,0,0,0
CGCCGACTATTCGCTA-1_V12D07-335_B1,0,0,0,0,0,0
TCTGGCGCAAGCCGGG-1_V12D07-335_B1,0,0,0,0,0,0
AGTGGTTGCGTATAGG-1_V12D07-335_B1,0,0,0,0,0,0
ATCGGTTACCTAGTAA-1_V12D07-335_B1,0,0,0,0,0,0
CCTGCCCGTTGTCTAG-1_V12D07-335_B1,1,0,0,0,0,1
GCACACGCCCATGGTC-1_V12D07-335_B1,2,2,1,0,0,5
AGTACGGCCCGTATCG-1_V12D07-335_B1,1,1,3,0,0,5
TATCTAGCCTAAAGGA-1_V12D07-335_B1,0,0,1,0,0,1
CACTCGGTTAGGAGGA-1_V12D07-335_B1,0,0,2,0,0,2
ATGTTCGTCGACCCAC-1_V12D07-335_B1,0,1,1,0,0,2
TTCCTCTGCCCGAATA-1_V12D07-335_B1,2,1,0,0,0,3
TTACTATCGGCTTCTC-1_V12D07-335_B1,0,0,5,0,0,5
GCCGCATTAGTCCGGC-1_V12D07-335_B1,0,1,4,0,0,5
TAAGGGCTGGGAGAGG-1_V12D07-335_B1,0,0,0,0,0,0
TAAGCAGGCGACACGC-1_V12D07-335_B1,2,0,1,0,0,3
AGCACTACCGGCCTGT-1_V12D07-335_B1,1,0,1,0,0,2
GAAAGCCCTTTGGACC-1_V12D07-335_B1,0,1,0,0,0,1
GACCGACTGAAGCGTC-1_V12D07-335_B1,1,0,1,0,0,2
CGGTGAAGACTAAAGT-1_V12D07-335_B1,0,0,2,0,0,2
CCCTGCGCTACGCATA-1_V12D07-335_B1,1,0,2,0,0,3
TACTGGACAGCTCGGC-1_V12D07-335_B1,1,0,4,0,0,5
TTAGTAGGGCGGCGGG-1_V12D07-335_B1,0,2,3,0,0,5
GAGGCTATCAAAGTCG-1_V12D07-335_B1,1,0,2,0,0,3
TTACCATTGATTACCC-1_V12D07-335_B1,1,0,1,0,0,2
ATACCACGGGCAACTT-1_V12D07-335_B1,1,1,0,0,0,2
TGTCCTAAGTCACCGC-1_V12D07-335_B1,2,0,1,0,0,3
AGGTAGGTACAAAGCT-1_V12D07-335_B1,0,1,2,0,0,3
GGCATACAGGTAGCGG-1_V12D07-335_B1,1,1,6,0,0,8
TGTAGTGATCTATAAT-1_V12D07-335_B1,1,1,3,0,0,5
TCCCGGGTGTGCTGCT-1_V12D07-335_B1,1,1,0,0,0,2
TACGATGTTGATCATC-1_V12D07-335_B1,0,1,1,0,0,2
CCTCTCTCCCATCTAG-1_V12D07-335_B1,1,0,3,0,0,4
GCAGGACTATAGAATA-1_V12D07-335_B1,5,0,1,0,0,6
CTAGTGAAGGACAGGA-1_V12D07-335_B1,0,1,1,0,0,2
TACGAGAACTTCACGT-1_V12D07-335_B1,3,1,0,0,0,4
CGTTGTTTCAATTCCC-1_V12D07-335_B1,1,0,1,0,0,2
GCAAATATTACGCTTT-1_V12D07-335_B1,0,1,1,0,0,2
CCAATAGTGCCGTCGA-1_V12D07-335_B1,2,1,1,0,0,4
ATTGCTGCTCCTCCAT-1_V12D07-335_B1,4,1,0,0,0,5
GAGATCTGCTTGGCAT-1_V12D07-335_B1,1,0,3,0,0,4
GCCGAAATTCCTACGT-1_V12D07-335_B1,3,0,1,0,0,4
GGCACTCCACTGGGCA-1_V12D07-335_B1,4,0,2,0,0,6
GGGTCACCGTGACGGT-1_V12D07-335_B1,0,0,4,0,0,4
CACTTAATCAGACGGA-1_V12D07-335_B1,0,0,0,0,0,0
CGTTTCGCTCATTACA-1_V12D07-335_B1,0,0,2,0,0,2
ATAAAGGCTCGGTCGT-1_V12D07-335_B1,0,0,0,0,0,0
CACTAAAGTTGCCTAT-1_V12D07-335_B1,1,0,2,0,0,3
GTGCTCAAGTACTGTC-1_V12D07-335_B1,2,0,0,0,0,2
CCATGCCTGTTTAGTA-1_V12D07-335_B1,1,0,0,0,0,1
TCTAGTTATCAGAAGA-1_V12D07-335_B1,1,0,0,0,0,1
TTGTAATCCGTACTCG-1_V12D07-335_B1,0,1,0,0,0,1
TCCCAGCTTTAGTCTG-1_V12D07-335_B1,2,1,0,0,0,3
CTACGCACGGAGTACC-1_V12D07-335_B1,1,0,2,0,0,3
AAATTAACGGGTAGCT-1_V12D07-335_B1,1,1,1,0,0,3
CGGCCACGCACAAAGT-1_V12D07-335_B1,1,1,0,0,0,2
GAAGCGTGAGGAATTT-1_V12D07-335_B1,1,1,1,0,0,3
ATATCTTAGGGCCTTC-1_V12D07-335_B1,2,0,0,0,0,2
ACGCGGGCCAAGGACA-1_V12D07-335_B1,1,2,0,0,0,3
GCGAGTTCTGCAAAGA-1_V12D07-335_B1,1,0,0,0,0,1
TATTCGTGCCAGAATA-1_V12D07-335_B1,1,0,0,0,0,1
AGGGCTGCAGTTACAG-1_V12D07-335_B1,2,0,0,0,0,2
CTAGCATAGTATAATG-1_V12D07-335_B1,2,0,1,0,0,3
TAGGTTCGAGTTCGTC-1_V12D07-335_B1,2,0,0,0,0,2
GAATTATAGTGAAAGG-1_V12D07-335_B1,3,0,2,0,0,5
CTATCGGGTCTCAACA-1_V12D07-335_B1,5,0,1,0,0,6
GCGCTAATTGAATAGA-1_V12D07-335_B1,2,2,1,0,0,5
ATGCGACAGTCCCATT-1_V12D07-335_B1,4,0,0,0,0,4
GGTAGTGCTCGCACCA-1_V12D07-335_B1,0,0,0,0,0,0
AAGCTCGTGCCAAGTC-1_V12D07-335_B1,1,0,1,0,0,2
TATTCAATTCTAATCC-1_V12D07-335_B1,1,0,1,0,0,2
TTCAAAGTCTCTAGCC-1_V12D07-335_B1,2,0,1,0,0,3
TTGAATATGGACTTTC-1_V12D07-335_B1,0,3,6,0,0,9
AAGAGCTCTTTATCGG-1_V12D07-335_B1,2,2,2,0,0,6
TTACTCCGGCCGGGAA-1_V12D07-335_B1,3,1,1,0,0,5
AAACGAGACGGTTGAT-1_V12D07-335_B1,0,0,2,1,0,3
GCTAAGTAGTTTCTCT-1_V12D07-335_B1,2,0,1,0,0,3
ATAACGCCGGAGGGTC-1_V12D07-335_B1,1,0,3,0,0,4
GGATCCGGAATATACT-1_V12D07-335_B1,1,1,1,2,0,5
TGAAAGGACCTGACTC-1_V12D07-335_B1,1,0,0,0,0,1
TCCGCGGCAGCATCTG-1_V12D07-335_B1,1,0,2,1,0,4
TGCATATGTCTGTCAC-1_V12D07-335_B1,0,0,1,1,0,2
TGTAGGAGAAATTTCC-1_V12D07-335_B1,0,0,1,1,0,2
AGTGAGACTTCCAGTA-1_V12D07-335_B1,0,2,5,0,0,7
CCCAAACATGCTGCTC-1_V12D07-335_B1,1,0,0,0,0,1
GCTTATGAAGCAGGAA-1_V12D07-335_B1,0,0,0,0,0,0
TTCTAACCGAAGCTTA-1_V12D07-335_B1,0,0,2,0,0,2
GGATGTCCTTACCGCA-1_V12D07-335_B1,3,0,0,0,0,3
AGGGTGCTCTCGAGGG-1_V12D07-335_B1,3,0,0,0,0,3
AACTCTCAATAGAGCG-1_V12D07-335_B1,0,0,0,0,0,0
TCTGAATTCCGTACAA-1_V12D07-335_B1,2,0,0,0,0,2
GCGTGGTACTGGGTTA-1_V12D07-335_B1,2,0,0,0,0,2
CGTCGGATAGTGTTGA-1_V12D07-335_B1,3,0,0,0,0,3
ATATGTCTCCCTAGCC-1_V12D07-335_B1,1,0,1,0,0,2
TCTTTAAGACTATGAA-1_V12D07-335_B1,2,1,1,0,0,4
TCATTTAAGTCTCCGA-1_V12D07-335_B1,1,0,2,0,0,3
GATATTGAGATTGGCG-1_V12D07-335_B1,0,1,1,0,0,2
TGACATCGAGCGGACC-1_V12D07-335_B1,1,0,0,0,0,1
GCGTAAATGGCCATAA-1_V12D07-335_B1,3,0,1,0,0,4
ATTGTACAACTCGGCT-1_V12D07-335_B1,2,0,0,0,0,2
TACGCTATAGAAACCT-1_V12D07-335_B1,3,0,0,0,0,3
CACCCAAATCTTATGT-1_V12D07-335_B1,1,0,1,0,0,2
AGATGATGGAGTCTGG-1_V12D07-335_B1,0,0,0,0,0,0
CCACGGTGCCCGGTAG-1_V12D07-335_B1,1,0,0,0,0,1
TCAAGAAATACTAGCT-1_V12D07-335_B1,2,0,0,0,0,2
AGGTATAATTGATAGT-1_V12D07-335_B1,1,0,2,0,0,3
CAAGGTCCTATAGGCT-1_V12D07-335_B1,1,0,0,0,0,1
CCGGCACGACCGTTTC-1_V12D07-335_B1,0,0,1,0,0,1
ACCTCCGTTATTCACC-1_V12D07-335_B1,1,0,0,0,0,1
GCAGCCTATATCACAT-1_V12D07-335_B1,1,0,0,0,0,1
GGTATAGTGACACATA-1_V12D07-335_B1,2,0,2,1,0,5
AAATTCCAGGTCCAAA-1_V12D07-335_B1,0,0,1,0,0,1
TCTTTAGCAGGCGAAC-1_V12D07-335_B1,2,5,3,0,0,10
TATTGACATTTCTGCC-1_V12D07-335_B1,1,0,0,0,0,1
TCTGATCGGGTGCTAG-1_V12D07-335_B1,1,0,0,1,0,2
GGCCCGGAGCATGTCT-1_V12D07-335_B1,0,0,0,0,0,0
GGGCGCAGCGTTACTC-1_V12D07-335_B1,0,0,0,1,0,1
TTGGCGATCCGAATAT-1_V12D07-335_B1,1,0,0,0,0,1
CCACGTAAATTAGACT-1_V12D07-335_B1,2,0,1,0,0,3
TCTGATTGGAAATGGA-1_V12D07-335_B1,3,0,1,0,0,4
ATGGCGGAATAGTCGC-1_V12D07-335_B1,3,2,3,0,0,8
ATCGCTTTACGTCTCA-1_V12D07-335_B1,3,0,0,0,0,3
TACGTGCAAGGTTCCT-1_V12D07-335_B1,1,0,2,1,0,4
CAGGACAGCTGCCCTT-1_V12D07-335_B1,1,0,0,0,0,1
CAAACCAGGTCTGCAT-1_V12D07-335_B1,0,0,0,0,0,0
ACAAGCTATATGGAAG-1_V12D07-335_B1,0,0,0,0,0,0
TCGCCCACTGCGAGAG-1_V12D07-335_B1,0,0,0,0,0,0
AGCCGCAAATTCAAAT-1_V12D07-335_B1,0,0,0,0,0,0
TTAACGTTAAAGCCTG-1_V12D07-335_B1,0,0,0,0,0,0
CAGCGCCAACACGATA-1_V12D07-335_B1,0,0,0,0,0,0
ATCCAATGGTACCGAA-1_V12D07-335_B1,0,0,0,0,0,0
GTGCTGCAGATAAGGA-1_V12D07-335_B1,0,0,0,0,0,0
GGCCTTTGCAACTGGC-1_V12D07-335_B1,0,0,0,0,0,0
GTCGTACCTACGATTG-1_V12D07-335_B1,4,0,0,0,0,4
TAGAAATTCACGTATA-1_V12D07-335_B1,1,0,1,0,0,2
AGAATAAATCTTCAGG-1_V12D07-335_B1,1,2,0,0,0,3
CATTGCGAAATGGGCG-1_V12D07-335_B1,0,2,1,0,0,3
GTCTACTCAATTACAA-1_V12D07-335_B1,1,2,4,0,0,7
TGTAATGACCACAATA-1_V12D07-335_B1,2,1,4,0,0,7
AAAGTCGACCCTCAGT-1_V12D07-335_B1,2,2,1,0,0,5
TACTCGGCACGCCGGG-1_V12D07-335_B1,0,0,3,0,0,3
AGGTGTATCGCCATGA-1_V12D07-335_B1,1,0,2,0,0,3
TGTGCTTTACGTAAGA-1_V12D07-335_B1,1,2,0,0,0,3
AAACCTCATGAAGTTG-1_V12D07-335_B1,0,1,2,0,0,3
TATAGGGTACTCATGA-1_V12D07-335_B1,1,0,1,0,0,2
CCAGCTGATGGTACTT-1_V12D07-335_B1,1,0,3,0,0,4
AATATTGGAGTATTGA-1_V12D07-335_B1,0,1,4,0,0,5
GGCCCTCACCCACTTA-1_V12D07-335_B1,2,2,1,0,0,5
AACCAAGACTTCTCTG-1_V12D07-335_B1,0,1,0,0,0,1
TCGTATTACCCATTGC-1_V12D07-335_B1,1,0,0,0,0,1
ATTCGACGCCGGGCCT-1_V12D07-335_B1,0,0,1,0,0,1
GGCGCAGGACATCTTC-1_V12D07-335_B1,3,1,0,0,0,4
GTACTCCCTTATCGCT-1_V12D07-335_B1,1,0,1,0,0,2
TGGTCTGTTGGGCGTA-1_V12D07-335_B1,0,1,3,0,0,4
AATAACAACGCTCGGC-1_V12D07-335_B1,1,1,4,0,0,6
CATACCCGTACCCAGT-1_V12D07-335_B1,0,1,4,0,0,5
ACAATCCATTTAAACC-1_V12D07-335_B1,0,0,2,0,0,2
GTTACAATTGGTGACG-1_V12D07-335_B1,2,0,3,0,0,5
TTGCCCTGATCACGGG-1_V12D07-335_B1,0,0,0,0,0,0
CTAACCGCGCGCCCGT-1_V12D07-335_B1,1,0,1,0,0,2
CTAAAGAATGCCTACT-1_V12D07-335_B1,0,1,3,0,0,4
ACCCATCTTGAGGGTA-1_V12D07-335_B1,0,0,0,0,0,0
GATCTTTGCAGGGTAT-1_V12D07-335_B1,0,0,2,0,0,2
GGGTACTTCATGAACT-1_V12D07-335_B1,0,2,2,0,0,4
GCCGCTTGTGAGAAAC-1_V12D07-335_B1,0,0,0,0,0,0
CCTGTAAGACATGATA-1_V12D07-335_B1,0,1,4,0,0,5
CGACAGTTCGCGTTAT-1_V12D07-335_B1,2,0,0,0,0,2
ACGATGCATATGTTAT-1_V12D07-335_B1,1,0,2,0,0,3
TGTTCCGCTTCCATGA-1_V12D07-335_B1,2,0,1,0,0,3
GGATGACGCGAGTTTA-1_V12D07-335_B1,3,0,3,0,0,6
GAAGTTTCCACTCAAT-1_V12D07-335_B1,1,1,0,0,0,2
GCGAGGCCCGAGCAGA-1_V12D07-335_B1,1,0,3,0,0,4
CATACTATGTAATTGT-1_V12D07-335_B1,3,1,1,0,0,5
CCAATGTCACAGCAAG-1_V12D07-335_B1,2,2,0,0,0,4
GTTGGATTTGCGTTGG-1_V12D07-335_B1,3,1,0,0,0,4
GGGAGGATGCCCGAAA-1_V12D07-335_B1,6,0,0,0,0,6
GATCGCGGGCTCTCCA-1_V12D07-335_B1,1,1,0,0,0,2
GTTCGCCATAAGTGCC-1_V12D07-335_B1,2,0,0,0,0,2
AGATTATAGGACGTTT-1_V12D07-335_B1,3,1,0,0,0,4
TCGAGACCAACACCGT-1_V12D07-335_B1,2,1,0,0,0,3
TATGGGACCGAGCAGG-1_V12D07-335_B1,1,1,0,0,0,2
GATGCGTCCTGCATTC-1_V12D07-335_B1,5,0,0,0,0,5
TATGGTCTGAGTAACA-1_V12D07-335_B1,1,0,0,0,0,1
GCATAGAGCACTCAGG-1_V12D07-335_B1,1,0,0,0,0,1
CTTCATTGTCAGTGGA-1_V12D07-335_B1,3,2,1,0,0,6
GCAGATTAGGGATATC-1_V12D07-335_B1,3,2,2,0,0,7
CCTGTCGCCCGTAAAT-1_V12D07-335_B1,2,0,0,0,0,2
CAATTTCGTATAAGGG-1_V12D07-335_B1,0,0,0,0,0,0
GTACACTTACCTGAAG-1_V12D07-335_B1,1,0,0,0,0,1
CCAGCCTGGACCAATA-1_V12D07-335_B1,4,0,0,0,0,4
ATGGAGCAGGCCGTGA-1_V12D07-335_B1,2,0,0,0,0,2
GTCATTAGAGCGAACG-1_V12D07-335_B1,3,1,0,0,0,4
AAGACTGCAAGCTACT-1_V12D07-335_B1,8,0,0,0,0,8
CTAGTCACGTCTTAAG-1_V12D07-335_B1,0,1,0,0,0,1
ACTCTTGTATAGTAAC-1_V12D07-335_B1,1,0,0,0,0,1
ATTAGGCGATGCTTTC-1_V12D07-335_B1,1,0,0,0,0,1
TTCGGGACTAATCGCG-1_V12D07-335_B1,1,1,1,0,0,3
TGGACTGTTCGCTCAA-1_V12D07-335_B1,4,0,0,0,0,4
AACGTGCGAAAGTCTC-1_V12D07-335_B1,0,1,2,0,0,3
CCACCCAAGGAAAGTG-1_V12D07-335_B1,0,0,4,0,0,4
CCGCACAAAGACCAAC-1_V12D07-335_B1,2,0,1,1,0,4
GCGATTGTTAACGTTA-1_V12D07-335_B1,1,1,1,0,0,3
ACTCGTCAGTAATCCC-1_V12D07-335_B1,0,2,4,0,0,6
GGTGATAAGGAGCAGT-1_V12D07-335_B1,2,1,4,0,0,7
AAGAGGCATGGATCGC-1_V12D07-335_B1,2,0,0,0,0,2
CACGTTCGTGCTCTAG-1_V12D07-335_B1,0,0,3,0,0,3
CTATTTGGTTACGGAT-1_V12D07-335_B1,0,1,0,0,0,1
GTACAGAGGCAAGGGT-1_V12D07-335_B1,1,0,1,0,0,2
GGGCCGGCCGAAGTAC-1_V12D07-335_B1,1,0,0,0,0,1
CCTGAACGATATATTC-1_V12D07-335_B1,0,0,1,0,0,1
CCGGGCTGCTCCATAC-1_V12D07-335_B1,1,0,1,0,0,2
TACTTGTTAGTAGTCC-1_V12D07-335_B1,1,0,5,1,0,7
CCTAGGCGTAGCGATC-1_V12D07-335_B1,0,0,1,0,0,1
CTGGCGCACAGGTCTG-1_V12D07-335_B1,0,0,1,1,0,2
ACTTATACTTACCCGG-1_V12D07-335_B1,0,0,0,1,0,1
GAAGTCTCCCTAGCGA-1_V12D07-335_B1,0,0,1,0,0,1
ACCGATGGTAGCATCG-1_V12D07-335_B1,1,0,0,0,0,1
CGAGTTTATCGGACTG-1_V12D07-335_B1,0,0,3,0,0,3
CATAACGGACAGTCGT-1_V12D07-335_B1,1,0,0,0,0,1
TGACGATGCACTAGAA-1_V12D07-335_B1,1,1,1,0,0,3
TAGGGAGCTTGGGATG-1_V12D07-335_B1,3,0,4,0,0,7
AGGGTCGATGCGAACT-1_V12D07-335_B1,1,0,2,0,0,3
TATATCCCTGGGAGGA-1_V12D07-335_B1,1,1,0,0,0,2
CATCTTACACCACCTC-1_V12D07-335_B1,1,0,1,0,0,2
GTGCGACAGGGAGTGT-1_V12D07-335_B1,1,0,0,0,0,1
CCGATCTCAACCTTAT-1_V12D07-335_B1,1,0,1,0,0,2
ACGATCATCTTGTAAA-1_V12D07-335_B1,0,0,1,0,0,1
GAAAGAACAGCGTTAT-1_V12D07-335_B1,0,0,0,0,0,0
CTAGGTCTGAAGGAAT-1_V12D07-335_B1,1,0,0,0,0,1
ATATCAACCTACAGAG-1_V12D07-335_B1,0,0,0,0,0,0
AAATAGCTTAGACTTT-1_V12D07-335_B1,1,0,0,0,0,1
GCGACATGTAAACATC-1_V12D07-335_B1,1,0,0,0,0,1
ATAAGTAGGGCGACTC-1_V12D07-335_B1,0,0,0,0,0,0
GCGAGCGCATGCTCCC-1_V12D07-335_B1,1,2,2,0,0,5
AGGGACCGGCTGCGTT-1_V12D07-335_B1,0,1,0,0,0,1
CCTATGAAGTGGTGCC-1_V12D07-335_B1,0,0,0,0,0,0
GCTTACGTAGTTAGTA-1_V12D07-335_B1,1,0,2,0,0,3
CATACTTAGGCAATAC-1_V12D07-335_B1,1,0,1,0,0,2
CCTGTCCCTCACGTTA-1_V12D07-335_B1,0,0,0,0,0,0
CAATGTGCCAACCCTT-1_V12D07-335_B1,0,0,0,0,0,0
GTTAAGTTAGAGTGGG-1_V12D07-335_B1,1,0,2,0,0,3
CTGGGATACGCTACCC-1_V12D07-335_B1,1,0,0,1,0,2
AACCTGTCACGGAATT-1_V12D07-335_B1,1,0,0,0,0,1
ACTGCGGACACACCGT-1_V12D07-335_B1,0,0,0,0,0,0
CCGTGAGGCATTCATG-1_V12D07-335_B1,3,0,0,0,0,3
GCCCAGATGCTGGAGA-1_V12D07-335_B1,1,0,0,1,0,2
TCTGGCCGTTCAAGTT-1_V12D07-335_B1,2,0,0,0,0,2
ATACGAAGGCTTTCCA-1_V12D07-335_B1,1,0,0,0,0,1
GATCCGAATATAAGTG-1_V12D07-335_B1,1,0,1,0,0,2
GTGGAGCATGTCGGCC-1_V12D07-335_B1,0,0,1,0,0,1
ACTCTTCAGCTCCCGC-1_V12D07-335_B1,0,0,0,0,0,0
CCCGATAGCCTCGCCT-1_V12D07-335_B1,1,0,1,0,0,2
ACAGGTGTGTTGTTGC-1_V12D07-335_B1,0,0,0,0,0,0
TGAACTGCTATGACTT-1_V12D07-335_B1,0,0,0,0,0,0
TGACATATATGACGAT-1_V12D07-335_B1,0,0,0,0,0,0
AAGTCTTCTGTGGCCT-1_V12D07-335_B1,0,0,0,0,0,0
ACCAGACCATAACAAC-1_V12D07-335_B1,0,0,0,0,0,0
TGAGACGTACCTCTCA-1_V12D07-335_B1,0,0,0,0,0,0
GACCGTTACATGCGAC-1_V12D07-335_B1,0,0,0,0,0,0
GGTTCGGATTATACTA-1_V12D07-335_B1,0,0,0,0,0,0
CCTCCTGAGCCCACAT-1_V12D07-335_B1,0,0,0,0,0,0
CCGCGATTTGGTAGGT-1_V12D07-335_B1,2,0,0,0,0,2
AATCTCTACTGTGGTT-1_V12D07-335_B1,0,0,1,0,0,1
ACTTTGACTGCATCCT-1_V12D07-335_B1,0,0,0,0,0,0
CCCTGACTAACAAATT-1_V12D07-335_B1,2,0,2,0,0,4
ACGCTGTGAGGCGTAG-1_V12D07-335_B1,0,0,3,0,0,3
GCATACGAGGTCTTTA-1_V12D07-335_B1,2,1,3,0,0,6
TCGGGATTCAAACATA-1_V12D07-335_B1,1,0,0,0,0,1
GGGCCCTACGAAAGGG-1_V12D07-335_B1,0,1,2,0,0,3
CGCCAAGAAGCCGAGT-1_V12D07-335_B1,0,0,5,0,0,5
GGTACATCTGGGACGA-1_V12D07-335_B1,0,0,1,0,0,1
GGATGCTGGCGTTCCT-1_V12D07-335_B1,1,0,2,0,0,3
CCGATTCGAGGGACCC-1_V12D07-335_B1,1,1,4,0,0,6
CCACTGGTGGCTGGTT-1_V12D07-335_B1,0,0,1,0,0,1
GACAGGCACACACTAT-1_V12D07-335_B1,0,0,3,0,0,3
TCAACGCGACCGGCAG-1_V12D07-335_B1,1,0,2,0,0,3
CTACGACTAGCTATAA-1_V12D07-335_B1,2,0,0,0,0,2
CGGTTGACCTGGCATA-1_V12D07-335_B1,0,2,0,0,0,2
ATCCTGAATCGCTGCG-1_V12D07-335_B1,1,0,4,0,0,5
GTTTCATATCGTCGCT-1_V12D07-335_B1,1,1,1,0,0,3
ATAAATATTAGCAGCT-1_V12D07-335_B1,2,0,1,0,0,3
AAGAGGATGTACGCGA-1_V12D07-335_B1,3,1,2,0,0,6
TCCTGCGTTGATACTC-1_V12D07-335_B1,1,0,1,0,0,2
CGTGCATTGTCGACGC-1_V12D07-335_B1,0,0,3,0,0,3
CCGGGTTCGAGGTTAC-1_V12D07-335_B1,2,1,0,0,0,3
CCCAATTTCACAACTT-1_V12D07-335_B1,2,0,2,0,0,4
TGATTTATTAGCTGTG-1_V12D07-335_B1,0,1,1,0,0,2
TGGAAGAAGGGAACGT-1_V12D07-335_B1,2,0,1,0,0,3
GACGCTTGCTTCTAAA-1_V12D07-335_B1,1,1,2,0,0,4
GGGAACGGGAGGTTAG-1_V12D07-335_B1,0,2,2,0,0,4
GCGGCTCTGACGTACC-1_V12D07-335_B1,2,0,2,0,0,4
ACGTTAGATTTGCCCG-1_V12D07-335_B1,0,1,0,0,0,1
GAGAGGGCGCGAGGTT-1_V12D07-335_B1,0,2,2,0,0,4
GCGTCTCTGCATTGGG-1_V12D07-335_B1,2,0,1,0,0,3
GCAGCACACAGCCCAG-1_V12D07-335_B1,1,0,0,0,0,1
CAGGCCGTTTGGGTGT-1_V12D07-335_B1,0,2,0,0,0,2
AACTCAAGTTAATTGC-1_V12D07-335_B1,1,2,1,0,0,4
CTTCGTAGATAGGTGA-1_V12D07-335_B1,3,0,3,0,0,6
TGCAGAGTACCGAGCA-1_V12D07-335_B1,0,0,4,0,0,4
GAAGTGATTTATCGTG-1_V12D07-335_B1,2,0,1,0,0,3
CGCTACGGGACATTTA-1_V12D07-335_B1,1,1,2,0,0,4
CCACACTGAGATATTA-1_V12D07-335_B1,0,1,2,0,0,3
CGATCCGACCCAGTGC-1_V12D07-335_B1,1,1,0,0,0,2
CTGTACTTCTTAGCAT-1_V12D07-335_B1,2,0,0,0,0,2
ACTTATTAGGATCGGT-1_V12D07-335_B1,1,0,0,0,0,1
TAGTCCGCAGAGAATG-1_V12D07-335_B1,1,2,1,0,0,4
TTCACGAAAGGATCAC-1_V12D07-335_B1,0,0,0,0,0,0
TACATTTCTAACGTGC-1_V12D07-335_B1,2,1,0,0,0,3
ACCATATCCGCAATAA-1_V12D07-335_B1,2,0,0,0,0,2
CACTCAAGAGCTATGG-1_V12D07-335_B1,2,0,0,0,0,2
TGTACGAACAAATCCG-1_V12D07-335_B1,1,0,0,0,0,1
ATCATCCAATATTTGT-1_V12D07-335_B1,1,2,0,0,0,3
CGCTATTCTTAGGCTC-1_V12D07-335_B1,3,3,0,0,0,6
TGGCAGCAGTAATAGT-1_V12D07-335_B1,1,1,0,0,0,2
TCACGTGCCCGATTCA-1_V12D07-335_B1,3,1,0,0,0,4
CATACGGCGTCTGGGC-1_V12D07-335_B1,3,1,0,0,0,4
CACATGATTCAGCAAC-1_V12D07-335_B1,2,4,0,0,0,6
GCTAGTAGAGCTTGTA-1_V12D07-335_B1,1,0,0,0,0,1
TGCTGTTGAAGAACTC-1_V12D07-335_B1,4,0,1,0,0,5
CGGAGCATGGCGATCC-1_V12D07-335_B1,1,2,0,0,0,3
TAGCGTTGGGTCTTAC-1_V12D07-335_B1,2,0,1,0,0,3
GTAGCGGCTATACACT-1_V12D07-335_B1,2,0,0,0,0,2
TAACATACAATGTGGG-1_V12D07-335_B1,1,2,0,0,0,3
TCTTCGAATAGACGTT-1_V12D07-335_B1,2,1,1,0,0,4
GATCGTGACTGATATC-1_V12D07-335_B1,0,0,3,0,0,3
GATCCGGGAATTAACA-1_V12D07-335_B1,0,0,2,0,0,2
TTATATACGCTGTCAC-1_V12D07-335_B1,0,0,0,0,0,0
GTCGCGTAACCCGTTG-1_V12D07-335_B1,1,0,4,0,0,5
AGCTCTAGACGTTCCA-1_V12D07-335_B1,2,0,2,0,0,4
GTCAAGCGGACTCGGG-1_V12D07-335_B1,1,2,1,0,0,4
CGAGGGACTGCGGTCG-1_V12D07-335_B1,2,1,2,0,0,5
AATCGCCTCAGCGCCA-1_V12D07-335_B1,1,0,1,0,0,2
CTTGTTGCTGAGTCAA-1_V12D07-335_B1,1,0,3,0,0,4
GATATGAGACACTAAC-1_V12D07-335_B1,0,1,4,0,0,5
TTATGATCTTAACGAA-1_V12D07-335_B1,1,2,0,0,0,3
CGCCGCCCATGCCTGT-1_V12D07-335_B1,10,0,0,2,0,12
CTGGGATAAATAATGG-1_V12D07-335_B1,0,1,3,0,0,4
GTGCCCGTTCGGATTC-1_V12D07-335_B1,2,0,1,2,0,5
TTCAATACTCTGAATC-1_V12D07-335_B1,0,0,0,0,0,0
CGCACATGTCCACTAC-1_V12D07-335_B1,4,0,0,0,0,4
AGAAGAGCGCCGTTCC-1_V12D07-335_B1,1,0,0,1,0,2
GATAACTCGCACTGTG-1_V12D07-335_B1,0,0,0,0,0,0
AGTCGACGGTCTCAAG-1_V12D07-335_B1,0,0,0,0,0,0
GTGACCGCACACTACG-1_V12D07-335_B1,0,0,0,0,0,0
GTATGTGGGTCTAGTT-1_V12D07-335_B1,0,0,0,0,0,0
CTTGAGTTAGGGTAAT-1_V12D07-335_B1,2,1,2,0,0,5
TTAGCTGATTTGCCGT-1_V12D07-335_B1,0,0,0,1,0,1
GCTGTTGCTACCGAAC-1_V12D07-335_B1,2,0,0,2,0,4
TATTACCATCCTGCTT-1_V12D07-335_B1,1,0,0,1,0,2
TTGAATTCACGTGAGG-1_V12D07-335_B1,2,1,1,0,0,4
CCATCTCACCAGTGAA-1_V12D07-335_B1,1,0,0,0,0,1
CGCACGTGCGCTATCA-1_V12D07-335_B1,0,0,0,0,0,0
ACCCGGATGACGCATC-1_V12D07-335_B1,0,0,0,0,0,0
CGCTAGAGACCGCTGC-1_V12D07-335_B1,0,0,0,0,0,0
ATAGTTCCACCCACTC-1_V12D07-335_B1,0,0,0,0,0,0
GCAGACCCAGCACGTA-1_V12D07-335_B1,2,0,0,0,0,2
TAGACTACCTAGCGTT-1_V12D07-335_B1,1,0,1,0,0,2
GGTTCTACTCGTCTGA-1_V12D07-335_B1,1,0,0,0,0,1
GACTCACCCACGTGAG-1_V12D07-335_B1,0,0,1,0,0,1
AGCTCTTCGTAACCTT-1_V12D07-335_B1,0,0,0,0,0,0
ACTATCCAGGGCATGG-1_V12D07-335_B1,1,0,0,0,0,1
AAGGATCGATCGCTTG-1_V12D07-335_B1,3,0,1,0,0,4
ATATCGGTAGGGAGAT-1_V12D07-335_B1,0,0,1,0,0,1
TTCCAGACGAGATTTA-1_V12D07-335_B1,1,0,0,0,0,1
GACCGACGTGAAAGCA-1_V12D07-335_B1,0,0,1,0,0,1
CCTGGAAACGTTCTGC-1_V12D07-335_B1,3,0,0,0,0,3
CCGGTAATGGCTAGTC-1_V12D07-335_B1,1,0,0,0,0,1
GCCGTGGAAGAAATGT-1_V12D07-335_B1,0,0,0,0,0,0
GTCTTGAGGAGCAGTG-1_V12D07-335_B1,0,0,0,0,0,0
TCCCAAAGCCCTAAAT-1_V12D07-335_B1,3,0,1,1,0,5
TTGAGCGCCACGTGAT-1_V12D07-335_B1,2,0,0,0,0,2
TTGAGTCCCGCTGCTG-1_V12D07-335_B1,0,1,4,1,0,6
ATGGAACCTTTGCACA-1_V12D07-335_B1,0,0,2,0,0,2
GCTAGCACCTGGGCCA-1_V12D07-335_B1,1,0,1,0,0,2
CGCCGTCTACCCATCG-1_V12D07-335_B1,1,0,0,0,0,1
GATAGGTGTCCCGGGC-1_V12D07-335_B1,2,0,1,0,0,3
AGGTATGCGGACATTA-1_V12D07-335_B1,1,0,1,0,0,2
TTGGTTCGCTCAAAGG-1_V12D07-335_B1,0,0,0,0,0,0
TCTGGAGCGTAAGAGT-1_V12D07-335_B1,0,0,1,0,0,1
TGCCTAAATTTAATAG-1_V12D07-335_B1,0,0,0,0,0,0
TAATTTCCGTCCAGTA-1_V12D07-335_B1,0,0,0,0,0,0
TCCTTCAATCCCTACG-1_V12D07-335_B1,0,0,0,0,0,0
TACCTATCCCTAGAGG-1_V12D07-335_B1,0,0,0,0,0,0
GCATGGGTACTGACGC-1_V12D07-335_B1,0,0,0,0,0,0
GTCGGGAACATGGTAG-1_V12D07-335_B1,0,0,0,0,0,0
GCAAATGAGGACACTT-1_V12D07-335_B1,0,0,0,0,0,0
GAATGGGCTTATCGAC-1_V12D07-335_B1,0,0,0,0,0,0
TGGTCGTGCAAGGCAA-1_V12D07-335_B1,0,0,0,0,0,0
CACCACGCCACACAGA-1_V12D07-335_B1,0,0,0,0,0,0
GAACCTCGACCTACAC-1_V12D07-335_B1,2,0,1,0,0,3
CAATACGCTCTGAGGC-1_V12D07-335_B1,1,0,0,0,0,1
TGGTAAGCAGGATTGA-1_V12D07-335_B1,0,0,0,0,0,0
AGTGGCTCCGTCGGCC-1_V12D07-335_B1,0,0,2,0,0,2
GATCGGATAGAACCAT-1_V12D07-335_B1,1,2,0,0,0,3
GCTACAGTACGGACCG-1_V12D07-335_B1,2,0,2,0,0,4
TCTATTACTAGAGGAT-1_V12D07-335_B1,0,1,3,0,0,4
TTCAGGCGTCAAAGCC-1_V12D07-335_B1,0,1,0,0,0,1
AGACCGGGAAACCCTG-1_V12D07-335_B1,1,0,1,0,0,2
AGAGATCTCTAAAGCG-1_V12D07-335_B1,1,1,0,0,0,2
CCCTGCCCAATCCGCT-1_V12D07-335_B1,0,1,0,0,0,1
GTGGCGGTCCCAGCGT-1_V12D07-335_B1,1,0,1,0,0,2
GCATTGTAATTCATAT-1_V12D07-335_B1,0,1,2,0,2,5
CCGTTCCGAATCTCGG-1_V12D07-335_B1,2,0,0,0,0,2
AGCTTGATCTTAACTT-1_V12D07-335_B1,1,0,4,0,0,5
CCTGTACTCACGCCCA-1_V12D07-335_B1,0,1,1,0,2,4
AAGTGACGACCGAATT-1_V12D07-335_B1,0,0,2,0,0,2
CTCACTTGGCTGGTAA-1_V12D07-335_B1,0,0,1,0,0,1
CGCCTGGCCTACGTAA-1_V12D07-335_B1,1,0,2,0,0,3
CCCGTAAGTCTAGGCC-1_V12D07-335_B1,1,1,2,0,0,4
TTGGACATGTGGCTTA-1_V12D07-335_B1,0,0,1,0,0,1
ATTACGCGCTGGCAGG-1_V12D07-335_B1,0,1,0,0,0,1
ACGCGCTACACAGGGT-1_V12D07-335_B1,3,1,1,0,0,5
TACGTTTACCGGCAAT-1_V12D07-335_B1,0,2,1,0,0,3
CGAAACGCAATTCATG-1_V12D07-335_B1,0,0,0,0,0,0
TAGTCTAACAACGAGA-1_V12D07-335_B1,0,0,2,0,0,2
TTGCATGCTGATCACG-1_V12D07-335_B1,1,0,2,0,0,3
TCTGGGTAGCGCTCAT-1_V12D07-335_B1,1,1,1,0,0,3
ACATCGGTCAGCCGCG-1_V12D07-335_B1,0,0,1,0,0,1
AGATACCGGTGTTCAC-1_V12D07-335_B1,2,0,3,0,0,5
GATTACTGAATTTGGG-1_V12D07-335_B1,0,1,0,0,0,1
TCCAACTTTAAATTCT-1_V12D07-335_B1,0,0,3,0,0,3
TCCTAGCAAAGAAGCT-1_V12D07-335_B1,0,1,0,0,0,1
GTCTATCTGAGTTTCT-1_V12D07-335_B1,0,0,4,0,0,4
GATGTTCAATCCACGA-1_V12D07-335_B1,1,0,2,0,0,3
AGTTAAACACTTGCGA-1_V12D07-335_B1,2,0,1,0,0,3
AGCTCTTTACTCAGTT-1_V12D07-335_B1,0,0,2,0,0,2
ATCCAGGATTCGTGAA-1_V12D07-335_B1,4,2,0,0,0,6
AGTCAACACCACCATC-1_V12D07-335_B1,0,0,2,0,0,2
CGATACCTCGCGGACA-1_V12D07-335_B1,1,1,1,0,0,3
TACAACGCACAACTCA-1_V12D07-335_B1,2,1,2,0,0,5
AATTAAAGGTCGGCGT-1_V12D07-335_B1,1,0,0,0,0,1
TACGCAGTTCTTTCCT-1_V12D07-335_B1,4,0,0,0,0,4
GACCGTGCTGACGGTG-1_V12D07-335_B1,1,1,0,0,0,2
GGCAAATTACTTTACT-1_V12D07-335_B1,2,1,0,0,0,3
GGTACAAACATGCTAT-1_V12D07-335_B1,4,0,0,0,0,4
CGGGCCTTCTTTGTAA-1_V12D07-335_B1,2,1,0,0,0,3
CGTGAAGTTAATTCAC-1_V12D07-335_B1,1,0,0,0,0,1
ATAGTGAAGCGTTCTC-1_V12D07-335_B1,0,1,0,0,0,1
TACGCCATATTCTAAT-1_V12D07-335_B1,1,0,0,0,0,1
GCCGGGTTAGGGTCGC-1_V12D07-335_B1,1,0,0,0,0,1
TACATAGGCATACACC-1_V12D07-335_B1,3,0,0,0,0,3
GCCGATTGGCCAAGCT-1_V12D07-335_B1,5,0,0,0,0,5
CTGCCATGCATCACAT-1_V12D07-335_B1,3,1,0,0,0,4
TTATGAATGAAAGGGA-1_V12D07-335_B1,1,0,0,0,0,1
GCTGAGGCGTGAGTAT-1_V12D07-335_B1,2,0,2,0,0,4
GCGCCGTTCCACGATA-1_V12D07-335_B1,3,1,1,0,0,5
CGCATGGTGCGATGCT-1_V12D07-335_B1,1,0,1,0,0,2
AGGTTTCACACACCTT-1_V12D07-335_B1,2,0,1,0,0,3
CAAGGATCGCATGTTC-1_V12D07-335_B1,2,1,0,0,0,3
ACGTTAATGTCGAAGA-1_V12D07-335_B1,0,1,0,0,0,1
TCCAGAGCACCGGTTC-1_V12D07-335_B1,1,0,0,0,0,1
GATTCGACGGTTCACG-1_V12D07-335_B1,0,0,0,0,0,0
GTTTCTGCAGTCTCCC-1_V12D07-335_B1,3,3,1,0,0,7
GCTGCACGGTTTCTTA-1_V12D07-335_B1,0,0,1,0,0,1
CGTGCAGACTGGGACA-1_V12D07-335_B1,0,0,2,0,0,2
GTGTTACTATGCGTCC-1_V12D07-335_B1,1,0,1,0,0,2
TCCTCGGGCTGGGCTT-1_V12D07-335_B1,0,0,3,0,0,3
GTGAGGACACTTAAGG-1_V12D07-335_B1,0,0,1,0,0,1
ATACGCCGGCGAAACC-1_V12D07-335_B1,1,3,1,0,0,5
TCTGCCAGAAACTGCA-1_V12D07-335_B1,1,0,2,0,0,3
TTCTGCGGGTTAGCGG-1_V12D07-335_B1,0,0,0,0,0,0
CTCGGTACCACTGCTC-1_V12D07-335_B1,2,0,0,0,0,2
GTAAGTAACAGTCTGG-1_V12D07-335_B1,0,0,1,0,0,1
GTGCGTGTATATGAGC-1_V12D07-335_B1,1,0,3,0,0,4
ATTTGTCTTGGGAGCT-1_V12D07-335_B1,2,2,0,1,0,5
CCTCGGACCGGGATAG-1_V12D07-335_B1,3,0,1,0,0,4
TAGGTGCTCGCCTAGC-1_V12D07-335_B1,0,1,1,0,0,2
CTTTAGGAACACTGTT-1_V12D07-335_B1,2,0,0,0,0,2
TCGGGCCGTCGTGGTA-1_V12D07-335_B1,1,0,0,0,0,1
AGTGCTTGCACGAATA-1_V12D07-335_B1,1,0,2,0,0,3
TGCAGTTTCCTCCCAT-1_V12D07-335_B1,0,0,2,0,0,2
TGAGAGATTTACCACG-1_V12D07-335_B1,0,0,1,0,0,1
GAAACAGATGACCACC-1_V12D07-335_B1,0,0,3,1,0,4
AGCAACATATCTTATT-1_V12D07-335_B1,1,0,1,0,0,2
CAAGTGTGGTTGCAAA-1_V12D07-335_B1,0,0,1,0,0,1
GCCTCATCTGGAAATA-1_V12D07-335_B1,0,0,1,0,0,1
AACCCTACTGTCAATA-1_V12D07-335_B1,0,0,1,0,0,1
ACGTATTACTCCGATC-1_V12D07-335_B1,0,0,0,0,0,0
TCTGGGAACCTTTGAA-1_V12D07-335_B1,0,0,1,0,0,1
GCTCGCTCATGTCCAA-1_V12D07-335_B1,1,0,1,0,0,2
GCGCAAGAGCGCGCTG-1_V12D07-335_B1,0,0,1,1,0,2
TTGACGCTCCATGAGC-1_V12D07-335_B1,0,0,0,0,0,0
TATAGATGGTCGCAGT-1_V12D07-335_B1,0,0,0,0,0,0
TTACATGCCACAACTA-1_V12D07-335_B1,2,1,1,0,0,4
ACATGGCGCCAAAGTA-1_V12D07-335_B1,0,0,1,0,0,1
TATGGTTAGTGGGAGA-1_V12D07-335_B1,0,1,1,0,0,2
CATGACTTCGCTGAAT-1_V12D07-335_B1,2,0,0,0,0,2
ACCACCAATGTAACAA-1_V12D07-335_B1,1,0,2,1,0,4
TCTTAGAGCTCCAATT-1_V12D07-335_B1,1,0,1,0,0,2
CCACGAATTTAACCTC-1_V12D07-335_B1,3,0,1,0,0,4
TTCTTGCTAGCATCTC-1_V12D07-335_B1,0,0,0,0,0,0
ACACCTTACTACTTGC-1_V12D07-335_B1,1,0,0,0,0,1
AGTCGGTTGCGTGAGA-1_V12D07-335_B1,1,0,0,0,0,1
ACCTACAGTATGTGGT-1_V12D07-335_B1,0,0,0,0,0,0
GAGGATAAACAGTGCT-1_V12D07-335_B1,1,0,0,0,0,1
TTCCGGTATCTGTGTC-1_V12D07-335_B1,0,0,0,1,0,1
GGAGGCCGAAGTCGTC-1_V12D07-335_B1,3,0,0,1,0,4
TTCGCTAGGAAGTTGT-1_V12D07-335_B1,2,0,0,0,0,2
TAAAGACAACCCTTTA-1_V12D07-335_B1,0,0,0,0,0,0
GTTGCGCTAACATTAC-1_V12D07-335_B1,2,1,0,0,0,3
GCTGAACTCTCCAGGG-1_V12D07-335_B1,1,0,0,1,0,2
AGCCCTGTCGCACCGT-1_V12D07-335_B1,1,0,1,0,0,2
AGCGCTAGAGCGATGT-1_V12D07-335_B1,1,0,0,0,0,1
TGCGCCGTTAATAACG-1_V12D07-335_B1,0,0,0,0,0,0
TGACAACGCATGTCGC-1_V12D07-335_B1,1,0,0,1,0,2
CGTCTTGAGTGTGACG-1_V12D07-335_B1,1,0,0,0,0,1
GATAGGATTAATTACA-1_V12D07-335_B1,0,0,0,0,0,0
GATACCGTGTCGGAGT-1_V12D07-335_B1,0,0,1,0,0,1
TGTGTCGAAGTCGAGG-1_V12D07-335_B1,0,0,0,0,0,0
GGATCAGAGCCATCAG-1_V12D07-335_B1,0,0,0,0,0,0
GTCCCAATCATCCCGC-1_V12D07-335_B1,0,0,0,0,0,0
TGCCACACTAGAGGAA-1_V12D07-335_B1,0,0,0,0,0,0
TGAATTTCACTTGCCT-1_V12D07-335_B1,0,0,0,0,0,0
CTCAGATTGTGATAAG-1_V12D07-335_B1,0,0,0,0,0,0
CGGACGTTACTTGAAG-1_V12D07-335_B1,0,0,0,0,0,0
CCGCCTTGCGATGTCG-1_V12D07-335_B1,0,0,0,0,0,0
CCAGTCAAATCTCTTA-1_V12D07-335_B1,0,0,0,0,0,0
AAACAGCTTTCAGAAG-1_V12D07-335_B1,2,0,0,0,0,2
TAGCTGATGTGAAGCG-1_V12D07-335_B1,2,0,2,0,0,4
CTTATGCGCTCAGGGC-1_V12D07-335_B1,0,2,2,0,0,4
TGGCTCTTGTCGCGTA-1_V12D07-335_B1,1,0,1,0,0,2
TTGTGAGGCATGACGC-1_V12D07-335_B1,0,0,2,0,0,2
CATAAGCTCTCCGTCT-1_V12D07-335_B1,0,0,1,0,0,1
CCTTCTCAGCGTTCCT-1_V12D07-335_B1,0,2,0,0,0,2
TGCAGCTACGTACTTC-1_V12D07-335_B1,0,1,1,0,0,2
CTCTACACTGGCGATT-1_V12D07-335_B1,1,0,2,0,0,3
TGCAGATCGTCCTAGG-1_V12D07-335_B1,0,0,0,0,1,1
TGCCAAAGTCAGACTT-1_V12D07-335_B1,3,0,2,0,0,5
ACAATAGTCGTACGTT-1_V12D07-335_B1,0,0,1,0,0,1
CATGCCAACTCGCAAA-1_V12D07-335_B1,0,1,2,0,0,3
TGCAGAACTATATCGT-1_V12D07-335_B1,1,2,1,0,0,4
TCGTGTCACGCTGACA-1_V12D07-335_B1,1,0,5,0,0,6
TGATCAGGGAACTGCT-1_V12D07-335_B1,0,1,4,0,0,5
CTTGCAACCGCCTCCT-1_V12D07-335_B1,1,0,1,0,0,2
AGCCCATACATGTAAG-1_V12D07-335_B1,1,0,2,0,0,3
ATCCAATGGAGGGTCC-1_V12D07-335_B1,0,0,2,0,0,2
AAACCGGGTAGGTACC-1_V12D07-335_B1,1,0,1,0,0,2
GCAACCACGGCCGCGT-1_V12D07-335_B1,1,1,0,0,0,2
CGCTTATTCCCGGTCG-1_V12D07-335_B1,1,0,2,0,0,3
TTACTCTGGTACGTAC-1_V12D07-335_B1,0,0,2,0,0,2
GTGGTTTCCGCCTTTC-1_V12D07-335_B1,2,0,2,0,0,4
ATAGGCGGCTATAGAA-1_V12D07-335_B1,2,1,1,0,0,4
GTGCCATCACACGGTG-1_V12D07-335_B1,0,0,0,0,0,0
CCCAACATACGTCGCG-1_V12D07-335_B1,1,0,1,0,0,2
CGGTGCAGATAGAACG-1_V12D07-335_B1,3,1,1,0,0,5
GGGCGGGTTCCCTACG-1_V12D07-335_B1,0,2,1,0,0,3
TGAGCCATACAGTCTC-1_V12D07-335_B1,0,0,2,0,0,2
CTCCGCCCACATGAGG-1_V12D07-335_B1,0,2,3,0,0,5
GTTGAACCGGTTCCAT-1_V12D07-335_B1,0,1,2,0,0,3
TTGACTACCATATGGT-1_V12D07-335_B1,1,0,1,0,0,2
ACCATCGTATATGGTA-1_V12D07-335_B1,0,0,1,0,0,1
TGCGTAAGAACCTGAT-1_V12D07-335_B1,0,3,1,0,0,4
AGAAGGTTGCCGAATT-1_V12D07-335_B1,1,0,1,0,0,2
AGGACGACCCATTAGA-1_V12D07-335_B1,1,0,1,0,0,2
GGTGCTGGTACACATT-1_V12D07-335_B1,1,1,3,0,0,5
GCGCTATGCCGAGGCA-1_V12D07-335_B1,0,0,5,0,0,5
ACCCGGTTACACTTCC-1_V12D07-335_B1,1,1,1,0,0,3
TAACTCATCCGCGCGG-1_V12D07-335_B1,1,1,1,0,0,3
CACAATGAGCTGCTAT-1_V12D07-335_B1,4,2,0,0,0,6
GTTACTTTGGGCCTAG-1_V12D07-335_B1,1,0,1,0,0,2
GGGCCCGTCTTAAACA-1_V12D07-335_B1,0,4,0,0,0,4
GAAATTGTCTCTATAA-1_V12D07-335_B1,0,0,0,0,0,0
GGCGCATGAATTGATG-1_V12D07-335_B1,2,0,0,0,0,2
CATATAGGTACAGTCA-1_V12D07-335_B1,0,3,0,0,1,4
TCAACGAGGAGACAAA-1_V12D07-335_B1,5,1,0,0,0,6
TTGCACAATTCAGAAA-1_V12D07-335_B1,1,1,0,0,3,5
CATCGGACGGGTTAAT-1_V12D07-335_B1,2,1,0,0,1,4
ATTAAACATGCGGACC-1_V12D07-335_B1,6,0,0,0,0,6
TATCTACCACAGCGGG-1_V12D07-335_B1,10,1,0,0,0,11
CGAGACCCTAGAGTGT-1_V12D07-335_B1,2,2,1,0,0,5
ACATCGATCGTTTACC-1_V12D07-335_B1,5,1,0,0,0,6
ATCGACCCAATACAGA-1_V12D07-335_B1,4,1,0,0,0,5
GAATCTGAACATTCTC-1_V12D07-335_B1,1,3,0,0,0,4
AGTTCCTATTTATGTT-1_V12D07-335_B1,3,0,0,0,0,3
CAGTCTGTATACTGGG-1_V12D07-335_B1,2,1,1,0,0,4
GGAGACGACACCTTTG-1_V12D07-335_B1,1,2,0,0,0,3
CCTAAATTAACGGTTC-1_V12D07-335_B1,0,1,0,0,0,1
GCTACGACTTATTGGG-1_V12D07-335_B1,3,1,0,0,0,4
CTGTGCAGGGTAGGTC-1_V12D07-335_B1,2,1,1,0,0,4
ACGCCGCTAGACGACC-1_V12D07-335_B1,0,0,1,0,0,1
ACTTGACTCCCTCTTT-1_V12D07-335_B1,1,0,1,0,0,2
CGCCTCCCTCCTCTAT-1_V12D07-335_B1,1,0,1,0,0,2
CTAGATTTACGACGGC-1_V12D07-335_B1,0,0,0,0,0,0
GATGCTGTATTTCATC-1_V12D07-335_B1,0,0,2,0,0,2
TGCGTTTGTTGACACT-1_V12D07-335_B1,3,0,2,0,0,5
CGTGCCCTCCCGAAGA-1_V12D07-335_B1,0,2,2,0,0,4
ACTCTCTGACTTAGGT-1_V12D07-335_B1,0,2,8,0,0,10
CTGGGTAGGCAGTTAA-1_V12D07-335_B1,0,1,0,0,0,1
GTTTGGCCCAAGTTAT-1_V12D07-335_B1,1,0,2,0,0,3
GAATGTGGTCCGGATT-1_V12D07-335_B1,0,0,1,0,0,1
CCCAGTTAAGGCGCCG-1_V12D07-335_B1,0,0,4,0,0,4
CGGTACTAGAATCAAA-1_V12D07-335_B1,1,1,2,1,0,5
GCTTAATGTAACTAAC-1_V12D07-335_B1,1,1,3,0,0,5
AGGACAGTCGAATCCC-1_V12D07-335_B1,6,1,1,0,0,8
GACAGCCAGACCTGAC-1_V12D07-335_B1,0,0,2,0,0,2
GGCGAAATCTAACTTG-1_V12D07-335_B1,1,1,1,0,0,3
CTGGTAACACATAGAA-1_V12D07-335_B1,2,0,2,0,0,4
TAGCCATTTCAAAGTC-1_V12D07-335_B1,1,1,3,0,0,5
GGGATTTACCGCACCT-1_V12D07-335_B1,1,0,0,0,0,1
ATGCCATTTGCGACCA-1_V12D07-335_B1,1,0,0,0,0,1
GAATAGACGCGACCCA-1_V12D07-335_B1,0,0,0,0,0,0
TGTATGGCGCAGACAG-1_V12D07-335_B1,0,0,3,1,0,4
GGATGAAGATCGCTGA-1_V12D07-335_B1,0,1,1,0,0,2
CGACAATTTGATCTAA-1_V12D07-335_B1,0,0,1,0,0,1
AAAGTTGACTCCCGTA-1_V12D07-335_B1,1,3,0,0,0,4
CGCGGCTCAACTTGAA-1_V12D07-335_B1,0,0,2,0,0,2
CACGCGGAACTGTTGC-1_V12D07-335_B1,2,0,0,0,0,2
TCTTAGAGTGAACTCT-1_V12D07-335_B1,1,0,1,0,0,2
AGTCCATTGGCTGATG-1_V12D07-335_B1,1,0,0,0,0,1
TTAAGATAGGATTGAC-1_V12D07-335_B1,1,0,2,0,0,3
ACATCCTGGTAACTGT-1_V12D07-335_B1,0,0,0,0,0,0
CACCTTGGCGCCTTTG-1_V12D07-335_B1,0,0,0,1,0,1
GCTAGACCGTCTACTG-1_V12D07-335_B1,2,0,0,0,0,2
CGGCCCAGGTATATCC-1_V12D07-335_B1,0,0,0,0,0,0
GTCCATTACTGCTACG-1_V12D07-335_B1,1,0,0,0,0,1
GGGTTTAGGATAGGAT-1_V12D07-335_B1,1,0,0,0,0,1
TAATTAGGACATCCGT-1_V12D07-335_B1,0,0,0,0,0,0
GCTCCCAGTCGGTCCA-1_V12D07-335_B1,2,1,0,0,0,3
ATTCGTGCTATCTCTT-1_V12D07-335_B1,0,0,0,0,0,0
GTTAACTATGTTGTCA-1_V12D07-335_B1,0,0,0,0,0,0
GCTCCGCTCGCTTCAG-1_V12D07-335_B1,1,0,2,0,0,3
GCAACGGCTAGTTATG-1_V12D07-335_B1,0,0,0,0,0,0
AATCGCGCAGAGGACT-1_V12D07-335_B1,1,0,0,0,0,1
AGGTTACACCATGCCG-1_V12D07-335_B1,1,1,0,0,0,2
CGAGATTTCGCTCGGG-1_V12D07-335_B1,4,0,0,0,0,4
CGATAATACTCAGGTT-1_V12D07-335_B1,1,0,0,0,0,1
AAGGCAGGCTGTCTCC-1_V12D07-335_B1,1,2,0,0,0,3
GTAAGTCCACACTCTA-1_V12D07-335_B1,0,0,0,0,0,0
ATGAGGGCAGCGGCTA-1_V12D07-335_B1,5,0,0,0,0,5
GCCGCACTCCGTTTCA-1_V12D07-335_B1,1,0,0,0,0,1
GAGCACGGCGCCTCTT-1_V12D07-335_B1,1,1,0,0,0,2
ACAATTTGGCCATATT-1_V12D07-335_B1,2,0,0,0,0,2
CTGGTTCGCGAGCTAC-1_V12D07-335_B1,1,0,0,0,0,1
GACGGTCCTAGGGTGT-1_V12D07-335_B1,1,0,0,0,0,1
ACTCGCGATCTGACGC-1_V12D07-335_B1,0,0,0,0,0,0
GTGTACGAACCGTTCC-1_V12D07-335_B1,2,0,0,0,0,2
CTTTGACGTCGCTTCT-1_V12D07-335_B1,0,0,0,0,0,0
CGTTATCATACTTCCA-1_V12D07-335_B1,0,0,0,0,0,0
GCTATGCCAGCTTATG-1_V12D07-335_B1,0,0,0,0,0,0
CAGTCGGCCTAGATAT-1_V12D07-335_B1,0,0,0,0,0,0
CCCGTGAGGGCGGTGA-1_V12D07-335_B1,0,0,0,0,0,0
TCTCGTGTTACGAGGA-1_V12D07-335_B1,0,0,0,0,0,0
ACGTCTCGTTCCGGGA-1_V12D07-335_B1,0,0,0,0,0,0
CGAGAGCGCGTAGATA-1_V12D07-335_B1,0,0,0,0,0,0
GACAGATTTCTGGCTC-1_V12D07-335_B1,0,0,0,0,0,0
GGGCCTAAATGGGCTA-1_V12D07-335_B1,0,0,1,0,0,1
ACTTGTAGTCCCTTCA-1_V12D07-335_B1,1,0,4,0,0,5
CCCGAAGTTTCGCGAA-1_V12D07-335_B1,0,0,0,0,0,0
ACCATCCGCCAACTAG-1_V12D07-335_B1,0,0,2,0,0,2
TGCGAATATGGGATTT-1_V12D07-335_B1,1,1,0,0,0,2
TACATCCCTATCCCTG-1_V12D07-335_B1,0,2,2,0,0,4
GTGGGAAGACTGAATC-1_V12D07-335_B1,0,1,2,0,0,3
TCAACATCGACCGAGA-1_V12D07-335_B1,1,3,1,0,0,5
CTATGTGAGTCACGGC-1_V12D07-335_B1,0,0,1,0,0,1
CCGAACACTGGGCCTC-1_V12D07-335_B1,2,0,1,0,0,3
AAACTTGCAAACGTAT-1_V12D07-335_B1,0,0,1,0,0,1
AGGGCGAGCAGCTGAT-1_V12D07-335_B1,0,2,1,0,0,3
AACACGAGACGCGGCC-1_V12D07-335_B1,1,0,2,0,0,3
TGACGAATATTTCCCT-1_V12D07-335_B1,1,0,1,0,0,2
TCGGAGAGTATCGGGA-1_V12D07-335_B1,2,1,1,0,0,4
CAAATCTCTCACAAGG-1_V12D07-335_B1,2,0,0,0,0,2
AGGCCCTAGAACGCCA-1_V12D07-335_B1,2,0,1,0,0,3
TAGAGATCATGCAACT-1_V12D07-335_B1,1,1,0,0,0,2
TTGTTTCCATACAACT-1_V12D07-335_B1,1,1,1,0,0,3
GAGAGGTGCATTCTGG-1_V12D07-335_B1,0,2,2,0,0,4
GTGGACCAACCCGATT-1_V12D07-335_B1,2,0,3,0,0,5
CTGGGCCTGCTATATC-1_V12D07-335_B1,0,1,2,0,0,3
CATAGTCCACAAGAAC-1_V12D07-335_B1,1,2,3,0,0,6
TTGACATGAACGTGGA-1_V12D07-335_B1,2,1,1,0,0,4
GGTTACCACCCTCGGG-1_V12D07-335_B1,3,0,1,0,0,4
TACCGGTCGTTTCCAT-1_V12D07-335_B1,0,0,1,0,0,1
CGAGTACTAAAGAGGA-1_V12D07-335_B1,2,0,1,0,0,3
GCAAGAATTCCTTGGC-1_V12D07-335_B1,0,0,5,0,0,5
TCGCCGAAGTTGCGTC-1_V12D07-335_B1,1,0,3,0,0,4
TTGAGAGTACTGCTAA-1_V12D07-335_B1,0,0,2,0,0,2
GCCACAATTTAAGGAC-1_V12D07-335_B1,0,1,2,0,0,3
ATATTCAGTTAAACCT-1_V12D07-335_B1,0,0,1,0,0,1
TGAGTGCCTCTTAAAT-1_V12D07-335_B1,0,0,1,0,0,1
ATCAGACGGCACGCCG-1_V12D07-335_B1,0,1,1,0,0,2
GTGCGAAATCGAACAC-1_V12D07-335_B1,0,0,1,0,0,1
GTGCCGCTTCAAAGGT-1_V12D07-335_B1,0,1,1,0,0,2
GATACGATGGGAGTCA-1_V12D07-335_B1,1,3,0,0,0,4
GACACTGAGTTCAGTG-1_V12D07-335_B1,0,0,1,0,0,1
ATCCTGCGTGGAATGG-1_V12D07-335_B1,0,0,2,0,0,2
ATCCTACCTAAGCTCT-1_V12D07-335_B1,1,2,2,0,0,5
AGTGATATGAGTAGTT-1_V12D07-335_B1,1,2,0,0,0,3
ATGATGCAATGGTACA-1_V12D07-335_B1,2,0,1,0,0,3
GAAACCGAATTACCTT-1_V12D07-335_B1,0,1,0,0,2,3
AGTGACCTACTTTACG-1_V12D07-335_B1,1,0,0,0,0,1
CAAATGTCCTTCCGTG-1_V12D07-335_B1,0,0,1,0,1,2
TTACTGGGATATTTCA-1_V12D07-335_B1,0,1,0,0,0,1
CTTGCCCAGGCTCTAC-1_V12D07-335_B1,0,0,0,0,1,1
AAATCGTGTACCACAA-1_V12D07-335_B1,0,0,0,0,4,4
GTGATCATAGATCTGC-1_V12D07-335_B1,1,2,0,0,0,3
TGGCAGATTACGATCA-1_V12D07-335_B1,2,4,0,0,0,6
TCACCCTCTTAAGATT-1_V12D07-335_B1,4,1,1,0,0,6
CAGGATATATCGTTGT-1_V12D07-335_B1,0,0,0,0,0,0
CCTGACCACCGATGGT-1_V12D07-335_B1,3,5,0,0,0,8
CTAAAGGGAAATAGGA-1_V12D07-335_B1,2,1,0,0,0,3
CCGCTATCAGCACCAG-1_V12D07-335_B1,4,0,2,0,0,6
CTTTAGTGCTATTATT-1_V12D07-335_B1,2,2,0,0,0,4
CGGGAATTTATGTAAA-1_V12D07-335_B1,1,1,0,1,0,3
TACGACTGCCTCTTAG-1_V12D07-335_B1,1,4,1,0,0,6
AAACTGCTGGCTCCAA-1_V12D07-335_B1,1,2,5,0,0,8
GTACGTTTGCCCGTCA-1_V12D07-335_B1,1,1,0,0,0,2
GGCAAGGCGAAATAGC-1_V12D07-335_B1,0,1,0,0,0,1
GATCTTGGAGGGCATA-1_V12D07-335_B1,0,1,1,0,0,2
AGCGTGGTATTCTACT-1_V12D07-335_B1,0,0,2,0,0,2
CTAAGGGAATGATTGG-1_V12D07-335_B1,0,0,0,0,0,0
CATGGTAAGTAGCGTT-1_V12D07-335_B1,0,0,1,0,0,1
CGTTGAGCGACCGTCG-1_V12D07-335_B1,0,1,0,0,0,1
TGCCCGTACCGTTAAA-1_V12D07-335_B1,0,3,1,0,0,4
ACAAGGGCAGGCTCTG-1_V12D07-335_B1,0,1,2,0,0,3
GAGATCTTCCATGACA-1_V12D07-335_B1,0,3,2,0,0,5
AATGACGTAGGATGTC-1_V12D07-335_B1,0,0,2,0,0,2
GTGGTGGCCAAGTGAA-1_V12D07-335_B1,0,0,1,0,0,1
TCCCGTGTGCAATTTG-1_V12D07-335_B1,2,0,1,0,0,3
ACATCGTATGCAATGG-1_V12D07-335_B1,0,2,1,0,0,3
GCGAAACTTAACTGGA-1_V12D07-335_B1,0,1,5,0,0,6
AATTGAACGCTCTGGT-1_V12D07-335_B1,0,1,3,0,0,4
ACAAATGGTAGTGTTT-1_V12D07-335_B1,0,1,0,0,0,1
ATGGTCGCGTGGTTTC-1_V12D07-335_B1,0,0,2,0,0,2
TGTTATTGTATGTGGC-1_V12D07-335_B1,2,0,1,0,0,3
TTCCGGTTACCCACTT-1_V12D07-335_B1,0,0,3,0,0,3
GAGTGTGCGGTACCCA-1_V12D07-335_B1,0,1,2,0,0,3
CAAGATATTATAACGT-1_V12D07-335_B1,0,0,2,0,0,2
ACACACCAGGACCAGT-1_V12D07-335_B1,0,0,2,0,0,2
ATGGGCCTCGGCCTCT-1_V12D07-335_B1,1,0,3,0,0,4
AAGGTGATAAACCAGC-1_V12D07-335_B1,0,0,2,0,0,2
TCTTACTTATGCCTCT-1_V12D07-335_B1,0,0,4,0,0,4
AAAGTGTGATTTATCT-1_V12D07-335_B1,0,0,0,0,0,0
TGCTCCACAGTTCTTA-1_V12D07-335_B1,1,1,1,0,0,3
CTGGCTGATTCATCCT-1_V12D07-335_B1,2,0,1,0,0,3
TAAGGCTGAATCCCTC-1_V12D07-335_B1,0,0,2,0,0,2
TCTAGTGATATCGTGG-1_V12D07-335_B1,1,0,1,0,0,2
TCGAAGAACCGAGCAC-1_V12D07-335_B1,3,1,1,0,0,5
GACAAACATATGCAGG-1_V12D07-335_B1,5,0,1,0,0,6
AAGTCAATTGTCGTCA-1_V12D07-335_B1,2,0,2,0,0,4
AGTGAACAAACTTCTC-1_V12D07-335_B1,0,0,0,0,0,0
CATGATGGAAGTTAGC-1_V12D07-335_B1,0,0,1,0,0,1
AAGTGCCTTGACTGTA-1_V12D07-335_B1,2,0,0,0,0,2
ATCGCCAGTCAACATT-1_V12D07-335_B1,0,0,3,0,0,3
ACCGCGGTGGAAGTCG-1_V12D07-335_B1,0,2,0,0,0,2
TCTTCTATAACCCGCC-1_V12D07-335_B1,2,0,0,0,0,2
CACATTTCTTGTCAGA-1_V12D07-335_B1,3,0,0,0,0,3
TAGCGTCCCTCGATTG-1_V12D07-335_B1,0,1,0,0,0,1
GTTCGGATCGGGAACA-1_V12D07-335_B1,2,0,0,0,0,2
CAAACTCGCGACGCCG-1_V12D07-335_B1,0,0,0,0,0,0
GTCTTGTAGCTATTCA-1_V12D07-335_B1,0,1,2,0,0,3
TCTCGACGTATCGCCG-1_V12D07-335_B1,0,0,0,0,0,0
TTGCCAAGCAGAACCC-1_V12D07-335_B1,0,0,0,0,0,0
AAACCCGAACGAAATC-1_V12D07-335_B1,0,0,1,1,0,2
TTGAGCAGCCCACGGT-1_V12D07-335_B1,0,0,0,0,0,0
CGCCTTTAGCATGCTC-1_V12D07-335_B1,0,0,1,0,0,1
TGTGGCTCCCACCAAC-1_V12D07-335_B1,0,0,0,0,0,0
CCGCCGTTGAGGATAA-1_V12D07-335_B1,5,0,0,0,0,5
CAATACGAGAGTCTGA-1_V12D07-335_B1,0,0,0,0,0,0
CATCTAGTGAAGGGAA-1_V12D07-335_B1,0,1,0,0,0,1
GGTGGAGGTTGATACG-1_V12D07-335_B1,0,0,0,0,0,0
CCGCACACGAACGTGT-1_V12D07-335_B1,1,0,0,0,0,1
AGAACCCAGCGTGACA-1_V12D07-335_B1,3,0,1,0,0,4
GCGCTCGATCACCTGT-1_V12D07-335_B1,0,0,0,0,0,0
ATCATGGACTACCGAC-1_V12D07-335_B1,2,0,0,0,0,2
TACGCCGCCTCAGAAG-1_V12D07-335_B1,0,0,0,0,0,0
CGACCTACTAGACAAT-1_V12D07-335_B1,0,0,0,0,0,0
GAGTCTTGTAAAGGAC-1_V12D07-335_B1,0,0,0,0,0,0
AATATCCTAGCAAACT-1_V12D07-335_B1,0,0,0,0,0,0
CCCTAGGCAACAAGAG-1_V12D07-335_B1,0,0,0,0,0,0
ACAAAGAAGGTAGGCC-1_V12D07-335_B1,0,0,0,0,0,0
CCCTGGCTGTTCCTTC-1_V12D07-335_B1,0,0,0,0,0,0
TCGCCGCACCGCGTGA-1_V12D07-335_B1,0,0,0,0,0,0
TATAGCGCACGTTATC-1_V12D07-335_B1,0,0,0,0,0,0
TTATCTGACATTAGGA-1_V12D07-335_B1,0,0,0,0,0,0
AGTGGTGTTACCCGTG-1_V12D07-335_B1,1,3,1,0,0,5
GCCAAGAATACTTCTG-1_V12D07-335_B1,1,0,3,0,0,4
CCGGCGTGAGACTCTG-1_V12D07-335_B1,0,0,1,0,0,1
TTCCCGGCGCCAATAG-1_V12D07-335_B1,0,1,1,0,0,2
AAACAGGGTCTATATT-1_V12D07-335_B1,2,2,2,0,0,6
ACAGTAATACAACTTG-1_V12D07-335_B1,0,0,0,0,0,0
CGAACGGCCGGACAAC-1_V12D07-335_B1,1,0,2,0,0,3
GCAACACACTAGAACT-1_V12D07-335_B1,1,1,0,0,0,2
ACTCCCATTCCTAAAG-1_V12D07-335_B1,2,0,3,0,0,5
ACCTGCGTGTCATGTT-1_V12D07-335_B1,1,0,3,0,0,4
TACTTTCCGCACGCCA-1_V12D07-335_B1,0,2,0,0,0,2
AGGTCAGGTGAGAGTG-1_V12D07-335_B1,0,2,3,0,0,5
TCCTCCTAAGACATTC-1_V12D07-335_B1,2,1,1,0,0,4
ATGTGAAAGCCTAATG-1_V12D07-335_B1,2,1,0,0,0,3
AGTCGGCTCAACTTTA-1_V12D07-335_B1,0,0,1,0,0,1
CGATCTGTTGGAGGAC-1_V12D07-335_B1,0,2,0,0,0,2
ACGGGAGTGTCGGCCC-1_V12D07-335_B1,0,2,1,0,0,3
TTAACTTCAGGTAGGA-1_V12D07-335_B1,1,0,5,0,0,6
CCACGGAGCCATAAGA-1_V12D07-335_B1,1,1,2,0,0,4
CTTCTATGTTGAAGTA-1_V12D07-335_B1,0,1,2,0,0,3
CACCGTTGCGCGATAT-1_V12D07-335_B1,0,0,0,0,0,0
TCTAGCAATCTCCGCC-1_V12D07-335_B1,0,0,0,0,0,0
AGTTTGGCCAGACCTA-1_V12D07-335_B1,1,1,2,0,0,4
TTGTAAGGACCTAAGT-1_V12D07-335_B1,0,2,3,0,0,5
AAATTTGCGGGTGTGG-1_V12D07-335_B1,0,2,3,0,0,5
AAGTTCGGCCAACAGG-1_V12D07-335_B1,1,0,3,0,0,4
CCGCTTACCTCACTCT-1_V12D07-335_B1,1,0,1,0,0,2
ATCACGTGCTAATTAA-1_V12D07-335_B1,0,0,6,0,0,6
GGTGAAGTACAGGGAT-1_V12D07-335_B1,0,2,2,0,0,4
GCTGTATTACTGGCCC-1_V12D07-335_B1,0,1,0,0,0,1
AACGGCCATCTCCGGT-1_V12D07-335_B1,0,2,1,0,0,3
TAAGTAACATCTTGAC-1_V12D07-335_B1,1,0,2,0,0,3
TTCTTGAGCCGCGCTA-1_V12D07-335_B1,1,0,0,0,0,1
AGTGCGTAGCTCGTAA-1_V12D07-335_B1,0,2,5,0,0,7
GGGATGGTCGTAACCG-1_V12D07-335_B1,1,2,2,0,0,5
GTCTGGGCGGTCGAGA-1_V12D07-335_B1,1,2,1,0,0,4
CGGAACGTAAACATAG-1_V12D07-335_B1,1,0,5,0,0,6
TGCGACACCCTAGTGC-1_V12D07-335_B1,0,0,0,0,0,0
CAAACGAGTATCGCAG-1_V12D07-335_B1,1,0,2,0,0,3
TCAGTAGGGACTATAA-1_V12D07-335_B1,0,1,4,0,0,5
GCGGTTCCCTATCATG-1_V12D07-335_B1,0,0,2,0,1,3
GTGACTTCAGTAGTGC-1_V12D07-335_B1,0,0,2,0,1,3
CGTCACGTCCATTGGT-1_V12D07-335_B1,0,0,0,0,2,2
ATAAGTTACCGCGACG-1_V12D07-335_B1,0,1,2,0,1,4
CTGAATCCGAGACCTC-1_V12D07-335_B1,0,0,1,0,0,1
TACGACGCTTGCTGCG-1_V12D07-335_B1,0,2,0,0,0,2
GAATTCACCCGGGTGT-1_V12D07-335_B1,0,0,1,0,0,1
GGGTGACACCTTAACT-1_V12D07-335_B1,0,0,2,0,0,2
TGAGTAAATTAGCGTA-1_V12D07-335_B1,1,1,1,0,0,3
GAGTCCGCTTACCGGA-1_V12D07-335_B1,0,1,0,0,0,1
GGCGCGTTCGAGTTTA-1_V12D07-335_B1,0,0,3,0,0,3
ATTCATATACTGTCCA-1_V12D07-335_B1,1,3,1,0,0,5
ATAAACGGACCCGTAA-1_V12D07-335_B1,0,1,3,0,0,4
GTCGTACCATCTCGGG-1_V12D07-335_B1,1,1,1,0,0,3
ATAATAGCTGTTGAAT-1_V12D07-335_B1,1,1,1,0,0,3
TTCCGCGTGAGGCGAT-1_V12D07-335_B1,0,2,5,0,0,7
TACCGGCTCACTGCCC-1_V12D07-335_B1,0,1,4,0,0,5
GTATCTTTCATAACCA-1_V12D07-335_B1,0,1,3,0,0,4
GTTACCTACAACTTGC-1_V12D07-335_B1,0,3,2,0,0,5
TGACTATAATCCTTTC-1_V12D07-335_B1,1,1,2,0,0,4
AAATACCTATAAGCAT-1_V12D07-335_B1,1,2,1,0,0,4
TTATTAGAGCGTGTTC-1_V12D07-335_B1,1,0,0,0,0,1
ATGTGGACATCTTGAT-1_V12D07-335_B1,3,0,0,0,0,3
GTACGCTTCATTGCAC-1_V12D07-335_B1,1,0,2,0,0,3
CACATATTAGCAGGAT-1_V12D07-335_B1,1,0,2,0,0,3
CAAGAGGGCGGAGTAC-1_V12D07-335_B1,1,0,3,0,0,4
TCGCAAAGATGCATTT-1_V12D07-335_B1,0,5,1,0,0,6
GTCGTTATTCGCTTAT-1_V12D07-335_B1,1,0,2,0,0,3
TCGTGTACTATGGATG-1_V12D07-335_B1,0,2,4,0,0,6
GCGGAGAGGGAGAACG-1_V12D07-335_B1,1,1,6,0,0,8
TCACAGGGAATCGCAA-1_V12D07-335_B1,0,1,4,0,0,5
GACTGCACCAGCCCAG-1_V12D07-335_B1,0,2,2,0,0,4
TCCGCTGTCATCCCGG-1_V12D07-335_B1,1,1,2,0,0,4
AGATACTCAAGATCGA-1_V12D07-335_B1,2,2,2,0,0,6
ACTGAATGGCGAAAGT-1_V12D07-335_B1,0,2,1,0,0,3
TCCTACATCCACGGCC-1_V12D07-335_B1,0,3,3,0,0,6
TTCAGCCCTGGTCCAC-1_V12D07-335_B1,1,0,0,0,0,1
TTAGAGTTTAGAAGGA-1_V12D07-335_B1,0,4,1,0,0,5
GGTTAGCTATATGTCT-1_V12D07-335_B1,1,1,2,0,0,4
CTGGTTTCGAGCAAGA-1_V12D07-335_B1,0,0,2,0,0,2
TGGGCCCATACTAATT-1_V12D07-335_B1,0,3,3,0,0,6
ACTTATTTATGTGCCA-1_V12D07-335_B1,1,0,2,0,0,3
TTAGTTATTCGTGGCA-1_V12D07-335_B1,0,2,4,0,0,6
AACCGCTAAGGGATGC-1_V12D07-335_B1,1,0,1,0,0,2
ATACGTCCACTCCTGT-1_V12D07-335_B1,1,0,4,0,0,5
CGACACGCTCCGACAG-1_V12D07-335_B1,3,0,0,0,0,3
TCTGAACTCGTACCCG-1_V12D07-335_B1,0,0,2,0,0,2
AGGATATAGGGATTTA-1_V12D07-335_B1,0,5,0,0,0,5
GTGATCACTAACGCCT-1_V12D07-335_B1,0,1,0,0,0,1
ACCGGGCCTTTGTTGA-1_V12D07-335_B1,0,0,0,0,0,0
TTGACAGGAGCTCCCG-1_V12D07-335_B1,1,1,0,0,0,2
CTCTTCTATTGACTGG-1_V12D07-335_B1,1,1,3,0,0,5
CGTGGCCGAATATCTA-1_V12D07-335_B1,1,0,0,0,0,1
GGTTTAGCCTTTCTTG-1_V12D07-335_B1,0,0,2,0,0,2
TCAAGGTTACTACACC-1_V12D07-335_B1,0,0,0,0,0,0
TTGACTATTGTCCGGC-1_V12D07-335_B1,0,0,0,0,0,0
CGGGAATATAGTATAC-1_V12D07-335_B1,2,0,1,0,0,3
GCAACAGCAGTATGCG-1_V12D07-335_B1,1,0,0,1,0,2
ATCAAACACTGTTCCA-1_V12D07-335_B1,2,0,1,0,0,3
TGGGCAATAGTTGGGT-1_V12D07-335_B1,1,0,0,0,0,1
TGAATGTCAGCCGGCC-1_V12D07-335_B1,1,0,0,0,0,1
CGGCTCTAAAGCTGCA-1_V12D07-335_B1,1,0,0,0,0,1
GGACACAAGTTTACAC-1_V12D07-335_B1,2,0,0,0,0,2
CCGAGAAGTCGCATAA-1_V12D07-335_B1,0,0,0,0,0,0
AACTACCCGTTTGTCA-1_V12D07-335_B1,0,0,0,0,0,0
GCACAAACGAGGCGTG-1_V12D07-335_B1,0,0,0,0,0,0
CACACAGCTTGCGCTC-1_V12D07-335_B1,2,0,0,0,0,2
GTGCTTACATCAGCGC-1_V12D07-335_B1,0,0,1,0,0,1
GCAAACGTCGCCAGGT-1_V12D07-335_B1,3,0,0,0,0,3
GAATAGCATTTAGGGT-1_V12D07-335_B1,1,0,0,0,0,1
TACTGTTTCTCTGGTA-1_V12D07-335_B1,2,0,0,0,0,2
TCCTATCATAGGTAAC-1_V12D07-335_B1,0,0,0,0,0,0
TTCGGTGGAGACGCCC-1_V12D07-335_B1,1,0,0,0,0,1
TGTTGCCGTCGTCCCA-1_V12D07-335_B1,0,0,0,0,0,0
CCAACTTGATAGATCC-1_V12D07-335_B1,1,0,0,0,0,1
CAAAGGTCATCTGAAA-1_V12D07-335_B1,0,0,0,0,0,0
CTAGCTTAATGGTCCC-1_V12D07-335_B1,0,0,2,0,0,2
AGGCCACATTGGTTAC-1_V12D07-335_B1,0,0,0,0,0,0
TTAGGATGGGAGGGTA-1_V12D07-335_B1,2,0,1,0,0,3
TATGACCTTGCGCTGG-1_V12D07-335_B1,0,0,0,0,0,0
ATATACATGTATGGTA-1_V12D07-335_B1,0,0,0,0,0,0
TGTGTGACCATGAATC-1_V12D07-335_B1,0,0,0,0,0,0
CCCACTCCACGGTATC-1_V12D07-335_B1,0,0,0,0,0,0
GGGCAGACGTCACTGC-1_V12D07-335_B1,0,0,0,0,0,0
TCAAAGAGCTATCTGT-1_V12D07-335_B1,0,0,0,0,0,0
AGATGCATCCTGTGTC-1_V12D07-335_B1,0,0,0,0,0,0
GTGAAGTCACGACTCG-1_V12D07-335_B1,0,0,0,0,0,0
TGATTCAGGTCCCGCG-1_V12D07-335_B1,0,0,0,0,0,0
CGCCACAGGTCGCGAT-1_V12D07-335_B1,4,0,3,0,0,7
TTGAATCGTTGTATAA-1_V12D07-335_B1,0,0,3,0,0,3
TGGCCAATTTGGTACT-1_V12D07-335_B1,0,0,2,0,0,2
CGACCCTTAACGCCGG-1_V12D07-335_B1,1,3,2,0,0,6
TCGGCGTACTGCACAA-1_V12D07-335_B1,0,0,3,0,0,3
GAGTAAGGCCACGGGA-1_V12D07-335_B1,3,0,1,0,0,4
ATCAGCTCGTCCACTA-1_V12D07-335_B1,1,0,2,0,0,3
AGGATCACGCGATCTG-1_V12D07-335_B1,0,0,3,0,0,3
AAATGGCCCGTGCCCT-1_V12D07-335_B1,2,0,0,0,0,2
CAGTACCAGTTTACGT-1_V12D07-335_B1,0,2,1,0,0,3
GGTCGTAAGCTCGCAC-1_V12D07-335_B1,1,0,0,0,0,1
CGTTCATGGTGCGCGT-1_V12D07-335_B1,1,1,0,0,0,2
GACTACAAAGCGGTGG-1_V12D07-335_B1,1,0,0,0,0,1
CAGCTGGCGTAACCGT-1_V12D07-335_B1,1,0,0,0,0,1
ACTCGTAACCCGTCCT-1_V12D07-335_B1,0,0,0,0,0,0
CATATGTCAGGCTACG-1_V12D07-335_B1,1,1,3,0,0,5
GCCCGACTTCTTCCCG-1_V12D07-335_B1,1,0,3,0,0,4
CTGGCATCCGAATGAG-1_V12D07-335_B1,1,0,2,0,0,3
AAGTGCGTTAGAATCT-1_V12D07-335_B1,0,2,2,0,0,4
AGAAGTGATTCGTGAT-1_V12D07-335_B1,0,1,2,0,0,3
TACCTTAAGATTTCCC-1_V12D07-335_B1,0,0,4,0,0,4
AATGACAGCAATGTCT-1_V12D07-335_B1,0,0,0,0,0,0
TCAACGCAGGAAATAA-1_V12D07-335_B1,0,1,3,0,0,4
TATTCCTCCGCCCACT-1_V12D07-335_B1,0,0,1,0,0,1
ATCAAACGAAGGTTTG-1_V12D07-335_B1,3,1,0,0,0,4
TTGATTAGCTGTTTCT-1_V12D07-335_B1,3,0,0,0,0,3
CTGCTGAGGCCACGAA-1_V12D07-335_B1,0,1,3,0,0,4
CCGTGTTAAATTCCAT-1_V12D07-335_B1,1,0,2,0,0,3
CACGTCGGCAACCTCT-1_V12D07-335_B1,0,0,1,0,0,1
GTATTCTGAGAAACGA-1_V12D07-335_B1,3,0,1,0,0,4
CGGTGCGCGTTGGTCC-1_V12D07-335_B1,1,0,1,0,0,2
GTGATTCGCCGCTCAA-1_V12D07-335_B1,3,0,0,0,0,3
GCCCGCGCGTAAACGG-1_V12D07-335_B1,2,1,2,0,0,5
AACGTACTGTGGGTAC-1_V12D07-335_B1,1,0,3,0,0,4
GAGTATGCCCGCCTTG-1_V12D07-335_B1,0,0,3,0,0,3
TGATTCTGTCGCCGGT-1_V12D07-335_B1,3,1,0,0,0,4
GGGCGGCAAATGAATT-1_V12D07-335_B1,0,0,1,0,1,2
TTCCAATCTGGCTATC-1_V12D07-335_B1,3,0,2,0,0,5
GGAACCGTGTAAATTG-1_V12D07-335_B1,0,0,0,0,2,2
TTGGTCACACTCGTAA-1_V12D07-335_B1,0,0,1,0,2,3
CGAACCCGCATGCGTC-1_V12D07-335_B1,0,0,1,0,3,4
GGGCGTCACCACGTAA-1_V12D07-335_B1,0,0,0,0,2,2
TACCAGAAGTAGGTTC-1_V12D07-335_B1,0,0,1,0,2,3
TTGGATATCGTCTACG-1_V12D07-335_B1,0,0,3,0,1,4
TAGATATGGACTGGAA-1_V12D07-335_B1,0,1,1,0,1,3
GCGACGATAGTTGTAC-1_V12D07-335_B1,0,1,0,0,2,3
CTGGATTTACACTTGA-1_V12D07-335_B1,0,1,0,0,2,3
GTTATATTATCTCCCT-1_V12D07-335_B1,1,0,1,0,1,3
TATTCCACTCAGCTCG-1_V12D07-335_B1,1,0,1,0,0,2
CTGTTACCCAATCTAG-1_V12D07-335_B1,0,0,4,0,0,4
ACGCGAAGTCAGACGA-1_V12D07-335_B1,2,0,2,0,0,4
GATAGGTAACGTTGAC-1_V12D07-335_B1,0,0,1,0,0,1
TGTTCGTATTGCGGTG-1_V12D07-335_B1,0,0,1,0,0,1
GGTCAGTGGGTCCCAC-1_V12D07-335_B1,0,0,5,0,0,5
AATTCTAGAGTTAGGC-1_V12D07-335_B1,2,2,4,0,0,8
GTTTACGTTCCATCTG-1_V12D07-335_B1,0,1,2,0,0,3
AGACCCACCGCTGATC-1_V12D07-335_B1,1,0,4,0,0,5
TCTAGCATGCCCAGAA-1_V12D07-335_B1,0,1,2,0,0,3
CCCGCAGCGCGAACTA-1_V12D07-335_B1,0,0,4,0,0,4
CTCTATTTGGCTGCAG-1_V12D07-335_B1,1,0,2,0,0,3
TTCTGCCGCGCCTAGA-1_V12D07-335_B1,2,0,2,0,0,4
ACTCCCTAGAATAGTA-1_V12D07-335_B1,1,0,1,0,0,2
CCGAACCTTCCCGGCC-1_V12D07-335_B1,0,1,2,0,0,3
TCAGACGCTATAGAAG-1_V12D07-335_B1,1,0,1,0,0,2
CAGGCGCCATGCTAGG-1_V12D07-335_B1,0,0,6,0,0,6
CACTCGAGCTGAACAA-1_V12D07-335_B1,3,0,0,0,0,3
ACAAGGAAATCCGCCC-1_V12D07-335_B1,0,5,2,0,0,7
ACCACGTGCAGCTATA-1_V12D07-335_B1,1,0,0,0,0,1
ACGGCGACGATGGGAA-1_V12D07-335_B1,1,0,1,0,0,2
TTACTAAAGGACTTTA-1_V12D07-335_B1,0,0,1,0,0,1
GGCTGAAATAGCAAAG-1_V12D07-335_B1,0,0,5,0,0,5
TTAGACGAGTCACCTC-1_V12D07-335_B1,2,1,1,0,0,4
GTAGTCGCGGGAATCA-1_V12D07-335_B1,0,0,2,0,0,2
GCAAACCCTACATTAT-1_V12D07-335_B1,0,0,3,0,0,3
GTTAAAGTAGGACTGG-1_V12D07-335_B1,0,0,3,0,0,3
ACCCTCCCTTGCTATT-1_V12D07-335_B1,0,2,4,0,0,6
CATGTCTCATTTATGG-1_V12D07-335_B1,0,0,0,0,0,0
AATAGAATCTGTTTCA-1_V12D07-335_B1,1,1,2,0,0,4
TCTCATGAGATAGGGT-1_V12D07-335_B1,0,1,4,0,0,5
ATGACTATGCGACATT-1_V12D07-335_B1,2,0,1,0,0,3
CCTAACCCAAACAAGT-1_V12D07-335_B1,0,1,1,0,0,2
AGTCAAGATGACACTT-1_V12D07-335_B1,0,0,3,0,0,3
CGGGAGCTTCAGTGTA-1_V12D07-335_B1,1,1,3,0,0,5
CCACAGTACCCATCCT-1_V12D07-335_B1,0,2,1,0,0,3
GAGCGCGCACGAGTAG-1_V12D07-335_B1,1,0,2,0,0,3
ACCAGTGCGGGAGACG-1_V12D07-335_B1,0,2,4,0,0,6
TCCTTACGACGGTCCG-1_V12D07-335_B1,0,1,2,0,0,3
TAGTCGATCACGGGTT-1_V12D07-335_B1,0,4,3,0,0,7
AGACGAAGTGCCGGTC-1_V12D07-335_B1,1,0,0,0,0,1
CGCTGGTGACTACCCT-1_V12D07-335_B1,0,0,1,0,0,1
AGGCATTGTCGTAGGG-1_V12D07-335_B1,0,0,1,0,0,1
TGGTAGAATATATGGG-1_V12D07-335_B1,0,0,2,0,0,2
TTCTTATCCGCTGGGT-1_V12D07-335_B1,1,0,1,0,0,2
AGTTTGGCACGGGTTG-1_V12D07-335_B1,2,0,2,0,0,4
GCATCGGCCGTGTAGG-1_V12D07-335_B1,0,0,2,0,0,2
ATGCGAGTCCCACCAC-1_V12D07-335_B1,1,0,2,0,0,3
TCGGCGAACCCAAACC-1_V12D07-335_B1,0,0,0,0,0,0
AGAGTAAACTTCACTA-1_V12D07-335_B1,1,0,1,0,0,2
AAGCCGAAGCGGTTTA-1_V12D07-335_B1,1,1,1,0,0,3
CCCGAGTTTCTCCGTA-1_V12D07-335_B1,0,0,0,0,0,0
AATATCGAATCAATGC-1_V12D07-335_B1,1,0,1,0,0,2
GCGCCTCCCACTCCGA-1_V12D07-335_B1,0,0,1,0,0,1
CGTTAAACTAGTTAGG-1_V12D07-335_B1,0,0,1,0,0,1
TGAGTTAAAGACATTC-1_V12D07-335_B1,1,0,1,0,0,2
AACAGGTAGTATGGAT-1_V12D07-335_B1,1,0,1,0,0,2
GAACGCGGGTCACACG-1_V12D07-335_B1,1,3,1,0,0,5
TGTTTGAGATCGTCAG-1_V12D07-335_B1,1,0,1,0,0,2
ATCTCGTGAGCGAAAC-1_V12D07-335_B1,2,0,1,0,0,3
CTGAGAAAGTTCGGCG-1_V12D07-335_B1,1,0,1,0,0,2
ATTACCACACTGCCTG-1_V12D07-335_B1,1,0,1,0,0,2
CTGCTGTCTAACGAGC-1_V12D07-335_B1,1,0,1,0,0,2
CGTGGAAGCCTCGTAC-1_V12D07-335_B1,1,0,1,1,0,3
GGACTCACAAATTAGG-1_V12D07-335_B1,0,0,0,0,0,0
CTTTGCTGTCATGGAT-1_V12D07-335_B1,1,1,1,0,0,3
GGTGTTGGGCGTCTTA-1_V12D07-335_B1,1,0,0,0,0,1
TACCATGTATTGATTT-1_V12D07-335_B1,0,0,0,0,0,0
GGTCTCCAAGTAGTGC-1_V12D07-335_B1,0,1,0,0,0,1
ATCCTTCTGAAAGAAC-1_V12D07-335_B1,0,0,0,0,0,0
CCGGAAGTTATCAGTC-1_V12D07-335_B1,1,0,0,0,0,1
TTAGAGGGATATACAG-1_V12D07-335_B1,0,0,0,0,0,0
TTGTACACCTCGAACA-1_V12D07-335_B1,0,0,0,0,0,0
GTGGGTACTGAGCGTA-1_V12D07-335_B1,0,0,0,0,0,0
CTTAAGCAGCGAGCCG-1_V12D07-335_B1,0,0,0,0,0,0
GCATTGACTTGCGGAA-1_V12D07-335_B1,0,0,0,0,0,0
CCATAACCTGTGCAGT-1_V12D07-335_B1,0,0,0,0,0,0
GGGCTACTATTTCGTG-1_V12D07-335_B1,0,0,0,0,0,0
GGCGAGCGAAACGGCA-1_V12D07-335_B1,0,0,0,0,0,0
GGAGACCATCTACATA-1_V12D07-335_B1,0,0,0,0,0,0
AGACCAAACCACACCT-1_V12D07-335_B1,0,0,1,0,0,1
CGACGCATCCGTACCT-1_V12D07-335_B1,0,2,3,0,0,5
CCTAGGTAAAGGTAGC-1_V12D07-335_B1,0,0,7,2,0,9
AGCGGCGGTTAGCGGT-1_V12D07-335_B1,0,1,0,0,0,1
CTGGACGCAGTCCGGC-1_V12D07-335_B1,0,1,1,0,0,2
AGCCTAATACCCACGT-1_V12D07-335_B1,2,2,2,0,0,6
AATCTGGCTTTCTAGT-1_V12D07-335_B1,0,2,3,0,0,5
CACCCTTGGTGAGACC-1_V12D07-335_B1,0,4,2,0,0,6
GGATCTTGACTCAACC-1_V12D07-335_B1,0,2,4,0,0,6
ACGAGGATACCACTCT-1_V12D07-335_B1,0,2,2,0,0,4
GAGTTGATGGCAATTT-1_V12D07-335_B1,0,0,2,0,0,2
GTGGCAAACAGCGGCA-1_V12D07-335_B1,0,2,1,0,0,3
GATGTAACGAACCACC-1_V12D07-335_B1,2,1,1,0,0,4
AGCCGTGGCTAAATGT-1_V12D07-335_B1,0,1,2,0,0,3
CTCCCTCCTTTCGATC-1_V12D07-335_B1,0,1,1,0,0,2
TTGGAAGAATACAGTC-1_V12D07-335_B1,0,2,0,0,0,2
AGTTAAGTCAACCGCT-1_V12D07-335_B1,0,1,4,0,0,5
CTCATGGTAATTTGCG-1_V12D07-335_B1,1,3,0,0,0,4
AAAGTAGCATTGCTCA-1_V12D07-335_B1,2,0,1,0,0,3
TTGTGGTAGGAGGGAT-1_V12D07-335_B1,0,0,7,0,0,7
AGTCGTGGGCATTACG-1_V12D07-335_B1,4,0,2,0,0,6
ACCTAAGTACCTTTCA-1_V12D07-335_B1,0,0,1,0,0,1
GTAGAGGGAGACAAGT-1_V12D07-335_B1,1,1,5,0,0,7
GATCCTCGACACTGGC-1_V12D07-335_B1,0,4,3,0,0,7
CCTACATTCACAGACG-1_V12D07-335_B1,0,3,4,0,0,7
TTGACCGTGTTAATGA-1_V12D07-335_B1,1,0,4,0,0,5
TCTGTTACCCAGCATA-1_V12D07-335_B1,1,3,0,0,0,4
CTAACTGGTCCGGTTC-1_V12D07-335_B1,0,0,0,0,0,0
AGCGACAGGAACGGTC-1_V12D07-335_B1,0,0,0,0,0,0
TAATAGAACAGAGTTA-1_V12D07-335_B1,0,1,1,0,0,2
ACAGGTGGAGGTGAGG-1_V12D07-335_B1,1,5,2,0,0,8
TGCGAGAATATTACCC-1_V12D07-335_B1,0,0,3,0,0,3
TTGCGTCGGCCAACCG-1_V12D07-335_B1,0,1,0,0,0,1
AGGCTTCCCGAAGAAG-1_V12D07-335_B1,0,1,1,0,0,2
GCGGACCGCGTTGTGG-1_V12D07-335_B1,1,0,2,0,0,3
GTAATCTGATTCTTCG-1_V12D07-335_B1,1,0,4,0,0,5
CCGCGGAATGCGTCAC-1_V12D07-335_B1,0,1,2,0,2,5
TTCCACACAGATTTGA-1_V12D07-335_B1,0,1,0,0,1,2
CTTCTATTAATGCTAG-1_V12D07-335_B1,0,1,1,0,2,4
CATTTGAGTGGTACGT-1_V12D07-335_B1,0,1,2,0,1,4
TCACAGCAAACTCGAA-1_V12D07-335_B1,0,1,2,0,1,4
CAGACGAACCTGATAC-1_V12D07-335_B1,0,0,3,0,1,4
TAGCTAGAAGGCATGA-1_V12D07-335_B1,0,0,1,0,3,4
ATCCAGAGCAACAACC-1_V12D07-335_B1,0,0,3,0,1,4
TCCGGTTCGTCCGGTC-1_V12D07-335_B1,0,0,2,0,2,4
CGCGCATGTTTGATTG-1_V12D07-335_B1,0,0,2,0,2,4
TGGCGATCAAGTTATG-1_V12D07-335_B1,1,0,2,0,0,3
CCCTTTGACAGGTCTT-1_V12D07-335_B1,1,1,2,0,0,4
CAGAGACGGTCACCCA-1_V12D07-335_B1,0,6,3,0,0,9
TAGCTCGCCTGATAAC-1_V12D07-335_B1,1,0,0,0,0,1
TTGTGTTTCCCGAAAG-1_V12D07-335_B1,1,0,1,0,0,2
TATACACAGACGCCTT-1_V12D07-335_B1,0,0,2,0,0,2
ACATTAGTTTATATCC-1_V12D07-335_B1,1,1,3,0,1,6
CCATCGCAGTTAAACT-1_V12D07-335_B1,0,2,5,0,0,7
AATTAGCGCTGCAGCG-1_V12D07-335_B1,1,1,2,0,0,4
TCCGCTTATCCCATTA-1_V12D07-335_B1,0,2,2,0,0,4
GTTTGGGCTTGTGAGC-1_V12D07-335_B1,2,0,0,1,0,3
CTTGTCAACATTCGAG-1_V12D07-335_B1,0,0,6,0,0,6
GGACCAACAGGATAAC-1_V12D07-335_B1,1,1,3,0,0,5
AAGCTAGATCGAGTAA-1_V12D07-335_B1,1,0,2,0,0,3
TACCGTGCCTCGGACC-1_V12D07-335_B1,2,1,3,0,0,6
GTAGCCAAACATGGGA-1_V12D07-335_B1,0,0,2,0,0,2
TGCCAGTACGTGGAGA-1_V12D07-335_B1,1,0,0,0,0,1
ATAAGGTGGAGAACAT-1_V12D07-335_B1,2,0,2,0,0,4
CTTTAATATTGGTCGA-1_V12D07-335_B1,0,0,5,0,0,5
TGGTTCAACGGGTAAT-1_V12D07-335_B1,0,1,5,0,0,6
GCTGCTACTGCGTAGC-1_V12D07-335_B1,2,2,0,0,0,4
CTGCACAACTACATAT-1_V12D07-335_B1,1,1,0,0,0,2
ATATTCCACATAGTGA-1_V12D07-335_B1,0,1,6,0,0,7
TGGCAAACTAAATTAC-1_V12D07-335_B1,5,1,1,0,0,7
ACCGCAATAACTGCCT-1_V12D07-335_B1,0,1,1,0,0,2
TCGCACCAGGAGGCAG-1_V12D07-335_B1,0,0,3,0,0,3
ACTTCAGGCTGATCCC-1_V12D07-335_B1,2,1,1,0,0,4
ACAAATCGCACCGAAT-1_V12D07-335_B1,0,0,4,0,0,4
TCTGATGTATTCTGTC-1_V12D07-335_B1,0,1,4,0,0,5
CTTTACCGAATAGTAG-1_V12D07-335_B1,0,0,2,0,0,2
GCAGATCCATAAGACT-1_V12D07-335_B1,1,0,1,0,0,2
TTCCTCGGACTAACCA-1_V12D07-335_B1,0,0,2,0,0,2
TTATCCGGGATCTATA-1_V12D07-335_B1,0,1,1,0,0,2
CTGGAAGACACGGTGG-1_V12D07-335_B1,0,0,3,0,0,3
GTTCGTCTAAAGAACT-1_V12D07-335_B1,1,0,1,0,0,2
GTCTATTGGTTCCGGT-1_V12D07-335_B1,0,0,5,0,0,5
CTAGGCGCCCTATCAG-1_V12D07-335_B1,0,0,4,0,0,4
AACGGACGTACGTATA-1_V12D07-335_B1,0,0,1,0,0,1
AACACACGCTCGCCGC-1_V12D07-335_B1,0,0,1,0,0,1
GCTACTATAGTAGAGT-1_V12D07-335_B1,0,1,3,0,0,4
AGCATATCAATATGCT-1_V12D07-335_B1,1,1,0,0,0,2
CGAACAGTATGGGCGT-1_V12D07-335_B1,0,0,3,0,0,3
ACAATTGTGTCTCTTT-1_V12D07-335_B1,0,1,1,0,0,2
GATCGCTACCCGATTT-1_V12D07-335_B1,1,1,7,0,0,9
ATTGCGATCAGTAACT-1_V12D07-335_B1,0,1,4,0,0,5
CAGCAGTCCAGACTAT-1_V12D07-335_B1,1,0,3,0,0,4
AGAGGCTTCGGAAACC-1_V12D07-335_B1,0,0,1,0,0,1
AAACAAGTATCTCCCA-1_V12D07-335_B1,0,0,5,0,0,5
GGCAGCAAACCTATGC-1_V12D07-335_B1,1,0,3,0,0,4
ACTAGTTGCGATCGTC-1_V12D07-335_B1,2,1,4,0,0,7
TTGGACCATCTGGCAA-1_V12D07-335_B1,0,0,4,0,0,4
CCCTCCTCGCTCGTAT-1_V12D07-335_B1,0,1,3,0,0,4
GAGCGCAAATACTCCG-1_V12D07-335_B1,0,1,4,0,0,5
ATTACATGTCAGTCTT-1_V12D07-335_B1,1,0,0,0,0,1
TTGGGACGTAAGAGTT-1_V12D07-335_B1,1,2,2,0,0,5
CTTCGGCCAATTGTTT-1_V12D07-335_B1,1,0,2,0,0,3
AGACCGCTCCGCGGTT-1_V12D07-335_B1,0,0,0,0,0,0
GACCGCGTCTGACGTG-1_V12D07-335_B1,2,0,2,0,0,4
CCAAATAACAAGATTC-1_V12D07-335_B1,0,0,1,0,0,1
TCTTTAGAGTCTAACA-1_V12D07-335_B1,1,0,2,0,0,3
CTCCCAATGAGTCGCG-1_V12D07-335_B1,0,0,1,0,0,1
TAGTCTTTCCGAATTG-1_V12D07-335_B1,0,0,2,1,1,4
GAGTAAACCGGAAAGT-1_V12D07-335_B1,0,0,0,0,0,0
GATCTCGACGCTGTGG-1_V12D07-335_B1,0,2,1,0,0,3
CTGACATAGAAATAGA-1_V12D07-335_B1,1,0,2,1,0,4
TATACCGAGTGCCACA-1_V12D07-335_B1,1,0,0,0,0,1
TCCGAACGTTGCCGCT-1_V12D07-335_B1,0,0,2,0,0,2
GCAGAAGGTAATCTCC-1_V12D07-335_B1,6,0,0,0,0,6
GGTACTAAGTGCTTTG-1_V12D07-335_B1,1,0,0,0,0,1
CAGAATATTCGTTATC-1_V12D07-335_B1,1,0,0,0,0,1
TAATCAACCAAATGGG-1_V12D07-335_B1,0,0,0,0,0,0
TCTGCTTAGAACAAGC-1_V12D07-335_B1,0,0,0,0,0,0
AACTGAGTTATACTGA-1_V12D07-335_B1,1,3,0,0,0,4
CCTCAACGATCGCTGT-1_V12D07-335_B1,0,0,0,0,0,0
CGGTACGGCAAACCCA-1_V12D07-335_B1,0,0,0,0,0,0
CAGATGTTTGTCCCAA-1_V12D07-335_B1,0,0,0,0,0,0
GTTTGTTAGCCAAGTA-1_V12D07-335_B1,0,0,0,0,0,0
ACGTGACAAAGTAAGT-1_V12D07-335_B1,0,0,0,0,0,0
TTGTCACCGCGGTATC-1_V12D07-335_B1,0,0,0,0,0,0
GATCTAACCGTATTCA-1_V12D07-335_B1,0,0,0,0,0,0
ATGGAAATTTAAGGAG-1_V12D07-335_B1,0,0,0,0,0,0
ATTGATCACCACATTT-1_V12D07-335_B1,0,0,0,0,0,0
ACTGCTCGGAAGGATG-1_V12D07-335_B1,1,0,1,0,0,2
TCTAAAGAACAGTCTC-1_V12D07-335_B1,0,2,1,0,0,3
CTGGGTTGAGTTAAAG-1_V12D07-335_B1,1,0,3,0,0,4
CCCAGTAAACTTGGGA-1_V12D07-335_B1,1,0,2,0,0,3
AGATTCACAACCGATA-1_V12D07-335_B1,1,0,3,0,0,4
AGAAGGTACACTTCAC-1_V12D07-335_B1,1,2,2,0,0,5
GCAGGAACTTAGATCT-1_V12D07-335_B1,1,1,3,0,0,5
AATCTAGGTTTACTTG-1_V12D07-335_B1,0,1,1,0,0,2
CCCGGTGTATCGGAAT-1_V12D07-335_B1,0,0,5,0,0,5
TTATCCTCAAGGAATA-1_V12D07-335_B1,1,2,1,0,0,4
AGCATCATTTCGAAAG-1_V12D07-335_B1,0,1,4,0,0,5
CGCGAGTCTGCCGGGT-1_V12D07-335_B1,1,0,1,0,0,2
TGCGTCATGACTGAGC-1_V12D07-335_B1,2,0,1,0,0,3
GTATGAAATTTCACTC-1_V12D07-335_B1,0,3,1,0,0,4
TTGGTTGCGGTGCGCG-1_V12D07-335_B1,0,0,0,0,0,0
ACAGAACTGAGAACAA-1_V12D07-335_B1,0,2,2,0,0,4
CTACTATCATAGGTTT-1_V12D07-335_B1,0,0,4,0,0,4
CCTCTATCGATTAGCA-1_V12D07-335_B1,2,1,2,0,0,5
CCGTATCTCGTCGTAG-1_V12D07-335_B1,0,0,5,0,0,5
TCACGATGTCCGTGGA-1_V12D07-335_B1,2,2,0,0,0,4
TCAACAAAGATAATTC-1_V12D07-335_B1,2,3,6,0,0,11
ATGACGCGTTCTATCC-1_V12D07-335_B1,0,0,1,0,0,1
ATTTGCGCGAGTAGCT-1_V12D07-335_B1,0,3,2,0,0,5
TTCTTGGACGATCTGC-1_V12D07-335_B1,0,3,1,0,0,4
AGACGACGATGCCGCT-1_V12D07-335_B1,1,3,4,0,0,8
GGTCTCTGAATGGACT-1_V12D07-335_B1,1,2,2,0,0,5
GCTCAATCCGTTTATT-1_V12D07-335_B1,1,1,2,0,0,4
CCAGAAAGCAACTCAT-1_V12D07-335_B1,1,1,2,0,0,4
CACCGTTAGGGATCAC-1_V12D07-335_B1,1,1,2,0,0,4
AATAACACTAGAACAA-1_V12D07-335_B1,0,1,3,0,0,4
CACCCGGTTTGTGACT-1_V12D07-335_B1,2,3,3,0,0,8
CCACCAACTTTACTGT-1_V12D07-335_B1,0,2,3,0,0,5
AACTCTCAGTGTGCTC-1_V12D07-335_B1,0,0,4,0,0,4
AAACCGTTCGTCCAGG-1_V12D07-335_B1,3,3,0,0,0,6
CAGCGATTCCCTTCAA-1_V12D07-335_B1,0,1,3,0,0,4
GCTAGCTTGAATAGCT-1_V12D07-335_B1,0,2,1,0,0,3
TTGCGGCATCAGAAAG-1_V12D07-335_B1,0,1,3,0,3,7
AATAGAACAGAGTGGC-1_V12D07-335_B1,0,2,0,0,1,3
GCCATCGAGCTGCGTG-1_V12D07-335_B1,0,0,0,0,1,1
ACACTGATCAAGGTGT-1_V12D07-335_B1,0,2,0,0,3,5
ACCAACGCTTATTTAT-1_V12D07-335_B1,0,1,0,0,1,2
GACATCGATTTATAAC-1_V12D07-335_B1,0,0,1,0,6,7
CAGACACCGATCGCTG-1_V12D07-335_B1,0,0,1,0,4,5
CCAAGAAAGTGGGCGA-1_V12D07-335_B1,0,2,1,0,0,3
GGTAGACCGTTGGGCG-1_V12D07-335_B1,1,0,6,0,0,7
TCGTTAGGAGTCCCTA-1_V12D07-335_B1,3,1,2,0,0,6
ACGGCCAACATGGACT-1_V12D07-335_B1,0,1,0,0,0,1
GTGAGTGGTACAACGC-1_V12D07-335_B1,1,1,0,0,0,2
GAGACTTCGCGACCGA-1_V12D07-335_B1,1,0,1,0,0,2
GAAGTCAGTTGCACTA-1_V12D07-335_B1,0,3,2,0,0,5
GTTTGGTAGGGTCAAC-1_V12D07-335_B1,1,1,1,0,1,4
ACGGCACTTGCTTGGG-1_V12D07-335_B1,0,1,1,0,0,2
CCTCTGTACTATTCTA-1_V12D07-335_B1,2,1,3,0,0,6
CTATTCATGTGTCCCA-1_V12D07-335_B1,0,1,3,0,0,4
GCCCGATCTGTGGTCG-1_V12D07-335_B1,1,0,2,0,0,3
TTAGAAGAACATGACT-1_V12D07-335_B1,1,2,3,0,0,6
AGGATAAAGTCGGGAT-1_V12D07-335_B1,0,1,2,0,0,3
CGGCAAACATCGTGCG-1_V12D07-335_B1,2,2,2,0,0,6
CTAGTTACAACCCGGT-1_V12D07-335_B1,0,0,3,0,0,3
TTCGACAGAGCCCGTG-1_V12D07-335_B1,2,3,3,0,0,8
AAGCATACTCTCCTGA-1_V12D07-335_B1,2,0,2,0,0,4
GACGACGATCCGCGTT-1_V12D07-335_B1,1,1,2,0,0,4
GGTAGAAGACCGCCTG-1_V12D07-335_B1,0,3,6,0,0,9
GAGATGGGAGTCGACA-1_V12D07-335_B1,0,0,0,0,0,0
AACGATAATGCCGTAG-1_V12D07-335_B1,0,2,5,0,0,7
TGGTCCCACGCTACGG-1_V12D07-335_B1,1,0,1,0,0,2
CTGCTTGGCGATAGCT-1_V12D07-335_B1,0,0,2,0,0,2
ATCGGAGACAGACGGC-1_V12D07-335_B1,0,1,2,0,0,3
TAGCGTCCGGTGTGGT-1_V12D07-335_B1,0,4,5,0,0,9
GTTGAGTCCCGCCGGT-1_V12D07-335_B1,0,3,1,0,0,4
AAATAGGGTGCTATTG-1_V12D07-335_B1,1,0,0,0,0,1
AAGTGTTTGGAGACGG-1_V12D07-335_B1,1,1,3,0,0,5
AGCACTACCTCACCAG-1_V12D07-335_B1,1,0,5,0,0,6
TGCCTTGGCCAGGCAA-1_V12D07-335_B1,2,0,4,0,0,6
TCGTCTTAGGCGTTAA-1_V12D07-335_B1,0,4,3,0,0,7
TTCTGACCGGGCTCAA-1_V12D07-335_B1,0,4,1,0,0,5
CAGAACTTAGCCCTCT-1_V12D07-335_B1,2,0,0,0,0,2
AGCTCCTTCGCACATC-1_V12D07-335_B1,0,0,2,0,0,2
ACAGGCTTGCCCGACT-1_V12D07-335_B1,0,2,4,0,0,6
GCTATACGTCTCGGAC-1_V12D07-335_B1,1,1,3,0,0,5
GAGCCAGCTACCTGTG-1_V12D07-335_B1,0,1,2,0,0,3
TGCTAAGTGTCTATTT-1_V12D07-335_B1,0,2,2,0,0,4
GTCCTACGAATAGTCT-1_V12D07-335_B1,0,3,0,0,0,3
CAGTGTCGGCTGGCCC-1_V12D07-335_B1,0,2,5,0,0,7
CTATCGACGAAATACA-1_V12D07-335_B1,0,0,3,0,0,3
CATCATTACCCTGAGG-1_V12D07-335_B1,2,0,2,0,0,4
TAAGTTGCGACGTAGG-1_V12D07-335_B1,0,0,6,0,0,6
AGTGCACGCTTAAGAA-1_V12D07-335_B1,0,0,2,0,0,2
TGTGCCGGTGCCGGAA-1_V12D07-335_B1,0,2,5,0,0,7
AGGAGGCCTTCGCGCG-1_V12D07-335_B1,1,1,2,0,0,4
TCCGCGGCCCAATGAA-1_V12D07-335_B1,0,1,3,0,0,4
TCCGTTAAGCTAATAT-1_V12D07-335_B1,0,1,0,0,0,1
AAATCTAGCCCTGCTA-1_V12D07-335_B1,0,0,2,0,0,2
CGCAGGCGATCCAAAC-1_V12D07-335_B1,0,0,3,0,0,3
CCATATGGAAACTATA-1_V12D07-335_B1,1,1,2,0,0,4
CACCGTATCCCATCCG-1_V12D07-335_B1,0,0,1,0,0,1
GGTCAAGACTACTTCG-1_V12D07-335_B1,1,1,2,0,0,4
CCCGTTTCGCAGATGT-1_V12D07-335_B1,2,0,4,0,0,6
GTTATAATACGGTGAA-1_V12D07-335_B1,0,3,4,0,0,7
ACTTGTGGATGGAACG-1_V12D07-335_B1,1,0,2,0,0,3
GTTCGCTGAGACGTCT-1_V12D07-335_B1,0,2,2,0,0,4
GACACTGGAACCCGAT-1_V12D07-335_B1,1,0,0,0,0,1
CCCAGGTCTGAAGGCT-1_V12D07-335_B1,1,0,1,0,0,2
TCTCGAGGAGGTTCGC-1_V12D07-335_B1,0,0,0,0,0,0
ACTATCTGCCCGCGTA-1_V12D07-335_B1,0,0,4,0,0,4
CCTAAATTGTATCCTA-1_V12D07-335_B1,1,0,2,0,0,3
AGAAATTATGACTCGC-1_V12D07-335_B1,1,0,2,0,0,3
TCCAGCGCTATAAGCG-1_V12D07-335_B1,1,0,1,0,0,2
TCGTGTATTGGTCACG-1_V12D07-335_B1,0,3,5,0,0,8
CCACATACTGCACCCA-1_V12D07-335_B1,1,1,1,0,0,3
GTTGCGGACGGTCAGG-1_V12D07-335_B1,3,2,2,1,0,8
GTATTTAATGGCATAA-1_V12D07-335_B1,2,0,1,0,0,3
GTCGATAGGTGACTTT-1_V12D07-335_B1,1,0,0,0,0,1
AATAATCTTCGTATCG-1_V12D07-335_B1,3,0,1,0,0,4
ATTGTTCAACGATCCG-1_V12D07-335_B1,0,0,2,1,0,3
GTGCAGCGTAGAGTAG-1_V12D07-335_B1,0,1,0,0,0,1
TGTGGTAGGGTGCCTT-1_V12D07-335_B1,0,0,1,0,0,1
TGTGGACTATCTACGT-1_V12D07-335_B1,4,0,2,0,0,6
GGCGGGCTCTAAGAGT-1_V12D07-335_B1,3,0,0,2,0,5
TGTGCCAGAGGCAAAG-1_V12D07-335_B1,0,0,0,0,0,0
TGGCTTATGTATAATG-1_V12D07-335_B1,0,0,0,0,0,0
GCAAGCTGGAAACCGC-1_V12D07-335_B1,0,0,0,0,0,0
GATATCAAGCAGGAGC-1_V12D07-335_B1,0,0,0,0,0,0
CACCAATCATCCGTCT-1_V12D07-335_B1,0,0,0,0,0,0
CCACATGGCTCTTTAT-1_V12D07-335_B1,0,0,0,0,0,0
GTCCTACTCTACGGGC-1_V12D07-335_B1,0,0,0,0,0,0
CTCGAGACATACGATA-1_V12D07-335_B1,0,0,0,0,0,0
TATCAGTGGCGTAGTC-1_V12D07-335_B1,1,0,0,0,0,1
TGACAGGACAAGTCCA-1_V12D07-335_B1,0,1,1,0,0,2
TATTAACACCAAAGCA-1_V12D07-335_B1,0,2,0,0,0,2
TAGGCGATGAGGTCTC-1_V12D07-335_B1,0,0,2,0,0,2
CCGCCGGAACTTCTCG-1_V12D07-335_B1,1,0,1,0,0,2
GCCATTAGCCTCAAAC-1_V12D07-335_B1,0,1,1,0,0,2
GTTAGGCTACCCGTTT-1_V12D07-335_B1,2,1,2,0,0,5
GGGTATTCTAGCAAAC-1_V12D07-335_B1,0,0,2,0,0,2
GCCCTAGCCGTCGCGA-1_V12D07-335_B1,0,0,0,0,0,0
CAGATCCTGGTTTGAA-1_V12D07-335_B1,0,0,3,0,0,3
CTTCAGTGGTCGCCTA-1_V12D07-335_B1,1,0,2,0,0,3
GGGCAACCGCACGTGC-1_V12D07-335_B1,0,0,3,0,0,3
GACCCAATTATGATAC-1_V12D07-335_B1,0,2,2,0,0,4
GAAGCTCGGACCCGTC-1_V12D07-335_B1,1,0,1,0,0,2
CGTCGGGTCTAAGCGC-1_V12D07-335_B1,1,0,0,0,0,1
GAGGCCCGACTCCGCA-1_V12D07-335_B1,1,0,0,0,0,1
TTGCCATAGCCCGCTC-1_V12D07-335_B1,0,2,1,0,0,3
TAACATACACGCGATC-1_V12D07-335_B1,1,1,2,0,0,4
CCGACGGGCATGAGGT-1_V12D07-335_B1,0,0,3,0,0,3
AATGTGCCCGAGGTGT-1_V12D07-335_B1,1,0,3,0,0,4
AGCTGTAACCTCAATC-1_V12D07-335_B1,1,0,3,0,0,4
CGAGTGAAGGTACCAG-1_V12D07-335_B1,1,0,0,0,0,1
AGTCTCACAAGACTAC-1_V12D07-335_B1,0,0,0,0,0,0
AAATTGATAGTCCTTT-1_V12D07-335_B1,1,1,2,0,0,4
TAAGTCGCCGAGTATC-1_V12D07-335_B1,1,2,1,0,0,4
GCGGAGAAACTTCGCA-1_V12D07-335_B1,0,1,2,0,0,3
GGCAAAGGCGCCAATA-1_V12D07-335_B1,0,0,3,0,0,3
ATTTCCGGGTTCTGCG-1_V12D07-335_B1,1,0,2,0,0,3
TAAACCCAGGAGGGCA-1_V12D07-335_B1,1,1,1,0,0,3
TTCGGGCGCTAGTCTT-1_V12D07-335_B1,2,2,1,0,0,5
GTGGAGTCGGCGGTTG-1_V12D07-335_B1,2,0,1,0,0,3
GCACGCCTACTTAGAT-1_V12D07-335_B1,1,0,4,0,1,6
CAATATTCTTGACCTA-1_V12D07-335_B1,0,0,2,0,0,2
CGTTTGTGTAGAGGGT-1_V12D07-335_B1,0,0,0,0,0,0
CATAGCGTTGCCCACC-1_V12D07-335_B1,0,2,0,0,1,3
TGATACATTTAGCCGT-1_V12D07-335_B1,0,1,0,0,1,2
TTCCGGCCTTGAGGCT-1_V12D07-335_B1,0,0,1,0,0,1
CCTATACCGTCCTGTC-1_V12D07-335_B1,0,2,0,0,3,5
TCGTTGCTATCCGGTC-1_V12D07-335_B1,0,1,1,0,3,5
TGGCGACTGCTCCAAA-1_V12D07-335_B1,0,3,0,0,3,6
CAGAGGCGATGCATGA-1_V12D07-335_B1,0,0,0,0,3,3
TCACAGGAGAATAAGA-1_V12D07-335_B1,0,1,0,0,2,3
GGGTTAACATTTGAGT-1_V12D07-335_B1,0,0,1,0,1,2
GCGGGCGAGCCTTACC-1_V12D07-335_B1,0,1,1,0,0,2
TGCCAATGGGTACTCT-1_V12D07-335_B1,0,0,1,0,2,3
AGGGACTCTACGCGAC-1_V12D07-335_B1,0,2,3,0,0,5
GACGCCGTAAAGGCTA-1_V12D07-335_B1,1,1,4,0,0,6
AAAGGCTCTCGCGCCG-1_V12D07-335_B1,0,1,3,0,0,4
CTGGCTGGTTGTCAGT-1_V12D07-335_B1,1,0,0,0,0,1
ACATCCCGGCCATACG-1_V12D07-335_B1,1,1,3,0,0,5
CTCTTGTCCCGCTTGG-1_V12D07-335_B1,0,0,3,0,0,3
TACGCCTCCATTCCGA-1_V12D07-335_B1,1,0,1,0,0,2
CGGAGCAATTTAATCG-1_V12D07-335_B1,1,0,1,0,0,2
AACTAGGCTTGGGTGT-1_V12D07-335_B1,0,0,2,0,0,2
GCGTCGCCAGGGTGAT-1_V12D07-335_B1,2,3,1,0,0,6
GTTGGTCATGCTATCC-1_V12D07-335_B1,1,0,3,0,0,4
GCTGGCGGCGCATGCT-1_V12D07-335_B1,1,0,2,0,0,3
TGAGCGGAAAGTGTTC-1_V12D07-335_B1,3,1,2,0,0,6
CTTTCTGTGCGGGCTT-1_V12D07-335_B1,1,0,1,0,0,2
ATCTAATATCCTACGG-1_V12D07-335_B1,1,1,2,0,0,4
AACCTTTAAATACGGT-1_V12D07-335_B1,0,0,5,0,0,5
TTCACTCGAGCACCTA-1_V12D07-335_B1,0,1,2,0,0,3
CTGCACTCCAGTACAG-1_V12D07-335_B1,0,5,0,0,0,5
CCATTTCTACCTATTA-1_V12D07-335_B1,0,1,2,0,0,3
CAAGCGGCACATAATT-1_V12D07-335_B1,0,0,4,0,0,4
GTTAACATCACTTAAA-1_V12D07-335_B1,2,1,3,0,0,6
ATATAAATGTAGCTGC-1_V12D07-335_B1,0,0,4,0,0,4
GCCTCTATACATAGCA-1_V12D07-335_B1,1,0,1,0,0,2
GTGTCGTATAGCGTTC-1_V12D07-335_B1,2,0,3,0,0,5
ATACGTACTTAGCCAC-1_V12D07-335_B1,0,0,2,0,0,2
GCTATCATACTCATGG-1_V12D07-335_B1,0,4,5,0,0,9
TATCCAATTGGTTATC-1_V12D07-335_B1,0,2,3,0,0,5
TCTCCCTGGGCAGCGT-1_V12D07-335_B1,1,0,5,0,0,6
CCTATAATGAGTGCCC-1_V12D07-335_B1,2,0,2,0,0,4
CAATGCGAGAAGTATC-1_V12D07-335_B1,0,0,3,0,0,3
TACCAATAAAGTACCA-1_V12D07-335_B1,0,0,3,0,0,3
GCTAGGCACCACGGAG-1_V12D07-335_B1,0,1,6,0,0,7
GGTGGACTGCTCTGGC-1_V12D07-335_B1,0,0,3,0,0,3
TATTCCGAGCTGTTAT-1_V12D07-335_B1,2,2,1,0,0,5
TTGAGAAGTTTAGCAT-1_V12D07-335_B1,0,0,2,0,0,2
GTCCGGACCTGAAATT-1_V12D07-335_B1,0,3,4,0,0,7
CTGTGGTCGGGAGATA-1_V12D07-335_B1,1,0,1,0,0,2
CATGTAAGAGACATTT-1_V12D07-335_B1,1,0,2,0,0,3
CACGTTTCGTACACAC-1_V12D07-335_B1,0,2,5,0,0,7
CATCCTCTCAAAGATC-1_V12D07-335_B1,0,1,2,0,0,3
GATTAACCGAAAGCCC-1_V12D07-335_B1,0,2,3,0,0,5
AACGCTGTTGCTGAAA-1_V12D07-335_B1,2,0,1,0,0,3
TTCAGCTGGCGTGCCC-1_V12D07-335_B1,2,0,1,0,0,3
TAGAGGTTCTACTTGT-1_V12D07-335_B1,1,0,2,0,0,3
GTATCAAACGTTAGCT-1_V12D07-335_B1,1,1,1,0,0,3
AATCATGTAAAGACTC-1_V12D07-335_B1,0,0,4,0,0,4
AGTCACTAGCTCTCGA-1_V12D07-335_B1,2,0,2,0,0,4
GCGAAACGATCGGGAG-1_V12D07-335_B1,0,2,3,0,0,5
CATGGATTGTCTTCCG-1_V12D07-335_B1,0,0,4,0,0,4
ATTGGATTACAGCGTA-1_V12D07-335_B1,1,0,1,0,0,2
CACACACGCTAACGAG-1_V12D07-335_B1,0,0,4,0,0,4
CTATGGGAAGCGGAAT-1_V12D07-335_B1,0,1,3,0,0,4
TGCCTAATTGAAGATT-1_V12D07-335_B1,0,0,3,0,0,3
TGGCAATGGGACGGCG-1_V12D07-335_B1,0,0,1,0,0,1
ACCTCCGCCCTCGCTG-1_V12D07-335_B1,2,0,0,0,0,2
CGGCAATAAGATCGCC-1_V12D07-335_B1,0,0,2,0,0,2
CCTTGACCACTTTATT-1_V12D07-335_B1,0,0,0,0,0,0
TCATTTAGAAGTGTGA-1_V12D07-335_B1,1,0,0,0,0,1
CAGAATAACACACGGA-1_V12D07-335_B1,0,1,5,0,0,6
TCTGAGCAATTGACTG-1_V12D07-335_B1,1,1,2,0,0,4
CAACGTGGTGGAGTCT-1_V12D07-335_B1,1,1,3,0,0,5
CACAGTTCGCTTCCCA-1_V12D07-335_B1,0,0,2,0,0,2
TCTCTCGCCGCACATA-1_V12D07-335_B1,0,1,2,0,0,3
TGGGCAGGCCACCGCA-1_V12D07-335_B1,0,1,3,0,0,4
CTCCTGTTCAAGGCAG-1_V12D07-335_B1,1,0,7,0,0,8
TATTTGATTTGCACAG-1_V12D07-335_B1,0,0,9,0,0,9
GCCACTCCTTACGGTA-1_V12D07-335_B1,1,2,2,0,0,5
ACCGATATTTAATCAT-1_V12D07-335_B1,0,0,3,0,0,3
TTATTATCTGGAAGGC-1_V12D07-335_B1,0,1,3,0,0,4
TACATGCCGGAATTGT-1_V12D07-335_B1,0,1,4,0,0,5
GGCACTCAGCCGACCC-1_V12D07-335_B1,0,1,4,0,0,5
AAACCGGAAATGTTAA-1_V12D07-335_B1,2,0,4,1,0,7
AGACAGGCATCTCAGC-1_V12D07-335_B1,1,0,2,0,0,3
GTGGTGATGGTTTGTG-1_V12D07-335_B1,0,0,1,1,0,2
CCGATATGACGTAAGG-1_V12D07-335_B1,0,1,5,0,0,6
CATACACAAAGTCAGC-1_V12D07-335_B1,0,0,0,0,0,0
TGCCGTTCTTAATCGG-1_V12D07-335_B1,0,0,0,0,0,0
TCGAGTCTACGATTCG-1_V12D07-335_B1,0,0,0,0,0,0
ACTTCCAGTGGAAGCT-1_V12D07-335_B1,0,0,0,0,0,0
CAATTGGGCCGCACTC-1_V12D07-335_B1,0,0,0,0,0,0
AAATCGCGGAAGGAGT-1_V12D07-335_B1,0,0,0,0,0,0
ATATCAATTCCAGCCT-1_V12D07-335_B1,0,0,0,0,0,0
CTTTGTCGAATGCTCC-1_V12D07-335_B1,0,0,0,0,0,0
TGAGGCATGTACTGTG-1_V12D07-335_B1,0,0,1,0,0,1
TTCGCCGCTCGCGCTA-1_V12D07-335_B1,0,0,1,0,0,1
GACTCCTTCCAATTGA-1_V12D07-335_B1,0,1,1,0,0,2
ACCGAAGAGTCTGGTT-1_V12D07-335_B1,0,1,2,0,0,3
TGGCATGAAGTTTGGG-1_V12D07-335_B1,3,1,1,0,0,5
ACGAGGTTTACAACGT-1_V12D07-335_B1,1,1,2,0,0,4
AACCCATCCCATGATC-1_V12D07-335_B1,1,0,1,0,0,2
TCGACAACTGAACCCG-1_V12D07-335_B1,0,0,5,0,0,5
TATCTTGCAATACAAC-1_V12D07-335_B1,1,1,1,0,0,3
TATTATGTTTGCCTGC-1_V12D07-335_B1,1,1,3,0,0,5
GTCAAAGAAGTGGTGT-1_V12D07-335_B1,1,0,3,0,0,4
GGGACAGAGTTACTCC-1_V12D07-335_B1,0,0,1,0,0,1
AGCAACCGAAAGTAAT-1_V12D07-335_B1,0,0,0,0,0,0
CTCTCTAACTGCCTAG-1_V12D07-335_B1,0,0,3,0,0,3
ATACGGAACGTCGTTT-1_V12D07-335_B1,0,0,1,0,0,1
TCGGTCCCGACAATAG-1_V12D07-335_B1,0,1,1,0,0,2
CGCGCAAATGTCCAGA-1_V12D07-335_B1,2,0,3,0,0,5
TCTAATACTGCCTCAG-1_V12D07-335_B1,1,1,0,0,0,2
CTCGGTTGTCGGCCCT-1_V12D07-335_B1,0,0,2,0,0,2
GGTAACCGGGAGGATA-1_V12D07-335_B1,1,2,3,0,0,6
CAGGCGCACGGTGGTC-1_V12D07-335_B1,1,1,1,0,0,3
TCATCGATGGTCCCAA-1_V12D07-335_B1,3,1,0,2,0,6
CAAAGATTATTGGGCC-1_V12D07-335_B1,1,3,2,0,0,6
ACAATGAATACGGAGA-1_V12D07-335_B1,1,1,0,0,0,2
GCTCCTGACATACTGG-1_V12D07-335_B1,0,0,4,0,0,4
GATGACAAGTAGGGCA-1_V12D07-335_B1,0,3,2,0,0,5
TACGCCGAGGGTACCC-1_V12D07-335_B1,1,5,1,0,0,7
AAGCGTCCCTCATCGA-1_V12D07-335_B1,0,2,1,0,0,3
CACTCCTATGTAAGAT-1_V12D07-335_B1,2,0,1,0,0,3
TCGAGCCAGGCAGGCC-1_V12D07-335_B1,1,0,3,0,0,4
TCGTCAAGTACGCGCA-1_V12D07-335_B1,0,0,1,0,1,2
CCCGTAGCTGGGAAGA-1_V12D07-335_B1,0,3,2,0,1,6
ACCCTATGCCATATCG-1_V12D07-335_B1,0,0,1,0,0,1
GTGGTATAGTCTGCCG-1_V12D07-335_B1,0,1,0,0,0,1
CCGGTTTGTAATTGTG-1_V12D07-335_B1,0,3,0,0,2,5
GTCGCCGTTGTGTGTT-1_V12D07-335_B1,0,0,0,0,2,2
TACTGAACAGATTTAG-1_V12D07-335_B1,0,1,0,0,0,1
TATTAACCTGACCGCG-1_V12D07-335_B1,0,0,0,0,2,2
CTGTAGCCATCTCACT-1_V12D07-335_B1,0,0,0,0,4,4
TACTATGGTTCCTCAG-1_V12D07-335_B1,0,0,0,0,3,3
GAGTCAGACCAGAATC-1_V12D07-335_B1,0,0,0,0,2,2
TAAGGCATAACATCAA-1_V12D07-335_B1,1,1,0,0,0,2
CTTCCGCTCCGTGAAG-1_V12D07-335_B1,1,0,2,0,0,3
GGGCTATGATCGATGG-1_V12D07-335_B1,2,0,0,0,0,2
GGTCGGTCGTCCACAG-1_V12D07-335_B1,0,1,1,0,0,2
GGGACCCGTATATCTT-1_V12D07-335_B1,0,1,3,0,0,4
GAAAGCAGTGCACTTT-1_V12D07-335_B1,1,1,1,0,0,3
AGCGCATAATGAATCG-1_V12D07-335_B1,4,1,1,0,0,6
GCTGCTAAGTAGTCGA-1_V12D07-335_B1,1,2,2,0,0,5
AATAGTCCGTCCCGAC-1_V12D07-335_B1,0,0,0,0,0,0
AGCAGCCAGATGAATA-1_V12D07-335_B1,0,0,3,0,0,3
CCTCGCGCTGTGCGAT-1_V12D07-335_B1,0,0,0,0,0,0
TTGTGTATGCCACCAA-1_V12D07-335_B1,1,0,0,0,0,1
TGCTCGGCGAAACCCA-1_V12D07-335_B1,0,3,1,0,0,4
CGATTAAATATCTCCT-1_V12D07-335_B1,2,0,1,0,0,3
TGCCGTGGATCGTCCT-1_V12D07-335_B1,0,2,1,0,0,3
GTGGACGCATTTGTCC-1_V12D07-335_B1,0,2,2,0,0,4
ACCCGGAAACTCCCAG-1_V12D07-335_B1,1,0,0,0,0,1
CCGCATGTGGTACGAT-1_V12D07-335_B1,1,1,1,0,0,3
GCAAACCTTGGCCATA-1_V12D07-335_B1,1,1,1,0,0,3
ATTCACTGATGTTGGA-1_V12D07-335_B1,0,0,3,0,0,3
ACTCCCTAATGCTAAA-1_V12D07-335_B1,1,0,2,0,0,3
TCCTAAATTGGGAAGC-1_V12D07-335_B1,0,1,3,0,0,4
GAACAGATTACTAAAT-1_V12D07-335_B1,0,2,2,0,0,4
ATACAGGCCCTCCAAT-1_V12D07-335_B1,1,0,3,0,0,4
CGATTCGCCTGGCTGC-1_V12D07-335_B1,2,0,2,0,0,4
TCCGCCTGTCTACAAG-1_V12D07-335_B1,0,1,5,0,0,6
CACATCTCACCGACGA-1_V12D07-335_B1,2,1,2,0,0,5
CGTCGTCCTTCGCGAA-1_V12D07-335_B1,1,0,2,0,0,3
CGTTGAATACCGCGCT-1_V12D07-335_B1,0,1,3,0,0,4
ACCAATATGCAAGTTA-1_V12D07-335_B1,1,1,1,0,0,3
ACGGATGGTGCGGATA-1_V12D07-335_B1,0,1,2,0,0,3
CACCCTAACAAGATCT-1_V12D07-335_B1,0,0,3,0,0,3
AAGCTCTTTCATGGTG-1_V12D07-335_B1,0,0,2,0,0,2
CATGGGTATGCCTTAT-1_V12D07-335_B1,0,0,0,0,0,0
GCGCGTCATTGGTACA-1_V12D07-335_B1,6,0,0,0,0,6
TCTGAAGCACGTGGTC-1_V12D07-335_B1,1,0,4,0,0,5
AAGTTCACTCCAAGCT-1_V12D07-335_B1,1,1,5,0,0,7
TTGGACCTATAACAGT-1_V12D07-335_B1,0,0,3,0,0,3
ATCAGCCTCATGCTGC-1_V12D07-335_B1,0,0,2,0,0,2
AGTACTCTTATGCCCA-1_V12D07-335_B1,1,2,3,0,0,6
GCGCTTAAATAATTGG-1_V12D07-335_B1,2,0,2,0,0,4
TTGTGAACCTAATCCG-1_V12D07-335_B1,1,0,4,0,0,5
AGTCGTCGACCACCAA-1_V12D07-335_B1,1,0,3,0,0,4
TCCTTTAAATCCGCTT-1_V12D07-335_B1,1,2,1,0,0,4
ACTGAAACGCCGTTAG-1_V12D07-335_B1,0,0,0,0,0,0
GCACACACTGGTAGCC-1_V12D07-335_B1,2,1,4,0,0,7
TAAGGGCCTGTCCGAT-1_V12D07-335_B1,1,0,1,0,0,2
GCTAGAGTAGAGATGT-1_V12D07-335_B1,3,1,1,0,0,5
CACAGGGCCATATAGT-1_V12D07-335_B1,1,0,3,0,0,4
CCATGCCCTAGATTTC-1_V12D07-335_B1,1,0,1,0,0,2
TCGCGTAGCAGTGTCC-1_V12D07-335_B1,3,0,2,0,0,5
GACGAGGCTAATAAAC-1_V12D07-335_B1,1,0,1,0,0,2
CTACACTCGCAGATGG-1_V12D07-335_B1,4,0,1,0,0,5
ACGCATACGTTTACTA-1_V12D07-335_B1,2,1,1,0,0,4
GGAGCAACATTTCAAG-1_V12D07-335_B1,3,0,1,0,0,4
CGAGAGGGTAGCCGCG-1_V12D07-335_B1,0,0,1,0,0,1
TCGTGTTCGACCACAA-1_V12D07-335_B1,0,1,1,0,1,3
TCTACCCAATAGAGAG-1_V12D07-335_B1,0,0,0,0,0,0
ATAAACGTTGCACCAC-1_V12D07-335_B1,3,0,1,0,0,4
TCAACTGCAGAGTCAG-1_V12D07-335_B1,0,0,3,0,0,3
AGCTCCATATATGTTC-1_V12D07-335_B1,1,1,6,0,0,8
GTAACATCTAAGATAA-1_V12D07-335_B1,0,0,4,0,0,4
CCGACAATAGGCCGCC-1_V12D07-335_B1,1,0,1,0,0,2
ATGCTTAGGAGTTGAT-1_V12D07-335_B1,2,1,0,0,0,3
AACCCGAGCAGAATCG-1_V12D07-335_B1,0,0,4,0,0,4
CGGGTTTGTTAGGGCT-1_V12D07-335_B1,2,2,4,0,0,8
AGGCACGTGACTGTCC-1_V12D07-335_B1,1,0,3,0,0,4
GACAAGAGATGAGATT-1_V12D07-335_B1,1,1,1,0,0,3
AGCCCTTGGACATCCC-1_V12D07-335_B1,1,0,2,0,0,3
GCAGTTCGATCCGAGC-1_V12D07-335_B1,0,1,2,0,0,3
TCGAGGGCAACAGACG-1_V12D07-335_B1,0,0,0,0,0,0
ACTTTGTCGACGCACT-1_V12D07-335_B1,0,0,3,0,0,3
GAGTATCAAAGTTACA-1_V12D07-335_B1,0,0,2,0,0,2
CCAGGCTGGCGTCTGA-1_V12D07-335_B1,1,1,1,0,0,3
GGACTCTTCCGGTTGA-1_V12D07-335_B1,0,1,1,0,0,2
TCCCAGCACACGACAT-1_V12D07-335_B1,0,0,2,0,0,2
GCTCCATGAGTGCAGA-1_V12D07-335_B1,0,0,2,0,0,2
GCAGTGCGGGCGGATG-1_V12D07-335_B1,0,1,0,0,0,1
GCGTTCTGACTAAGCG-1_V12D07-335_B1,0,1,0,0,0,1
ATTTGGAGATTGCGGT-1_V12D07-335_B1,0,0,0,0,0,0
AAGGGTTTGATTTCAG-1_V12D07-335_B1,0,0,0,0,0,0
CCGGCCGCGAGCATAT-1_V12D07-335_B1,0,0,0,0,0,0
GAGTTCTGTGGGTGCT-1_V12D07-335_B1,0,0,0,0,0,0
AAACGAAGATGGAGTA-1_V12D07-335_B1,0,0,0,0,0,0
AATTACGAGACCCATC-1_V12D07-335_B1,0,0,0,0,0,0
CCTTTGAATTATGGCT-1_V12D07-335_B1,0,0,0,0,0,0
CATGGTATTAGTTTGT-1_V12D07-335_B1,0,0,0,0,0,0
AACGAAAGTCGTCCCA-1_V12D07-335_B1,0,0,1,0,0,1
ACATAAGTCGTGGTGA-1_V12D07-335_B1,3,0,0,0,0,3
GCACAACCTCGGGCGT-1_V12D07-335_B1,1,1,3,0,0,5
ATGCACGCGCTGTTCA-1_V12D07-335_B1,0,0,3,0,0,3
CGATGTTGTTATCTAC-1_V12D07-335_B1,1,2,3,0,0,6
GTCTCCTGCCAGTATG-1_V12D07-335_B1,1,1,3,0,0,5
GATGCCTTCTGCGGCA-1_V12D07-335_B1,0,0,4,0,0,4
ACCGGTCAGGTACACC-1_V12D07-335_B1,1,0,2,0,0,3
GTGGAGCGTTTACCGA-1_V12D07-335_B1,1,0,4,0,0,5
AGGCGGTTTGTCCCGC-1_V12D07-335_B1,2,1,1,0,0,4
TCCCTGGCGTATTAAC-1_V12D07-335_B1,1,1,1,0,0,3
AAACACCAATAACTGC-1_V12D07-335_B1,1,0,0,0,0,1
TGGACGCAATCCAGCC-1_V12D07-335_B1,2,2,2,0,0,6
GGAACCTTGACTCTGC-1_V12D07-335_B1,0,0,2,0,0,2
GTATCTCAGTCTTGAC-1_V12D07-335_B1,0,1,2,0,0,3
GCTGAATCTTCCAATC-1_V12D07-335_B1,0,0,3,0,0,3
AGATGCAAGACGTGCA-1_V12D07-335_B1,0,0,2,0,0,2
TTAAGGCCCGTACTTT-1_V12D07-335_B1,0,1,0,0,0,1
AGTATGCTGGAGACCA-1_V12D07-335_B1,1,0,1,0,0,2
GCGGCAAAGTATTGCC-1_V12D07-335_B1,1,3,1,0,0,5
GCGCAAATATATTCAA-1_V12D07-335_B1,0,2,2,0,0,4
GAAGAAACGATATTGT-1_V12D07-335_B1,0,2,1,0,0,3
GGACCTCTAGGCCGCC-1_V12D07-335_B1,2,0,0,0,0,2
AACAGCTGTGTGGCAA-1_V12D07-335_B1,0,0,3,0,0,3
TCGAATATCCCGCAGG-1_V12D07-335_B1,1,0,1,0,0,2
GCGACCCAACCATCTG-1_V12D07-335_B1,2,0,2,0,0,4
AGAGAAGGAGTACAAT-1_V12D07-335_B1,1,1,1,0,0,3
GGCTCCTCCACCTGTT-1_V12D07-335_B1,0,1,2,0,1,4
TCAGTGTATACGTCAT-1_V12D07-335_B1,0,0,4,0,3,7
ATTATTATGTCCGTCA-1_V12D07-335_B1,0,2,0,0,0,2
TTAGGTCATAACCGAC-1_V12D07-335_B1,0,3,0,1,0,4
AAGATGGCACCGGACC-1_V12D07-335_B1,0,2,0,0,0,2
CTACAAGAAATAACCC-1_V12D07-335_B1,0,5,0,0,0,5
ACTATTTCCGGGCCCA-1_V12D07-335_B1,0,1,0,0,1,2
TTGTTTCACATCCAGG-1_V12D07-335_B1,0,4,0,0,0,4
CGCTGTGTGGATGTTG-1_V12D07-335_B1,1,1,0,1,0,3
TCAACATAGCGCCCTA-1_V12D07-335_B1,0,1,0,0,2,3
GGCCGTTTGGGTTTCA-1_V12D07-335_B1,1,0,3,0,0,4
TACTCTTTCGTCTTCA-1_V12D07-335_B1,2,1,1,0,0,4
TTCGCGCGCCATACGA-1_V12D07-335_B1,1,1,1,0,0,3
CGGAAAGAATCAAACG-1_V12D07-335_B1,0,0,2,0,0,2
AGGCAGGGAGCGTACT-1_V12D07-335_B1,0,1,2,0,0,3
CCTTTAAGGGAGCACT-1_V12D07-335_B1,0,0,2,0,0,2
CGCCCAGCACGCCTAG-1_V12D07-335_B1,0,0,0,0,0,0
AGTATTTGGCACGACC-1_V12D07-335_B1,0,1,2,0,0,3
TATCCGCACCGTCGGG-1_V12D07-335_B1,0,0,1,0,0,1
ACCCGTGTCATCAGTA-1_V12D07-335_B1,1,1,3,0,0,5
CAACTGCTCATCCGAT-1_V12D07-335_B1,0,1,0,0,0,1
CCGGAGCGTACTTTCT-1_V12D07-335_B1,0,0,1,0,0,1
TACCGTAGGTTAACTA-1_V12D07-335_B1,0,0,4,0,0,4
TGAGGAGTGCCAGCTT-1_V12D07-335_B1,1,0,3,0,0,4
CCAGTCTTGTCATAGA-1_V12D07-335_B1,1,1,2,0,0,4
GGGCAGAGCAATCGTT-1_V12D07-335_B1,2,0,2,0,0,4
TACCAAATAGCCCAGA-1_V12D07-335_B1,1,1,1,0,0,3
TACCTACTCCCAGTAT-1_V12D07-335_B1,1,0,1,0,0,2
TGTGAGACTAGCCCAA-1_V12D07-335_B1,0,1,2,0,0,3
ATACCTAACCAAGAAA-1_V12D07-335_B1,1,0,0,0,0,1
GTCGGGAAGCAGAAAC-1_V12D07-335_B1,1,1,1,1,0,4
AATTAACGGATTTCCA-1_V12D07-335_B1,1,0,2,0,0,3
GAACCCTCTGTGTTCT-1_V12D07-335_B1,0,1,2,0,0,3
ATATAAAGCGCTCGTG-1_V12D07-335_B1,0,0,4,0,0,4
CCTGGTCGAATGTGGG-1_V12D07-335_B1,0,0,2,0,0,2
CTAGGTTCGGACGTGA-1_V12D07-335_B1,0,0,0,0,0,0
TCGGGAGACAGCGTAC-1_V12D07-335_B1,0,0,3,0,0,3
CATAAGAAGCTTGGCT-1_V12D07-335_B1,0,0,2,0,0,2
AAGCACCCTGCGTATC-1_V12D07-335_B1,1,0,2,0,0,3
AGTTTGCACCTGCCTC-1_V12D07-335_B1,1,2,0,0,0,3
GACTGCAAATCGAGCT-1_V12D07-335_B1,1,0,0,0,0,1
GTGTATATCAGCGGGC-1_V12D07-335_B1,0,0,1,0,0,1
CTTCAACTCCACTTGG-1_V12D07-335_B1,0,1,1,0,0,2
ACTTACGCATCCACGC-1_V12D07-335_B1,0,0,0,0,0,0
CATGAGATGCACTCTC-1_V12D07-335_B1,0,0,1,0,0,1
GAGCACCTGTGTCCAG-1_V12D07-335_B1,0,3,0,0,0,3
CGCGACCGCGACAGAT-1_V12D07-335_B1,2,0,3,0,0,5
GTCCCGCGACGTTATG-1_V12D07-335_B1,2,1,0,0,0,3
GCAGTGTGGCTATAGG-1_V12D07-335_B1,0,0,2,0,0,2
ATACTGCCTTACACCG-1_V12D07-335_B1,1,0,3,0,0,4
TACAGAAACGGTGGGC-1_V12D07-335_B1,0,0,2,0,0,2
GGCGCGGAGATCTTTC-1_V12D07-335_B1,0,0,6,0,0,6
CGTTAATGTCCCGACG-1_V12D07-335_B1,0,0,1,0,0,1
GCTAACTGAAGTCTGA-1_V12D07-335_B1,0,0,2,0,0,2
AGTGATAACCTGCGCG-1_V12D07-335_B1,0,0,1,0,0,1
TATGATCTTCTCTTTA-1_V12D07-335_B1,1,0,2,0,0,3
TGTACCTACACGAGGG-1_V12D07-335_B1,0,0,0,0,0,0
ATATCGTTCCTCGAAC-1_V12D07-335_B1,0,0,2,0,0,2
CGGCGCCATCAATCCC-1_V12D07-335_B1,1,0,1,0,0,2
CCTGTTTGAAGACACG-1_V12D07-335_B1,2,0,2,0,0,4
GCCACTCAGAGCGCGA-1_V12D07-335_B1,1,0,3,0,0,4
TCGGCTTGTATCGACG-1_V12D07-335_B1,1,0,1,0,0,2
TAGATGGTTCCTTACT-1_V12D07-335_B1,2,0,4,0,0,6
ATCGTTAGCTAGCGGA-1_V12D07-335_B1,0,0,0,0,0,0
ACAGCGACATTCTCAT-1_V12D07-335_B1,1,0,1,0,0,2
ATTCAACCATTTAAGG-1_V12D07-335_B1,1,0,3,0,0,4
CACTCTTCTGCTAGCC-1_V12D07-335_B1,0,0,0,0,3,3
CTAACTGATAATCGCC-1_V12D07-335_B1,2,0,1,0,2,5
TGATGTCAATTAAGTG-1_V12D07-335_B1,0,0,1,0,0,1
CGCCGTTCAGCATAGT-1_V12D07-335_B1,0,0,2,0,5,7
ATACTACCCGTACCAC-1_V12D07-335_B1,1,0,0,0,0,1
CCACTGTTTGGATTAA-1_V12D07-335_B1,1,0,1,0,0,2
CACTACGGGAGCTGCC-1_V12D07-335_B1,1,1,2,0,0,4
GACCAAACGTTGACTG-1_V12D07-335_B1,0,0,2,0,0,2
AAGAGGCCCTTTGGAA-1_V12D07-335_B1,2,1,3,0,0,6
ACACGTAGGCCACAAG-1_V12D07-335_B1,2,1,0,0,0,3
TACTCTTACTTTACTG-1_V12D07-335_B1,3,0,0,0,0,3
AGAGCCGCCGAGATTT-1_V12D07-335_B1,0,0,2,0,0,2
GGCCTGCTTCTCCCGA-1_V12D07-335_B1,2,0,1,0,0,3
TCAAGCGCGGACGGTA-1_V12D07-335_B1,0,0,4,0,0,4
ACACTGGGACAGTCGT-1_V12D07-335_B1,1,0,3,0,0,4
TGTGTAGTAGCACGTG-1_V12D07-335_B1,0,0,2,0,0,2
CTAGCCACAGGCGAGC-1_V12D07-335_B1,1,0,3,0,0,4
CTATCGCGTAGAGAAC-1_V12D07-335_B1,2,0,3,0,0,5
GTTCCCGTAAACATAT-1_V12D07-335_B1,0,0,1,0,0,1
TCTTTCCTTCGAGATA-1_V12D07-335_B1,1,0,2,0,0,3
ATATTGGAGAGGCCTT-1_V12D07-335_B1,0,1,2,0,0,3
AGGCGATAACTGGCGT-1_V12D07-335_B1,1,0,0,0,0,1
ACCCGGAGCACCACAA-1_V12D07-335_B1,1,0,0,0,0,1
TGAGCTCAACTGTATA-1_V12D07-335_B1,0,0,0,0,0,0
ACGACCCATGAGTTGC-1_V12D07-335_B1,2,0,3,0,0,5
CGGTCAGTCCATATTT-1_V12D07-335_B1,1,1,2,0,0,4
TCCGGCTGTCGGGTCG-1_V12D07-335_B1,1,1,6,0,0,8
ATTCCCGAAGGTACAG-1_V12D07-335_B1,0,0,0,0,0,0
CTAACAGCACAATAAC-1_V12D07-335_B1,0,0,0,0,0,0
TTGTGCGGAAGCGGAT-1_V12D07-335_B1,0,0,0,0,0,0
GGGCACTATTGACCAT-1_V12D07-335_B1,0,0,0,0,0,0
CCATAGAGGCTGCCAG-1_V12D07-335_B1,0,0,0,0,0,0
CCGAAGCATTGACCAA-1_V12D07-335_B1,0,0,0,0,0,0
TACTGAGGGAAGAAAG-1_V12D07-335_B1,0,0,0,0,0,0
TATGTAGAAACCCGGC-1_V12D07-335_B1,0,0,0,0,0,0
TGGTTAACTTACATTT-1_V12D07-335_B1,0,0,0,0,0,0
AGAACCCTCAATTGGG-1_V12D07-335_B1,1,1,5,0,0,7
CCTATATCGTGTCACG-1_V12D07-335_B1,1,0,1,0,0,2
ACGGCTGGATGTAGAA-1_V12D07-335_B1,0,0,1,0,0,1
CTCGCATTGCATAGCC-1_V12D07-335_B1,0,0,3,0,0,3
ACTTTGGTCGTGCTCC-1_V12D07-335_B1,0,2,2,0,2,6
GCTGGTTTAGGCCATA-1_V12D07-335_B1,0,0,2,0,0,2
TGTCGTTATCACATAT-1_V12D07-335_B1,0,1,1,0,0,2
ACACATGATCAAATCT-1_V12D07-335_B1,1,1,5,0,0,7
TATCCATCTCGGTTAG-1_V12D07-335_B1,0,1,2,0,0,3
CTCGTCGAGGGCTCAT-1_V12D07-335_B1,1,0,1,0,0,2
ATCAATGCCGTGGCTG-1_V12D07-335_B1,1,0,2,0,0,3
GAAACATAGGAAACAG-1_V12D07-335_B1,0,1,0,0,0,1
TAATAGGTCACCAGAA-1_V12D07-335_B1,0,1,2,0,0,3
CACCAGTCAGCATGCA-1_V12D07-335_B1,0,0,2,0,0,2
GAGCGCTGTTAGGTAA-1_V12D07-335_B1,0,2,1,0,0,3
CCCTATGTAGAGCAGA-1_V12D07-335_B1,1,1,0,0,0,2
GATCGCTATATCTCAG-1_V12D07-335_B1,0,1,2,0,0,3
AAGGGACTATGCATTC-1_V12D07-335_B1,1,0,4,0,0,5
CTCGGGTTCTCTGGCC-1_V12D07-335_B1,0,0,0,1,0,1
TATATATCGAGAAATG-1_V12D07-335_B1,1,0,3,0,0,4
ACCCGAGCGAAATTAC-1_V12D07-335_B1,1,2,2,0,0,5
TTGTTTCATTAGTCTA-1_V12D07-335_B1,0,0,1,0,0,1
ATGGGACCTGCTGAAC-1_V12D07-335_B1,0,0,0,0,0,0
TGCGACGGCCGAACGT-1_V12D07-335_B1,2,2,4,0,0,8
AGCTAACAAGCAATGT-1_V12D07-335_B1,0,0,1,0,0,1
CGTGTCTCGTTACGAC-1_V12D07-335_B1,0,3,3,0,1,7
CTAAATCCGGTGTACA-1_V12D07-335_B1,0,1,0,0,1,2
GAATAGTGCTCGATTA-1_V12D07-335_B1,0,5,0,0,0,5
AACAATACATTGTCGA-1_V12D07-335_B1,1,0,1,0,3,5
CACATCGTGCACGCGC-1_V12D07-335_B1,0,2,2,0,0,4
ACCGTGACCACGTGGG-1_V12D07-335_B1,0,1,1,0,0,2
CCCAATGAGATTTGCA-1_V12D07-335_B1,0,0,0,0,0,0
TCAGCAGTAGGCCCTG-1_V12D07-335_B1,2,0,0,0,0,2
CTACTCAAGGTATAGT-1_V12D07-335_B1,1,0,0,0,0,1
TAGTAGCTTATACCAG-1_V12D07-335_B1,0,2,2,0,0,4
ACGTTCGTTCAGGAAA-1_V12D07-335_B1,0,1,3,0,0,4
TTAGAATAAGGGTCGG-1_V12D07-335_B1,0,1,1,0,0,2
TTCTAGAAAGTCTTAT-1_V12D07-335_B1,0,1,1,0,0,2
CCTTCAGTTAAAGTGA-1_V12D07-335_B1,0,0,1,0,0,1
TAGCTAGTGATGATGG-1_V12D07-335_B1,0,0,1,0,0,1
AGCCCGGTAGCCTGTA-1_V12D07-335_B1,0,0,3,0,0,3
TACCTCAGTTGTCTGT-1_V12D07-335_B1,0,0,1,0,0,1
GACGGGTTGGCCCGTA-1_V12D07-335_B1,0,0,4,0,0,4
GAAACCTATACAAATG-1_V12D07-335_B1,2,0,0,0,0,2
TCCACCTCTAGCCTTT-1_V12D07-335_B1,1,1,3,0,0,5
AAGACCCAACTGAACA-1_V12D07-335_B1,1,0,0,0,0,1
CATACACGGTTCCCAC-1_V12D07-335_B1,0,1,1,0,0,2
ACTACGCGTTAGAATT-1_V12D07-335_B1,0,0,4,0,0,4
CTTGGCCAAGCTGGGA-1_V12D07-335_B1,1,1,3,0,0,5
TTACCCTAGGGATTGG-1_V12D07-335_B1,1,0,1,0,0,2
TTCGCACTGTACGACA-1_V12D07-335_B1,0,0,2,0,0,2
TAGGTGTTCCACAGAT-1_V12D07-335_B1,0,0,2,0,0,2
GAAGCCTGCACATTCC-1_V12D07-335_B1,2,0,0,0,0,2
GGCTTTCAATAAGGGT-1_V12D07-335_B1,0,2,0,0,0,2
TCCAGGGTATATACGA-1_V12D07-335_B1,0,2,3,0,0,5
CTCGCCGAATGTAGGG-1_V12D07-335_B1,1,0,1,0,0,2
AGGAAGCTGTCCGCCG-1_V12D07-335_B1,0,0,3,0,0,3
GTCTCAAGGCCCGGCT-1_V12D07-335_B1,2,0,4,0,0,6
ACCGACACATCTCCCA-1_V12D07-335_B1,0,1,0,0,0,1
TATACGCGTCATCACT-1_V12D07-335_B1,1,1,2,0,0,4
ATCTGGGCTGTTCTTG-1_V12D07-335_B1,0,1,2,0,0,3
TCAAATTTGAGACTCA-1_V12D07-335_B1,1,0,2,0,0,3
GTTAAGGGTGCGATGT-1_V12D07-335_B1,0,0,2,0,0,2
AGCAAAGGCCGCTAGT-1_V12D07-335_B1,3,0,1,0,0,4
TTATAGGTAATTGTCT-1_V12D07-335_B1,1,1,0,0,0,2
TTGTGCAGCCACGTCA-1_V12D07-335_B1,0,1,3,0,0,4
ACGGACTCTCAAAGCG-1_V12D07-335_B1,1,0,2,0,0,3
ATGCTCTGGCGCGGTA-1_V12D07-335_B1,0,4,1,0,0,5
ATAATCTTGGAGAACC-1_V12D07-335_B1,1,1,0,0,0,2
CTCATTGCTCTAACAA-1_V12D07-335_B1,0,2,2,0,0,4
TAGGTGACGATAACCT-1_V12D07-335_B1,0,2,0,0,0,2
CGGATCCTCAAGGACT-1_V12D07-335_B1,1,0,2,0,0,3
GGGCGTGGTTTCCCAG-1_V12D07-335_B1,0,1,3,0,0,4
TGGCTATGTGACATAC-1_V12D07-335_B1,0,5,3,0,0,8
CTTAGTGTAGTAGCAT-1_V12D07-335_B1,0,1,0,0,0,1
GGATTGCTGTGACTCC-1_V12D07-335_B1,2,0,2,0,0,4
ACTTCCATGCGGGACA-1_V12D07-335_B1,0,0,0,0,0,0
ACTCAAGTGCAAGGCT-1_V12D07-335_B1,1,0,0,0,0,1
ACAAGGATGCTTTAGG-1_V12D07-335_B1,0,0,1,0,0,1
TTGAACGACGTGCTGA-1_V12D07-335_B1,0,0,1,0,0,1
ATTCATCGTTGAGGCA-1_V12D07-335_B1,0,1,3,0,0,4
TGCAACCCATCTGCGG-1_V12D07-335_B1,1,0,1,0,0,2
AGTGCTAAACACAGCA-1_V12D07-335_B1,0,1,5,0,0,6
AACTCCAGAGCGTGTT-1_V12D07-335_B1,2,0,1,0,0,3
TCTCCACAAGTTGAAT-1_V12D07-335_B1,0,0,0,0,0,0
CTTTGCATCGCTCTTG-1_V12D07-335_B1,2,0,1,0,0,3
TCACAAACCGAGGTAC-1_V12D07-335_B1,1,0,3,0,0,4
CCGTAGGAAATCCCTG-1_V12D07-335_B1,1,0,2,0,0,3
AAACATTTCCCGGATT-1_V12D07-335_B1,1,0,1,0,2,4
GCCTCCGACAATTCAC-1_V12D07-335_B1,2,0,0,0,0,2
TCTGCATACCTTGCTT-1_V12D07-335_B1,0,1,2,0,2,5
ACCCATTTGTCCCTCT-1_V12D07-335_B1,0,0,2,0,2,4
CTGCAGAGAATCAGAG-1_V12D07-335_B1,0,0,1,0,0,1
GGAAACTAAATGGGCC-1_V12D07-335_B1,1,0,1,0,1,3
CAACCTACCGAGCAGT-1_V12D07-335_B1,1,0,2,0,0,3
CCGTAGGGTTGTTTAC-1_V12D07-335_B1,2,0,1,0,0,3
GGTTTGTGACCTGAGG-1_V12D07-335_B1,0,0,0,0,0,0
TAACCTAGGGAGTCCA-1_V12D07-335_B1,2,1,0,0,0,3
TTCCATCGACAGCGTG-1_V12D07-335_B1,0,0,0,0,0,0
ATCTCCCACGGAATAT-1_V12D07-335_B1,1,0,1,0,0,2
GTTTCAAACGAGTTGT-1_V12D07-335_B1,0,0,0,0,0,0
GGAACTTTGGCGATTA-1_V12D07-335_B1,0,0,0,0,0,0
CTGCAAGCACGTTCCG-1_V12D07-335_B1,0,0,0,0,0,0
CACAGTCCCGCTTCGC-1_V12D07-335_B1,1,0,2,0,0,3
TACGCTCGGTATTGGA-1_V12D07-335_B1,0,0,0,0,0,0
CTGGTAAAGTGTGGGC-1_V12D07-335_B1,2,2,2,0,0,6
CAACCAGTGGCCTACC-1_V12D07-335_B1,0,0,0,0,0,0
TCTTCGCGGTGAGAGG-1_V12D07-335_B1,2,0,3,0,0,5
TTCGGGTTGCCACGGG-1_V12D07-335_B1,3,0,3,0,0,6
ACCGATAGGCATAACC-1_V12D07-335_B1,0,0,3,0,0,3
CTTATAGATGGCTGTT-1_V12D07-335_B1,6,0,0,0,0,6
AGACGCCCACTTCGCC-1_V12D07-335_B1,2,0,1,0,0,3
AGGTCGCCTCCCAACA-1_V12D07-335_B1,3,1,0,0,0,4
CCTCACGTCAGCTAAT-1_V12D07-335_B1,0,0,2,0,0,2
CCACCTGTATGGAATA-1_V12D07-335_B1,0,0,3,0,0,3
GGACTCGAAGCTTTCA-1_V12D07-335_B1,2,0,1,0,0,3
AAGCCGGAGAGCAGGA-1_V12D07-335_B1,1,0,1,0,0,2
GCCTATCAGGTAAGAT-1_V12D07-335_B1,1,0,1,0,0,2
TCAGAGTGTGAGCATG-1_V12D07-335_B1,0,0,0,0,0,0
AAACATGGTGAGAGGA-1_V12D07-335_B1,0,0,0,0,0,0
ATCATTGTACCGCATT-1_V12D07-335_B1,0,0,0,0,0,0
TCAGCTTGAGCTTTCG-1_V12D07-335_B1,0,0,0,0,0,0
CCGCGCAAGATACCCA-1_V12D07-335_B1,0,0,0,0,0,0
CTATACTTAAAGCGAG-1_V12D07-335_B1,0,0,0,0,0,0
ACCGTCCACTGGGCCC-1_V12D07-335_B1,0,0,0,0,0,0
AAGACCAAATAACTCA-1_V12D07-335_B1,0,0,0,0,0,0
TGTTTCTGAAGCGTGC-1_V12D07-335_B1,0,0,0,0,0,0
TTCTCTTACAGGTGAT-1_V12D07-335_B1,2,0,0,0,0,2
AATTCATTGTCATGCA-1_V12D07-335_B1,1,1,3,0,0,5
GCCCGAGAGTCTAAAT-1_V12D07-335_B1,1,1,0,0,1,3
ATATAGAGTATTGGTC-1_V12D07-335_B1,0,0,0,0,1,1
TTGAAGGATGGGCGCC-1_V12D07-335_B1,0,0,2,0,1,3
TAGTACCACAACTTTC-1_V12D07-335_B1,0,1,2,0,0,3
ATCCCATCCACAGCGC-1_V12D07-335_B1,0,1,4,0,0,5
CTTAGGTATAGACCAG-1_V12D07-335_B1,0,0,1,0,0,1
TGACTCCGAATCATAC-1_V12D07-335_B1,1,0,2,0,0,3
ACTACATCCCGACAAG-1_V12D07-335_B1,0,0,3,0,0,3
TTGCCGCAGACCTACA-1_V12D07-335_B1,1,0,1,0,0,2
TAAGAGGGACAGGGAC-1_V12D07-335_B1,0,0,4,0,0,4
CGAATGAAGTCATTGC-1_V12D07-335_B1,0,0,2,0,0,2
AAGGGAACGACTGGCT-1_V12D07-335_B1,1,0,2,0,1,4
CGAATCTGCTCGACGC-1_V12D07-335_B1,0,1,2,0,0,3
ATCGTGGAAAGTCTGG-1_V12D07-335_B1,0,2,2,0,0,4
CCTATGGCTCCTAGTG-1_V12D07-335_B1,1,1,3,0,0,5
CGTCGCTTGGTTATAC-1_V12D07-335_B1,0,0,1,0,0,1
TGCTTAGAGAGAATGC-1_V12D07-335_B1,0,0,0,0,0,0
GATTGCTCCAGTTGCA-1_V12D07-335_B1,1,0,0,0,0,1
CGTGCTTCTACCTAAA-1_V12D07-335_B1,2,0,2,0,0,4
ACTCCAATATCATCAT-1_V12D07-335_B1,0,2,2,0,0,4
GCCGACCCACGACTGC-1_V12D07-335_B1,0,0,1,0,0,1
GAGGGTAGTAACAAAG-1_V12D07-335_B1,1,0,0,0,0,1
GGCCGAGACTCTGGTG-1_V12D07-335_B1,1,1,3,0,0,5
TATATAGGGCTTTACG-1_V12D07-335_B1,0,0,3,0,0,3
TGCCGGATGTACGAGC-1_V12D07-335_B1,1,1,2,0,1,5
AGGTAGATCGAGATAT-1_V12D07-335_B1,0,3,0,0,0,3
GATCAACATAAAGGGA-1_V12D07-335_B1,0,1,1,0,0,2
TAACAGCGTTTGTGCT-1_V12D07-335_B1,1,0,1,0,0,2
CTATAGGCGTTGATGT-1_V12D07-335_B1,0,0,0,0,0,0
GGTTTAATTACCATCG-1_V12D07-335_B1,0,1,0,0,0,1
CTCTTCTGGAAGTTAG-1_V12D07-335_B1,1,1,2,0,0,4
ATCTGACATGGAAGGA-1_V12D07-335_B1,0,1,1,0,0,2
TACGTACTAGTGCTGA-1_V12D07-335_B1,0,2,4,0,0,6
ATGACTATCAGCTGTG-1_V12D07-335_B1,1,0,3,0,0,4
CTTTGGGATTGTTGCA-1_V12D07-335_B1,0,1,1,0,0,2
AGACTGTTACCGGGTC-1_V12D07-335_B1,1,0,2,0,0,3
TCCTAACCGTCGGGCA-1_V12D07-335_B1,0,2,2,0,0,4
ACGCAAACTAATAGAT-1_V12D07-335_B1,1,0,2,0,0,3
AAGTGAGTCGGGTTTA-1_V12D07-335_B1,3,0,0,0,0,3
TAAAGCGGTATTTCCA-1_V12D07-335_B1,1,0,0,0,0,1
CTCCTCCAGCTCACAC-1_V12D07-335_B1,1,0,2,0,0,3
CGGTCCGTCGCAAGCC-1_V12D07-335_B1,0,0,0,0,0,0
CCTATATTTGTCCTGG-1_V12D07-335_B1,2,0,1,0,0,3
TCCAATAAAGGCTACC-1_V12D07-335_B1,0,0,1,0,0,1
AAAGGCTACGGACCAT-1_V12D07-335_B1,1,1,1,0,0,3
CGTGACCAGTCCTCTG-1_V12D07-335_B1,0,0,7,0,0,7
GATCTGCTATCTAAGG-1_V12D07-335_B1,0,0,1,0,0,1
CGAATGACGCATAATG-1_V12D07-335_B1,1,1,3,0,0,5
GCTCAATGTAATACCG-1_V12D07-335_B1,0,1,3,0,0,4
CTATGCCCGAATGCAA-1_V12D07-335_B1,0,2,0,0,0,2
CACAGGGCCGTTGTCA-1_V12D07-335_B1,1,0,1,0,0,2
TCAATACGCCGTCATG-1_V12D07-335_B1,1,1,2,0,0,4
AGCGGACACTTCGTAG-1_V12D07-335_B1,0,1,0,0,0,1
ATACGTTATGCACGGA-1_V12D07-335_B1,0,0,0,0,0,0
GAGTAGATACTAGTTG-1_V12D07-335_B1,1,0,2,0,0,3
CCAGCTCGAACGCATT-1_V12D07-335_B1,1,1,3,0,0,5
TGCTTCCCAAGCAGTA-1_V12D07-335_B1,0,1,0,0,0,1
GTAGACACGCCTGACT-1_V12D07-335_B1,0,0,2,0,0,2
CTCACATTTACTAAAT-1_V12D07-335_B1,0,0,2,0,0,2
GAATGCGAATCGGTTC-1_V12D07-335_B1,0,2,2,0,0,4
TAAGGCCCGTCACCCT-1_V12D07-335_B1,0,1,2,0,0,3
GAGTATGCGCGTGCAT-1_V12D07-335_B1,0,0,2,0,0,2
ATCCACATCGACAGAA-1_V12D07-335_B1,2,1,5,0,0,8
TAGACGAAACGCCAAT-1_V12D07-335_B1,2,0,0,0,0,2
CAGCAGTCTGTGCTGC-1_V12D07-335_B1,2,0,2,0,0,4
CTCACTGTGATACTTA-1_V12D07-335_B1,0,1,3,0,0,4
TTAATTGCTTTGGGTG-1_V12D07-335_B1,0,2,3,0,0,5
GTAGTCTACGATATTG-1_V12D07-335_B1,0,2,3,0,0,5
TTGCCGCTTTCTAGTA-1_V12D07-335_B1,0,1,1,0,0,2
GAACCTTTAACGATCC-1_V12D07-335_B1,1,0,1,0,0,2
TGGACCAATCTAAGAT-1_V12D07-335_B1,0,1,3,0,0,4
CTAGTAGAAAGGGATT-1_V12D07-335_B1,1,0,2,0,0,3
AACCTCGCTTTAGCCC-1_V12D07-335_B1,0,0,3,0,0,3
GAGTGTCAACCAGAAA-1_V12D07-335_B1,0,0,1,0,0,1
GTGATCCTTGTCATGA-1_V12D07-335_B1,0,1,0,0,0,1
CTCAACTAACCCGGAT-1_V12D07-335_B1,0,0,4,0,0,4
AGTGGCGTCTGAAGGT-1_V12D07-335_B1,1,0,6,0,0,7
GGGAAGGGCTTTCTCA-1_V12D07-335_B1,0,1,1,0,0,2
AGGCCTGAGAATCTCG-1_V12D07-335_B1,0,0,1,0,0,1
AGCCACAGGTTACCCG-1_V12D07-335_B1,1,0,3,0,0,4
TGCAATCTAACACGGT-1_V12D07-335_B1,0,0,1,0,0,1
GTTTGGGTTTCGCCCG-1_V12D07-335_B1,1,1,3,0,0,5
CCTATGTCCACTCCAC-1_V12D07-335_B1,2,0,0,0,0,2
CTGCCTTTCTAGTAAA-1_V12D07-335_B1,0,0,0,0,0,0
TTAGTAAACCTGCTCT-1_V12D07-335_B1,1,0,1,0,0,2
TTGTGGTGGTACTAAG-1_V12D07-335_B1,1,0,1,0,0,2
CCTCCTGTTGTGTCGT-1_V12D07-335_B1,2,0,0,0,0,2
ACAAAGCATGACCTAG-1_V12D07-335_B1,1,0,0,0,0,1
ATAGCAACTAGGGAAG-1_V12D07-335_B1,1,0,3,0,0,4
CCGCTCTTCCGAACTA-1_V12D07-335_B1,0,0,0,0,0,0
TAGAATAGCCGATGAA-1_V12D07-335_B1,2,0,4,0,0,6
GGTCTCCGTCCAGGTT-1_V12D07-335_B1,0,0,2,0,0,2
TAATTACGTCAGTAGA-1_V12D07-335_B1,0,0,0,0,0,0
TACGTAAAGCGGAGTG-1_V12D07-335_B1,1,0,0,0,0,1
GCTACAATCGAGGATA-1_V12D07-335_B1,1,0,2,0,0,3
TCAGCCAATCCGTAAA-1_V12D07-335_B1,1,0,3,0,0,4
ATCATAGCCCTATGTA-1_V12D07-335_B1,0,0,2,0,0,2
GAGGCCTGTTGATACA-1_V12D07-335_B1,0,0,0,0,0,0
ATATACGCTCGTGACG-1_V12D07-335_B1,0,0,0,0,0,0
CCCTTTAATGGAGTTC-1_V12D07-335_B1,1,0,1,0,0,2
TTACACGATCTGCGAC-1_V12D07-335_B1,0,0,2,0,0,2
TCGCATAAAGGGCGCA-1_V12D07-335_B1,0,0,0,0,0,0
TGTAGCCATCCCATTC-1_V12D07-335_B1,0,0,0,0,0,0
GGGTCTATCGCTTTCC-1_V12D07-335_B1,0,0,0,0,0,0
GGAGGGTCAAGTAAGA-1_V12D07-335_B1,0,0,0,0,0,0
TACGGCATGGACGCTA-1_V12D07-335_B1,0,0,3,0,0,3
CACGTCAATCAATGGA-1_V12D07-335_B1,1,0,0,0,0,1
CGCTTGGACGGATAGA-1_V12D07-335_B1,0,0,0,0,0,0
CGCGGTACGGTATACA-1_V12D07-335_B1,1,0,2,0,0,3
CCTACTCAACACGATT-1_V12D07-335_B1,1,0,2,0,0,3
CGTTTGGTGTTGTGGG-1_V12D07-335_B1,1,0,0,0,0,1
GTTGTTGCAAGATGGC-1_V12D07-335_B1,2,0,1,0,0,3
CATTCGTCGTAGCGGT-1_V12D07-335_B1,3,0,3,0,0,6
CAGCCTCGATAGCGGT-1_V12D07-335_B1,0,0,2,0,0,2
TCATAAGTCCAAGAAG-1_V12D07-335_B1,1,0,3,0,0,4
AAAGTGCCATCAATTA-1_V12D07-335_B1,1,0,0,0,0,1
GTTGCAGTCGACAACA-1_V12D07-335_B1,2,0,0,0,0,2
TAAATGGGCTACTGAG-1_V12D07-335_B1,0,0,3,0,0,3
GGACAAGCCATGATCG-1_V12D07-335_B1,0,0,0,0,0,0
TCCAATGCGTCGCCGC-1_V12D07-335_B1,0,0,0,0,0,0
AAAGAATGACCTTAGA-1_V12D07-335_B1,0,0,0,0,0,0
CCTATTATTCCGGCCG-1_V12D07-335_B1,0,0,0,0,0,0
CAGTAAGGGACGTCTC-1_V12D07-335_B1,0,0,0,0,0,0
GGGATGGACCCGCGTC-1_V12D07-335_B1,0,0,0,0,0,0
GACGCATACCCGTCGG-1_V12D07-335_B1,0,0,0,0,0,0
GGGCAGGATTTCTGTG-1_V12D07-335_B1,0,0,0,0,0,0
TATCTGAGCCGATATT-1_V12D07-335_B1,0,0,0,0,0,0
AATGTATGGCACTGTA-1_V12D07-335_B1,0,1,2,0,0,3
GCCTTTGTCAGTGGAC-1_V12D07-335_B1,1,0,2,0,0,3
AACCATAGGGTTGAAC-1_V12D07-335_B1,0,0,5,0,0,5
AAACTTAATTGCACGC-1_V12D07-335_B1,0,2,5,0,1,8
TAGGCGGCTGCAAAGA-1_V12D07-335_B1,1,0,0,0,0,1
TCCATCAATACTAATC-1_V12D07-335_B1,1,1,1,0,0,3
ACCTCGAACTTATGCT-1_V12D07-335_B1,1,0,0,0,0,1
ACAAACCATGCGTCCT-1_V12D07-335_B1,0,0,1,0,0,1
ACACCGGTCTGACCGC-1_V12D07-335_B1,0,0,4,0,0,4
ATGGCAGCATTACGAT-1_V12D07-335_B1,0,2,2,0,0,4
CTGGTGAATGGGCCTA-1_V12D07-335_B1,0,1,5,0,0,6
CACAGAGACGAGGACG-1_V12D07-335_B1,0,1,4,0,0,5
GCACAAACCCTAGATG-1_V12D07-335_B1,0,1,4,0,0,5
ACTATGTCCAGCTGCC-1_V12D07-335_B1,0,1,1,0,0,2
AAGCCGCCGTGAAATC-1_V12D07-335_B1,1,2,3,0,0,6
ATGGGTGTATACCTCC-1_V12D07-335_B1,0,0,1,0,0,1
TAAGCGCGAATCAAAT-1_V12D07-335_B1,0,0,4,0,0,4
AGCCCGGCATTAGAGG-1_V12D07-335_B1,0,0,1,0,0,1
GTGATCAAGCGTGCAC-1_V12D07-335_B1,1,0,1,0,0,2
CTGCCTTTAATACCTT-1_V12D07-335_B1,0,1,2,0,0,3
TACCTCCACACCAATG-1_V12D07-335_B1,0,0,2,0,0,2
GAGCATCAACAACTTG-1_V12D07-335_B1,1,0,1,0,0,2
CATACGAACTAGCTGG-1_V12D07-335_B1,1,0,1,0,0,2
GGGAACGGTTTCAGAT-1_V12D07-335_B1,0,0,0,0,0,0
AGGGTGCCGTTCTTTA-1_V12D07-335_B1,1,1,1,0,0,3
ACGACTGGTCATACTC-1_V12D07-335_B1,0,0,1,0,0,1
GGATCTTACTGCCCTT-1_V12D07-335_B1,0,2,1,0,0,3
TACTCCTCTAGTTGAC-1_V12D07-335_B1,0,1,4,0,0,5
GTAGCTCCGGGAGGCT-1_V12D07-335_B1,3,1,1,0,0,5
GGACTCGTGAGTGGTC-1_V12D07-335_B1,0,0,2,0,0,2
GTAGTTCGAAGGCGAA-1_V12D07-335_B1,0,0,3,0,0,3
CTCAAACCACTGCCCG-1_V12D07-335_B1,1,0,3,0,0,4
GAGGGAGTCAGATCGC-1_V12D07-335_B1,1,0,2,0,0,3
GCGTCCCTAAGACATA-1_V12D07-335_B1,0,0,1,1,0,2
TCTCTTACCGCGAACC-1_V12D07-335_B1,0,0,1,0,0,1
GGCTACTATACACTCC-1_V12D07-335_B1,0,1,1,0,0,2
CGTTGCCCGCGTGGGA-1_V12D07-335_B1,1,1,0,0,0,2
TATAGAGTCGCTTGAA-1_V12D07-335_B1,3,1,1,0,0,5
ATGTTGTAGTCTGTTT-1_V12D07-335_B1,0,0,0,1,0,1
AGTATACACAGCGACA-1_V12D07-335_B1,1,0,1,0,0,2
TGTGGTTGCTAAAGCT-1_V12D07-335_B1,0,0,1,0,0,1
TGATTCCCGGTTACCT-1_V12D07-335_B1,0,2,1,0,0,3
CACTGACGATTGTGGA-1_V12D07-335_B1,0,0,1,0,0,1
AACATTGTGACTCGAG-1_V12D07-335_B1,1,0,4,0,0,5
GTCCAATATTTAGCCT-1_V12D07-335_B1,0,1,2,0,0,3
GCTCTTTCCGCTAGTG-1_V12D07-335_B1,0,0,0,0,0,0
GGGTCAGGAGCTAGAT-1_V12D07-335_B1,0,2,2,0,0,4
AGGTGGTGACCTTCGC-1_V12D07-335_B1,0,0,1,0,0,1
CCCGGGTCGTTCAGGG-1_V12D07-335_B1,0,1,3,0,0,4
AGCCAAGCTTTGTGTC-1_V12D07-335_B1,1,0,4,0,0,5
TGTGGCGGGCTTCTGG-1_V12D07-335_B1,1,0,5,0,0,6
CGAGGGTATCCAGGTG-1_V12D07-335_B1,0,0,3,0,0,3
CGTTCAGACCCGCGAA-1_V12D07-335_B1,1,1,0,0,0,2
TCATATGAGCTTTGTT-1_V12D07-335_B1,0,2,1,0,0,3
AGTTGACGGTCCTTGC-1_V12D07-335_B1,0,0,2,0,0,2
ATAATTAGCTAAGTAG-1_V12D07-335_B1,0,0,5,0,0,5
GGTCTTGAGCGCTCTT-1_V12D07-335_B1,0,0,1,0,0,1
CGTTGTCGGCAATTGA-1_V12D07-335_B1,0,0,2,0,0,2
TCTTGCTCCCGATACT-1_V12D07-335_B1,0,0,2,0,0,2
AGCAGAAGGAGAAAGA-1_V12D07-335_B1,0,0,1,0,0,1
GAAGCCACTGATTATG-1_V12D07-335_B1,0,1,2,0,0,3
TGCTCTTGAGAGTTTG-1_V12D07-335_B1,0,0,1,0,0,1
GACATCCGTCGAACTG-1_V12D07-335_B1,1,0,3,0,0,4
AGATATAATACGACTA-1_V12D07-335_B1,0,0,1,0,0,1
TCGCTACTGGCTTTGA-1_V12D07-335_B1,1,1,2,0,0,4
GTGACAGCTTCCCACT-1_V12D07-335_B1,0,1,3,0,0,4
GTGACGCAGGTTTCAT-1_V12D07-335_B1,0,0,3,0,0,3
GGGAAGACGGTCTGTC-1_V12D07-335_B1,0,0,3,0,0,3
CGTCGCATGTGAGCCA-1_V12D07-335_B1,0,0,3,0,0,3
AGAAGGTTGTAGGTCG-1_V12D07-335_B1,0,0,4,0,0,4
GGCCGGCGTCTGCTAT-1_V12D07-335_B1,0,0,2,0,0,2
TTGACCAGGAACAACT-1_V12D07-335_B1,0,0,3,0,0,3
AGTCGTATAAAGCAGA-1_V12D07-335_B1,3,0,2,0,0,5
GGCGTAGGGAAAGCTG-1_V12D07-335_B1,3,2,0,0,0,5
AAACCTAAGCAGCCGG-1_V12D07-335_B1,1,2,1,0,0,4
ATTGCCTTTATGTTTG-1_V12D07-335_B1,1,2,2,0,0,5
CAGGCAGTCTTACCAG-1_V12D07-335_B1,0,0,0,0,0,0
AGCTAAGTACGCAGGC-1_V12D07-335_B1,2,0,1,0,0,3
AAATCCGATACACGCC-1_V12D07-335_B1,0,1,2,0,0,3
CGAGAGCTTTCACTAC-1_V12D07-335_B1,0,1,3,0,0,4
CGCCCAGCGTTTCACG-1_V12D07-335_B1,2,0,3,0,0,5
TTAAGTATTGTTATCC-1_V12D07-335_B1,0,0,2,0,0,2
AAACGGGCGTACGGGT-1_V12D07-335_B1,0,1,3,0,0,4
GTATCCTTTGGTAACC-1_V12D07-335_B1,2,1,4,0,0,7
CATAGTCAAATACATA-1_V12D07-335_B1,1,1,5,0,0,7
TCTATGCTATAACGAC-1_V12D07-335_B1,2,0,1,0,0,3
ACGTTCTGTACAAGTC-1_V12D07-335_B1,0,0,2,0,0,2
CGCGAAGTGGCATACT-1_V12D07-335_B1,0,0,0,0,0,0
ACCAACCGCACTCCAC-1_V12D07-335_B1,3,0,0,0,0,3
GTCATGCGCGAGGGCT-1_V12D07-335_B1,2,1,0,0,0,3
TAGGCTAAAGTGGCAC-1_V12D07-335_B1,0,0,1,0,0,1
TGGCTACACTCTACCT-1_V12D07-335_B1,2,0,1,0,0,3
TGTCCACGGCTCAACT-1_V12D07-335_B1,0,0,0,0,0,0
AATTGCAGCAATCGAC-1_V12D07-335_B1,0,0,0,0,0,0
GTCAACCAGGCCTATA-1_V12D07-335_B1,1,0,3,0,0,4
ATCTTATCGCACACCC-1_V12D07-335_B1,0,0,5,0,0,5
GTCTATTGCATGCTCG-1_V12D07-335_B1,0,0,3,0,0,3
GCACGTGGTTTACTTA-1_V12D07-335_B1,0,0,3,0,0,3
ATTCGCGCCTTGAGAG-1_V12D07-335_B1,1,0,0,0,0,1
AGCGATGCGCCTAATA-1_V12D07-335_B1,2,0,3,0,0,5
TCTATAGGTGGGTAAT-1_V12D07-335_B1,0,0,1,0,0,1
AGATACCAATAGAACC-1_V12D07-335_B1,0,0,0,0,0,0
CGTGTATGGGAGCTGA-1_V12D07-335_B1,0,0,0,0,0,0
ATGTACATGCGGTGAG-1_V12D07-335_B1,1,0,1,0,0,2
TTGGCTCAATATGTGT-1_V12D07-335_B1,1,0,4,0,0,5
GTTCGGAGCACTCAAC-1_V12D07-335_B1,1,0,0,0,0,1
TCCCTCTTCTCAAGGG-1_V12D07-335_B1,1,0,2,0,0,3
TTACGTATCTATGACA-1_V12D07-335_B1,0,0,5,0,0,5
CCCATATAGGTCGATT-1_V12D07-335_B1,1,0,1,0,0,2
GTCCACGTCGCATTCG-1_V12D07-335_B1,0,0,2,0,0,2
AATTGTGGTTGCCAAA-1_V12D07-335_B1,1,0,2,0,0,3
AGGAACGAACGACTTC-1_V12D07-335_B1,1,0,0,0,0,1
TAATTCCAATGCTTCA-1_V12D07-335_B1,1,0,1,0,0,2
AGGGCCCTAATGTTCT-1_V12D07-335_B1,0,0,0,0,0,0
AGGTGTTGCCGACCAC-1_V12D07-335_B1,2,0,4,0,0,6
CTGAGAGTAGAAATAC-1_V12D07-335_B1,0,0,1,0,0,1
TAGAAGAAGGGTTACA-1_V12D07-335_B1,0,0,3,0,0,3
GGTGACTGATAGAGAG-1_V12D07-335_B1,0,0,2,0,0,2
TACCCTCGGTAACCCT-1_V12D07-335_B1,3,0,0,0,0,3
TGTAAGACTGATAAGA-1_V12D07-335_B1,0,0,0,0,0,0
GTCACTCATGAGCGAT-1_V12D07-335_B1,0,0,0,0,0,0
CGGTTTACTGAACATT-1_V12D07-335_B1,0,0,0,0,0,0
GAGATCGATCTTACTC-1_V12D07-335_B1,0,0,0,0,0,0
TCTTTCATCCGTCCTT-1_V12D07-335_B1,0,0,0,0,0,0
TCGGATCTGGATGACC-1_V12D07-335_B1,0,0,0,0,0,0
GTCCTAGGATACCTTA-1_V12D07-335_B1,0,0,0,0,0,0
TGTACCCGACCCTAAT-1_V12D07-335_B1,0,0,0,0,0,0
AGGTTCTCCTTTCCGG-1_V12D07-335_B1,1,0,2,0,0,3
AATTGCGTGGATTACA-1_V12D07-335_B1,1,0,1,0,0,2
CGATAGCGATACAGTG-1_V12D07-335_B1,2,1,2,0,0,5
CGCCCTAATTGTTCAA-1_V12D07-335_B1,0,1,5,0,0,6
ATTATGAGACCCAATT-1_V12D07-335_B1,0,0,4,0,0,4
CCTCCTAGCTAGAGTC-1_V12D07-335_B1,1,3,1,0,0,5
CGAAGGGTTTCAGATT-1_V12D07-335_B1,0,1,3,0,0,4
CACAAGCTAAGAAAGG-1_V12D07-335_B1,0,0,3,1,0,4
CACCGGTAGAGACATT-1_V12D07-335_B1,1,0,1,0,0,2
ACTCATGGCAGCCTTC-1_V12D07-335_B1,0,0,1,0,0,1
CATCCAATATAGTTTG-1_V12D07-335_B1,0,0,2,0,0,2
CAGATATGAAGATGAC-1_V12D07-335_B1,0,4,2,0,0,6
GCAAAGGGCGTTAGCC-1_V12D07-335_B1,0,0,1,0,0,1
CTGTTGTTCAGTCGTA-1_V12D07-335_B1,0,1,2,0,0,3
AAAGGCCCTATAATAC-1_V12D07-335_B1,1,0,2,0,0,3
AACATTGAAGTTGATC-1_V12D07-335_B1,0,1,4,0,0,5
GCTAGCGATAGGTCTT-1_V12D07-335_B1,0,0,3,0,0,3
ATTGCCTATTAGACCG-1_V12D07-335_B1,0,1,3,0,0,4
GGGCGTTTACATTCAT-1_V12D07-335_B1,0,3,2,0,0,5
CCTCTACAAGGATTGG-1_V12D07-335_B1,0,2,1,0,0,3
AGTGACTGTGACACAA-1_V12D07-335_B1,0,4,3,0,0,7
AGCCCTCCCTGGTGGC-1_V12D07-335_B1,0,1,2,0,0,3
CGGTTGAGTATCCTTC-1_V12D07-335_B1,0,1,1,0,0,2
CATTATCCCATTAACG-1_V12D07-335_B1,0,2,2,0,0,4
AATGTGCTAATCTGAG-1_V12D07-335_B1,1,0,1,0,0,2
CTTAGTTGAGGAATCG-1_V12D07-335_B1,0,0,2,0,0,2
CTTCTGGGCGTACCTA-1_V12D07-335_B1,0,0,2,0,0,2
AGTCAAATGATGTGAT-1_V12D07-335_B1,4,2,0,0,0,6
TGAACAAGCAGGGACT-1_V12D07-335_B1,0,0,2,0,0,2
AATACCGGAGGGCTGT-1_V12D07-335_B1,0,0,1,0,0,1
GTTTGGTGATCGGTGC-1_V12D07-335_B1,1,2,0,0,0,3
GACTGCTGGTGAGAAA-1_V12D07-335_B1,0,1,1,0,0,2
CGATCCTCGCAACATA-1_V12D07-335_B1,1,0,1,0,0,2
CCAACCTTATGTAACT-1_V12D07-335_B1,0,1,0,0,0,1
CGTGGTACCCAAAGGC-1_V12D07-335_B1,0,0,4,0,0,4
AACCCGACAACCCGTG-1_V12D07-335_B1,0,2,1,0,0,3
TATGTAAAGTGCTTAA-1_V12D07-335_B1,0,0,3,0,0,3
GCAAGTGTAAAGCATG-1_V12D07-335_B1,0,3,4,0,0,7
GTAACTGCCCAAGGAG-1_V12D07-335_B1,2,3,3,0,0,8
GGTGCATAAATGATTA-1_V12D07-335_B1,1,0,0,0,0,1
TAGTCCCGGAGACCAC-1_V12D07-335_B1,0,0,1,0,0,1
CGGCCAGAGCGACCAT-1_V12D07-335_B1,0,0,5,0,0,5
TGAATGAGTGTTTCCC-1_V12D07-335_B1,1,0,1,0,0,2
TTCACTTCCTAGAACG-1_V12D07-335_B1,0,1,1,0,0,2
CGCTTAGTATTGATAC-1_V12D07-335_B1,2,0,3,0,0,5
AACGCGACCTTGGGCG-1_V12D07-335_B1,0,0,2,0,0,2
GTGCACCAGCTTCAAC-1_V12D07-335_B1,1,2,2,0,0,5
TTCTATTAAACGCAGC-1_V12D07-335_B1,0,0,2,0,0,2
TGGCAAGCACAAGTCG-1_V12D07-335_B1,0,2,2,0,0,4
ATCTGCTGTTATCGCC-1_V12D07-335_B1,0,1,3,0,0,4
AATTCCAAGCATGTAC-1_V12D07-335_B1,0,0,0,0,0,0
AAACGGTTGCGAACTG-1_V12D07-335_B1,1,1,3,0,0,5
GAAGGAGTCGAGTGCG-1_V12D07-335_B1,0,0,2,0,0,2
GGCAAGCCCATAGTGG-1_V12D07-335_B1,0,4,3,0,0,7
TGACCAAATCTTAAAC-1_V12D07-335_B1,1,0,0,0,0,1
TTCGGTACTGTAGAGG-1_V12D07-335_B1,0,0,2,0,0,2
ATGTACGATGACGTCG-1_V12D07-335_B1,1,0,3,0,0,4
ATCTAGCTTGTGAGGG-1_V12D07-335_B1,0,0,1,0,0,1
AGCGGGTCTGACACTC-1_V12D07-335_B1,2,0,3,0,0,5
GAGGTACGCGTGTCCC-1_V12D07-335_B1,3,0,0,0,0,3
GCACTGCCTACCTTTA-1_V12D07-335_B1,0,1,1,0,0,2
GGAGCGAGGCCTACTT-1_V12D07-335_B1,0,0,1,0,0,1
AAACTCGGTTCGCAAT-1_V12D07-335_B1,2,1,1,1,0,5
GGCGCTTCATTCCCTG-1_V12D07-335_B1,2,0,0,0,0,2
TGCTCGGTGGGTCACC-1_V12D07-335_B1,0,0,3,0,0,3
AAGCGCAGGGCTTTGA-1_V12D07-335_B1,1,1,1,0,0,3
GACCTTCCACGTCTAC-1_V12D07-335_B1,1,0,0,0,0,1
GTTAGCCCATGACATC-1_V12D07-335_B1,1,0,1,0,0,2
AATTCGATTCGAGGAT-1_V12D07-335_B1,0,2,0,0,0,2
AGTCTTTAAAGTGTCC-1_V12D07-335_B1,0,0,0,0,0,0
GACTAGGCCGTTAGGT-1_V12D07-335_B1,1,0,1,1,0,3
TCCAAGCCTAGACACA-1_V12D07-335_B1,0,0,1,0,0,1
GATTGGGAAAGGTTGT-1_V12D07-335_B1,0,0,3,0,0,3
GATGAGGAACCTTCGG-1_V12D07-335_B1,0,1,0,0,0,1
TGAATACCGACGCGTA-1_V12D07-335_B1,0,2,2,0,0,4
AATCGTGAGCCGAGCA-1_V12D07-335_B1,2,0,1,0,0,3
GCGAAGAATCTGACGG-1_V12D07-335_B1,1,1,1,0,0,3
GAACAACTGGGATGAA-1_V12D07-335_B1,0,0,1,0,0,1
TCGCCGACATATTCGC-1_V12D07-335_B1,0,1,0,0,0,1
CGTAGAGAGTAATTAT-1_V12D07-335_B1,2,1,0,0,0,3
CGATAGTCGTACTGCA-1_V12D07-335_B1,0,0,1,0,0,1
CGCATGCCGAATGCGT-1_V12D07-335_B1,0,0,1,0,0,1
CTCTAGCCCTCGGAAA-1_V12D07-335_B1,2,0,3,0,0,5
TCCAACTCAGCTATCT-1_V12D07-335_B1,1,1,2,0,0,4
GTCTAGTGAGCCGCTT-1_V12D07-335_B1,0,1,2,0,0,3
TACCGAATAATTGTAA-1_V12D07-335_B1,0,0,4,0,0,4
ATATAACACGGGCGCA-1_V12D07-335_B1,2,0,2,0,0,4
GCATGCTAATAACGAT-1_V12D07-335_B1,0,0,2,0,0,2
TCCGGGCTTGACGGGA-1_V12D07-335_B1,0,1,2,0,0,3
ATTATTCAGAGTCACT-1_V12D07-335_B1,0,0,3,0,0,3
TAGCAGTATGACTAAA-1_V12D07-335_B1,1,0,2,0,0,3
TATGAAGAATTAAGGT-1_V12D07-335_B1,0,0,0,0,0,0
CAAGGCCAGTGGTGCA-1_V12D07-335_B1,1,0,1,0,0,2
TGCGTACGGCTAATTG-1_V12D07-335_B1,0,0,2,0,0,2
CAGATAATGGGCGGGT-1_V12D07-335_B1,2,0,1,0,0,3
GAGAACGGTTCTGACT-1_V12D07-335_B1,1,0,0,0,0,1
CGCTTCGGTCTAAGAC-1_V12D07-335_B1,0,0,0,0,0,0
AGCATTACGAGGCAAG-1_V12D07-335_B1,2,0,0,0,0,2
AAGTTGTGATGTTATA-1_V12D07-335_B1,2,0,1,0,0,3
TTGCTCATAGTACGTG-1_V12D07-335_B1,0,0,0,0,0,0
TACTTAAACATGTACA-1_V12D07-335_B1,0,0,0,0,0,0
AGTGAGTCGAATTAAC-1_V12D07-335_B1,1,0,0,0,0,1
TAGGCCTATATAGTCT-1_V12D07-335_B1,0,0,0,0,0,0
ACTCGCCGTTCGATAA-1_V12D07-335_B1,0,0,2,0,0,2
GGTACGTTGCGGCCGG-1_V12D07-335_B1,1,0,1,0,0,2
TATTGCCGGGCTTGTA-1_V12D07-335_B1,0,0,6,0,0,6
GGTAAACTCTGCGCTG-1_V12D07-335_B1,0,0,0,0,0,0
TCCCTTGTCTGAAACT-1_V12D07-335_B1,0,0,0,0,0,0
CATGATCGCTTTGAGA-1_V12D07-335_B1,2,0,1,0,0,3
GAGAGGCCTATGTGTA-1_V12D07-335_B1,0,0,1,0,0,1
CGTATCTAGAACTAAG-1_V12D07-335_B1,0,0,0,0,0,0
GCACCTTCCCGAAGGT-1_V12D07-335_B1,0,0,0,0,0,0
TACCTCTTTACCATCC-1_V12D07-335_B1,0,0,0,0,0,0
TGACTCTAACTGGTAA-1_V12D07-335_B1,0,0,0,0,0,0
GAGAAACTGGATCCCA-1_V12D07-335_B1,2,0,0,0,0,2
ATCCGGACCAGCCTGA-1_V12D07-335_B1,0,0,0,0,0,0
TTATTTAGGTTCCTTA-1_V12D07-335_B1,1,0,1,0,0,2
CGAATTCCCGGTTCAA-1_V12D07-335_B1,0,0,0,0,0,0
TAGTTTGATCGGTCGC-1_V12D07-335_B1,0,0,0,0,0,0
AGTCGAAACGATTCAG-1_V12D07-335_B1,0,0,0,0,0,0
ACGTCGGGCAACTCGG-1_V12D07-335_B1,0,0,0,0,0,0
ACTTGCTCTATCTACC-1_V12D07-335_B1,0,0,0,0,0,0
ATTACGGGCTACGGTT-1_V12D07-335_B1,0,0,0,0,0,0
GCAAACGTAAGCGACC-1_V12D07-335_B1,0,0,0,0,0,0
TTCGGACTGGGCATGG-1_V12D07-335_B1,0,0,0,0,0,0
GGGCCATTCGTGCTGG-1_V12D07-335_B1,0,2,2,0,0,4
GAGTTGTCACCAGTCT-1_V12D07-335_B1,0,2,1,2,0,5
AGTAATTTGCAAGCGT-1_V12D07-335_B1,0,9,7,2,0,18
GTGGCCGGTTTCTCGG-1_V12D07-335_B1,0,1,3,3,0,7
ATCTTAGGGCATTAAT-1_V12D07-335_B1,0,6,8,0,0,14
CTACATATCGCGGGAC-1_V12D07-335_B1,0,0,15,1,0,16
ATGGTATTTACTGATT-1_V12D07-335_B1,0,3,8,0,0,11
CCGTCAACCTCTGGCG-1_V12D07-335_B1,0,4,7,3,0,14
GCTTCGACGTTCAATC-1_V12D07-335_B1,0,1,9,0,0,10
GACCGATTAAATATGT-1_V12D07-335_B1,0,4,4,0,0,8
GTCGAATTTGGGCGCT-1_V12D07-335_B1,0,1,5,0,0,6
TCACGGCCCAAGAGAG-1_V12D07-335_B1,0,1,4,1,0,6
CTACGATCCTATCCTA-1_V12D07-335_B1,0,1,7,0,0,8
TGCAGTGGTAGGGAAC-1_V12D07-335_B1,0,1,1,1,0,3
TTGCCTAATCCAAAGT-1_V12D07-335_B1,0,2,5,0,0,7
AGCGAGACGTGAAGGC-1_V12D07-335_B1,0,7,2,0,0,9
TTCTACCTCAATCGGT-1_V12D07-335_B1,0,1,10,1,0,12
TACGCTGCTGTGTTAA-1_V12D07-335_B1,0,4,0,0,0,4
TAGTCCTGCACTAAGC-1_V12D07-335_B1,0,6,6,0,0,12
AGCACACGTTTAGACT-1_V12D07-335_B1,0,6,0,0,0,6
GTTCGACAATTGTATA-1_V12D07-335_B1,0,6,5,1,0,12
CCATGTTCATCTATAT-1_V12D07-335_B1,0,2,0,0,0,2
CCCTCGATAATACACA-1_V12D07-335_B1,0,2,7,2,0,11
ACTGCCCGCCATTCTC-1_V12D07-335_B1,0,1,1,0,0,2
CTATATCCAGCCTGGC-1_V12D07-335_B1,0,1,2,3,0,6
CGCACGTCTGTTTATG-1_V12D07-335_B1,0,3,1,1,0,5
AATCAGGTTTCATTTA-1_V12D07-335_B1,0,2,5,1,0,8
AGAGAAACACCAGAAA-1_V12D07-335_B1,0,1,4,0,0,5
ACCCGATTGGTTCCGA-1_V12D07-335_B1,0,0,3,1,0,4
TACCAGGAATCCCGTC-1_V12D07-335_B1,0,0,4,0,0,4
AAGTGCTTCTCTATTG-1_V12D07-335_B1,0,2,4,1,0,7
TGCATGTGACCCATAG-1_V12D07-335_B1,0,3,2,0,0,5
TAGATTCAAAGTGCGG-1_V12D07-335_B1,0,3,5,1,0,9
AGGGTCAGAGCACTCG-1_V12D07-335_B1,1,0,0,0,0,1
GTGAGATAACCTTATA-1_V12D07-335_B1,0,7,1,0,0,8
GTGTCAGTGTACGTGG-1_V12D07-335_B1,0,0,2,0,0,2
CTGTAGTGAGGATCGA-1_V12D07-335_B1,0,2,3,0,0,5
GATAGTGCGAGTAAGT-1_V12D07-335_B1,1,1,1,0,0,3
AGGGTTCAGACGGTCC-1_V12D07-335_B1,0,4,1,0,0,5
GGACTCGACAGCGCAT-1_V12D07-335_B1,1,1,0,0,0,2
CACTCTCAAGCATCGA-1_V12D07-335_B1,0,2,0,0,0,2
GAGCGGAATGCGGTGT-1_V12D07-335_B1,0,0,1,1,0,2
CAGTTCGAGGACCCGA-1_V12D07-335_B1,0,0,2,0,0,2
CGTAACTTCGACACTT-1_V12D07-335_B1,2,1,1,0,0,4
TGATCACCACACTGAC-1_V12D07-335_B1,0,1,0,0,0,1
CATACTTCTTTCTCCG-1_V12D07-335_B1,1,1,1,0,0,3
CAAGTAAGTGATAGAC-1_V12D07-335_B1,2,1,1,0,0,4
AGCCCGCAACAAGCAG-1_V12D07-335_B1,0,0,1,0,0,1
GCTCCATGCAAAGCAA-1_V12D07-335_B1,1,0,1,0,0,2
TCGTACCGACGTCAAG-1_V12D07-335_B1,0,0,2,0,0,2
ATTATCGGAATGTACG-1_V12D07-335_B1,0,0,2,0,0,2
ACCTACTATAAATCTA-1_V12D07-335_B1,0,0,2,0,0,2
TATCCTATCAACTGGT-1_V12D07-335_B1,0,0,1,0,0,1
GCGCGGTCTAGTAACT-1_V12D07-335_B1,0,1,0,0,0,1
CCTTCGTATAGAATCC-1_V12D07-335_B1,0,0,0,0,0,0
TGGGCGATACAATAAG-1_V12D07-335_B1,0,0,1,0,0,1
TGACATGTAACGTGAC-1_V12D07-335_B1,0,1,3,0,0,4
TTGGGAAGACGAGCCG-1_V12D07-335_B1,0,2,0,0,0,2
GGTGTAAATCGATTGT-1_V12D07-335_B1,0,6,0,0,0,6
GAACTGTGGAGAGACA-1_V12D07-335_B1,0,1,4,0,0,5
TCCACATCGTATATTG-1_V12D07-335_B1,1,0,1,0,0,2
CCTATGGTCAAAGCTG-1_V12D07-335_B1,0,1,1,0,0,2
TCCTTGTCCTTTAATT-1_V12D07-335_B1,0,0,2,0,0,2
AAGTTTATGGGCCCAA-1_V12D07-335_B1,0,1,3,0,0,4
GTCCGGGTTCACATTA-1_V12D07-335_B1,1,0,1,0,0,2
ATGTAGCGCGCGTAGG-1_V12D07-335_B1,0,1,2,0,0,3
TACGGAAGCCAAACCA-1_V12D07-335_B1,0,0,3,0,0,3
GCCCTGAGGATGGGCT-1_V12D07-335_B1,0,0,4,0,0,4
CGGGCGATGGATCACG-1_V12D07-335_B1,0,1,1,0,0,2
TGCGGACTTGACTCCG-1_V12D07-335_B1,0,3,4,0,0,7
TAATACTAGAACAGAC-1_V12D07-335_B1,0,0,3,0,0,3
TCGCTGCCAATGCTGT-1_V12D07-335_B1,1,0,2,0,0,3
TACGTGGGCCCAGGGC-1_V12D07-335_B1,0,1,1,0,0,2
GCCTACGTTCTGTGCA-1_V12D07-335_B1,0,4,2,0,0,6
TTGCGTGTGTAGGCAT-1_V12D07-335_B1,0,0,0,0,0,0
TCCTAAAGATTCAGAC-1_V12D07-335_B1,1,2,4,0,0,7
TGGGTGCACAAGCCAT-1_V12D07-335_B1,0,0,1,0,0,1
GGGAGCGACCGTAGTG-1_V12D07-335_B1,0,1,2,0,0,3
CATAGAGGAGATACTA-1_V12D07-335_B1,0,1,3,0,0,4
CTTCGATTGCGCAAGC-1_V12D07-335_B1,0,1,1,0,0,2
GTGCCTGAGACCAAAC-1_V12D07-335_B1,1,1,1,0,0,3
TCATCCTCAGCTGCTT-1_V12D07-335_B1,0,1,1,0,0,2
TGCAACTACTGGTTGA-1_V12D07-335_B1,0,0,1,0,0,1
ATGTTGATTAGAGACT-1_V12D07-335_B1,1,0,2,0,0,3
GTTTCTAGAGGCGCGG-1_V12D07-335_B1,2,0,0,0,0,2
TACAAGGGCTTCTTTA-1_V12D07-335_B1,0,0,0,0,0,0
ACAGGCACGGATCCTT-1_V12D07-335_B1,0,0,2,0,0,2
CCCAAGTCATTACACT-1_V12D07-335_B1,0,1,2,0,0,3
ACTCTGACCTAATAGA-1_V12D07-335_B1,0,0,1,0,0,1
GGATGGCTTGAAGTAT-1_V12D07-335_B1,2,0,2,0,0,4
ACCCTCCCGTCAGGGC-1_V12D07-335_B1,3,0,2,0,0,5
AGCTTCTTCTCGAGCA-1_V12D07-335_B1,1,0,1,0,0,2
TTGCGCTTGATCAATA-1_V12D07-335_B1,0,0,1,0,0,1
TGGGTGTAATAGATTT-1_V12D07-335_B1,0,0,1,0,0,1
CATGGTTTATTAATCA-1_V12D07-335_B1,0,0,2,0,0,2
TTGCCTTCTCGCCGGG-1_V12D07-335_B1,1,0,0,0,0,1
TTAAAGTAAGTCGCCA-1_V12D07-335_B1,0,0,2,0,0,2
AGTTGGCAAGGCTAGA-1_V12D07-335_B1,1,0,0,0,0,1
CCGCACTTGCAATGAC-1_V12D07-335_B1,1,1,1,0,0,3
AATGTTGTCGTGAGAC-1_V12D07-335_B1,2,0,0,0,0,2
CCAAGGTTGCCCTTTC-1_V12D07-335_B1,0,1,1,0,0,2
TGTGACTAGAGTTTGC-1_V12D07-335_B1,2,0,1,0,0,3
TTGTGATCTGTTCAGT-1_V12D07-335_B1,0,0,1,0,0,1
GGAGTTGATTCTGTGT-1_V12D07-335_B1,0,0,1,0,0,1
GTAGTGAGCAACCTCA-1_V12D07-335_B1,1,0,2,0,0,3
AAGACATACGTGGTTT-1_V12D07-335_B1,0,0,0,0,0,0
CATCCCGAGATTCATA-1_V12D07-335_B1,2,0,0,0,0,2
GGCCGCAGGAACCGCA-1_V12D07-335_B1,1,0,0,0,0,1
AGGACATCGGCACACT-1_V12D07-335_B1,0,0,0,0,0,0
GACAAGACGCCCGTGC-1_V12D07-335_B1,0,0,0,0,0,0
GAGTAAATTAAGAACC-1_V12D07-335_B1,0,0,0,0,0,0
TAAGTCGGTGAGCTAG-1_V12D07-335_B1,0,0,0,0,0,0
CTTACTGACTCCTCTG-1_V12D07-335_B1,0,0,0,0,0,0
TTAACTGATCGTTTGG-1_V12D07-335_B1,0,0,0,0,0,0
GGGCGATCCATAGGCC-1_V12D07-335_B1,0,0,0,0,0,0
CGTATTGTTTGGCGCC-1_V12D07-335_B1,0,0,0,0,0,0
CGCGTGGGCCTGTGTT-1_V12D07-335_B1,0,0,0,0,0,0
AAATCTGCCCGCGTCC-1_V12D07-335_B1,0,0,0,0,0,0
GCTGAAGGGTTCTTGG-1_V12D07-335_B1,0,0,0,0,0,0
TAATTGCGCTGATTAC-1_V12D07-335_B1,0,0,0,0,0,0
TCGCGCGTTTACATGA-1_V12D07-335_B1,0,0,0,0,0,0
TAACTGAAATACGCCT-1_V12D07-335_B1,0,3,1,0,0,4
CCTGTCGTGTATGAAG-1_V12D07-335_B1,0,4,4,1,0,9
CGGGAACGCCCTGCAT-1_V12D07-335_B1,0,0,12,0,0,12
AGTTGCGGTCCTCAAC-1_V12D07-335_B1,0,2,10,0,0,12
GGGTCCTTGGAAGAAG-1_V12D07-335_B1,0,0,13,0,0,13
CGGGAAGTACCGTGGC-1_V12D07-335_B1,0,2,10,0,0,12
ACGGTCACCGAGAACA-1_V12D07-335_B1,0,3,6,0,0,9
TAGACTCAGTTGGCCT-1_V12D07-335_B1,0,0,9,0,0,9
CCTTCCGCAACGCTGC-1_V12D07-335_B1,0,0,14,0,0,14
CAGTGTTAATCTCTCA-1_V12D07-335_B1,0,1,9,0,0,10
CAGGCCAGTACCACCT-1_V12D07-335_B1,0,1,11,0,0,12
GATCGCTGTGGTGCGT-1_V12D07-335_B1,0,1,15,0,0,16
GTATCTCGGGCGCTTT-1_V12D07-335_B1,0,1,11,0,0,12
CCGGGCTAAGAATTTC-1_V12D07-335_B1,0,0,15,0,0,15
CTTCACGCCCTGGTAC-1_V12D07-335_B1,0,2,11,0,0,13
CGGATGAATGCTGTGA-1_V12D07-335_B1,0,0,9,0,0,9
CTCTGCAGGCATTCTT-1_V12D07-335_B1,0,2,9,0,0,11
TCAAAGTCACGGCGTC-1_V12D07-335_B1,0,0,10,0,0,10
TGGGTTTCGGGCGTAC-1_V12D07-335_B1,0,4,11,0,0,15
TGCTATGGCAAAGGGA-1_V12D07-335_B1,0,0,14,0,0,14
TTCACGGTCGTCACGT-1_V12D07-335_B1,0,0,16,0,0,16
CGTAAAGCAAGAAATC-1_V12D07-335_B1,0,0,10,0,0,10
CTGATCCCTTTATGCA-1_V12D07-335_B1,0,0,14,0,0,14
GAGTATACCCTAATCA-1_V12D07-335_B1,0,0,12,0,0,12
CCACGGCAGGTGTAGG-1_V12D07-335_B1,0,0,17,0,0,17
ACGTACTTTGGCACGG-1_V12D07-335_B1,0,1,13,0,0,14
CCTGAGAATAAATGCA-1_V12D07-335_B1,0,0,14,0,0,14
TTGATGCCGCTCGTCG-1_V12D07-335_B1,0,0,12,0,0,12
GCCAGGAAAGAACACT-1_V12D07-335_B1,0,1,9,0,0,10
TCCGACCGCTAATCAA-1_V12D07-335_B1,0,2,14,0,0,16
TATATCAAAGTGATCT-1_V12D07-335_B1,0,1,8,0,0,9
CCTCGGTTTCCTTGCC-1_V12D07-335_B1,0,2,4,0,0,6
TAAATTTAGTAACACC-1_V12D07-335_B1,0,0,9,0,0,9
CTCGTTACGGCTACCA-1_V12D07-335_B1,0,6,10,0,0,16
GCCGTCGGTTTCGGGC-1_V12D07-335_B1,0,0,15,0,0,15
GTTCCGTCCGCCTGCA-1_V12D07-335_B1,0,3,8,0,0,11
CTAGGGATAGGGACAA-1_V12D07-335_B1,0,0,11,0,0,11
GTCCAGGCACGTGTGC-1_V12D07-335_B1,0,2,11,0,0,13
GAGGAATATCTCTTTG-1_V12D07-335_B1,0,0,11,0,0,11
CGTTCAAGGAAACGGA-1_V12D07-335_B1,0,4,11,2,0,17
GTGGGAACAAACCGGG-1_V12D07-335_B1,0,0,8,0,0,8
GGGCACGTAGTACTGT-1_V12D07-335_B1,0,4,6,1,0,11
ACTACAAAGAGAGGTG-1_V12D07-335_B1,0,1,11,0,0,12
GGTGTAGGTAAGTAAA-1_V12D07-335_B1,0,5,3,3,0,11
CCTGTTCAACCTCGGG-1_V12D07-335_B1,0,0,6,0,0,6
TGAGGTGTGTGGCGGA-1_V12D07-335_B1,0,4,5,4,0,13
ATTGTCTGTTTCATGT-1_V12D07-335_B1,0,0,17,0,0,17
GCCGGTCGTATCTCTC-1_V12D07-335_B1,0,2,6,3,0,11
ATATGGGATAGCAACT-1_V12D07-335_B1,0,4,10,0,0,14
GATAGAACCCGCTAGG-1_V12D07-335_B1,0,1,6,1,0,8
ATCCCATTTCCGTGGG-1_V12D07-335_B1,0,3,9,0,0,12
GATGCTACCTTCGATG-1_V12D07-335_B1,0,2,5,1,0,8
TGCAAAGTTCGTCTGT-1_V12D07-335_B1,0,2,12,1,0,15
GTTCAGTCGCCAAATG-1_V12D07-335_B1,0,2,5,0,0,7
GTCTCCGCCTCAATAC-1_V12D07-335_B1,0,2,7,0,0,9
AGTAGAAGGCGCCTCA-1_V12D07-335_B1,0,1,3,0,0,4
GTTGTAGATTTATGAG-1_V12D07-335_B1,0,5,5,2,0,12
CTATTTGCTTGGAGGA-1_V12D07-335_B1,0,4,0,0,0,4
AGCCATATAGTATGTG-1_V12D07-335_B1,0,7,2,2,0,11
TGTTCCGGCCTGAGCT-1_V12D07-335_B1,0,1,1,0,0,2
TGCCGTGGGACCCAAT-1_V12D07-335_B1,0,3,1,0,0,4
TTGCAAGAAGACTCCT-1_V12D07-335_B1,0,0,0,0,0,0
CCGCTCCAGGGCGATC-1_V12D07-335_B1,0,1,3,6,0,10
CAAACCCTCCGGCGGG-1_V12D07-335_B1,0,0,3,0,0,3
CGGACCTTTACGTCCC-1_V12D07-335_B1,0,0,5,5,0,10
ACGTAGGAGAGTCGCT-1_V12D07-335_B1,0,0,2,0,0,2
CTGCGACCTCGCCGAA-1_V12D07-335_B1,0,2,4,1,0,7
GGCCCAGCTGGTTTGC-1_V12D07-335_B1,0,1,2,0,0,3
GGATTAATCATGGACC-1_V12D07-335_B1,0,6,5,3,0,14
GAGATGGCTTTAATCA-1_V12D07-335_B1,0,3,0,0,0,3
AGTACAGAAGCTTATA-1_V12D07-335_B1,0,3,7,4,0,14
GCGGCTTTAGCAAGTT-1_V12D07-335_B1,0,2,2,0,0,4
ACCGAGTCTCCTTATT-1_V12D07-335_B1,0,1,5,2,0,8
CTCGTCTGTGCCTTCG-1_V12D07-335_B1,0,1,0,0,0,1
GGACTCTTTGACTAAG-1_V12D07-335_B1,0,1,5,0,0,6
TCATCGACGACCGTCG-1_V12D07-335_B1,2,0,1,0,0,3
TACTACGTGCAATGCG-1_V12D07-335_B1,0,0,2,0,0,2
CCCTACTTGAACAATG-1_V12D07-335_B1,1,0,0,0,0,1
GCAGCTGTCAACGCAT-1_V12D07-335_B1,0,1,1,0,0,2
ATCTACCATCTGCTCC-1_V12D07-335_B1,0,0,5,0,0,5
TCTCAAATCAATCGGG-1_V12D07-335_B1,0,0,2,0,0,2
ACTCCGGCCGACCACT-1_V12D07-335_B1,0,0,3,0,0,3
TACACCTCTTCGAATC-1_V12D07-335_B1,0,0,2,0,0,2
GTGGCTGTTTCTGTTC-1_V12D07-335_B1,1,0,1,0,0,2
ACGACTCTAGGGCCGA-1_V12D07-335_B1,0,1,3,0,0,4
TCGTTTACGCGACCCT-1_V12D07-335_B1,0,1,1,0,0,2
AGGATATCCGACTGCA-1_V12D07-335_B1,0,0,2,0,0,2
GACACTTCCAATTACC-1_V12D07-335_B1,1,0,1,0,0,2
ACGGTACAGTTCAATG-1_V12D07-335_B1,0,0,1,0,0,1
CTTGATGACCATCCAG-1_V12D07-335_B1,0,0,0,0,0,0
CTGGTAAAGACTTACA-1_V12D07-335_B1,0,1,2,0,0,3
CTTGCCCACCCACGCA-1_V12D07-335_B1,0,1,2,0,0,3
CATTACGCAGGAAGGG-1_V12D07-335_B1,0,1,1,0,0,2
GGACAACCATGAAGCC-1_V12D07-335_B1,0,0,0,0,0,0
GTTATCAAGCTATCGA-1_V12D07-335_B1,0,1,2,0,0,3
AGGTGCACGTCCACAT-1_V12D07-335_B1,0,0,0,0,0,0
AAAGAATGTGGACTAA-1_V12D07-335_B1,1,0,2,1,0,4
ACCAAGTCATCGGCAG-1_V12D07-335_B1,1,0,1,0,0,2
AGTAACTATAGCAGCC-1_V12D07-335_B1,0,0,2,0,0,2
GGGAAAGAATGCCAAC-1_V12D07-335_B1,0,0,0,0,0,0
AATCGGTATAGCCCTC-1_V12D07-335_B1,0,0,0,0,0,0
GGCACTGCGGTGGTTT-1_V12D07-335_B1,0,0,3,0,0,3
CGTCCTCATCGCGTGC-1_V12D07-335_B1,0,0,2,0,0,2
CTTAACTTACAGTATA-1_V12D07-335_B1,0,0,3,0,0,3
GTGAGTCGACTAATAG-1_V12D07-335_B1,1,1,3,0,0,5
TGTACTTCCGGGCATG-1_V12D07-335_B1,0,0,1,0,0,1
CACAAACCGCAGAACT-1_V12D07-335_B1,1,0,2,0,0,3
GCTTTACACAACTGGG-1_V12D07-335_B1,1,0,2,0,0,3
CAGAGCGATGGATGCT-1_V12D07-335_B1,0,0,2,0,1,3
CATAGTGGGCACGCCT-1_V12D07-335_B1,0,0,1,0,1,2
AAACGCTGGGCACGAC-1_V12D07-335_B1,0,0,2,0,3,5
TGTTCTCATACTATAG-1_V12D07-335_B1,0,0,0,0,1,1
TCCGCTGGGTCGATCG-1_V12D07-335_B1,0,0,0,0,0,0
TTAGCATCCCTCACGT-1_V12D07-335_B1,0,0,0,0,0,0
AGCCTTGTCACTGATA-1_V12D07-335_B1,0,0,0,0,0,0
GTTTCTTGTTAGAGCT-1_V12D07-335_B1,0,0,0,0,0,0
TCGGAGTCCTGGTTGC-1_V12D07-335_B1,0,0,0,0,0,0
ACGGGTTGTGACCTGT-1_V12D07-335_B1,0,0,0,0,0,0
TGACAGAAATCTTGCT-1_V12D07-335_B1,0,0,0,0,0,0
TAGCCATGATTGCCTA-1_V12D07-335_B1,0,0,5,0,0,5
CGAAGCCACAGCATGG-1_V12D07-335_B1,0,2,4,0,0,6
ACCCGTAGCAGAGAAT-1_V12D07-335_B1,0,0,0,0,0,0
AGCTTGATCAGGGTAG-1_V12D07-335_B1,0,5,2,0,0,7
CTATAAGTAGGGTTTG-1_V12D07-335_B1,0,1,0,0,0,1
TATAGTTAGGTGTACT-1_V12D07-335_B1,0,3,2,0,0,5
TACGCTGATAGTTGTA-1_V12D07-335_B1,0,0,0,0,0,0
TTCTCAATTGCTACAA-1_V12D07-335_B1,0,3,7,0,0,10
GTTGCCCTAACGGGTG-1_V12D07-335_B1,0,2,2,0,0,4
GACATTTCGCCCAGCC-1_V12D07-335_B1,0,5,9,0,0,14
GTAACTACGTAGACCT-1_V12D07-335_B1,0,4,1,0,0,5
CCAGTGTACAGACCGA-1_V12D07-335_B1,0,3,3,0,0,6
GCCCGATGCCCAGTTC-1_V12D07-335_B1,0,6,0,0,0,6
CGAACCTCTTTCCTAG-1_V12D07-335_B1,0,3,5,1,0,9
CATGCACATGAGAGGC-1_V12D07-335_B1,1,1,2,0,0,4
CCAAATCAAAGGGCAA-1_V12D07-335_B1,0,2,8,5,0,15
GTAGTTTAAGCACACG-1_V12D07-335_B1,0,3,2,0,0,5
TAAGTGAATAGTCTAC-1_V12D07-335_B1,0,2,6,0,0,8
GGTCCACGTCTATTTG-1_V12D07-335_B1,0,0,3,0,0,3
CCCTCAGATCGAGAAC-1_V12D07-335_B1,0,5,9,1,0,15
ACATTCGCGCGGAATA-1_V12D07-335_B1,0,5,1,0,0,6
CTATGAACACCTTGCC-1_V12D07-335_B1,0,5,7,2,0,14
CGAATGGTAGGTCGTC-1_V12D07-335_B1,0,3,2,0,0,5
TCGACATAGCGTAGCG-1_V12D07-335_B1,0,6,8,0,0,14
GACGTTGCTCGGCGGC-1_V12D07-335_B1,0,0,7,0,0,7
CTCGAGGCAAGTTTCA-1_V12D07-335_B1,0,6,6,0,0,12
GCTGGGAGCGCGTCAA-1_V12D07-335_B1,0,1,8,0,0,9
GACGATATCACTGGGT-1_V12D07-335_B1,0,2,8,0,0,10
CAGCTCTGGGCTCACT-1_V12D07-335_B1,0,2,9,0,0,11
TAGTCTGCGGCACATT-1_V12D07-335_B1,0,2,11,0,0,13
TGGTCGATATACCTCT-1_V12D07-335_B1,0,3,3,0,0,6
TTCAGTTCAAGAGGAG-1_V12D07-335_B1,0,0,9,0,0,9
GTCTGTAGGTTGAACA-1_V12D07-335_B1,0,1,7,0,0,8
GAGAGTCTCGGGAGAG-1_V12D07-335_B1,0,3,9,0,0,12
TTGTTTGTATTACACG-1_V12D07-335_B1,0,1,8,0,0,9
GCACAGCACGGGCCGA-1_V12D07-335_B1,0,1,8,0,0,9
AAACAGTGTTCCTGGG-1_V12D07-335_B1,0,0,16,0,0,16
TGGAGAATAATCGTCC-1_V12D07-335_B1,0,0,7,0,0,7
CGCCGCGTTCTGAACG-1_V12D07-335_B1,0,4,4,1,0,9
CATGCGTTGAGAGGAG-1_V12D07-335_B1,0,4,11,0,0,15
TACGCTCCTAGAACTG-1_V12D07-335_B1,0,7,8,1,0,16
CCTTGTGAACGTGGTT-1_V12D07-335_B1,0,1,11,0,0,12
TTAAAGGCGATGCTCG-1_V12D07-335_B1,0,4,4,0,0,8
TAAAGTGCACGTCTCG-1_V12D07-335_B1,0,1,10,0,0,11
TGTCCGCAAACAATTC-1_V12D07-335_B1,0,5,9,1,0,15
AGGCCTATCATACCAA-1_V12D07-335_B1,0,2,9,0,0,11
ACTGGGATGCCAGTGC-1_V12D07-335_B1,0,2,13,0,0,15
CGATCCACCATTGTTG-1_V12D07-335_B1,0,1,13,0,0,14
GGGCATGCATGTCGAG-1_V12D07-335_B1,0,1,8,0,0,9
TCCAGGCAGGACGATC-1_V12D07-335_B1,0,3,10,0,0,13
CAATGACCCTTAATTT-1_V12D07-335_B1,0,3,6,0,0,9
ATCAAGATCCCAGGAC-1_V12D07-335_B1,0,0,13,0,0,13
CTCAGAGCTAATGTCG-1_V12D07-335_B1,0,7,8,0,0,15
CTGCGATTTCGAGATT-1_V12D07-335_B1,0,0,11,0,0,11
ATGGTATTGGGAACCG-1_V12D07-335_B1,0,2,11,0,0,13
TAGGTTCTGCTGAGAA-1_V12D07-335_B1,0,0,15,0,0,15
GCCTGTCCCGGTGCAT-1_V12D07-335_B1,0,2,12,0,0,14
GGCCTGCTCTGATGTT-1_V12D07-335_B1,0,0,7,0,0,7
TAGAGGGAGTTTATCT-1_V12D07-335_B1,0,0,9,0,0,9
CTCTACATCCTGCGTG-1_V12D07-335_B1,0,0,12,0,0,12
ACACATTTCCGTAGAC-1_V12D07-335_B1,0,3,7,0,0,10
TGGGTGTTAAGTAGAA-1_V12D07-335_B1,0,7,6,0,0,13
GAGCTCAACATGAGCG-1_V12D07-335_B1,0,1,13,0,0,14
GCACACAGCTATTACC-1_V12D07-335_B1,0,5,12,0,0,17
GCGACGGTAGTCTCCT-1_V12D07-335_B1,0,4,11,0,0,15
GTATCAAGGTACTTCC-1_V12D07-335_B1,0,5,11,0,0,16
GGAAAGGGAATTGAGC-1_V12D07-335_B1,0,3,15,0,0,18
TACACAGCCGTGGTGC-1_V12D07-335_B1,0,5,9,0,0,14
CGGTTGGGCAGGGTCC-1_V12D07-335_B1,0,3,10,0,0,13
GCACGCCGATTCCCGC-1_V12D07-335_B1,0,2,12,0,0,14
CGCTTTCCGCCAAGGT-1_V12D07-335_B1,0,3,6,0,0,9
TGCCCGATAGTTAGAA-1_V12D07-335_B1,0,2,9,0,0,11
TCAGAACGGCGGTAAT-1_V12D07-335_B1,0,2,13,0,0,15
GGAAGGACACCGTATA-1_V12D07-335_B1,0,5,8,0,0,13
CGCGGGAATTCCTTTC-1_V12D07-335_B1,0,5,7,5,0,17
TCTATCCGATTGCACA-1_V12D07-335_B1,0,8,3,1,0,12
TACTCGTTTGAATCAA-1_V12D07-335_B1,0,2,4,9,0,15
GTCTGCCGACTCGACG-1_V12D07-335_B1,0,3,5,0,0,8
TACGGGTAATAACATA-1_V12D07-335_B1,0,2,7,0,0,9
CCAGTTCGGTAACTCA-1_V12D07-335_B1,0,7,4,0,0,11
CGTGCACACCACTGTA-1_V12D07-335_B1,0,4,2,1,0,7
CTTCAGTTGGACAACG-1_V12D07-335_B1,0,2,3,0,0,5
TGATCTATCACACTCT-1_V12D07-335_B1,0,1,2,1,0,4
TAGCAGATACTTAGGG-1_V12D07-335_B1,0,4,0,4,0,8
CACCGGGCATCACAAG-1_V12D07-335_B1,0,0,3,0,0,3
AGTGGCCCGCAAATGG-1_V12D07-335_B1,0,6,2,12,0,20
CTCGCTAGGTAAGCGA-1_V12D07-335_B1,0,2,3,0,0,5
GATAGATAGTACAGTC-1_V12D07-335_B1,0,1,2,2,0,5
CGAGACTACTGCTGCT-1_V12D07-335_B1,0,1,2,0,0,3
ACATTTGAAACCTAAC-1_V12D07-335_B1,0,5,5,4,0,14
GACACAGCCGGGACTG-1_V12D07-335_B1,0,0,1,0,0,1
ACGGAACACGAGTGCC-1_V12D07-335_B1,0,6,6,5,0,17
ACGCCAGTGCGTTTGC-1_V12D07-335_B1,0,1,4,0,0,5
GCACCTAGGCGAGTCC-1_V12D07-335_B1,0,1,4,0,0,5
TCACTATCCCTTCGGT-1_V12D07-335_B1,2,0,1,0,0,3
TGAGTGTAACAACGGG-1_V12D07-335_B1,1,2,1,0,0,4
ATTGGTTGTGCATTAC-1_V12D07-335_B1,0,0,5,0,0,5
CTGGCGATTTACATGT-1_V12D07-335_B1,1,0,3,0,0,4
TCCACCAAGACATAGG-1_V12D07-335_B1,0,0,1,0,0,1
AACGTCGCTGCACTTC-1_V12D07-335_B1,0,0,1,0,0,1
GTCTCCCGAGTCCCGT-1_V12D07-335_B1,0,0,2,0,0,2
AGCCCGCACTACAATG-1_V12D07-335_B1,1,0,2,0,0,3
GGCACGCTGCTACAGT-1_V12D07-335_B1,0,0,0,0,0,0
GCTTGAGTGACCTCTG-1_V12D07-335_B1,1,2,2,0,0,5
ATAGCCATAACAGTCA-1_V12D07-335_B1,0,1,4,0,0,5
TAGGAGGCTCGAGAAC-1_V12D07-335_B1,0,0,3,0,0,3
GTCGGGTGAAGTACCG-1_V12D07-335_B1,2,0,2,0,0,4
CACCCGCGTTTGACAC-1_V12D07-335_B1,0,0,1,0,0,1
ATCGCCGTGGTTCATG-1_V12D07-335_B1,0,0,0,0,0,0
CTGCTCTCAACACACC-1_V12D07-335_B1,1,1,3,0,0,5
GCATGACACAAAGGAA-1_V12D07-335_B1,0,0,3,0,0,3
CAACGATCGATCCAAT-1_V12D07-335_B1,0,0,2,0,0,2
ATACAGCGTCCACTGA-1_V12D07-335_B1,0,0,0,0,0,0
TCACGATTAATACGTT-1_V12D07-335_B1,0,0,0,0,0,0
CGTGAACTGACCCGAT-1_V12D07-335_B1,0,0,0,0,0,0
TCGATGTTACGGCCGT-1_V12D07-335_B1,0,0,0,0,0,0
GACCGGTGATACTCTC-1_V12D07-335_B1,0,0,0,0,0,0
TCTGTTTAGATTGTTC-1_V12D07-335_B1,0,0,0,0,0,0
GCTACTCGGACGCAGA-1_V12D07-335_B1,0,0,0,0,0,0
AAGAAAGTTTGATGGG-1_V12D07-335_B1,0,0,0,0,0,0
CGCCAGTAGTACCTTG-1_V12D07-335_B1,1,0,0,0,0,1
CTCCCTTGTATCAAGG-1_V12D07-335_B1,0,0,0,0,0,0
ACTTTATACACCACTT-1_V12D07-335_B1,0,0,0,0,0,0
AGATCTGGAGAGGATA-1_V12D07-335_B1,0,0,0,0,0,0
TCATCCATCTGATCAC-1_V12D07-335_B1,0,0,0,0,0,0
AGAACACGGCGATGGT-1_V12D07-335_B1,0,0,0,0,0,0
CCGCTCCGGATAAGCT-1_V12D07-335_B1,0,0,0,0,0,0
TGGTCGGGTACAGGGC-1_V12D07-335_B1,0,0,0,0,0,0
ACGGACGCAGCGACAA-1_V12D07-335_B1,0,0,0,0,0,0
ACATGCTTACGGCAGC-1_V12D07-335_B1,0,0,0,0,0,0
CAGGGAGATAGGCCAG-1_V12D07-335_B1,0,0,0,0,0,0
TCGCCACCCGGATTAC-1_V12D07-335_B1,0,0,0,0,0,0
TCTTGGTCAATGATAC-1_V12D07-335_B1,0,0,0,0,0,0
CATAGGGACACTTGTG-1_V12D07-335_B1,0,0,0,0,0,0
CACGAGCAAACCAGAC-1_V12D07-335_B1,0,0,0,0,0,0
GGGATATTGATCGCCA-1_V12D07-335_B1,0,0,0,0,0,0
TAATGTCGGTTCATGG-1_V12D07-335_B1,0,0,0,0,0,0
CGATTTGTCATTAATG-1_V12D07-335_B1,0,0,0,0,0,0
TTAAGATACCCAGAGA-1_V12D07-335_B1,0,0,0,0,0,0
CGACCGTTGGTATTCG-1_V12D07-335_B1,0,0,0,0,0,0
ACTACCATCCGAGGGC-1_V12D07-335_B1,0,0,0,0,0,0
TCTACGCACGATCTCC-1_V12D07-335_B1,0,0,0,0,0,0
AAGCCACTTGCAGGTA-1_V12D07-335_B1,0,0,0,0,0,0
ACGTTGTCGTTGAAAG-1_V12D07-335_B1,0,0,0,0,0,0
ACCGCTAGTCATTGGT-1_V12D07-335_B1,0,0,0,0,0,0
CATGAGTCCATCACGG-1_V12D07-335_B1,0,0,0,0,0,0
ATGTCTTGTTTGACTC-1_V12D07-335_B1,0,0,2,0,0,2
TCCCAAACATCCTCTA-1_V12D07-335_B1,0,0,0,0,0,0
CAACGCGATGAGCCAA-1_V12D07-335_B1,0,1,1,0,0,2
GACACCCAAAGACGCG-1_V12D07-335_B1,0,0,0,0,0,0
ACGTTCACTATGCCGC-1_V12D07-335_B1,0,2,0,0,0,2
ATGGACTGCTTAGTTG-1_V12D07-335_B1,0,0,0,0,0,0
CCATGGCAAACGCTCA-1_V12D07-335_B1,0,7,1,0,0,8
TTGTCTCGGCAAGATG-1_V12D07-335_B1,0,0,0,0,0,0
TTCGAACGAAACATGC-1_V12D07-335_B1,0,4,1,0,0,5
GGAAAGTCTTGATTGT-1_V12D07-335_B1,0,0,0,0,0,0
ATCATAGATCGACGAG-1_V12D07-335_B1,0,4,1,0,0,5
GATTAGAAACAAGCGT-1_V12D07-335_B1,0,0,0,0,0,0
GCTGCGAAGAATTATT-1_V12D07-335_B1,0,3,1,0,0,4
TTCCAGTGGGTTTCGT-1_V12D07-335_B1,0,0,0,0,0,0
GCTCATTGATCATATC-1_V12D07-335_B1,0,3,1,1,0,5
ATACGAGGTTTGTAAG-1_V12D07-335_B1,0,0,0,0,0,0
GTCTATACACGCATGG-1_V12D07-335_B1,0,2,4,1,0,7
GATTTGCGCTAACACC-1_V12D07-335_B1,0,0,0,0,0,0
TGGTGCCCTGCCTTAC-1_V12D07-335_B1,0,4,3,2,0,9
TCGAATCGCAGGGTAG-1_V12D07-335_B1,0,2,0,0,0,2
GGTAGGCCAATATCAC-1_V12D07-335_B1,0,0,4,2,0,6
CGTAAATAACAAAGGG-1_V12D07-335_B1,0,1,0,0,0,1
GACTCTAGAGTTCCAA-1_V12D07-335_B1,0,0,10,1,0,11
ACTTGTTACCGGATCA-1_V12D07-335_B1,0,2,3,0,0,5
GGCATTGAACATCTCA-1_V12D07-335_B1,0,2,10,2,0,14
AACCCGCTGTATTCCA-1_V12D07-335_B1,0,3,2,0,0,5
TAACAGGTTCCCTTAG-1_V12D07-335_B1,0,5,8,2,0,15
GTTCTTGTAACTCAAT-1_V12D07-335_B1,0,4,2,1,0,7
GATTCTGTTAATGAGT-1_V12D07-335_B1,0,5,4,4,0,13
GGACACCTCGGTGTTG-1_V12D07-335_B1,0,2,6,0,0,8
CGATCGAGAAGCACCA-1_V12D07-335_B1,0,7,7,2,0,16
CTGCTCTGACGGCAAA-1_V12D07-335_B1,0,5,2,1,0,8
CCCAGGAAGAATTCGA-1_V12D07-335_B1,0,8,4,1,0,13
TGTCGTGGGTATAGGC-1_V12D07-335_B1,0,2,4,1,0,7
ATATGTCTAGAGCGTG-1_V12D07-335_B1,0,7,4,2,0,13
GCGGGCAGACGGGTGA-1_V12D07-335_B1,0,8,1,3,0,12
CGAAGATCAGTTTCAT-1_V12D07-335_B1,0,10,6,0,0,16
ACGCCACTCGAAACAG-1_V12D07-335_B1,0,4,3,2,0,9
CTTAGATGTTTCATCC-1_V12D07-335_B1,0,5,8,0,0,13
GCGAATGGACTAGCGA-1_V12D07-335_B1,0,4,6,1,0,11
TAAATTGTGGGTAAAG-1_V12D07-335_B1,0,0,6,0,0,6
ATTTATACTGGTAAAG-1_V12D07-335_B1,0,2,6,2,0,10
GCGTCGTAACATGGTC-1_V12D07-335_B1,0,10,4,0,0,14
CGGTATGGGCACTCTG-1_V12D07-335_B1,0,9,2,5,0,16
CTATCACAACGCTGGA-1_V12D07-335_B1,0,8,3,0,0,11
ACCACACGGTTGATGG-1_V12D07-335_B1,0,3,5,5,0,13
AATGTTAAGACCCTGA-1_V12D07-335_B1,0,7,2,5,0,14
AACATAGCGTGTATCG-1_V12D07-335_B1,0,12,0,3,0,15
AGCAGTCGAAGCATGC-1_V12D07-335_B1,0,8,6,1,0,15
GTACTACGGCCTCGTT-1_V12D07-335_B1,0,9,3,6,0,18
TTGGCCAAATTGTATC-1_V12D07-335_B1,0,7,6,0,0,13
TCAGAGGACGCGTTAG-1_V12D07-335_B1,0,9,2,0,0,11
AGTAATCTAAGGGTGG-1_V12D07-335_B1,0,3,9,0,0,12
AATTATACCCAGCAAG-1_V12D07-335_B1,0,9,4,0,0,13
CCCTACCCACACCCAG-1_V12D07-335_B1,0,2,9,0,0,11
CTCTGTCCATGCACCA-1_V12D07-335_B1,0,8,6,0,0,14
TCGCCTCCTTCGGCTC-1_V12D07-335_B1,0,4,9,0,0,13
CCTGATTCGCGAAGAA-1_V12D07-335_B1,0,5,5,0,0,10
GACTTCAACGCATCAA-1_V12D07-335_B1,0,9,5,0,0,14
GCTTCCCGTAAGCTCC-1_V12D07-335_B1,0,10,5,0,0,15
AGAACTGTACTTTGTA-1_V12D07-335_B1,0,4,8,0,0,12
CCTTAAGTACGCAATT-1_V12D07-335_B1,0,8,7,0,0,15
GGCCAATTGTATAGAC-1_V12D07-335_B1,0,8,4,0,0,12
AGAATACAGGCTATCC-1_V12D07-335_B1,0,13,8,0,0,21
AATACCTGATGTGAAC-1_V12D07-335_B1,0,8,4,1,0,13
TAGAGTGTTCCGGGTA-1_V12D07-335_B1,0,4,10,0,0,14
GCTTCCATGTAACCGC-1_V12D07-335_B1,0,4,9,2,0,15
GGTTCGCATTTGCCGT-1_V12D07-335_B1,0,7,8,0,0,15
TCAATCCGGGAAGTTT-1_V12D07-335_B1,0,7,1,7,0,15
CCGGAAGTGCAATATG-1_V12D07-335_B1,0,11,5,0,0,16
CTCATAAATGTGTATA-1_V12D07-335_B1,0,1,5,5,0,11
GACGGGCATCGAATTT-1_V12D07-335_B1,0,8,2,2,0,12
GCTAAGCCCAGTATGC-1_V12D07-335_B1,0,1,11,3,0,15
GCTATAAGGGCCAGGA-1_V12D07-335_B1,0,8,4,5,0,17
GCGGATTACTTGTTCT-1_V12D07-335_B1,0,2,7,1,0,10
TACAACAGCGCATACA-1_V12D07-335_B1,0,6,6,4,0,16
TCTAACCTAGCCTGCG-1_V12D07-335_B1,0,5,0,0,0,5
TCTACCCGCATCATTT-1_V12D07-335_B1,0,10,2,0,0,12
GTCTTACCACGCCAAG-1_V12D07-335_B1,0,3,3,0,0,6
AATAACGTCGCGCCCA-1_V12D07-335_B1,0,2,3,4,0,9
CGTTTCGGTTATATGC-1_V12D07-335_B1,0,2,2,0,0,4
TACGCTGCACGGTCGT-1_V12D07-335_B1,0,0,5,12,0,17
GCCCGTCAAGCCCAAT-1_V12D07-335_B1,1,0,4,0,0,5
ATTCGTCCCGAGGTTA-1_V12D07-335_B1,0,5,2,1,0,8
TCAAATTATGTTCGAC-1_V12D07-335_B1,1,1,5,0,0,7
AACGTTCTACCATTGT-1_V12D07-335_B1,1,3,0,0,0,4
CTGTCCTGCGCACTAC-1_V12D07-335_B1,0,0,0,0,0,0
GCCCAGCGACACAAAG-1_V12D07-335_B1,0,0,0,0,0,0
TATAGCTATTATCTCT-1_V12D07-335_B1,0,0,0,0,0,0
AAGCTATGGATTGACC-1_V12D07-335_B1,0,0,0,0,0,0
CCGAAACACGACCTCT-1_V12D07-335_B1,0,0,0,0,0,0
ATCAGAAGCTGGTTGC-1_V12D07-335_B1,0,0,0,0,0,0
TGAACCTGAATGTGAG-1_V12D07-335_B1,0,0,0,0,0,0
TCAGAGCATGTCAACG-1_V12D07-335_B1,0,0,0,0,0,0
ATACCCTCCCGGCCAA-1_V12D07-335_B1,0,0,0,0,0,0
GCCACCTTATTCGCGA-1_V12D07-335_B1,0,0,0,0,0,0
CAACGAGCTTATTATG-1_V12D07-335_B1,0,0,0,0,0,0
GATCCAACCTTTAAAC-1_V12D07-335_B1,0,0,0,0,0,0
TTGTGGAGACAGCCGG-1_V12D07-335_B1,0,0,0,0,0,0
AGATAATCACACCTAT-1_V12D07-335_B1,0,0,0,0,0,0
GGTTAGGGATGCTAAT-1_V12D07-335_B1,0,0,0,0,0,0
TCATGAAGCGCTGCAT-1_V12D07-335_B1,0,0,0,0,0,0
CCAGGCGAGATGGTCT-1_V12D07-335_B1,0,0,0,0,0,0
CGACTTGCCGGGAAAT-1_V12D07-335_B1,0,0,0,0,0,0
GTGCCAAACGTTTCGA-1_V12D07-335_B1,0,0,0,0,0,0
TGCTCAAAGGATGCAC-1_V12D07-335_B1,0,0,0,0,0,0
GCCTCAGGTACCGGTC-1_V12D07-335_B1,0,0,0,0,0,0
ACAAGTAATTGTAAGG-1_V12D07-335_B1,0,0,0,0,0,0
TTAGAGTATTGTCGAG-1_V12D07-335_B1,0,0,0,0,0,0
GTCATCCCAAACTCAC-1_V12D07-335_B1,0,0,0,0,0,0
CTCCTAGTAATCGTGA-1_V12D07-335_B1,0,0,0,0,0,0
CCCTCATCACAGAGTA-1_V12D07-335_B1,0,0,0,0,0,0
GGAAACAGAGCTTGGG-1_V12D07-335_B1,0,0,0,0,0,0
ACATCGCAATATTCGG-1_V12D07-335_B1,0,0,0,0,0,0
TTAGCCATAGGGCTCG-1_V12D07-335_B1,0,0,0,0,0,0
CGGATTCTGCCTTATG-1_V12D07-335_B1,0,0,0,0,0,0
TTGTTGGCAATGACTG-1_V12D07-335_B1,0,0,0,0,0,0
GGATCTACCGTTCGTC-1_V12D07-335_B1,0,0,0,0,0,0
GGTGGGATTAGGTCCC-1_V12D07-335_B1,0,0,0,0,0,0
AATAGGCACGACCCTT-1_V12D07-335_B1,0,0,0,0,0,0
GAGGTCCGTTCGCTGT-1_V12D07-335_B1,0,0,0,0,0,0
TGACAACTTAAAGGTG-1_V12D07-335_B1,0,0,0,0,0,0
AGCTAAGCTCCGTCCG-1_V12D07-335_B1,0,0,0,0,0,0
CTAGCCCGGGAGACGA-1_V12D07-335_B1,0,0,0,0,0,0
CCCAGATTCCCGTGAC-1_V12D07-335_B1,0,0,0,0,0,0
GCCCGTTCACACAATT-1_V12D07-335_B1,0,0,0,0,0,0
ACAAACTCCATCAGAG-1_V12D07-335_B1,0,0,0,0,0,0
GGTTCCGTACGACTAA-1_V12D07-335_B1,0,0,0,0,0,0
TTGCGGAAAGCTGCCC-1_V12D07-335_B1,0,0,0,0,0,0
GGAACTCGTGAATACG-1_V12D07-335_B1,0,0,0,0,0,0
GGTTACCGCTCCCTAC-1_V12D07-335_B1,0,0,0,0,0,0
AGCGACTTTGAAGACA-1_V12D07-335_B1,0,0,0,0,0,0
CCGTTTCCTTTCCGTG-1_V12D07-335_B1,0,0,0,0,0,0
TGGATGGCATCTTGGA-1_V12D07-335_B1,0,0,0,0,0,0
CAAGTCGTTGAAATCT-1_V12D07-335_B1,0,0,0,0,0,0
TGCAAACGTACTAGTT-1_V12D07-335_B1,0,0,0,0,0,0
GGCTGTCCTACTGCGG-1_V12D07-335_B1,0,0,0,0,0,0
TACTGCATGATTAAAT-1_V12D07-335_B1,0,0,0,0,0,0
CGGACCTCTGTAGTTA-1_V12D07-335_B1,0,0,0,0,0,0
CCCTAGCTCTAAGGTC-1_V12D07-335_B1,0,0,0,0,0,0
GTAACAGGTTAACGGC-1_V12D07-335_B1,0,0,0,0,0,0
CCCGCAAATAATCATC-1_V12D07-335_B1,0,0,0,0,0,0
AATCCCGCTCAGAGCC-1_V12D07-335_B1,0,0,0,0,0,0
AACGTCATCCGGCTTG-1_V12D07-335_B1,0,0,0,0,0,0
CTCGTGGCACTGAAAG-1_V12D07-335_B1,0,0,0,0,0,0
CTTTATCCGACGCATG-1_V12D07-335_B1,0,0,0,0,0,0
AAATGACTGATCAAAC-1_V12D07-335_B1,0,0,0,0,0,0
TTCGTGCATGTTATAG-1_V12D07-335_B1,0,0,0,0,0,0
ATCAAAGAGCCGTGGT-1_V12D07-335_B1,0,0,0,0,0,0
ATGTCATAATAAACGA-1_V12D07-335_B1,0,0,0,0,0,0
CTTAATCGACTTAGTA-1_V12D07-335_B1,0,0,0,0,0,0
CTAAAGGATGAGATAC-1_V12D07-335_B1,0,0,0,0,0,0
GTGCTATCCAGCTGGA-1_V12D07-335_B1,0,0,0,0,0,0
GACAGAGGTCTTCAGT-1_V12D07-335_B1,0,0,0,0,0,0
TCGATTTACGAAACGA-1_V12D07-335_B1,0,0,1,0,0,1
AGGCTTAAGTTGCACA-1_V12D07-335_B1,0,0,0,0,0,0
TAGGATCTTAACCGCA-1_V12D07-335_B1,2,2,4,0,0,8
GACTTTCGAGCGGTTC-1_V12D07-335_B1,0,0,0,0,0,0
CCCTGGGAGGGATCCT-1_V12D07-335_B1,0,2,3,0,0,5
TAGTAGTTGCCGGACA-1_V12D07-335_B1,0,0,0,0,0,0
GCCCTAAGTGCAGGAT-1_V12D07-335_B1,0,1,3,0,0,4
ACTTGGGCTTTCGCCA-1_V12D07-335_B1,0,0,0,0,0,0
CATGATACGGTGAAAC-1_V12D07-335_B1,0,2,5,1,0,8
TCCTGCAGCCGCCAAT-1_V12D07-335_B1,0,0,0,0,0,0
GTCCGTTAGAGGGCCT-1_V12D07-335_B1,0,5,2,0,0,7
GCTTTATTAAGTTACC-1_V12D07-335_B1,0,0,0,0,0,0
AATCGAGGTCTCAAGG-1_V12D07-335_B1,0,4,3,0,0,7
GTGCTGTTAGAACATA-1_V12D07-335_B1,0,0,0,0,0,0
GGCTTCTCGTGGGTGG-1_V12D07-335_B1,0,6,2,0,0,8
CCTACAGTTGAGGGAG-1_V12D07-335_B1,0,0,0,0,0,0
CTCTAACACCGGCAGC-1_V12D07-335_B1,0,5,3,0,0,8
CTTCATCACCAGGGCT-1_V12D07-335_B1,0,1,3,0,0,4
GGCTGGCAATCCCACG-1_V12D07-335_B1,0,5,4,0,0,9
CAAACCATAAGCGTAT-1_V12D07-335_B1,1,1,1,0,0,3
CATGTGGGCTCATCAC-1_V12D07-335_B1,0,3,3,4,0,10
CCCGTGACAGTGCCTT-1_V12D07-335_B1,0,7,2,0,0,9
GATTATCTTGCATTAT-1_V12D07-335_B1,0,1,5,4,0,10
GAGTCCACCAGGTTTA-1_V12D07-335_B1,0,3,2,0,0,5
TGTACTATCGCTCGTT-1_V12D07-335_B1,0,5,4,5,0,14
TTAGCGAATAGATAGG-1_V12D07-335_B1,0,5,0,0,0,5
ACATACAATCAAGCGG-1_V12D07-335_B1,0,3,6,4,0,13
ATTCGTGTACCCATTC-1_V12D07-335_B1,0,2,3,0,0,5
GCTAGCAACGCACCTA-1_V12D07-335_B1,0,9,2,1,0,12
ACCTCAGCGAGGCGCA-1_V12D07-335_B1,0,5,1,0,0,6
TCCGGGCCACTAACGG-1_V12D07-335_B1,0,5,4,2,0,11
TCCCAATATCGACGAC-1_V12D07-335_B1,0,3,4,1,0,8
GGATTGAAGTAGCCTC-1_V12D07-335_B1,0,7,6,0,0,13
GGCGCACAGTTTACCT-1_V12D07-335_B1,0,4,3,4,0,11
CCCGGCACGTGTCAGG-1_V12D07-335_B1,0,6,4,0,0,10
AGTAAGGGACAGAATC-1_V12D07-335_B1,0,4,5,3,0,12
TTGCGCACAACCACGT-1_V12D07-335_B1,0,12,2,0,0,14
CCTGCTACAACCATAC-1_V12D07-335_B1,0,3,6,6,0,15
CTGGGCTACTGGAGAG-1_V12D07-335_B1,0,12,6,0,0,18
AGCTACGAATGGTGGT-1_V12D07-335_B1,0,10,3,4,0,17
ATTCGTTTATCGTATT-1_V12D07-335_B1,0,6,3,1,0,10
GGCATTCCCTCCCTCG-1_V12D07-335_B1,0,2,7,1,0,10
AGTTATTCAGACTGTG-1_V12D07-335_B1,0,7,5,0,0,12
CCACTTTCCTTCTAGG-1_V12D07-335_B1,0,8,6,2,0,16
CGCAGTTCTATCTTTC-1_V12D07-335_B1,0,7,6,1,0,14
AGGAGCGTTTATTATC-1_V12D07-335_B1,0,8,5,1,0,14
GACAGGTAATCCGTGT-1_V12D07-335_B1,0,5,7,1,0,13
TTCCCAAAGTACTGAT-1_V12D07-335_B1,0,14,1,0,0,15
ATTGAATTCCCTGTAG-1_V12D07-335_B1,0,5,3,1,0,9
TACCTCACCAATTGTA-1_V12D07-335_B1,0,11,3,0,0,14
AGTCGAATTAGCGTAA-1_V12D07-335_B1,0,6,4,5,0,15
TTGAAGTGCATCTACA-1_V12D07-335_B1,0,8,5,1,0,14
