key,oligo,microglia,other,neuron,astrocyte,n_cells
TGTAATGCCTTCGGAC-1_V12D07-335_A1,4,0,0,0,0,4
TACGATCCAAGCCACT-1_V12D07-335_A1,0,0,0,0,0,0
AGATTCAAGCGGGTCG-1_V12D07-335_A1,1,0,0,0,0,1
GTAACATCAGCTCATC-1_V12D07-335_A1,3,0,1,0,0,4
GGGCCTATACAACCGG-1_V12D07-335_A1,0,0,0,0,0,0
AAACCACTACACAGAT-1_V12D07-335_A1,1,0,0,0,0,1
TTGAGGGTCGAACGCG-1_V12D07-335_A1,0,0,1,0,0,1
AGGGTGTGCTACACGC-1_V12D07-335_A1,7,2,2,1,0,12
AATGGCCGCCAATGCG-1_V12D07-335_A1,7,0,0,0,0,7
GGGTCACTGAGTAGTG-1_V12D07-335_A1,7,4,0,0,0,11
GATCTTAGTGAACGTG-1_V12D07-335_A1,5,0,1,2,0,8
CTAATGCGCCCAACAA-1_V12D07-335_A1,1,1,2,0,0,4
GCCACCCATTCCACTT-1_V12D07-335_A1,0,0,0,0,0,0
TAGAACGCCAGTAACG-1_V12D07-335_A1,2,0,0,0,0,2
TGATGGGACTAAGTCA-1_V12D07-335_A1,3,0,2,0,0,5
TCGCCTCGACCTGTTG-1_V12D07-335_A1,0,0,0,0,0,0
AGGAAAGCCTCTGATG-1_V12D07-335_A1,0,0,0,0,0,0
GTATCGGGACGAGCTG-1_V12D07-335_A1,1,1,0,0,0,2
CATACGGGTGCATGAT-1_V12D07-335_A1,0,0,0,0,0,0
AAATTGCGGCGGTTCT-1_V12D07-335_A1,0,0,0,0,0,0
CATTCAGGTCAGTGCG-1_V12D07-335_A1,1,0,0,0,0,1
TGCTATACAAACGGAC-1_V12D07-335_A1,0,0,0,0,0,0
TATTCCGGCAGTCCTA-1_V12D07-335_A1,0,1,0,0,0,1
ATGTGTAGTTTAGTCA-1_V12D07-335_A1,3,0,0,0,0,3
AAGTTTACTAATGGCA-1_V12D07-335_A1,6,0,0,0,0,6
GATTGACACTCTGCTC-1_V12D07-335_A1,1,1,0,0,0,2
ACCGTTCCCGCTCTGA-1_V12D07-335_A1,0,1,0,0,0,1
CATTCACTGACAGCTA-1_V12D07-335_A1,1,1,1,1,0,4
CATGAACCTCTTATCA-1_V12D07-335_A1,1,1,0,0,0,2
AATAAGTCCTCGAGAC-1_V12D07-335_A1,1,0,0,1,0,2
CTACGAACTAGGTCGA-1_V12D07-335_A1,2,0,0,0,0,2
CACTACTCAGTTCTGT-1_V12D07-335_A1,8,2,0,0,0,10
CATTTATCGTTCAAGA-1_V12D07-335_A1,7,1,0,0,0,8
TAGAAACCACTAAGTA-1_V12D07-335_A1,6,0,1,0,0,7
TCGTATTTCGTCCGGA-1_V12D07-335_A1,3,1,0,0,0,4
ATCCACGCTAAATGTT-1_V12D07-335_A1,4,0,0,0,0,4
ATAAAGGTCAAGTACG-1_V12D07-335_A1,6,0,0,0,0,6
TAGGAACAGCCTCCAG-1_V12D07-335_A1,2,1,2,0,0,5
CACACGTTTCAATGGG-1_V12D07-335_A1,6,0,0,0,0,6
AGTAACGTTCATCCTG-1_V12D07-335_A1,1,0,0,0,0,1
GTATAGTGGCCCATGT-1_V12D07-335_A1,0,0,0,0,0,0
TCTACACGTTCATGCA-1_V12D07-335_A1,1,1,0,0,0,2
AATCTGGGTAGACCCT-1_V12D07-335_A1,1,0,0,0,0,1
TCGGTTAGCCATGTAG-1_V12D07-335_A1,1,2,1,0,0,4
TGCCATGGCTTATAAG-1_V12D07-335_A1,5,0,1,0,0,6
TAAGTAAATGTGCCGC-1_V12D07-335_A1,3,0,1,0,0,4
GTGTCCGATAAGGCAT-1_V12D07-335_A1,2,0,1,0,0,3
TGGCACGAGCTCGAGT-1_V12D07-335_A1,3,0,0,0,0,3
ACCGGTCTGAGTACGG-1_V12D07-335_A1,4,0,2,0,0,6
GAACTTAGCGCCCGGT-1_V12D07-335_A1,5,1,1,0,0,7
AGTAGCTAGACGCCGA-1_V12D07-335_A1,4,0,0,0,0,4
ATAGGAATCTAAGCTT-1_V12D07-335_A1,6,1,1,0,0,8
CTTCCTGCATATTTAC-1_V12D07-335_A1,2,0,2,0,0,4
CAATATGTAGATTTAC-1_V12D07-335_A1,3,1,1,0,0,5
ACAAGGCCTACCAGCC-1_V12D07-335_A1,5,0,1,0,0,6
TTATAGTCCAAGGTGC-1_V12D07-335_A1,0,0,2,0,0,2
AAACGCCCGAGATCGG-1_V12D07-335_A1,3,1,1,1,0,6
CCTCGTTACGCCTGTT-1_V12D07-335_A1,11,0,1,0,0,12
GAACGGTGTAAAGCAG-1_V12D07-335_A1,4,0,2,0,0,6
ACGCATAAATGACATG-1_V12D07-335_A1,2,1,2,0,0,5
GGTTCGATGCTGAGTT-1_V12D07-335_A1,4,0,1,0,0,5
CTTTGGCAGACAGAGT-1_V12D07-335_A1,4,1,3,0,0,8
TTCGTGGGCTGGAAGC-1_V12D07-335_A1,4,1,3,0,0,8
CAAAGGTTAAATTCAG-1_V12D07-335_A1,2,7,1,2,0,12
GTTTGGCGTCAGGCAC-1_V12D07-335_A1,1,1,5,0,0,7
GCTTTCTATCTCAACT-1_V12D07-335_A1,5,0,1,0,0,6
TGCATCTCCGGATCTT-1_V12D07-335_A1,2,1,2,0,0,5
CTGAAACGGCCCTCAG-1_V12D07-335_A1,2,4,3,0,0,9
TAGCAGTAAATACGCG-1_V12D07-335_A1,5,3,3,0,0,11
CGGGCTACTTAAATTG-1_V12D07-335_A1,6,0,2,0,0,8
ATTATGCTCAGTATTG-1_V12D07-335_A1,3,0,1,0,0,4
TGATGCTCACGTAGTC-1_V12D07-335_A1,4,0,2,0,1,7
GTCTAAGATGCCCAGC-1_V12D07-335_A1,1,3,3,1,0,8
AACCCGATAGGGCTTC-1_V12D07-335_A1,4,1,4,1,0,10
CGCTATCGTGGCTTTA-1_V12D07-335_A1,4,0,1,0,0,5
CGTCTCTCGCCGAGGC-1_V12D07-335_A1,0,0,4,0,0,4
AGTGGGAGTATACACG-1_V12D07-335_A1,1,0,5,0,0,6
GGTCTTGGTGTTAACT-1_V12D07-335_A1,0,0,1,0,0,1
GGCTGGCAGCTTTATG-1_V12D07-335_A1,0,0,2,0,0,2
CGCCAATTATTGCGTT-1_V12D07-335_A1,0,0,1,0,0,1
GGTAACCGGCAAAGGT-1_V12D07-335_A1,0,0,0,0,0,0
TGGGACCATTGGGAGT-1_V12D07-335_A1,1,0,2,0,0,3
CTGCAGGTGCTCGGCC-1_V12D07-335_A1,3,0,2,0,0,5
CCGGTGCGAGTGATAG-1_V12D07-335_A1,2,0,1,0,0,3
GGGTACACTCTGGAGG-1_V12D07-335_A1,1,1,1,0,0,3
TAGCCAGAGGGTCCGG-1_V12D07-335_A1,0,0,2,0,0,2
CTTGTGAGGACAGCGG-1_V12D07-335_A1,0,0,0,0,0,0
GAAGGGCATAACCATG-1_V12D07-335_A1,0,0,1,0,0,1
CAACATGGCCTGATAA-1_V12D07-335_A1,1,0,3,0,0,4
CAATTTGACCGGGAAG-1_V12D07-335_A1,0,1,1,0,0,2
TCTGACTGTAATGGTT-1_V12D07-335_A1,2,0,2,0,0,4
TTCATAGCCTTGTAAC-1_V12D07-335_A1,0,0,2,1,0,3
TGGAAACGGAGTGAAC-1_V12D07-335_A1,1,0,0,0,0,1
ATCGCACGATTGTTCA-1_V12D07-335_A1,0,1,0,0,0,1
CGCCACCCGCATTAAC-1_V12D07-335_A1,7,0,1,0,0,8
TGGACCACGGCGTTGA-1_V12D07-335_A1,2,1,1,0,0,4
GTATATGTTACGGCGG-1_V12D07-335_A1,3,1,1,0,0,5
GTATTCTTACCGTGCT-1_V12D07-335_A1,2,2,3,0,0,7
TTCAGAGTAACCTGAC-1_V12D07-335_A1,0,1,2,0,0,3
GCGGTAACCCAAATGA-1_V12D07-335_A1,2,0,1,0,0,3
CTACGTGTTGCCACCA-1_V12D07-335_A1,3,0,2,0,0,5
CTAGATAAACTCCTCG-1_V12D07-335_A1,3,0,0,0,0,3
TCCATTAGTTGGATAG-1_V12D07-335_A1,4,0,0,0,0,4
CTGGCTCCTGCGGGAT-1_V12D07-335_A1,4,0,2,0,0,6
CAGTCTCTCGGCTAAT-1_V12D07-335_A1,2,0,1,0,0,3
GTATGACGTGGGAAAC-1_V12D07-335_A1,1,1,0,0,0,2
AGTCACTCCGCCTCAT-1_V12D07-335_A1,2,0,0,0,0,2
GCAGCGGTGGGCATTA-1_V12D07-335_A1,2,0,4,0,0,6
TATGGAGTTTCTCGTT-1_V12D07-335_A1,1,0,2,0,0,3
ACTCAACGAATGTATT-1_V12D07-335_A1,2,2,1,0,0,5
AACACGCGGCCGCGAA-1_V12D07-335_A1,6,1,0,0,0,7
CGATATTAGCCGCAGG-1_V12D07-335_A1,1,3,2,0,0,6
AGCGTCTGAACCCGCA-1_V12D07-335_A1,6,0,1,0,0,7
GATGTCCGGATCACAT-1_V12D07-335_A1,1,1,1,0,0,3
GGTCACGTTAGATTCA-1_V12D07-335_A1,4,1,0,0,0,5
TTAAGGATACGGAGGT-1_V12D07-335_A1,2,0,2,0,0,4
GTGCGGGACCATCGGC-1_V12D07-335_A1,6,1,3,0,0,10
CCATCTTGTTCACAAT-1_V12D07-335_A1,4,0,2,0,0,6
TCCGAGAAGGCTAAGC-1_V12D07-335_A1,1,1,4,0,0,6
TGGCGGTGTGCGATTG-1_V12D07-335_A1,4,0,2,0,0,6
ATCCTGCTGCAGATAG-1_V12D07-335_A1,4,0,1,0,0,5
TTATGCGTCCCGGTCC-1_V12D07-335_A1,4,0,3,0,0,7
CATAATGAGCGGGCGA-1_V12D07-335_A1,1,2,3,0,0,6
AGACATAGATCCTTCC-1_V12D07-335_A1,0,0,1,0,0,1
GGTGAAACCGGGAATG-1_V12D07-335_A1,0,1,0,0,0,1
AACTGGTGTGGGCCTT-1_V12D07-335_A1,5,0,1,0,0,6
GTAGCGCTGTTGTAGT-1_V12D07-335_A1,7,0,2,1,0,10
TTGTTTGTGTAAATTC-1_V12D07-335_A1,5,0,0,0,0,5
GGATCAAAGGACGAGG-1_V12D07-335_A1,1,0,0,0,0,1
CGTAGCGCCGACGTTG-1_V12D07-335_A1,4,2,1,0,1,8
CAAGTGAACTTTGGTT-1_V12D07-335_A1,1,0,1,0,4,6
GTAGACAACCGATGAA-1_V12D07-335_A1,6,0,0,0,1,7
CAATGGTCGGCCTGGG-1_V12D07-335_A1,1,1,0,0,3,5
ACAGATTAGGTTAGTG-1_V12D07-335_A1,4,1,1,0,1,7
GTTATCACCTTCTGAA-1_V12D07-335_A1,5,1,0,0,5,11
TGGTATCGGTCTGTAT-1_V12D07-335_A1,5,0,1,0,0,6
GGAATAACCTCAAGAA-1_V12D07-335_A1,2,0,2,0,0,4
ATTATCTCGACAGATC-1_V12D07-335_A1,2,1,1,0,0,4
CCGAGGGATGTTAGGC-1_V12D07-335_A1,3,0,1,0,0,4
TGAGATCAAATACTCA-1_V12D07-335_A1,4,1,2,1,0,8
AAACGAAGAACATACC-1_V12D07-335_A1,1,0,2,0,0,3
CTGGTCCTAACTTGGC-1_V12D07-335_A1,1,0,1,0,0,2
TGCACGAGTCGGCAGC-1_V12D07-335_A1,2,0,1,0,0,3
ATAGTCTTTGACGTGC-1_V12D07-335_A1,1,0,2,0,0,3
TGGAGCTAAAGTTCCC-1_V12D07-335_A1,4,1,2,0,0,7
GGGTGGTCCAGCCTGT-1_V12D07-335_A1,2,2,2,0,0,6
CATGCATGGAGACCCT-1_V12D07-335_A1,5,1,0,0,0,6
ACACGGCACTATGCAT-1_V12D07-335_A1,2,0,1,0,0,3
CCCTGGTATGGGCGGC-1_V12D07-335_A1,8,3,1,0,0,12
GGAGGATTGAAAGGAG-1_V12D07-335_A1,0,0,1,0,0,1
CCGCTGGTGCCATTCA-1_V12D07-335_A1,3,3,0,0,0,6
GTTAGAGTGTGCCGCT-1_V12D07-335_A1,0,0,2,0,0,2
TCGGAATGACCATCAA-1_V12D07-335_A1,2,1,3,0,0,6
TTCAATTAGCCATAAT-1_V12D07-335_A1,2,2,0,0,0,4
GATGTGTTGTCACAAG-1_V12D07-335_A1,5,2,2,0,0,9
TCTTTCTCTTAAGGAG-1_V12D07-335_A1,2,1,2,0,0,5
ACCCTTTAGTTCTCCA-1_V12D07-335_A1,2,0,3,0,0,5
ACCACAACTCAGAACA-1_V12D07-335_A1,2,0,1,0,0,3
TATGATAAATCTAACG-1_V12D07-335_A1,2,1,1,0,0,4
GATCCTCTTGCGCTTA-1_V12D07-335_A1,0,2,0,0,0,2
TTCTACCTTTATGTTG-1_V12D07-335_A1,4,1,1,0,0,6
GAAATACCTGCTGGCT-1_V12D07-335_A1,3,0,2,0,0,5
ATTCTGAGTATGAACT-1_V12D07-335_A1,6,2,0,0,0,8
GGATTAAGCTAAGGTC-1_V12D07-335_A1,7,0,3,0,0,10
AGTACGTGGCCTGTCT-1_V12D07-335_A1,2,2,1,1,0,6
TCAGGGTGCACGAAAC-1_V12D07-335_A1,4,0,1,1,0,6
AAATTTACCGAAATCC-1_V12D07-335_A1,3,3,2,0,0,8
TTGAGGCATTTAACTC-1_V12D07-335_A1,2,0,3,0,0,5
AACCAGTATCACTCTT-1_V12D07-335_A1,4,1,1,0,0,6
CACCGGAGATATCTCC-1_V12D07-335_A1,3,0,0,0,0,3
GACTGGGCGCCGCAAC-1_V12D07-335_A1,1,1,0,0,0,2
CACGTCTATGATGTGG-1_V12D07-335_A1,5,3,0,0,0,8
TTAAGACGAACGAACC-1_V12D07-335_A1,3,0,1,0,0,4
TGACCAGCTTCAAAGT-1_V12D07-335_A1,3,0,0,0,0,3
AGAGTTAGAGACCGAT-1_V12D07-335_A1,2,1,0,0,0,3
TTCGGACTGATGCCTT-1_V12D07-335_A1,4,0,2,0,0,6
CTCGAATGGAACGTAT-1_V12D07-335_A1,1,1,2,0,0,4
GGACGGCTTGCGCAAC-1_V12D07-335_A1,3,2,0,0,0,5
CTAAGTACAGGGCTAC-1_V12D07-335_A1,3,2,0,0,0,5
ACAAATTCAGATCTGA-1_V12D07-335_A1,2,1,3,0,0,6
CATGGAAATGGGACCA-1_V12D07-335_A1,4,1,2,0,0,7
GGTGGACCACGTGTTA-1_V12D07-335_A1,1,0,0,0,0,1
CACGACGTAATAGTAA-1_V12D07-335_A1,8,0,0,1,0,9
CGGGTTCGGCACGTAT-1_V12D07-335_A1,5,0,2,0,0,7
CTGGGCTATCCTTTGG-1_V12D07-335_A1,4,1,1,0,0,6
GTATTAGGGTTCGCGT-1_V12D07-335_A1,8,2,1,0,0,11
TCATTCGTATAATTTG-1_V12D07-335_A1,1,0,3,0,0,4
AATAGCAAGCCTCCTG-1_V12D07-335_A1,3,0,4,0,0,7
CATCTACCCGAGAACG-1_V12D07-335_A1,2,0,0,0,0,2
GCTTCAGTGGGATTAC-1_V12D07-335_A1,4,2,1,0,0,7
TCTGTGATGGAGGTTG-1_V12D07-335_A1,9,1,3,1,0,14
ATCCACTTTCAGACTA-1_V12D07-335_A1,5,0,1,0,0,6
ATGGTTACGAAACATG-1_V12D07-335_A1,3,1,1,0,0,5
GGCCCAATCTAGAGGG-1_V12D07-335_A1,3,2,0,0,0,5
GATGGTGAAATAACCC-1_V12D07-335_A1,5,2,2,0,0,9
AGAGGGACAATTGTCC-1_V12D07-335_A1,4,0,3,0,0,7
CGCGTACATTCTGGAA-1_V12D07-335_A1,4,3,1,0,0,8
CAAGAAACCCTAAACT-1_V12D07-335_A1,4,1,0,0,0,5
TTGGTGCGGTGTTGAA-1_V12D07-335_A1,0,0,3,1,0,4
GGTTCCCTAGTGTCTC-1_V12D07-335_A1,0,2,6,5,0,13
CGATAACCAATTTGAG-1_V12D07-335_A1,1,3,0,5,0,9
GCCCACTGGTCCACAA-1_V12D07-335_A1,0,2,2,4,0,8
GAGGGCCGGCAGAGTC-1_V12D07-335_A1,4,0,2,0,0,6
CGACACGGATGCCCAC-1_V12D07-335_A1,1,0,2,0,0,3
CTGTCTGTGGCTGGCT-1_V12D07-335_A1,1,0,3,0,0,4
ATATTATCCCGTATTT-1_V12D07-335_A1,2,0,0,0,0,2
GCGCTGGCGGAAAGTC-1_V12D07-335_A1,1,1,1,0,0,3
ATCTAACGTCCCTATG-1_V12D07-335_A1,0,1,1,0,0,2
GTCAGACAGCGTTGGA-1_V12D07-335_A1,0,0,3,0,0,3
GCCAGGCTTAGTGGTA-1_V12D07-335_A1,0,0,1,0,0,1
ATTCAAAGTACCTGTT-1_V12D07-335_A1,0,0,0,0,0,0
TGGACGTAGGCGAATC-1_V12D07-335_A1,0,2,1,3,0,6
ACACATTGACGCAACA-1_V12D07-335_A1,0,0,1,0,0,1
GATATCAGTATGTATC-1_V12D07-335_A1,0,1,0,3,0,4
TGGGCCTTGCCTGCAT-1_V12D07-335_A1,0,1,0,0,0,1
CAAAGTCAGGTTAGCT-1_V12D07-335_A1,0,0,1,0,0,1
GGATCCCTACCAGCTA-1_V12D07-335_A1,1,1,1,0,0,3
ATCGTCCAATCGAGTC-1_V12D07-335_A1,0,0,1,0,0,1
ACATGGCTCAATTTAG-1_V12D07-335_A1,2,1,0,1,0,4
AGGCCCAGTGACTGGT-1_V12D07-335_A1,1,2,1,0,0,4
GCTTCCAGCTTAGATT-1_V12D07-335_A1,1,0,1,0,0,2
TGCTTGAAACCATGCA-1_V12D07-335_A1,2,1,0,1,0,4
CAATATTGGACTAGTG-1_V12D07-335_A1,1,0,3,0,0,4
CGTGCTGGCCTAGTCG-1_V12D07-335_A1,0,1,0,0,0,1
CCTGCGATAGAACTGT-1_V12D07-335_A1,0,1,2,0,0,3
GGGTAATGCTGTGTTT-1_V12D07-335_A1,2,1,0,0,0,3
AACGCGAACGGCAACA-1_V12D07-335_A1,1,2,2,0,0,5
TGTCGGCATGGTGGAA-1_V12D07-335_A1,0,1,5,0,0,6
AGCGTACGAGAGCTAG-1_V12D07-335_A1,0,0,3,0,0,3
ATACTCTCGCCACTCT-1_V12D07-335_A1,1,0,1,0,0,2
AATCCATGCAAGGGTG-1_V12D07-335_A1,1,0,0,0,0,1
TTAAACAGAGTCCCGC-1_V12D07-335_A1,2,0,2,0,0,4
CCACAGCTGAAATCAT-1_V12D07-335_A1,1,0,3,1,0,5
CGGTTCCGGCTTCTTG-1_V12D07-335_A1,0,0,2,3,0,5
GACGTGAGACTCCATG-1_V12D07-335_A1,0,1,2,7,0,10
TCGTTGGCTCGTCAAT-1_V12D07-335_A1,2,0,6,0,0,8
GGTGAACGGGCTAGCC-1_V12D07-335_A1,3,3,4,0,0,10
GCACTGTGCAAATGTA-1_V12D07-335_A1,2,0,0,0,0,2
ACGAGAACCCATCACG-1_V12D07-335_A1,3,1,3,0,0,7
CCAGCTACGCCTCATA-1_V12D07-335_A1,0,0,0,0,0,0
TCCCGGTCAGGAATTT-1_V12D07-335_A1,2,0,2,0,0,4
TCGCATTCAATGACTT-1_V12D07-335_A1,3,0,0,0,0,3
CTGGTTCAACGCATCA-1_V12D07-335_A1,2,0,0,0,0,2
GGTGATTTCATCTTGT-1_V12D07-335_A1,0,0,1,0,0,1
CACCCTTTCCTCGCTC-1_V12D07-335_A1,0,0,1,0,0,1
CAACTTGTAGTGGGCA-1_V12D07-335_A1,0,0,2,0,0,2
AATATCAAGGTCGGAT-1_V12D07-335_A1,3,1,1,0,0,5
ACTCAGACCTGCTTCT-1_V12D07-335_A1,1,0,3,0,0,4
TTGGAGTCTCCCTTCT-1_V12D07-335_A1,1,0,0,0,0,1
GGATACTCATGAATTG-1_V12D07-335_A1,1,0,2,0,0,3
TGGGCACAAACAGAAC-1_V12D07-335_A1,1,0,2,0,0,3
GAGCCACGGTAGTAGG-1_V12D07-335_A1,0,0,0,0,0,0
TCGATAGGCTAGTCGC-1_V12D07-335_A1,1,1,1,0,0,3
TAACCGCCCGCAGTGC-1_V12D07-335_A1,1,0,1,0,0,2
GCCTATTTGCTACACA-1_V12D07-335_A1,1,0,1,0,0,2
TTGACGATTCAGCACG-1_V12D07-335_A1,2,1,1,0,0,4
TTAAACCGGTAGCGAC-1_V12D07-335_A1,3,0,0,0,1,4
ACCGAAAGGGCCCTGC-1_V12D07-335_A1,2,1,0,0,0,3
ACGTTCCGCGCTCCGT-1_V12D07-335_A1,3,0,0,0,1,4
ATACCAGGCTAATAGA-1_V12D07-335_A1,2,3,1,0,0,6
CGGCTTTGTATGATAA-1_V12D07-335_A1,2,0,1,0,1,4
CTTGACCCGAAAGATA-1_V12D07-335_A1,4,0,1,0,0,5
CGCAGAAACATTTGCG-1_V12D07-335_A1,3,1,0,0,0,4
GACCCGTCGCCGGCTA-1_V12D07-335_A1,1,0,0,0,0,1
AATCGGGACACTACGA-1_V12D07-335_A1,4,0,0,0,0,4
GTCACAAAGTTTCCAA-1_V12D07-335_A1,2,0,0,0,0,2
TATATTCGCGTCGATA-1_V12D07-335_A1,0,0,2,0,0,2
CCTCCCGACAATCCCT-1_V12D07-335_A1,0,0,0,0,0,0
CGACATGCGATCTTCT-1_V12D07-335_A1,1,1,0,0,0,2
AACACGACTGTACTGA-1_V12D07-335_A1,0,0,1,0,0,1
CCCAACCACACTAACA-1_V12D07-335_A1,0,1,0,0,0,1
CACCGCCGACCAGCGA-1_V12D07-335_A1,0,0,0,0,0,0
TGGTATCGCATCCCAA-1_V12D07-335_A1,1,1,0,0,0,2
CAGAGTGATTTAACGT-1_V12D07-335_A1,0,1,0,0,0,1
AACCCTGGTGGAACCA-1_V12D07-335_A1,1,0,1,0,0,2
GTCAGTTGTGCTCGTT-1_V12D07-335_A1,0,0,0,0,0,0
ATTGACGTAACTCGGT-1_V12D07-335_A1,0,1,2,0,0,3
GATGTCGGTCAACTGC-1_V12D07-335_A1,1,2,3,0,0,6
AGGGCAGCGGCGTGGT-1_V12D07-335_A1,0,0,1,0,0,1
ACATCGTTAACCTAGT-1_V12D07-335_A1,1,1,0,0,0,2
TCCATTGTGACCTCGT-1_V12D07-335_A1,1,0,3,0,0,4
TGTTTAATACTTCATC-1_V12D07-335_A1,0,0,1,0,0,1
TTGCTGGCCGGGCTTC-1_V12D07-335_A1,1,1,2,0,0,4
CATATTATTTGCCCTA-1_V12D07-335_A1,0,1,1,0,0,2
CTGCCTAGCCACCAAG-1_V12D07-335_A1,4,0,2,0,0,6
ACGAGATATTTGCTTA-1_V12D07-335_A1,0,0,1,0,0,1
GACTACAATTGCTCGT-1_V12D07-335_A1,1,1,2,0,0,4
AACGTGATGAAGGACA-1_V12D07-335_A1,0,0,5,0,0,5
ACTCTCTTATACACGA-1_V12D07-335_A1,2,0,9,0,0,11
CGCATCATGGCTTCAG-1_V12D07-335_A1,2,0,1,0,0,3
CGGCTCTTCGTCGAAC-1_V12D07-335_A1,5,0,0,0,0,5
ATTCTTCGTACTTATG-1_V12D07-335_A1,4,1,1,0,0,6
AGTGAGGGTTTCTGAC-1_V12D07-335_A1,4,0,0,0,0,4
GCCAGGCGTTCGCATG-1_V12D07-335_A1,3,0,1,0,0,4
GACTAACACAGCACCT-1_V12D07-335_A1,4,1,3,0,0,8
CAATGGAATCTACATA-1_V12D07-335_A1,4,0,0,0,0,4
GTGGTCAGCGAAGTAT-1_V12D07-335_A1,2,1,1,0,0,4
ATGGCTGGAAATGGCC-1_V12D07-335_A1,1,0,2,0,0,3
ATCAGGTCGCCATTGC-1_V12D07-335_A1,4,1,2,0,0,7
TATCACCATGTAAAGT-1_V12D07-335_A1,5,1,0,0,0,6
AGCGCTTATGGGCAAG-1_V12D07-335_A1,3,1,3,0,0,7
AAGCGGCGTCATGGGT-1_V12D07-335_A1,2,1,1,0,0,4
ACTAATACGTCAGGCG-1_V12D07-335_A1,1,1,8,0,0,10
GGCTGAGCATCGTAAG-1_V12D07-335_A1,1,1,3,0,0,5
CGGTTGGGTTCAAGTT-1_V12D07-335_A1,2,4,3,0,0,9
GACTGATTGGTCACAA-1_V12D07-335_A1,0,0,3,2,0,5
AGACGGGCCGATTTAA-1_V12D07-335_A1,1,0,2,0,0,3
ACCAGTGCCCGGTCAA-1_V12D07-335_A1,0,0,1,4,0,5
GTCCTTTAATGACTTC-1_V12D07-335_A1,2,2,1,0,0,5
CCTACAAGTCCGGAAT-1_V12D07-335_A1,1,0,1,5,0,7
GCCTGCTACACTGAGA-1_V12D07-335_A1,1,0,2,0,0,3
GACTCGGTCGGCGGAT-1_V12D07-335_A1,2,2,2,0,0,6
CTAGACATATATGTAG-1_V12D07-335_A1,2,2,1,0,0,5
TCGCCCAACTGACTCC-1_V12D07-335_A1,0,1,4,0,0,5
AAACTAACGTGGCGAC-1_V12D07-335_A1,3,3,1,0,0,7
AACTGAGGTCAGCGTC-1_V12D07-335_A1,5,1,3,0,0,9
ACAATGATTCTTCTAC-1_V12D07-335_A1,5,0,1,0,0,6
ATAAGTACCCGATTGT-1_V12D07-335_A1,1,5,1,0,0,7
ATTGGGAGTTCTGTAA-1_V12D07-335_A1,4,0,3,0,0,7
CGAACATAGTCAGAAA-1_V12D07-335_A1,5,1,1,0,0,7
TAGCTCAGATCCTAGT-1_V12D07-335_A1,7,0,2,0,0,9
GTGTCGTATTCACCTT-1_V12D07-335_A1,4,2,3,0,0,9
CTCACCGATCCAAACT-1_V12D07-335_A1,2,2,2,0,0,6
ATATGTGCACAAACCA-1_V12D07-335_A1,0,1,2,0,0,3
CAGTCCAACGCCTTCT-1_V12D07-335_A1,3,1,2,0,0,6
TCGTCCGGGTACACTC-1_V12D07-335_A1,5,2,0,0,0,7
GCAGAAACGTAATCCA-1_V12D07-335_A1,2,1,0,0,0,3
TTCGAGCCGGCGCTAC-1_V12D07-335_A1,2,1,1,0,0,4
GGAAGATAAGACTGTA-1_V12D07-335_A1,4,3,1,0,0,8
ATAAGCAAACACCGAG-1_V12D07-335_A1,2,1,1,0,0,4
GCATAAATTGAACGCC-1_V12D07-335_A1,0,0,6,0,0,6
CGCCGGTGTCGCAGTA-1_V12D07-335_A1,5,0,1,1,0,7
GACCTGGTCTGGGCGT-1_V12D07-335_A1,1,0,2,0,0,3
AGCCGCTTGATTAGCG-1_V12D07-335_A1,3,1,2,0,0,6
CCCGGCTAGGTGAGAA-1_V12D07-335_A1,1,0,1,0,0,2
CGAGCCGAGCACTCGA-1_V12D07-335_A1,0,0,1,0,0,1
TAGTGCTTGAATCCTT-1_V12D07-335_A1,0,0,1,0,0,1
CAACCGCACCTAGACA-1_V12D07-335_A1,0,0,3,0,0,3
ACCACTGTTCAAGAAG-1_V12D07-335_A1,2,0,1,4,0,7
AGATGCTATAACGAGC-1_V12D07-335_A1,0,0,3,10,0,13
AATTACTCGTACGCTC-1_V12D07-335_A1,0,0,0,22,0,22
CGTCAATCTTTAACAT-1_V12D07-335_A1,0,0,3,11,0,14
CCAAAGCAGTTGGTTG-1_V12D07-335_A1,0,0,3,7,0,10
CCATATTGGATCATGA-1_V12D07-335_A1,0,0,2,14,0,16
CGTACCGAAAGTCTAG-1_V12D07-335_A1,0,0,3,2,0,5
CTCGAGATCCAAAGCA-1_V12D07-335_A1,1,0,2,6,0,9
TGGATAGAGTAACAGA-1_V12D07-335_A1,0,0,0,1,0,1
TCACAGATCCTCAAAC-1_V12D07-335_A1,1,1,0,0,0,2
AGAGCTACGAAAGCAT-1_V12D07-335_A1,0,1,0,0,0,1
TGCGTGATTGGGTGTC-1_V12D07-335_A1,0,1,0,1,0,2
CACATGTTTGGACATG-1_V12D07-335_A1,0,0,2,0,0,2
TTCGCATCCGGAAGCA-1_V12D07-335_A1,0,0,0,0,0,0
CCCTAGTGTCAGGTGT-1_V12D07-335_A1,0,0,0,0,0,0
TTACCGCCTTAGGGAA-1_V12D07-335_A1,1,0,0,0,0,1
CCAGTCCATTATTCGA-1_V12D07-335_A1,3,2,2,0,0,7
CGTAAACGCTTGAGTG-1_V12D07-335_A1,1,0,0,0,0,1
ATTCCTTCCAGGCGGT-1_V12D07-335_A1,2,0,0,0,0,2
TTCCTTTCTGTGTTGC-1_V12D07-335_A1,3,0,2,0,0,5
AGTTGACATCGGCTGG-1_V12D07-335_A1,0,0,2,0,0,2
AACTCGATGGCGCAGT-1_V12D07-335_A1,1,0,6,0,0,7
GATAAGGCAGATGCAA-1_V12D07-335_A1,5,0,2,1,0,8
GGCTGGCTAGCTTAAA-1_V12D07-335_A1,0,0,3,0,0,3
CCTCATGCAGCTACGA-1_V12D07-335_A1,2,0,2,0,0,4
GACGCCTGTTGCAGGG-1_V12D07-335_A1,2,0,0,0,0,2
TAATTAGATGGATATG-1_V12D07-335_A1,0,1,1,0,0,2
GAGGGCATCGCGTATC-1_V12D07-335_A1,0,0,4,0,0,4
CTTGTGAGTCTTTGAC-1_V12D07-335_A1,2,0,3,0,0,5
TCAACACATTGGGTAA-1_V12D07-335_A1,6,1,1,0,0,8
ACTGTATACGCGAGCA-1_V12D07-335_A1,4,0,0,0,0,4
GTGAAACGTGCTCCAC-1_V12D07-335_A1,1,0,0,1,0,2
CGAGTGCTATAGTTCG-1_V12D07-335_A1,0,0,0,0,0,0
GTACTGCATGAAGCGT-1_V12D07-335_A1,0,0,0,0,0,0
GTAACTTGCGGCAGTC-1_V12D07-335_A1,0,0,1,0,0,1
GAATCGCCGGACACGG-1_V12D07-335_A1,1,0,2,0,0,3
GGGAGTAATGGCTGGC-1_V12D07-335_A1,0,0,3,0,0,3
CATGAACCGACATTTG-1_V12D07-335_A1,0,0,2,7,0,9
TCTGTCATACAAGAGC-1_V12D07-335_A1,0,0,4,1,0,5
GTCGTCAATTATAAGG-1_V12D07-335_A1,0,0,2,21,0,23
TAAAGAGCCCGAAACC-1_V12D07-335_A1,0,0,3,0,0,3
GTACTGAGGTCGTAAC-1_V12D07-335_A1,0,0,1,13,0,14
AAAGACCCAAGTCGCG-1_V12D07-335_A1,0,0,1,0,0,1
CGTCAGTGCGCACAAG-1_V12D07-335_A1,0,0,4,0,0,4
TGTATCCTTATTCCAT-1_V12D07-335_A1,0,1,0,0,0,1
ATTCTCGTCTCTTTAG-1_V12D07-335_A1,0,0,1,0,0,1
AAAGTCACTGATGTAA-1_V12D07-335_A1,0,0,2,0,0,2
TGTCTACAGTTTCTGT-1_V12D07-335_A1,1,0,0,0,0,1
TTAACGTCGCAAGACC-1_V12D07-335_A1,0,0,0,0,0,0
CTATGTCTATTGAAAC-1_V12D07-335_A1,0,0,1,0,0,1
TCGGGTGAAACTGCTA-1_V12D07-335_A1,0,1,1,0,0,2
TGTCCCGACATAGCAC-1_V12D07-335_A1,3,1,0,0,0,4
ACAGCATAGAGCCAGT-1_V12D07-335_A1,1,0,2,0,0,3
ATATTCCCACAGGTCA-1_V12D07-335_A1,0,0,0,0,0,0
TTGGATCGACTTCTGG-1_V12D07-335_A1,2,0,3,0,0,5
CACCATCGGAGGAGAC-1_V12D07-335_A1,1,0,1,0,0,2
TCGTTCGTTATTATGT-1_V12D07-335_A1,0,0,5,4,0,9
CTTAACTTCGAAGTAC-1_V12D07-335_A1,3,0,2,0,0,5
GCACAAGTGTCGGAAG-1_V12D07-335_A1,0,0,1,0,0,1
TACCAGCTAGGTTTAA-1_V12D07-335_A1,2,0,1,0,0,3
ACGTACAGATTTCTCT-1_V12D07-335_A1,0,1,0,0,0,1
AATTTGGTTCCAAAGA-1_V12D07-335_A1,0,0,0,0,0,0
GTAAGGATTTGTCGGA-1_V12D07-335_A1,0,0,1,0,0,1
CATCATCTACCCGGAC-1_V12D07-335_A1,1,0,2,0,0,3
ACGATGGATCCGATGC-1_V12D07-335_A1,1,0,1,0,0,2
CACTCAGCTCTTGAGG-1_V12D07-335_A1,0,0,1,1,0,2
TAGATCCGAAGTCGCA-1_V12D07-335_A1,1,0,1,0,0,2
TGAAACTTATGCAAGC-1_V12D07-335_A1,0,1,0,0,0,1
GCGATTCTGGAAGCAG-1_V12D07-335_A1,0,0,1,0,0,1
CAAACTATTGAGCTTC-1_V12D07-335_A1,0,1,0,0,0,1
TAGAATTAAGGGCAAC-1_V12D07-335_A1,0,0,0,0,0,0
CGAAACATAGATGGCA-1_V12D07-335_A1,0,0,0,1,0,1
GATGGTGCCCTAGGCA-1_V12D07-335_A1,0,0,2,0,0,2
CCCGCAGGGCCCAAAG-1_V12D07-335_A1,1,1,2,5,0,9
ACAGCGCACCCGCAGC-1_V12D07-335_A1,0,0,2,0,0,2
GGTAAATGTGCGTTAC-1_V12D07-335_A1,1,0,3,4,0,8
GTCCTTCTAGTGGGTT-1_V12D07-335_A1,0,0,1,0,0,1
GGAAGCTCGCTTACAG-1_V12D07-335_A1,0,1,2,6,0,9
CACCGATACACCGAGC-1_V12D07-335_A1,0,1,3,0,0,4
CAGCCGGGCCCTCTAT-1_V12D07-335_A1,0,0,2,0,0,2
CGGAGCTTATAACACC-1_V12D07-335_A1,0,0,0,0,0,0
ATTACAACTACCGGCC-1_V12D07-335_A1,0,0,3,0,0,3
TCCTCTGGCCCATTAG-1_V12D07-335_A1,2,0,2,0,0,4
CGGCACCGTTAGCGCC-1_V12D07-335_A1,0,0,1,0,0,1
TCGGTCCCTGACTCCA-1_V12D07-335_A1,2,0,0,0,0,2
TGGTTGGAGGATCCTG-1_V12D07-335_A1,3,0,0,0,0,3
CTGCGGTAGTCACGTG-1_V12D07-335_A1,2,0,1,0,0,3
GTGCCTCAGTGTACGG-1_V12D07-335_A1,1,0,1,0,0,2
ATCGTTCACTTTCGCC-1_V12D07-335_A1,2,1,1,0,0,4
ACTTACCGGGCGCGCA-1_V12D07-335_A1,1,0,1,0,0,2
CTAGACTGCATTTCGT-1_V12D07-335_A1,5,0,1,0,0,6
TTGCCGGTGATCCCTC-1_V12D07-335_A1,4,0,2,0,0,6
CTGTCACGCCAGGCGC-1_V12D07-335_A1,3,1,2,0,0,6
CGGTATAGGTATTAGC-1_V12D07-335_A1,3,0,1,0,0,4
CCAACGCTTGCCAGGG-1_V12D07-335_A1,2,1,2,0,0,5
CGTTGAGTAATTGCGT-1_V12D07-335_A1,0,1,3,0,0,4
TGTATTTACCTAATGC-1_V12D07-335_A1,0,0,0,6,0,6
TAAATGCCGTCTCATG-1_V12D07-335_A1,0,2,0,10,0,12
CGGTTTATGAAGGAAC-1_V12D07-335_A1,0,0,0,0,0,0
GCAAGATGTGTTCGCG-1_V12D07-335_A1,0,0,0,6,0,6
AAAGGTAAGCTGTACC-1_V12D07-335_A1,0,0,2,2,0,4
GTACGTCACGTATTAA-1_V12D07-335_A1,0,0,1,12,0,13
AGTACCTTCGAGTGCT-1_V12D07-335_A1,3,0,3,0,0,6
ATTGTGACTTCGCTGC-1_V12D07-335_A1,0,0,4,0,0,4
TGTATCAGACTGAAGC-1_V12D07-335_A1,0,0,7,0,0,7
GAGACCCTGCAACGCC-1_V12D07-335_A1,2,0,3,1,0,6
TGGGTGGGATGTCATT-1_V12D07-335_A1,0,1,2,0,0,3
GGCTAATGATTGAAAT-1_V12D07-335_A1,0,0,3,0,0,3
ATAACGTTACCTCCAC-1_V12D07-335_A1,2,1,1,0,0,4
TGCGAGATGGCGGCCA-1_V12D07-335_A1,4,0,0,0,0,4
CACACTTGTATTGCGA-1_V12D07-335_A1,1,3,4,0,0,8
GCTGGTGACTCGTAGT-1_V12D07-335_A1,3,0,2,0,0,5
CGACACCGCTTAAGGA-1_V12D07-335_A1,2,0,1,1,0,4
GTAACAACTGACCTTG-1_V12D07-335_A1,2,0,0,0,0,2
CAACTGAGGGTATGAC-1_V12D07-335_A1,0,1,3,0,0,4
CTAATTATGAAGCGTA-1_V12D07-335_A1,1,2,1,0,0,4
CCGATCTTAAGAGGCT-1_V12D07-335_A1,4,0,2,0,0,6
CGACTCGGTACACGGT-1_V12D07-335_A1,7,0,4,0,0,11
TGCTGCGTCAGAGTTA-1_V12D07-335_A1,2,1,2,0,0,5
AGAGTTGCAGGCCTCC-1_V12D07-335_A1,5,0,6,0,0,11
ACTGGCGAACCTGCGT-1_V12D07-335_A1,3,0,1,0,0,4
ACTAAGGACGCACACC-1_V12D07-335_A1,7,1,4,0,0,12
CGTCCAGATGGCTCCA-1_V12D07-335_A1,2,0,2,1,0,5
ACTATCGCCGGCTAAA-1_V12D07-335_A1,0,0,1,8,0,9
GATAGCGTACCACGCG-1_V12D07-335_A1,0,0,6,0,0,6
AGGACTTATAGGAGAA-1_V12D07-335_A1,3,0,1,0,0,4
TAGTCGGGATTCTTCG-1_V12D07-335_A1,1,0,1,0,0,2
ACCATTAAGGGTGTCA-1_V12D07-335_A1,2,0,1,0,0,3
TTAATGTGTTTGCAGG-1_V12D07-335_A1,0,0,4,0,0,4
TCCGCAGCCACCTAGC-1_V12D07-335_A1,0,0,1,3,0,4
GAGGAGATCCTCATGC-1_V12D07-335_A1,2,1,0,22,0,25
GGTCCTTCATACGACT-1_V12D07-335_A1,0,0,0,20,0,20
CCCTGTTGGCAAAGAC-1_V12D07-335_A1,0,0,3,7,0,10
GTGCCTAGCTATGCTT-1_V12D07-335_A1,1,0,3,2,0,6
GTCATCTCCTACAGCT-1_V12D07-335_A1,0,0,1,14,0,15
GCGAGAAACGGGAGTT-1_V12D07-335_A1,0,0,1,4,0,5
CGTCGCGGCGGGATTT-1_V12D07-335_A1,0,0,0,27,0,27
CATTGTGTGCTAGATC-1_V12D07-335_A1,0,0,4,5,0,9
CGCGGCAGTATTACGG-1_V12D07-335_A1,0,0,1,13,0,14
GAAATGGGATGTAAAC-1_V12D07-335_A1,0,0,1,20,0,21
CATTCCCTAAGTACAA-1_V12D07-335_A1,1,0,1,2,0,4
AGTTCTGCGTTGTATC-1_V12D07-335_A1,0,0,1,11,0,12
ACCCTATAGGACTGAG-1_V12D07-335_A1,0,3,2,0,0,5
TTAGATAGGTCGATAC-1_V12D07-335_A1,0,0,0,1,0,1
ATTGATAGCAACGAGA-1_V12D07-335_A1,2,0,0,0,0,2
TCTCGGCTCCAGGACT-1_V12D07-335_A1,0,0,0,0,0,0
CTTGAGGTTATCCCGA-1_V12D07-335_A1,3,0,1,0,0,4
AAGAAGGATCAGTTAG-1_V12D07-335_A1,0,1,4,0,0,5
GTACGACGGCGCTGCG-1_V12D07-335_A1,3,0,0,1,0,4
CTTATGTTGACTACCA-1_V12D07-335_A1,0,1,6,1,0,8
CGGCACTCAAGAAAGT-1_V12D07-335_A1,1,0,0,19,0,20
GTCAAAGTTTACATAG-1_V12D07-335_A1,0,0,0,2,0,2
CTCCTAAGTTATGTCT-1_V12D07-335_A1,0,0,7,0,0,7
ACTGTGCTAGTAGATC-1_V12D07-335_A1,0,1,0,0,0,1
GTTTGGCCGCTCAGCG-1_V12D07-335_A1,2,0,5,0,0,7
TTATCCAATCGAACTC-1_V12D07-335_A1,3,0,1,0,0,4
CCGTACCCAAGCGCCA-1_V12D07-335_A1,1,0,2,0,0,3
CATACAAAGCCGAACC-1_V12D07-335_A1,3,0,0,0,0,3
GGTCGGTAATTAGACA-1_V12D07-335_A1,0,0,1,0,0,1
AGCGGGAAGGGTCCAT-1_V12D07-335_A1,0,0,1,0,0,1
GCCCACCAAGGCTGTC-1_V12D07-335_A1,1,0,1,0,0,2
GTAGACGTCGTTACAT-1_V12D07-335_A1,0,0,1,0,0,1
GAGCATCATCCCTGGG-1_V12D07-335_A1,1,0,0,0,0,1
AGGTAACCTCCTATTC-1_V12D07-335_A1,0,0,0,0,0,0
GGTTTGAGTGCTGGAA-1_V12D07-335_A1,0,0,0,5,0,5
GCACTAGTCGCGCTAT-1_V12D07-335_A1,0,0,0,15,0,15
GGTAACTATGTATCTG-1_V12D07-335_A1,1,0,1,14,0,16
GCGGTCCCTAGACGCA-1_V12D07-335_A1,0,0,0,16,0,16
CGAGCGTTGATCAGCC-1_V12D07-335_A1,0,0,2,17,0,19
AATCCAAGGGCCTGAG-1_V12D07-335_A1,0,0,0,3,0,3
CCGTGCCCATGACGGC-1_V12D07-335_A1,0,0,0,20,0,20
GAAATTCACATCGCTG-1_V12D07-335_A1,0,1,2,16,0,19
CTCTGCGAAGCAAGCA-1_V12D07-335_A1,0,0,2,0,0,2
AGTAGGTAACATACAT-1_V12D07-335_A1,0,0,4,0,0,4
ATTGGGAATATCTTGG-1_V12D07-335_A1,0,0,0,0,0,0
TAGAGCTACGAAGAAC-1_V12D07-335_A1,0,0,1,0,0,1
TGCGGCATAGTTCAAC-1_V12D07-335_A1,0,0,0,0,0,0
CCGCCGGTCAACACAC-1_V12D07-335_A1,0,0,2,0,0,2
TCGTATAGTGCAATTA-1_V12D07-335_A1,0,0,1,0,0,1
TAGTTTATTCTTGCTT-1_V12D07-335_A1,0,0,1,0,0,1
GATATCTCATGCAATA-1_V12D07-335_A1,0,0,1,0,0,1
CGTTTAAGCGGAGCAC-1_V12D07-335_A1,0,0,1,0,0,1
CATGCTGGCTCCAATT-1_V12D07-335_A1,0,0,0,0,0,0
GAAACAGCCATGCAGT-1_V12D07-335_A1,0,0,0,0,0,0
AGTTTCGCAGGTCGGA-1_V12D07-335_A1,1,0,3,0,0,4
CTCATGGCTCACAATC-1_V12D07-335_A1,0,0,0,0,0,0
AACCGTTGTGTTTGCT-1_V12D07-335_A1,0,0,0,0,0,0
ACCCTTCATCTGCGAA-1_V12D07-335_A1,2,0,0,0,0,2
TGCGGTGAAATTTCAT-1_V12D07-335_A1,0,0,1,0,0,1
CAAATTGTCAGCAAGC-1_V12D07-335_A1,0,0,2,0,0,2
GAGGTACATCCATCTT-1_V12D07-335_A1,0,0,1,0,0,1
AAATGGCATGTCTTGT-1_V12D07-335_A1,0,0,0,0,0,0
TCATCCCAGAGGGTGG-1_V12D07-335_A1,0,0,0,0,0,0
CGTAGCGAATTGTCAG-1_V12D07-335_A1,0,2,1,0,0,3
CCTAGTTAGTCGCATG-1_V12D07-335_A1,0,0,3,0,0,3
GAAACTCTAATGAAGG-1_V12D07-335_A1,0,0,1,0,0,1
TTGTATCACACAGAAT-1_V12D07-335_A1,1,1,0,1,0,3
TTCAAGCCGAGCTGAG-1_V12D07-335_A1,0,1,3,5,0,9
AGGTACGATATTGCCA-1_V12D07-335_A1,0,0,1,7,0,8
TTAAGCCGACAACTTC-1_V12D07-335_A1,0,0,1,21,0,22
GTCTTAGTACAGCCGG-1_V12D07-335_A1,0,0,3,16,0,19
TGGGTAAGGTTCCCGC-1_V12D07-335_A1,0,1,0,22,0,23
CTACGCCATTTCCGAT-1_V12D07-335_A1,0,0,2,19,0,21
GACCGTCAGGTCGTGA-1_V12D07-335_A1,2,0,0,17,0,19
TAGTTAAGATAGGATA-1_V12D07-335_A1,0,0,1,23,0,24
GAATATTCGGAGTCCC-1_V12D07-335_A1,0,0,0,12,0,12
CAAACTACGATAGAGA-1_V12D07-335_A1,0,0,0,9,0,9
CAGGAAGACTTTATAT-1_V12D07-335_A1,0,0,2,14,0,16
TTCGTAATCCCAGCGG-1_V12D07-335_A1,0,0,5,1,0,6
GTGAGGAGCGGTTGAG-1_V12D07-335_A1,0,0,1,9,0,10
CAATCCCTATACCAGC-1_V12D07-335_A1,0,0,2,0,0,2
AGGGAAACGAGGTACT-1_V12D07-335_A1,0,0,2,0,0,2
TCCTGCCAACTGGAGA-1_V12D07-335_A1,0,0,1,0,0,1
AATTTGGGACATAGTA-1_V12D07-335_A1,0,0,1,0,0,1
AACTCCTAATCCCATG-1_V12D07-335_A1,0,0,1,0,0,1
GCTCATTACTGCATGT-1_V12D07-335_A1,0,1,1,0,0,2
TCTCGAACGAGGTCAC-1_V12D07-335_A1,2,0,0,0,0,2
TCACTACGACCAATGC-1_V12D07-335_A1,3,0,3,0,0,6
GTGATGCACAACATCT-1_V12D07-335_A1,0,0,0,0,0,0
CCGACGTAAACACAAC-1_V12D07-335_A1,3,0,0,0,0,3
TGGGATGCACTCATTC-1_V12D07-335_A1,2,0,1,0,0,3
TTCCATCATGCGGTGA-1_V12D07-335_A1,1,1,1,0,0,3
TGCACAGTGAAGTTAT-1_V12D07-335_A1,3,0,1,0,0,4
CTATTGTGTTTGGTCA-1_V12D07-335_A1,8,0,0,0,0,8
TGCGAGCCCTTCCGCG-1_V12D07-335_A1,5,0,0,0,0,5
TTGAAAGGTGTAAAGG-1_V12D07-335_A1,5,1,1,0,0,7
GGTGCAGAGCCTATCG-1_V12D07-335_A1,2,0,3,0,0,5
ACTATATGCTGTGTTC-1_V12D07-335_A1,4,0,4,0,0,8
TCCTGGCGCTGCCTGG-1_V12D07-335_A1,0,1,1,0,0,2
GAGCCGAGCGTTTATT-1_V12D07-335_A1,3,0,1,0,0,4
AGAATGCGGGTTCGGA-1_V12D07-335_A1,0,0,1,0,0,1
ATGCGACAATTGGTCC-1_V12D07-335_A1,4,1,2,0,0,7
TTCCGGCTCGACTTCT-1_V12D07-335_A1,0,0,1,0,0,1
TGATTATGGCACGCAG-1_V12D07-335_A1,1,2,9,0,0,12
GGTTTGACAAGAAGCT-1_V12D07-335_A1,0,0,8,0,0,8
GCAGCTATGGACAGGT-1_V12D07-335_A1,3,0,5,0,0,8
CACCATGATCGCAAAG-1_V12D07-335_A1,3,1,3,0,0,7
GTCGGAAGGATACCAG-1_V12D07-335_A1,0,0,3,0,0,3
GGCCCAGTTATCAGCA-1_V12D07-335_A1,2,1,0,0,0,3
GGGCCTATTTAAGTAT-1_V12D07-335_A1,3,0,1,1,0,5
GTTGTTACATTGCGCT-1_V12D07-335_A1,3,1,0,0,0,4
CAACTCCGTAACTTGC-1_V12D07-335_A1,6,2,2,1,0,11
GATCTTTGCTCAAAGA-1_V12D07-335_A1,4,0,4,0,0,8
TCGCTTAATTACGAAG-1_V12D07-335_A1,2,1,1,0,0,4
CGATCATTAGAGGCAC-1_V12D07-335_A1,5,0,2,0,0,7
TGTTCTCTACTCCCTA-1_V12D07-335_A1,3,0,3,0,0,6
GCTTAGGGAAGCGGTA-1_V12D07-335_A1,0,1,8,0,0,9
CAGGTTTAGTACTACA-1_V12D07-335_A1,3,0,1,0,0,4
AAGCGGAGTGCGCGCA-1_V12D07-335_A1,5,2,3,0,0,10
TCAGATGGAGACGTAG-1_V12D07-335_A1,1,0,1,0,0,2
TCGCACTAACGTTTGT-1_V12D07-335_A1,0,4,2,6,0,12
CACGTCGGGTTCTAGA-1_V12D07-335_A1,0,0,0,0,0,0
GGAGTACACATGAGCT-1_V12D07-335_A1,0,0,0,0,0,0
GTGTGTCGACGTCGCT-1_V12D07-335_A1,0,0,2,0,0,2
GAAGCTCTTTGCTTAG-1_V12D07-335_A1,5,1,0,0,0,6
ACACCGAGCGCTCTTT-1_V12D07-335_A1,2,0,2,0,0,4
CGTAATAATTACGAGT-1_V12D07-335_A1,0,0,2,0,0,2
CATCAACACCTACTAA-1_V12D07-335_A1,0,0,0,0,0,0
CCAAGTTTCTACAGAT-1_V12D07-335_A1,0,0,3,2,0,5
ACGGGTCATGTGACTT-1_V12D07-335_A1,0,0,1,2,0,3
AGTGTGCTAAGATCGC-1_V12D07-335_A1,0,0,2,18,0,20
GGCGGTTTGCCGGTGC-1_V12D07-335_A1,0,0,0,8,0,8
GTATAATCTCCCGGAT-1_V12D07-335_A1,0,2,4,3,0,9
TAGTCCGTATGCATAA-1_V12D07-335_A1,0,0,5,1,0,6
CACTTCGTCTTATCTC-1_V12D07-335_A1,0,0,3,1,0,4
CATCCGCAGGCCCGAA-1_V12D07-335_A1,1,0,4,0,0,5
CCCTGATGTAACTCGT-1_V12D07-335_A1,0,0,1,6,0,7
CCATAGTCAGTAACCC-1_V12D07-335_A1,0,0,2,1,0,3
CGGGCCATAGCCGCAC-1_V12D07-335_A1,1,0,1,15,0,17
CTCCGGCTTGTAGACA-1_V12D07-335_A1,0,0,1,11,0,12
AACTTGCGTTCTCGCG-1_V12D07-335_A1,0,0,1,19,0,20
AATGAGTTCGCATATG-1_V12D07-335_A1,0,0,2,8,0,10
CGAGGCCAGGCATTGG-1_V12D07-335_A1,0,0,1,0,0,1
TCTGCGTCCGGTTTCT-1_V12D07-335_A1,0,0,1,0,0,1
CAATCCTGCCGTGGAG-1_V12D07-335_A1,1,0,0,1,0,2
CTGAGCAAGTAACAAG-1_V12D07-335_A1,1,0,0,0,0,1
GGGTACCCACGGTCCT-1_V12D07-335_A1,0,0,2,0,0,2
ACGGAATTTAGCAAAT-1_V12D07-335_A1,1,1,5,0,0,7
GGGCGGTCCTATTGTC-1_V12D07-335_A1,1,0,0,0,0,1
ATGTTACGAGCAATAC-1_V12D07-335_A1,4,0,2,0,0,6
AACCATGGGATCGCTA-1_V12D07-335_A1,0,0,0,0,0,0
TCGCATCCCTAAGTGT-1_V12D07-335_A1,0,0,5,0,0,5
ACTTAGTACGACAAGA-1_V12D07-335_A1,2,0,3,0,0,5
GAGCTCTCGGACCTAA-1_V12D07-335_A1,5,0,0,0,0,5
TCTATTACGCTGGCGA-1_V12D07-335_A1,1,0,0,0,0,1
AGATACGACTTCATAT-1_V12D07-335_A1,1,0,2,0,0,3
CGCTATACCGCCCACT-1_V12D07-335_A1,4,0,2,0,0,6
CAGTGTCCGCAGAATG-1_V12D07-335_A1,3,0,2,0,0,5
CCATCCATACCAAGTC-1_V12D07-335_A1,0,1,1,0,0,2
AACCCAGAGACGGAGA-1_V12D07-335_A1,0,0,0,0,0,0
GAAGAACGGTGCAGGT-1_V12D07-335_A1,0,0,0,0,0,0
GATAAATCGGTGGATG-1_V12D07-335_A1,0,0,0,0,0,0
CAGCTCGTGCTTGTGT-1_V12D07-335_A1,0,0,0,0,0,0
GAGTACGGGTATACAA-1_V12D07-335_A1,0,0,0,0,0,0
CATCGCCCGCGGCCAA-1_V12D07-335_A1,0,0,1,17,0,18
TCTTACAGAGGTACCG-1_V12D07-335_A1,0,0,1,15,0,16
TGGAAGACGAACACCA-1_V12D07-335_A1,0,0,2,7,0,9
GTTGTCGTGTTAGTTG-1_V12D07-335_A1,0,0,4,5,0,9
CCAAGGAACAGAGAGG-1_V12D07-335_A1,0,0,0,2,0,2
CTGCACCTGGAACCGC-1_V12D07-335_A1,2,0,0,0,0,2
CGCTTTCATACCGGTG-1_V12D07-335_A1,0,0,3,14,0,17
GTTCTTCCCTCGATGT-1_V12D07-335_A1,1,0,2,3,0,6
ATTTAACTCGTATTAC-1_V12D07-335_A1,0,0,0,16,0,16
AACGATAGAAGGGCCG-1_V12D07-335_A1,0,0,1,10,0,11
TATCCTGCATGGGAAT-1_V12D07-335_A1,0,0,1,3,0,4
AGGCCCATTGTACAGG-1_V12D07-335_A1,0,1,1,12,0,14
CCGGCGCATATTGGAT-1_V12D07-335_A1,1,0,1,0,0,2
ATCTGTAATTGTACCC-1_V12D07-335_A1,0,0,1,3,0,4
GAGCGAGGGAGTACCG-1_V12D07-335_A1,1,1,0,0,0,2
TTATTAGGGAAGCATC-1_V12D07-335_A1,0,0,2,0,0,2
CTTCTTACGTCGTATA-1_V12D07-335_A1,2,0,0,0,0,2
GAAGTGCTGGATAGCT-1_V12D07-335_A1,2,0,4,0,0,6
GTGCAACAAATGTGGC-1_V12D07-335_A1,0,0,2,0,0,2
CATGCGTTAGACAGAA-1_V12D07-335_A1,2,0,2,0,0,4
ACACACTTTCTACACG-1_V12D07-335_A1,0,0,2,0,0,2
AGCCCTAAGCGAAGTT-1_V12D07-335_A1,1,0,1,0,0,2
ATTAATTCGGTCACTC-1_V12D07-335_A1,0,0,1,0,0,1
AACAGGAAATCGAATA-1_V12D07-335_A1,0,0,0,0,0,0
ACGTTTAGTTGTGATC-1_V12D07-335_A1,0,0,0,0,0,0
TCCTTCAGTGGTCGAA-1_V12D07-335_A1,0,0,0,0,0,0
CGAACGCCCAGTGCCG-1_V12D07-335_A1,0,1,2,0,0,3
CCTCGAAGTGGACGGG-1_V12D07-335_A1,0,1,2,0,0,3
CTCTGTTTGAGGATTC-1_V12D07-335_A1,1,0,3,0,0,4
TGGGCACGTTCTATGG-1_V12D07-335_A1,2,1,2,0,0,5
ACTATTCGTCCGTGGT-1_V12D07-335_A1,0,0,4,0,0,4
CCTCTGGCCTAGACGG-1_V12D07-335_A1,0,0,0,22,0,22
CCATAAACAACCCGAC-1_V12D07-335_A1,0,0,1,15,0,16
CATAGTACATTGAGAG-1_V12D07-335_A1,0,0,1,11,0,12
ATTTCATTATTTCGCG-1_V12D07-335_A1,0,0,0,17,0,17
CAACTATATCGAATGC-1_V12D07-335_A1,1,0,1,5,0,7
CTAGTATTCGGAATTA-1_V12D07-335_A1,1,0,3,10,0,14
GTGGAACCTACATGCG-1_V12D07-335_A1,0,0,3,1,0,4
CCTAAAGGCTGACGCT-1_V12D07-335_A1,0,0,4,1,0,5
CGTGACATTGGGTCGT-1_V12D07-335_A1,0,0,1,3,0,4
CCAATCGGTAGATCGA-1_V12D07-335_A1,1,0,2,2,0,5
ATTGTCGCAATACCTT-1_V12D07-335_A1,1,0,1,0,0,2
AAATTACACGACTCTG-1_V12D07-335_A1,1,0,1,20,0,22
CACTCCTCTCGGTCGG-1_V12D07-335_A1,0,0,3,10,0,13
AAATAACCATACGGGA-1_V12D07-335_A1,0,0,4,12,0,16
AGTTACTCTATCGTGG-1_V12D07-335_A1,0,1,0,20,0,21
CGTTAGCTCACAACTG-1_V12D07-335_A1,0,0,0,0,0,0
GAATGTATGGCAGGTC-1_V12D07-335_A1,0,1,1,4,0,6
GCAACCACCAGACCGG-1_V12D07-335_A1,1,0,1,0,0,2
TCACTCGTGCAACGGC-1_V12D07-335_A1,0,0,2,0,0,2
AAACAGAGCGACTCCT-1_V12D07-335_A1,0,0,2,0,0,2
CAGCCTCTCCTCAAGA-1_V12D07-335_A1,0,0,0,0,0,0
TTGCGTGAACGCTTAG-1_V12D07-335_A1,1,0,0,0,0,1
CCGCCTGCGAATTGGT-1_V12D07-335_A1,1,1,2,0,0,4
AGATGAGGGTTGCGAT-1_V12D07-335_A1,0,0,1,0,0,1
CGGTGGGCTCCAGCCT-1_V12D07-335_A1,1,1,1,1,0,4
GGCAGCGGTAATCCTA-1_V12D07-335_A1,4,0,1,0,0,5
GCTAGCAGGGAGTGGG-1_V12D07-335_A1,2,0,1,0,0,3
CTCAAGACATTAGCGC-1_V12D07-335_A1,1,0,2,0,0,3
CACGGCGCGCCAAAGG-1_V12D07-335_A1,7,0,2,0,0,9
TGCAATTTGGGCACGG-1_V12D07-335_A1,3,0,0,0,0,3
ATGCCAATCGCTCTGC-1_V12D07-335_A1,6,1,3,0,0,10
GCTGGACCCAAAGTGG-1_V12D07-335_A1,8,1,2,0,0,11
ATTCCTAAGACGTGGA-1_V12D07-335_A1,3,0,0,0,0,3
TCCGGAGGAAGGGCTG-1_V12D07-335_A1,2,0,2,0,0,4
TCGGTGACCGCTCCGG-1_V12D07-335_A1,3,0,2,0,0,5
TCCGAAGTAGTCACCA-1_V12D07-335_A1,2,0,0,0,0,2
CATGTAGGAGCGCCAA-1_V12D07-335_A1,3,0,1,0,0,4
CACAAGAAAGATATTA-1_V12D07-335_A1,7,0,2,0,0,9
AGGGTCAGTAACCCTA-1_V12D07-335_A1,2,0,1,0,0,3
TAAGCCCTTACGACCA-1_V12D07-335_A1,0,0,1,0,0,1
ATACCGTCATCCATAA-1_V12D07-335_A1,5,0,6,0,0,11
GGACGTCCATAGTTGG-1_V12D07-335_A1,3,0,2,0,0,5
CATCAAACTGGCGCCC-1_V12D07-335_A1,2,1,2,0,0,5
AAACGTGTTCGCCCTA-1_V12D07-335_A1,5,1,2,1,0,9
AAATTGGTGAGAAGCA-1_V12D07-335_A1,1,2,4,0,0,7
GGTCATTGTAGTCATA-1_V12D07-335_A1,7,0,1,0,0,8
TGCAGTGAGGCTCGGG-1_V12D07-335_A1,4,0,1,1,0,6
GAACATTAGTATGTTA-1_V12D07-335_A1,4,0,0,1,0,5
GGTTTGCGAACACGTA-1_V12D07-335_A1,4,1,1,0,0,6
ACACAAATATTCCTAG-1_V12D07-335_A1,0,1,6,0,0,7
TTGGGTTTATTCAGCG-1_V12D07-335_A1,4,1,5,0,0,10
ATTCGCAGAGGACACT-1_V12D07-335_A1,4,0,3,0,0,7
GATTTAGTGCGTACTG-1_V12D07-335_A1,0,0,0,0,0,0
TAGAAACACAATAGTG-1_V12D07-335_A1,0,0,2,0,0,2
CAGTAGATGATGTCCG-1_V12D07-335_A1,0,0,2,0,0,2
TCTTAACTCGGATGTA-1_V12D07-335_A1,1,1,1,0,0,3
TACATCTTGTTTCTTG-1_V12D07-335_A1,0,0,1,0,0,1
TTCATAGGGTGTCCAT-1_V12D07-335_A1,2,1,0,0,0,3
TGAAGTAGCTTACGGA-1_V12D07-335_A1,0,0,1,0,0,1
GCACAAGTGGATCATA-1_V12D07-335_A1,0,0,1,0,0,1
GGGCGAATTTCTCCAC-1_V12D07-335_A1,0,0,2,0,0,2
ATGTTCCTGCCCACCT-1_V12D07-335_A1,0,0,1,0,0,1
GCTCAACCTCTTAGAG-1_V12D07-335_A1,0,0,0,0,0,0
ATAGCTGCTCTTGTTA-1_V12D07-335_A1,0,1,2,14,0,17
CGTCAGCTATTTACTC-1_V12D07-335_A1,0,0,2,14,0,16
ATCTGATAGTGTCTTA-1_V12D07-335_A1,0,0,2,2,0,4
TGCACTATGTGAGTGC-1_V12D07-335_A1,2,0,3,0,0,5
CCGACAAACACATGAG-1_V12D07-335_A1,0,0,4,1,0,5
GCCTTGTATATGCAGT-1_V12D07-335_A1,2,0,1,0,0,3
ATAATACCGTTAGCCG-1_V12D07-335_A1,0,2,6,0,0,8
ACACTCCAATGTCACT-1_V12D07-335_A1,1,0,1,1,0,3
AGTTGCTGACTGATAT-1_V12D07-335_A1,0,0,2,2,0,4
GGCGCTCCTCATCAAT-1_V12D07-335_A1,0,0,1,1,0,2
TGCCTGACATCGGTCA-1_V12D07-335_A1,0,1,0,15,0,16
TTGGCCATCTTGCGCT-1_V12D07-335_A1,0,0,3,17,0,20
CAGTGGTTGCACATGA-1_V12D07-335_A1,1,0,2,2,0,5
AGAATTGTTTGACATA-1_V12D07-335_A1,0,0,2,0,0,2
AAATGCTCGTTACGTT-1_V12D07-335_A1,0,0,2,0,0,2
CACCTAATAGAGTCGT-1_V12D07-335_A1,1,0,1,0,0,2
CATTTCTAGCAGACTA-1_V12D07-335_A1,1,0,2,0,0,3
CCGAAAGTGGTGAGCA-1_V12D07-335_A1,0,0,0,0,0,0
AGTCAGCCACCGCCTG-1_V12D07-335_A1,2,1,0,0,0,3
TCATCACTCGAGCTCG-1_V12D07-335_A1,2,0,1,0,0,3
CTCAGGACTCACCTGT-1_V12D07-335_A1,1,0,2,0,0,3
CGGTGTACTTGATCCC-1_V12D07-335_A1,3,0,0,0,0,3
CCTACGGCTCAGTCGA-1_V12D07-335_A1,2,0,1,0,0,3
GTACTTGGGCACTTCT-1_V12D07-335_A1,1,0,3,0,0,4
TGATTTCCTCCTGACG-1_V12D07-335_A1,7,0,0,0,0,7
CCTCACCAATCTTGAC-1_V12D07-335_A1,2,0,2,0,0,4
GGTGAGATGCAGATAA-1_V12D07-335_A1,0,0,1,0,0,1
GCTAGTTTCATTGAGG-1_V12D07-335_A1,1,0,1,0,0,2
AGGACATCGCACGTCG-1_V12D07-335_A1,0,0,3,0,0,3
GTGGACGTGCTGAGAC-1_V12D07-335_A1,0,0,3,0,0,3
TAAGGAACTTGTGGGA-1_V12D07-335_A1,0,0,0,0,0,0
TCGCTGTGCGTAAATC-1_V12D07-335_A1,0,0,1,0,0,1
GCATCCCTAACTTTGA-1_V12D07-335_A1,0,0,2,0,0,2
CACCCACACGTCACCC-1_V12D07-335_A1,1,0,1,0,0,2
CCCTCATTCTGGAATT-1_V12D07-335_A1,1,0,2,0,0,3
AGGGCGTGATCGGCTA-1_V12D07-335_A1,1,0,2,0,0,3
GGTGCGGATAAGTGGC-1_V12D07-335_A1,0,0,0,17,0,17
TAATATTGAAATTCGC-1_V12D07-335_A1,1,0,1,18,0,20
CTTACACTGGGAAATA-1_V12D07-335_A1,1,1,2,4,0,8
ACCAAGAACGCGTGTC-1_V12D07-335_A1,0,0,3,0,0,3
GCCTTCAGCCCTACCG-1_V12D07-335_A1,1,1,3,0,0,5
GATGCTACAAGCGCCT-1_V12D07-335_A1,2,1,1,0,0,4
CCGGGACCCGCAGAGA-1_V12D07-335_A1,1,0,3,0,0,4
GTTCCAGTCTGACCAT-1_V12D07-335_A1,0,0,4,0,0,4
ATGATCGGGAATAGAC-1_V12D07-335_A1,0,0,13,0,0,13
TTGGATTGGGTACCAC-1_V12D07-335_A1,1,0,2,0,0,3
TACCTCACGCTTGTAC-1_V12D07-335_A1,0,0,1,12,0,13
CATGGCAGGAAGATCG-1_V12D07-335_A1,0,0,1,1,0,2
ATGACGCCGGCTCTAA-1_V12D07-335_A1,0,0,1,19,0,20
AGCGACATCCCATTCA-1_V12D07-335_A1,0,0,1,5,0,6
AGTAATGTCTTGCCGC-1_V12D07-335_A1,0,0,2,17,0,19
TTCTTAGTGGCTCAGA-1_V12D07-335_A1,1,1,1,7,0,10
CGTCTGGAAGGGCCCG-1_V12D07-335_A1,0,0,1,0,0,1
ACGTGCGCCTCGTGCA-1_V12D07-335_A1,1,1,3,14,0,19
AGAGCGGGCTAATCAT-1_V12D07-335_A1,0,0,1,2,0,3
GCGTCGAAATGTCGGT-1_V12D07-335_A1,0,1,3,18,0,22
AACTGATATTAGGCCT-1_V12D07-335_A1,0,0,0,0,0,0
CGAGCTGGGCTTTAGG-1_V12D07-335_A1,1,0,0,20,0,21
GGGTGTTTCAGCTATG-1_V12D07-335_A1,0,0,3,4,0,7
TTAATTTCAGACGCGG-1_V12D07-335_A1,1,0,2,12,0,15
ACTGCCGTCGTAACTC-1_V12D07-335_A1,0,0,0,9,0,9
GTGCACGAAAGTGACT-1_V12D07-335_A1,2,1,0,9,0,12
ATCTCCCTGCAATCTA-1_V12D07-335_A1,1,0,0,22,0,23
ACGCCAGATGATTTCT-1_V12D07-335_A1,0,0,1,5,0,6
AGCTATTTAATCCAAC-1_V12D07-335_A1,0,0,2,19,0,21
CCACGAGAAGAGAATC-1_V12D07-335_A1,1,1,0,0,0,2
GATTCCGCGTTTCCGT-1_V12D07-335_A1,0,0,4,6,0,10
GTCGGATGTAGCGCGC-1_V12D07-335_A1,0,1,1,0,0,2
TATTTATACCGAGTAG-1_V12D07-335_A1,0,0,0,2,0,2
GTAGGTGATCCGTGTA-1_V12D07-335_A1,0,1,1,1,0,3
AGTTAAGCGGTCCCGG-1_V12D07-335_A1,0,1,7,0,0,8
CTGGCGACATAAGTCC-1_V12D07-335_A1,1,0,1,0,0,2
TTGGCCTAGAATTTCG-1_V12D07-335_A1,0,0,3,0,0,3
GGCATATCGGTTCTGC-1_V12D07-335_A1,1,0,2,0,0,3
GGGCGTCCACTGGCTC-1_V12D07-335_A1,4,1,1,0,0,6
TTACCCATTGCCGGGT-1_V12D07-335_A1,1,0,0,0,0,1
TTAGACACGATCGTTG-1_V12D07-335_A1,1,4,3,1,0,9
GCGCTGATCCAGACTC-1_V12D07-335_A1,2,1,0,1,0,4
TTCGGCAACCCGCTGA-1_V12D07-335_A1,1,1,1,2,0,5
GATATTTCCTACATGG-1_V12D07-335_A1,2,1,1,1,0,5
CTGCGTTACGATATAA-1_V12D07-335_A1,0,0,2,16,0,18
TAATAAACAAGGAGAT-1_V12D07-335_A1,0,0,3,8,0,11
AACCTTTACGACGTCT-1_V12D07-335_A1,1,0,0,14,0,15
AGTCCCGCCTTTAATT-1_V12D07-335_A1,0,0,0,25,0,25
TGAGATTAGGCCCTAA-1_V12D07-335_A1,0,0,2,0,0,2
AGTGTATTGCGCATTG-1_V12D07-335_A1,1,0,2,1,0,4
GTTGGATTCAGTGGCT-1_V12D07-335_A1,0,1,0,0,0,1
TAAAGCTGCAATAGGG-1_V12D07-335_A1,0,0,1,0,0,1
AGTAGGAAGGAAGTTG-1_V12D07-335_A1,0,0,2,0,0,2
TATCACTTCGAGTAAC-1_V12D07-335_A1,1,0,1,0,0,2
TGATCTACGCTGATCT-1_V12D07-335_A1,0,0,1,0,0,1
GGATCATCCCGTACGC-1_V12D07-335_A1,0,0,3,0,0,3
TGACACTTCTCTTTGC-1_V12D07-335_A1,0,0,2,0,0,2
AGCCCTTCTAATCCGA-1_V12D07-335_A1,0,1,2,0,0,3
CACCGCGTCCACTCTA-1_V12D07-335_A1,0,0,1,0,0,1
TAATTGGAATCGGGAA-1_V12D07-335_A1,3,0,1,0,0,4
TCGTAAGCTCCGAGGA-1_V12D07-335_A1,2,1,0,0,0,3
TATATTACAAATGTCG-1_V12D07-335_A1,2,1,3,0,0,6
CGCGAGAGGGACTTGT-1_V12D07-335_A1,0,0,0,0,0,0
GGACCTACGGTAACGT-1_V12D07-335_A1,4,0,1,0,0,5
GAAATATGCTTGAATG-1_V12D07-335_A1,3,0,1,0,0,4
CCGTATTAGCGCAGTT-1_V12D07-335_A1,2,0,1,0,0,3
AGGCGTCTATGGACGG-1_V12D07-335_A1,1,0,0,0,0,1
AACATCGATACGTCTA-1_V12D07-335_A1,3,0,1,0,0,4
TGAATATGCTATAAAC-1_V12D07-335_A1,1,2,1,0,0,4
ACCAAACACCCAGCGA-1_V12D07-335_A1,5,0,0,0,0,5
TGGCTTGTACAAGCTT-1_V12D07-335_A1,3,0,4,0,0,7
GAATGAAGGTCTTCAG-1_V12D07-335_A1,0,0,2,0,0,2
AGATACCAGCACTTCA-1_V12D07-335_A1,2,0,4,0,0,6
GCGGTCCCGGTGAAGG-1_V12D07-335_A1,1,0,2,1,0,4
GAGGCATTTGCAGCAG-1_V12D07-335_A1,2,0,3,0,0,5
GGCAAGCCAGGGATAG-1_V12D07-335_A1,2,0,0,0,0,2
TCTACGGGCTCAGTTG-1_V12D07-335_A1,0,1,2,0,0,3
TCTGCGAATCGTTCGC-1_V12D07-335_A1,1,0,1,0,0,2
AGCTCGTTGATGGAAA-1_V12D07-335_A1,5,0,0,0,0,5
TGAATGAGATACAGCA-1_V12D07-335_A1,2,0,3,0,0,5
ACCCTTGCCTGGGTCG-1_V12D07-335_A1,6,2,2,0,0,10
GGCGAACCGTTCTGAT-1_V12D07-335_A1,3,1,1,0,0,5
GCGATGTCTGTGCTTG-1_V12D07-335_A1,1,0,1,0,0,2
ATTAACACCTGAGATA-1_V12D07-335_A1,0,0,2,0,0,2
GAAATCTGACCAAGTT-1_V12D07-335_A1,0,0,0,0,0,0
CCTGACAAACTCGCGC-1_V12D07-335_A1,0,0,1,0,0,1
ATGTCATTTCCCATTG-1_V12D07-335_A1,0,0,1,0,0,1
GCGGTGCGGAGCATCG-1_V12D07-335_A1,1,0,3,0,0,4
CGGAAAGCAAATGTGC-1_V12D07-335_A1,0,0,0,0,0,0
GCTGAGCAACGGTTCT-1_V12D07-335_A1,0,0,1,1,0,2
TCACTCTTCGTCTGTC-1_V12D07-335_A1,0,0,1,0,0,1
GATCTTCATTGTCCTC-1_V12D07-335_A1,0,0,1,0,0,1
ACTCGATGTATTTCAT-1_V12D07-335_A1,0,0,2,5,0,7
TGAAGAGCGGTCCTAG-1_V12D07-335_A1,0,1,1,13,0,15
TAAACGTCGTCAATGA-1_V12D07-335_A1,1,0,4,1,0,6
ACGTTATTGGTCACTC-1_V12D07-335_A1,0,1,0,0,0,1
ATAGCCTCAGTACCCA-1_V12D07-335_A1,1,0,2,0,0,3
CGGGAGTATACCGCCG-1_V12D07-335_A1,1,0,1,1,0,3
GTCCTACAGGCGGCTC-1_V12D07-335_A1,3,0,0,2,0,5
CGGATAAGCGGACATG-1_V12D07-335_A1,0,0,1,0,0,1
AACTTCTGCGTCTATC-1_V12D07-335_A1,1,0,0,0,0,1
GGGTTCAGACGAACAA-1_V12D07-335_A1,0,0,1,1,0,2
AGTCTGGACATCCTTG-1_V12D07-335_A1,0,0,2,0,0,2
TTGAACGAATCCTTTG-1_V12D07-335_A1,0,0,1,1,0,2
GAAATACTAAACGTTT-1_V12D07-335_A1,0,0,0,17,0,17
CCCGCGCAATGCACCC-1_V12D07-335_A1,1,0,5,11,0,17
TTCGGCTAGAGATGGT-1_V12D07-335_A1,1,0,3,0,0,4
GACACGAGTTAGAGGA-1_V12D07-335_A1,2,0,1,1,0,4
GAGGTCCCAAAGATCT-1_V12D07-335_A1,0,0,1,0,0,1
TAACTCCATGGAGGCT-1_V12D07-335_A1,0,0,1,0,0,1
CTTGTTTATGTAGCCA-1_V12D07-335_A1,0,0,1,0,0,1
GATGGCGCACACATTA-1_V12D07-335_A1,0,0,2,0,0,2
ATAATAGTGTAGGGAC-1_V12D07-335_A1,2,0,1,0,0,3
CGCTATTCAATGTATG-1_V12D07-335_A1,0,0,1,0,0,1
ATATTGCTGTCAAAGT-1_V12D07-335_A1,1,0,2,0,0,3
GGATTCAGTACGGTGG-1_V12D07-335_A1,0,0,2,0,0,2
TTCTTAGTGAACGGTG-1_V12D07-335_A1,3,0,2,1,0,6
AATGGTTCTCACAAGC-1_V12D07-335_A1,2,0,0,0,0,2
TATACACGCAAAGTAT-1_V12D07-335_A1,2,0,1,0,0,3
CTTCATAGCTCAAGAA-1_V12D07-335_A1,0,0,3,0,0,3
CAACGGTTCTTGATAC-1_V12D07-335_A1,0,0,2,0,0,2
ACACCCGAGAAATCCG-1_V12D07-335_A1,0,0,2,0,0,2
TCTATCATGCAGTTAC-1_V12D07-335_A1,0,0,1,0,0,1
CCCGCCATGCTCCCGT-1_V12D07-335_A1,0,0,1,0,0,1
CGCTTCCACTGAAATC-1_V12D07-335_A1,0,0,2,0,0,2
CACTGTCCAAGTGAGA-1_V12D07-335_A1,0,0,1,0,0,1
ATTACTAGCCTCTTGC-1_V12D07-335_A1,0,0,2,0,0,2
CATAGTAGCATAGTAG-1_V12D07-335_A1,0,0,2,0,0,2
CAACTCCTTGATCCCG-1_V12D07-335_A1,1,0,0,2,0,3
AAGTAGAAGACCGGGT-1_V12D07-335_A1,2,0,2,5,0,9
GCGGGAACCAGGCCCT-1_V12D07-335_A1,0,0,0,20,0,20
ATTAGATTGATAGCGG-1_V12D07-335_A1,0,0,2,12,0,14
CTCGGTCCGTAGCCTG-1_V12D07-335_A1,0,0,1,2,0,3
TGGCTTTGGGTAGACA-1_V12D07-335_A1,1,0,1,0,0,2
TATCCATATCATGCGA-1_V12D07-335_A1,1,0,3,0,0,4
GGAGTGCCGCCCTGGA-1_V12D07-335_A1,1,0,2,0,0,3
TGAGAATGCTTTACCG-1_V12D07-335_A1,3,0,5,1,0,9
TTAACCAACCCTCCCT-1_V12D07-335_A1,0,0,1,1,0,2
TGTTTCGGTACTTCTC-1_V12D07-335_A1,2,2,2,1,0,7
TTGCTGAAGGAACCAC-1_V12D07-335_A1,0,0,1,0,0,1
TATTTAGTCTAGATCG-1_V12D07-335_A1,0,1,1,0,0,2
CTCCGGCCTAATATGC-1_V12D07-335_A1,1,0,2,0,0,3
TTGTGGCCCTGACAGT-1_V12D07-335_A1,1,1,1,0,0,3
TCGCCGGTCGATCCGT-1_V12D07-335_A1,3,0,1,0,0,4
CCATAGGTTGGCGTGG-1_V12D07-335_A1,0,0,0,0,0,0
GAACGACCGAATGATA-1_V12D07-335_A1,1,0,3,0,0,4
TCCGATAATTGCCATA-1_V12D07-335_A1,2,0,2,1,0,5
CATTACGTCGGCCCGT-1_V12D07-335_A1,0,0,2,0,0,2
CAAGCACCAAATGCCT-1_V12D07-335_A1,1,0,1,0,0,2
TGCATGGATCGGATCT-1_V12D07-335_A1,1,2,0,0,0,3
GAAATCGCGCGCAACT-1_V12D07-335_A1,0,0,2,1,0,3
CTGAAAGAGATCCGAC-1_V12D07-335_A1,1,0,3,0,0,4
CACCTCGATGGTGGAC-1_V12D07-335_A1,1,0,3,0,0,4
ATTTGTTCCAGGGCTC-1_V12D07-335_A1,1,0,2,0,0,3
TGGGCCACAAGAGCGC-1_V12D07-335_A1,2,0,2,0,0,4
CCTTCTTGATCCAGTG-1_V12D07-335_A1,0,0,4,0,0,4
CCTCGCCAGCAAATTA-1_V12D07-335_A1,1,0,0,0,0,1
TTCATGGCGCAACAGG-1_V12D07-335_A1,0,0,0,0,0,0
TTAATCAGTACGTCAG-1_V12D07-335_A1,1,0,3,0,0,4
CCTATCTATATCGGAA-1_V12D07-335_A1,1,0,3,0,0,4
ATTATACTTTGCTCGT-1_V12D07-335_A1,2,0,3,0,0,5
ATGGATCCGGCGTCCG-1_V12D07-335_A1,0,0,3,1,0,4
CGCCCGCTTCCGTACA-1_V12D07-335_A1,0,0,0,0,0,0
GGATTCCGCTATACCC-1_V12D07-335_A1,0,0,2,0,0,2
CGGTCTATCAACCCGT-1_V12D07-335_A1,2,0,2,0,0,4
ATGCCGGTTGATGGGA-1_V12D07-335_A1,1,0,0,0,0,1
TCATGCAGGTTCTCAT-1_V12D07-335_A1,1,2,2,0,0,5
TGAGCTTTAATGACGC-1_V12D07-335_A1,0,0,1,0,0,1
TCCCTTAGATTACTCG-1_V12D07-335_A1,1,0,4,0,0,5
ATATCTCCCTCGTTAA-1_V12D07-335_A1,0,1,2,0,0,3
AGCTCTTCCCAGTGCA-1_V12D07-335_A1,0,0,1,0,0,1
TCGCTAAACCGCTATC-1_V12D07-335_A1,1,1,1,0,0,3
CACATTCTTTCGATGG-1_V12D07-335_A1,1,0,2,1,0,4
GATATGCGGTAGCCAA-1_V12D07-335_A1,3,0,1,0,0,4
CGTTTCACTTCGGGCG-1_V12D07-335_A1,0,0,2,2,0,4
CCAATTACGGGTCGAG-1_V12D07-335_A1,0,0,0,0,0,0
GCAGGTAGAGTATGGT-1_V12D07-335_A1,0,0,1,14,0,15
GTCGTATTGGCGTACA-1_V12D07-335_A1,0,0,0,12,0,12
GAAATTAGCACGGATA-1_V12D07-335_A1,0,0,2,5,0,7
AATGCACCAAGCAATG-1_V12D07-335_A1,1,0,5,10,0,16
AGGACGCTCGATGTTG-1_V12D07-335_A1,0,0,0,0,0,0
GGCTAAAGGGCGGGTC-1_V12D07-335_A1,0,0,2,0,0,2
CATCTATCCCGTGTCT-1_V12D07-335_A1,0,1,1,0,0,2
CAGTAACTATTTATTG-1_V12D07-335_A1,0,0,1,0,0,1
CATATACTACTGATAA-1_V12D07-335_A1,0,0,2,0,0,2
GCGTTCGGAGACCGGG-1_V12D07-335_A1,0,0,0,0,0,0
AAGTTCAGTCTGCGTA-1_V12D07-335_A1,2,0,1,0,0,3
CGAAGCTATAAATTCA-1_V12D07-335_A1,1,2,2,0,0,5
CGCGGTCACAAACCAA-1_V12D07-335_A1,1,0,2,0,0,3
GGGAATGAGCCCTCAC-1_V12D07-335_A1,0,0,2,0,0,2
ACGGAGCGCAAATTAC-1_V12D07-335_A1,7,1,2,0,0,10
CGTTCTTCGCACACCT-1_V12D07-335_A1,0,0,0,0,0,0
GAATAGCCCTGCGGTC-1_V12D07-335_A1,4,0,1,0,0,5
AATAGCTACCGCGTGC-1_V12D07-335_A1,0,0,4,0,0,4
CCGAGCTGTGCTTGTC-1_V12D07-335_A1,2,1,2,0,0,5
GATGACGATGATCGCG-1_V12D07-335_A1,0,0,2,0,0,2
GCCTATGCTGGGCCTT-1_V12D07-335_A1,2,0,0,0,0,2
TTACTGTCTAGAGCTC-1_V12D07-335_A1,2,0,0,0,0,2
AGCGGTTGCCGCTCTG-1_V12D07-335_A1,2,0,0,0,0,2
GCTTGCAGCACAATTG-1_V12D07-335_A1,4,0,2,0,0,6
CCGGAGGTCTTATGGT-1_V12D07-335_A1,1,1,1,0,0,3
ACAGTATACCGTGGGA-1_V12D07-335_A1,3,1,3,0,0,7
GGGATCCCAATACAAA-1_V12D07-335_A1,1,1,2,0,0,4
ATTACGACTCCACAGT-1_V12D07-335_A1,3,1,7,0,0,11
CTCACACGCAAGCCTA-1_V12D07-335_A1,4,0,3,0,0,7
CCAGATGTAAATGGGT-1_V12D07-335_A1,3,0,2,0,0,5
GAACTTGTGCACGGGA-1_V12D07-335_A1,3,0,2,0,0,5
AAGCCGCTTTACCTTG-1_V12D07-335_A1,2,2,2,1,0,7
TCCATTCCCACTAGAG-1_V12D07-335_A1,3,0,0,0,0,3
AGAGCGCTTGTAACGG-1_V12D07-335_A1,0,0,4,0,0,4
TGGGTTCCCGGACGGA-1_V12D07-335_A1,0,0,3,6,0,9
GCTGCGCCTCCCACGT-1_V12D07-335_A1,0,0,1,7,0,8
CTGTTGGCTCTTCTGA-1_V12D07-335_A1,0,0,4,0,0,4
TTGTTCTAGATACGCT-1_V12D07-335_A1,0,0,2,16,0,18
CCCTCAAGCTCTTAGT-1_V12D07-335_A1,0,0,0,0,0,0
TGGTCTAGCTTACATG-1_V12D07-335_A1,0,0,5,6,0,11
ATGCACCTTCCTTAAT-1_V12D07-335_A1,1,0,2,0,0,3
GGGATACGGTAATAAT-1_V12D07-335_A1,0,0,4,5,0,9
AGTTCACCGGTTGGAC-1_V12D07-335_A1,0,0,1,0,0,1
GACATACTGTCGCAGA-1_V12D07-335_A1,0,0,2,8,0,10
TGGACACCGTTGCTTG-1_V12D07-335_A1,1,1,5,17,0,24
TGCGATGCTAATGGCT-1_V12D07-335_A1,0,0,1,0,0,1
TTCTGTTTCCTGTCGC-1_V12D07-335_A1,0,0,1,0,0,1
CGTTGTAAACGTCAGG-1_V12D07-335_A1,2,0,0,3,0,5
GATCGGCGATAAGTCG-1_V12D07-335_A1,1,0,2,1,0,4
AGCCTTAAAGCGGAAG-1_V12D07-335_A1,0,0,0,0,0,0
TCCGTAACCACAATCC-1_V12D07-335_A1,0,1,5,1,0,7
GAATGCCGAAATGACC-1_V12D07-335_A1,0,0,0,1,0,1
TATACTCATGCGGCAA-1_V12D07-335_A1,0,0,0,1,0,1
TAGTGTCAGAAACGGC-1_V12D07-335_A1,0,0,3,1,0,4
CGTCATACCATATCCA-1_V12D07-335_A1,1,0,3,0,0,4
TAGTACCTTAGTGGTC-1_V12D07-335_A1,1,0,5,0,0,6
CTGGCGGGAATAAGTA-1_V12D07-335_A1,0,0,1,0,0,1
AGTGTGGTCTATTGTG-1_V12D07-335_A1,0,0,4,3,0,7
GCTATCGCGGCGCAAC-1_V12D07-335_A1,0,1,0,18,0,19
CAGTAATCCCTCCCAG-1_V12D07-335_A1,0,0,3,20,0,23
GTATTAAGGCGTCTAA-1_V12D07-335_A1,0,0,1,0,0,1
CTAATTTCAACAACAC-1_V12D07-335_A1,0,0,1,0,0,1
TTAGCAACATGGATGT-1_V12D07-335_A1,0,0,1,0,0,1
ATGCTCAGTGTTGCAT-1_V12D07-335_A1,0,0,4,0,0,4
GATGTTTGTGCGAGAT-1_V12D07-335_A1,2,0,0,0,0,2
CACTTCGCCACAGGCT-1_V12D07-335_A1,1,0,4,0,0,5
CTGTATGGTGTAGAAA-1_V12D07-335_A1,2,1,0,0,0,3
TACGTGCACTATGCTG-1_V12D07-335_A1,1,0,1,0,0,2
GTATCAGCTTGGGTTC-1_V12D07-335_A1,0,1,2,0,0,3
TAACAAAGGGAGAAGC-1_V12D07-335_A1,0,0,0,0,0,0
TTACATCGTGGCCTGG-1_V12D07-335_A1,0,0,1,0,0,1
TCTGAACCGGTCGGCT-1_V12D07-335_A1,0,0,1,0,0,1
GGCTCGTGCCACCAGC-1_V12D07-335_A1,0,0,3,0,0,3
TATAAGTGAGGATAGC-1_V12D07-335_A1,0,0,0,0,0,0
GCCCGCGCGTTTGACA-1_V12D07-335_A1,0,0,0,0,0,0
TGCTGGTTGGACAATT-1_V12D07-335_A1,1,0,0,0,0,1
GCCTAGCGATCTGACC-1_V12D07-335_A1,0,0,1,0,0,1
CCATGCTCTGCAGGAA-1_V12D07-335_A1,0,0,0,0,0,0
TATAAATCCACAAGCT-1_V12D07-335_A1,0,0,1,0,0,1
CGCTCGACATAATGAT-1_V12D07-335_A1,0,0,1,0,0,1
CCAATTGAATGTTAAT-1_V12D07-335_A1,0,0,1,0,0,1
GCTAATACCGAATGCC-1_V12D07-335_A1,0,0,0,0,0,0
TTCAACGACCCGACCG-1_V12D07-335_A1,0,0,0,17,0,17
TTCCTCGAGGGTGTCT-1_V12D07-335_A1,0,0,0,25,0,25
CAACGACCCGTTTACA-1_V12D07-335_A1,1,0,4,3,0,8
CTTGTACTTGTTGACT-1_V12D07-335_A1,3,0,2,0,0,5
TCTCTAATAGCTGGTA-1_V12D07-335_A1,1,0,0,0,0,1
ATTATGCCATAGGGAG-1_V12D07-335_A1,2,0,1,1,0,4
GACAACGCAGCTTACG-1_V12D07-335_A1,0,0,0,0,0,0
AGATGACTCGCCCACG-1_V12D07-335_A1,1,0,2,1,0,4
GTGCGGGTCTCCAAAT-1_V12D07-335_A1,1,0,0,0,0,1
GTACGAGATTGCGACA-1_V12D07-335_A1,0,1,2,0,0,3
GTATAGGACTCAGTAG-1_V12D07-335_A1,1,0,3,0,0,4
TTGCACGGAGCAGCAC-1_V12D07-335_A1,0,0,0,0,0,0
CACAGCTAGGGAGTGA-1_V12D07-335_A1,0,0,2,0,0,2
ATACTAGCATGACCCT-1_V12D07-335_A1,0,0,4,0,0,4
CCAAGACTTCTGCGAA-1_V12D07-335_A1,0,2,1,0,0,3
ACATAATAAGGCGGTG-1_V12D07-335_A1,0,0,1,0,0,1
TAATACACAGTAGTAT-1_V12D07-335_A1,0,0,1,1,0,2
TCTTGGTAACACCAAA-1_V12D07-335_A1,1,1,2,0,0,4
AACTGGGTCCCGACGT-1_V12D07-335_A1,1,1,0,1,0,3
ATCACTTCATCCTCGC-1_V12D07-335_A1,0,2,2,0,0,4
TGGAAGGATAAAGATG-1_V12D07-335_A1,1,0,1,0,0,2
CATGATGCACAATTCT-1_V12D07-335_A1,1,1,1,0,0,3
TGCCTGATCAAACGAT-1_V12D07-335_A1,0,0,1,0,0,1
ATAGGGATATCCTTGA-1_V12D07-335_A1,1,0,2,1,0,4
CACCTAATCAGTTTAC-1_V12D07-335_A1,1,0,4,1,0,6
TGTGACTACGCCAGTC-1_V12D07-335_A1,1,1,2,0,0,4
CCCGACCATAGTCCGC-1_V12D07-335_A1,1,0,1,1,0,3
CGCGCCCGACTTAATA-1_V12D07-335_A1,1,0,1,0,0,2
TGCCACCTGGCGAAAC-1_V12D07-335_A1,1,0,2,0,0,3
CTGCCAAGGTTGGAAG-1_V12D07-335_A1,0,1,2,0,0,3
TCTCCAACGTAGGTTA-1_V12D07-335_A1,2,2,1,1,0,6
TTCTTGGAGTAATGAG-1_V12D07-335_A1,0,0,1,0,0,1
GTCTCGATCTGCTTTC-1_V12D07-335_A1,1,1,0,3,0,5
TACTCTCCGAACAAAT-1_V12D07-335_A1,2,0,3,0,0,5
ATCACATTAGAATATC-1_V12D07-335_A1,2,1,3,0,0,6
TACGGGATGCTAGCAG-1_V12D07-335_A1,0,0,1,0,0,1
AGCTGAAGTAAACCAA-1_V12D07-335_A1,0,0,2,0,0,2
CATGGGTCGGGTGTGG-1_V12D07-335_A1,2,1,3,0,0,6
CACCCACGAGGCAATT-1_V12D07-335_A1,4,0,2,0,0,6
TGCCATTACTAAAGAA-1_V12D07-335_A1,0,0,2,1,0,3
CCGTTACGTTAGAACA-1_V12D07-335_A1,0,0,0,0,0,0
GCCAGGAGTAACCGAT-1_V12D07-335_A1,2,2,4,0,0,8
GGAAAGTGCCCATGCC-1_V12D07-335_A1,0,0,2,0,0,2
TCTTACCGGAACTCGT-1_V12D07-335_A1,2,1,2,0,0,5
TATGTCAAGACCGACT-1_V12D07-335_A1,0,0,1,0,0,1
CCTAACTAAGGCTCTA-1_V12D07-335_A1,0,0,1,0,0,1
GCGGTGAACTGCGCTC-1_V12D07-335_A1,1,0,2,0,0,3
CCTCGCGCGATATAGG-1_V12D07-335_A1,0,1,0,0,0,1
ATCGGCAAGCAGTCCA-1_V12D07-335_A1,2,0,1,5,0,8
AGATCGTGCATAAGAT-1_V12D07-335_A1,0,0,0,2,0,2
ATTCAGGACCTATTTC-1_V12D07-335_A1,0,1,1,14,0,16
AGCTAGAAGCAGAAGT-1_V12D07-335_A1,0,5,1,11,0,17
TTCGCTATCTGACGTG-1_V12D07-335_A1,0,0,1,0,0,1
TTCCGCAGAGAAATAT-1_V12D07-335_A1,0,0,0,1,0,1
CAGTACATTCTCTAAA-1_V12D07-335_A1,1,0,2,0,0,3
GTGAAGATTTCAAGTG-1_V12D07-335_A1,1,0,1,0,0,2
AACGCATGATCTGGGT-1_V12D07-335_A1,0,0,2,0,0,2
CCCAGAGGAGGGCGTA-1_V12D07-335_A1,0,1,1,0,0,2
GGAAACCTTGTTGAAT-1_V12D07-335_A1,0,0,0,0,0,0
GTGAAGCCGTATAGTC-1_V12D07-335_A1,1,1,2,0,0,4
GAGCTGTCGTCTCGGA-1_V12D07-335_A1,0,0,0,0,0,0
TGTCATTTGTTGGGAA-1_V12D07-335_A1,0,0,3,0,0,3
ACCAACACCACACACT-1_V12D07-335_A1,0,0,1,0,0,1
AAATGATTCGATCAGC-1_V12D07-335_A1,0,0,1,0,0,1
CTGCTTTATGTCCGCG-1_V12D07-335_A1,0,0,2,0,0,2
GCGAGAGGCCATGTAA-1_V12D07-335_A1,0,0,1,0,0,1
ATTGACCGGCGATGAC-1_V12D07-335_A1,0,0,1,0,0,1
ACCCTGGTAACGCCCT-1_V12D07-335_A1,1,0,2,0,0,3
GTTGGACCGCATCAGG-1_V12D07-335_A1,1,0,3,0,0,4
CGTTTACAAGGCAGCT-1_V12D07-335_A1,2,0,2,0,0,4
CGGTCCATGAGACTCC-1_V12D07-335_A1,4,0,0,0,0,4
GTTCGTCTGGGTCCCT-1_V12D07-335_A1,2,0,1,1,0,4
TGTACTACTCTCACGG-1_V12D07-335_A1,1,0,0,0,0,1
AGTGAAGATGGTGTCC-1_V12D07-335_A1,1,0,1,0,0,2
GAGGGCCATAATATTA-1_V12D07-335_A1,4,0,2,0,0,6
ACTCCCGTAGACTAGG-1_V12D07-335_A1,3,0,2,0,0,5
CGTCAAATGGTCGCAG-1_V12D07-335_A1,4,1,2,1,0,8
AAGTCTAGTAGCTGCC-1_V12D07-335_A1,4,1,2,0,0,7
AAGAAATCACCAGATT-1_V12D07-335_A1,5,0,2,1,0,8
GAGTGCACGGACAACA-1_V12D07-335_A1,4,0,2,0,0,6
GTTCAAATCAGATGTC-1_V12D07-335_A1,1,0,1,0,0,2
CATGGCTCCCTATGTC-1_V12D07-335_A1,0,0,1,1,0,2
GGCCACACGAAAGCCT-1_V12D07-335_A1,0,0,0,0,0,0
GAAGCCGGGTAAGCTC-1_V12D07-335_A1,1,0,0,0,0,1
TTGCGCTCTCTCGCTT-1_V12D07-335_A1,0,0,4,3,0,7
TACATGACCTTATCCG-1_V12D07-335_A1,1,0,1,0,0,2
GTCCTTCTACAACCCA-1_V12D07-335_A1,0,1,2,0,0,3
TATATGCTGGGTTGCC-1_V12D07-335_A1,3,1,0,0,0,4
GTTTATGGGATTTAGA-1_V12D07-335_A1,0,0,2,3,0,5
GGAACCCGAACAAGAA-1_V12D07-335_A1,0,0,0,3,0,3
AACGTTATCAGCACCT-1_V12D07-335_A1,0,0,1,0,0,1
CATCGTCCGGTTACTA-1_V12D07-335_A1,0,0,0,1,0,1
AGACAGCTCAGAATCC-1_V12D07-335_A1,1,0,2,0,0,3
GCAGATCCTCGCAAAT-1_V12D07-335_A1,0,0,0,1,0,1
GGGTCATGCGTACCAT-1_V12D07-335_A1,3,1,1,2,0,7
CTGGTCATTCCAATCC-1_V12D07-335_A1,1,0,0,0,0,1
TCAGGGCGCAAACTCG-1_V12D07-335_A1,0,0,1,0,0,1
GATGCCAGCAGAAGGC-1_V12D07-335_A1,0,0,1,2,0,3
GTTATTAACGTGGGAG-1_V12D07-335_A1,0,0,1,0,0,1
AATACAATGTTTCAGG-1_V12D07-335_A1,1,0,1,1,0,3
TTGCTGCACCTATCCA-1_V12D07-335_A1,0,1,1,0,0,2
CCAGAGACAAAGCCGG-1_V12D07-335_A1,0,0,2,1,0,3
CCGAAGTATATTGTTC-1_V12D07-335_A1,0,0,7,0,0,7
GCTAAACCTGAGGTGA-1_V12D07-335_A1,0,2,1,0,0,3
TCATACTTACAGATCC-1_V12D07-335_A1,0,1,0,1,0,2
CGAGCACTTCAAGTTT-1_V12D07-335_A1,0,0,1,0,0,1
TAGCAACCTGTCACAA-1_V12D07-335_A1,0,0,1,15,0,16
TGGGAAATGCCTTTCC-1_V12D07-335_A1,0,0,1,4,0,5
AGACCATGGGATACAA-1_V12D07-335_A1,1,0,1,2,0,4
TAAATGAATCCGTTTC-1_V12D07-335_A1,1,0,5,3,0,9
ACAACGGTCCCTGCGA-1_V12D07-335_A1,0,0,3,0,0,3
GTCACTCTCCAAATCT-1_V12D07-335_A1,0,0,2,1,0,3
TTCTACTTGCGAGGGC-1_V12D07-335_A1,0,0,0,0,0,0
CGCAATTACTTTCGGT-1_V12D07-335_A1,0,0,0,0,0,0
CTGTTCATCTCACGGG-1_V12D07-335_A1,0,0,1,0,0,1
TTCTTGTAACCTAATG-1_V12D07-335_A1,0,0,1,0,0,1
GCTTGATGATAATCAG-1_V12D07-335_A1,2,0,1,1,0,4
TTGGCTCGCATGAGAC-1_V12D07-335_A1,0,0,0,0,0,0
GCCCAGTTGGTATGCC-1_V12D07-335_A1,1,0,1,0,0,2
ATTCCTCCGCCAGTGC-1_V12D07-335_A1,1,0,0,0,0,1
TCGTCCGCTGGCGTCT-1_V12D07-335_A1,0,0,1,0,0,1
GGAGAAGTCATTGGCA-1_V12D07-335_A1,1,0,1,0,0,2
TTGTTAGCAAATTCGA-1_V12D07-335_A1,1,0,1,0,0,2
TCTAGCATCTTCGATG-1_V12D07-335_A1,1,0,1,0,0,2
TTCTAGGCCAATTGTG-1_V12D07-335_A1,0,0,2,0,0,2
TCACGGTCATCGCACA-1_V12D07-335_A1,1,0,2,0,0,3
ATGAAGCCAAGGAGCC-1_V12D07-335_A1,1,0,1,1,0,3
AATGACTGTCAGCCGG-1_V12D07-335_A1,0,0,0,16,0,16
CCAAACAGAACCCTCG-1_V12D07-335_A1,0,0,2,17,0,19
TATCGATGATTAAACG-1_V12D07-335_A1,1,0,3,6,0,10
GAACACACATCAACCA-1_V12D07-335_A1,0,0,0,1,0,1
CCCGTCAGCGTCTGAC-1_V12D07-335_A1,1,0,0,0,0,1
AGCATCGTCGATAATT-1_V12D07-335_A1,0,0,1,0,0,1
GACTAAGATCATGCAC-1_V12D07-335_A1,1,0,2,0,0,3
TAGGGTGTTTCAAGAG-1_V12D07-335_A1,2,0,2,0,0,4
TGGTTCGTAGCAAAGG-1_V12D07-335_A1,0,0,5,1,0,6
CTGTTCACTGCCTGTG-1_V12D07-335_A1,0,1,0,1,0,2
ATGTGCATCCGACGCA-1_V12D07-335_A1,2,0,4,2,0,8
TTGTCGTTCAGTTACC-1_V12D07-335_A1,0,1,3,0,0,4
CGGGATCAATGTAAGA-1_V12D07-335_A1,1,1,1,0,0,3
TTATCTGTATCATAAC-1_V12D07-335_A1,0,0,1,1,0,2
ATCGACTCTTTCCGTT-1_V12D07-335_A1,1,0,1,1,0,3
CTCATTTGATGGGCGG-1_V12D07-335_A1,2,0,1,0,0,3
GTAAGCGGGCAGTCAG-1_V12D07-335_A1,0,0,3,0,0,3
TCTATCGGTCGCAACA-1_V12D07-335_A1,0,0,1,1,0,2
AACGCGGTCTCCAGCC-1_V12D07-335_A1,0,0,2,0,0,2
ATTAATACTACGCGGG-1_V12D07-335_A1,0,0,2,0,0,2
CTTTAACTTTCAAAGG-1_V12D07-335_A1,0,0,1,2,0,3
CGTACCTGATAGGCCT-1_V12D07-335_A1,3,0,1,0,0,4
GAATGTTGGGTAATCT-1_V12D07-335_A1,0,0,1,0,0,1
TGCGGAGTAAAGGTGC-1_V12D07-335_A1,0,0,1,0,0,1
CCTGAATATTTACATA-1_V12D07-335_A1,0,0,3,0,0,3
TTGCTCCCATACCGGA-1_V12D07-335_A1,0,0,3,0,0,3
CCTCTAATCTGCCAAG-1_V12D07-335_A1,1,0,1,1,0,3
AGGTTGAGGCACGCTT-1_V12D07-335_A1,1,0,0,0,0,1
TCCCGTCAGTCCCGCA-1_V12D07-335_A1,1,0,0,0,0,1
TCCGATGACTGAGCTC-1_V12D07-335_A1,0,0,1,1,0,2
CAGCCTCCTGCAGAGG-1_V12D07-335_A1,0,0,1,0,0,1
CTTAGCCTTCCACATG-1_V12D07-335_A1,1,0,1,0,0,2
ATTAATGAACCAGTCG-1_V12D07-335_A1,0,1,0,0,0,1
ACGATACATAGAACTA-1_V12D07-335_A1,2,0,1,0,0,3
AGCCACTCCCGTGCTT-1_V12D07-335_A1,0,0,1,0,0,1
ATACGGGTTTCGATTG-1_V12D07-335_A1,0,1,3,0,0,4
CTGTCAAATGGCTCGG-1_V12D07-335_A1,1,0,1,0,0,2
GCTCGGAATTTAAAGC-1_V12D07-335_A1,1,0,3,1,0,5
TAGGCATGTTACGCCA-1_V12D07-335_A1,1,0,1,0,0,2
TGGCAACTCGCGCGCC-1_V12D07-335_A1,1,0,2,0,0,3
ATCAGTAGGCAGGGAT-1_V12D07-335_A1,3,0,2,0,0,5
TATCGATCTATGCATA-1_V12D07-335_A1,0,0,3,1,0,4
CGACTCAGGATGTTAT-1_V12D07-335_A1,2,0,1,1,0,4
GCCATATTGCACACAG-1_V12D07-335_A1,2,0,2,0,0,4
AATTCATAAGGGATCT-1_V12D07-335_A1,1,0,1,0,0,2
CGGTAGAGGTGCAGGT-1_V12D07-335_A1,1,0,0,1,0,2
AATGATGATACGCTAT-1_V12D07-335_A1,0,1,3,0,0,4
CTTGTGCTCACCGATT-1_V12D07-335_A1,0,1,3,0,0,4
TTCCAATCAGAGCTAG-1_V12D07-335_A1,1,0,1,0,0,2
CGATGGACCCTACGCC-1_V12D07-335_A1,0,0,3,0,0,3
GGTCGGATAAACGGCG-1_V12D07-335_A1,0,0,2,1,0,3
TTAGCTAATACGATCT-1_V12D07-335_A1,1,1,0,1,0,3
CTCGATATTTGCGAGC-1_V12D07-335_A1,1,0,0,2,0,3
ATTACTTACTGGGCAT-1_V12D07-335_A1,1,1,4,13,0,19
CTAGCCGATGTTATGA-1_V12D07-335_A1,0,0,3,4,0,7
TACTGCAATCAATTAC-1_V12D07-335_A1,0,0,2,5,0,7
TAGTCTGTGACGTTGC-1_V12D07-335_A1,0,0,1,15,0,16
CTCGTTTCTAATGTTT-1_V12D07-335_A1,2,0,2,0,0,4
TTCGTTCAACGAAGTT-1_V12D07-335_A1,0,0,2,0,0,2
CTGAATTTATTGCCAG-1_V12D07-335_A1,2,0,4,0,0,6
TGGAATATCCTTGACC-1_V12D07-335_A1,0,0,0,0,0,0
CAGATCATTTAAAGTC-1_V12D07-335_A1,0,0,1,0,0,1
CTCCTTTACGCAAGTC-1_V12D07-335_A1,0,0,1,0,0,1
TCCCAAACAGACAACG-1_V12D07-335_A1,2,0,1,0,0,3
ATCGCTGCGTGCAGCA-1_V12D07-335_A1,1,0,0,0,0,1
TTAGTTCAAGTGTTCG-1_V12D07-335_A1,0,0,1,0,0,1
AAACTCGTGATATAAG-1_V12D07-335_A1,0,0,3,0,0,3
TTAACGAACAAGCAGT-1_V12D07-335_A1,1,0,2,0,0,3
GTTATATCAGGAGCCA-1_V12D07-335_A1,0,0,1,0,0,1
CAAATTGGATTATGCC-1_V12D07-335_A1,0,0,0,0,0,0
CGAGGAGCTTCCATAT-1_V12D07-335_A1,1,0,1,0,0,2
GGAGACCAATGTGCTT-1_V12D07-335_A1,2,1,0,0,0,3
CATTGATGAACACGCC-1_V12D07-335_A1,2,0,3,0,0,5
GTCAATGCTATAATTT-1_V12D07-335_A1,3,0,1,0,0,4
ACCACCCTCTCTTCTA-1_V12D07-335_A1,1,0,1,0,0,2
TGGAGGGAAACACCTC-1_V12D07-335_A1,2,1,1,0,0,4
CACGGACGTGGATGGC-1_V12D07-335_A1,2,2,1,0,0,5
AACTTTCTCGATCATG-1_V12D07-335_A1,3,2,3,0,0,8
CGTATTGTTTCCTAAT-1_V12D07-335_A1,0,0,4,0,0,4
CCTACTGCGGCGGCCA-1_V12D07-335_A1,1,0,1,0,0,2
CTTAGGTCCCAATCGT-1_V12D07-335_A1,1,2,0,0,0,3
CGCAATCGATCATTAG-1_V12D07-335_A1,0,0,2,0,0,2
TGGTTATGCTTGCGGT-1_V12D07-335_A1,1,1,3,0,0,5
GGCTTGGCTCTCACCT-1_V12D07-335_A1,0,0,2,0,0,2
ATTGGTAGGATCCGCT-1_V12D07-335_A1,1,1,3,0,0,5
TCAGGGCGACTTCCTT-1_V12D07-335_A1,0,0,1,1,0,2
TCTGCAGATTCGAGTC-1_V12D07-335_A1,0,2,5,0,0,7
CTCTCGCTGTACTATG-1_V12D07-335_A1,0,0,1,0,0,1
AATAGTCGCGAGTCGG-1_V12D07-335_A1,0,0,0,0,0,0
AGTTACCCTTAAGACT-1_V12D07-335_A1,0,1,1,1,0,3
CTTAAATAAGACCCAT-1_V12D07-335_A1,0,0,1,0,0,1
GGTTGTGCTCTTGTCC-1_V12D07-335_A1,2,0,2,1,0,5
GTGAGTCTAAGACGGA-1_V12D07-335_A1,0,0,0,0,0,0
CGCGACACTGCGCAGC-1_V12D07-335_A1,1,0,2,0,0,3
GCTCGCGGTTCCGCTC-1_V12D07-335_A1,0,0,0,0,0,0
TTAACTCACGCGTGGA-1_V12D07-335_A1,0,0,2,0,0,2
GGAACGGCCTGCAGCC-1_V12D07-335_A1,0,1,3,0,0,4
GTAGAAACGGGTGGAG-1_V12D07-335_A1,3,0,1,1,0,5
TAATGAAAGACCCTTG-1_V12D07-335_A1,1,0,2,0,0,3
AGGCTTGCTAGACACC-1_V12D07-335_A1,0,0,0,1,0,1
TTGCGTAGTTTGAGGA-1_V12D07-335_A1,0,0,1,0,0,1
CGCCCTTGAAGGCTGA-1_V12D07-335_A1,0,0,1,0,0,1
CCCGGTGGAAGAACCT-1_V12D07-335_A1,0,0,1,0,0,1
TTAACACCTCGAACAT-1_V12D07-335_A1,0,0,1,1,0,2
GATTCCTATACGGCGC-1_V12D07-335_A1,1,1,0,0,0,2
TTACCCTAACAGTCCT-1_V12D07-335_A1,0,0,1,0,0,1
ACCCACCTACATGCTC-1_V12D07-335_A1,1,0,0,0,0,1
AAAGGGCAGCTTGAAT-1_V12D07-335_A1,1,0,0,2,0,3
CACACAGGGATAGATT-1_V12D07-335_A1,0,0,1,0,0,1
AGAGCGTACAAGCTCG-1_V12D07-335_A1,1,0,3,3,0,7
TCTTACGGCATCCGAC-1_V12D07-335_A1,0,1,3,0,0,4
GCCTATTCCGATATAG-1_V12D07-335_A1,0,0,1,11,0,12
GAAAGTGACTAACTGC-1_V12D07-335_A1,0,0,6,11,0,17
CCGGAATGGTTTCAGT-1_V12D07-335_A1,0,0,2,0,0,2
AGTATAATACTAGGCA-1_V12D07-335_A1,0,0,1,12,0,13
TAACTATCGAAGGTCC-1_V12D07-335_A1,0,0,0,0,0,0
ATGAGGAGTGTTAATC-1_V12D07-335_A1,0,0,2,2,0,4
TGTGTCGCGAGTTGCA-1_V12D07-335_A1,0,0,0,0,0,0
ATCCAACGCAGTCATA-1_V12D07-335_A1,0,0,0,0,0,0
AAGGCGCGTAAAGCTT-1_V12D07-335_A1,0,0,2,0,0,2
AGTCGGCCCAAACGAC-1_V12D07-335_A1,0,0,2,0,0,2
AACGTCAGACTAGTGG-1_V12D07-335_A1,0,1,2,0,0,3
ACTACCAGCTCTCTGG-1_V12D07-335_A1,1,0,1,0,0,2
GCAAGTGCACAGAGAA-1_V12D07-335_A1,0,0,2,0,0,2
ACACCTTAAGTAGGGC-1_V12D07-335_A1,0,0,2,4,0,6
TTCGACGGGAAGGGCG-1_V12D07-335_A1,0,0,1,2,0,3
TTCGCACTCGCGTGCT-1_V12D07-335_A1,1,0,0,23,0,24
TATTTGTTACCCTTTA-1_V12D07-335_A1,0,0,2,21,0,23
CGCTGTGACGCCGCAC-1_V12D07-335_A1,0,0,0,1,0,1
GTTGCACGGAGTTTCG-1_V12D07-335_A1,1,0,0,6,0,7
GTTTCCTGGAGGGTGA-1_V12D07-335_A1,0,0,0,0,0,0
ACACCCAGCATGCAGC-1_V12D07-335_A1,1,0,0,0,0,1
TCAACCATGTTCGGGC-1_V12D07-335_A1,1,0,0,0,0,1
TTACAACTACGCATCC-1_V12D07-335_A1,1,0,0,1,0,2
TCCGATGGTGCGACAT-1_V12D07-335_A1,0,0,1,0,0,1
GGGCGTACATTTATAT-1_V12D07-335_A1,1,0,0,0,0,1
AGCGACCAACGATATT-1_V12D07-335_A1,0,0,5,0,0,5
ACACAAAGACGGGTGG-1_V12D07-335_A1,0,0,1,0,0,1
ATCGCACGCCGGGAGA-1_V12D07-335_A1,1,0,2,2,0,5
GCTCTAAACCCTGACG-1_V12D07-335_A1,0,0,1,0,0,1
AATGCAACCGGGTACC-1_V12D07-335_A1,0,0,2,0,0,2
TCAAACAACCGCGTCG-1_V12D07-335_A1,1,0,4,1,0,6
TATGCTCCCTACTTAC-1_V12D07-335_A1,0,0,0,1,0,1
AAAGGGATGTAGCAAG-1_V12D07-335_A1,0,0,1,0,0,1
ACGATCATACATAGAG-1_V12D07-335_A1,0,0,1,0,0,1
TTGTTCAGTGTGCTAC-1_V12D07-335_A1,0,1,1,0,0,2
ATGCATGATCCAGGAT-1_V12D07-335_A1,0,0,0,0,0,0
AGTCTTCTCCTCAAAT-1_V12D07-335_A1,0,0,1,0,0,1
GATTCCCTTGTCGCAG-1_V12D07-335_A1,1,0,1,0,0,2
CTCGCACCTATATAGT-1_V12D07-335_A1,0,0,3,0,0,3
ACTCAATAAAGGCACG-1_V12D07-335_A1,1,0,0,1,0,2
AACCGAGCTTGGTCAT-1_V12D07-335_A1,0,0,2,0,0,2
TAAGGCAACATAAGAT-1_V12D07-335_A1,0,0,0,0,0,0
CACGCACAGCGCAGCT-1_V12D07-335_A1,0,1,1,1,0,3
GGTTTACAATCTCAAT-1_V12D07-335_A1,0,0,0,0,0,0
TGCAGGATCGGCAAAG-1_V12D07-335_A1,1,0,0,0,0,1
ATAACGGAGTCCAACG-1_V12D07-335_A1,1,1,1,2,0,5
AACGATATGTCAACTG-1_V12D07-335_A1,0,0,0,0,0,0
GACAACGACCATTGAA-1_V12D07-335_A1,1,0,2,0,0,3
TTGACCATGTTCTCCG-1_V12D07-335_A1,1,0,0,1,0,2
AGTACGGGCACCTGGC-1_V12D07-335_A1,0,0,3,0,0,3
CGCCATCCGATTATGA-1_V12D07-335_A1,0,1,2,0,0,3
AAGGTATCCTAATATA-1_V12D07-335_A1,0,0,1,0,0,1
TGTTGTCAAGAAGTCT-1_V12D07-335_A1,0,0,2,0,0,2
CAGTGAATAAATGACT-1_V12D07-335_A1,1,0,0,0,0,1
CACCTTGCGAAACTCG-1_V12D07-335_A1,0,0,0,0,0,0
CATTTAGCGGACCATG-1_V12D07-335_A1,0,0,3,0,0,3
CCAGTCTAGACGGCGC-1_V12D07-335_A1,1,0,4,0,0,5
TCGCTTTAAACGTTTG-1_V12D07-335_A1,1,1,4,0,0,6
GTGAAACGGCGCCACC-1_V12D07-335_A1,0,2,1,0,0,3
GGGCTCATCGAACCCA-1_V12D07-335_A1,0,0,0,0,0,0
TTGATGTGTAGTCCCG-1_V12D07-335_A1,0,0,2,0,0,2
CAGTAGCCCACGCGGT-1_V12D07-335_A1,2,0,2,0,0,4
AGCGCGGGTGCCAATG-1_V12D07-335_A1,3,0,1,1,0,5
TAATCGATCCGTACGT-1_V12D07-335_A1,1,0,0,0,0,1
AGTGGCGGCAATTTGA-1_V12D07-335_A1,0,0,2,0,0,2
CCTTTCAATGAAGAAA-1_V12D07-335_A1,0,0,1,0,0,1
CTCAGTCACGACAAAT-1_V12D07-335_A1,0,1,1,1,0,3
ATAGGCTAGCTTCGCA-1_V12D07-335_A1,0,0,6,0,0,6
CGGTTCAAGTAGGTGT-1_V12D07-335_A1,0,0,2,0,0,2
CAGTCGAGGATGCAAT-1_V12D07-335_A1,0,0,3,1,0,4
TATCACCCAACCGACC-1_V12D07-335_A1,0,0,1,0,0,1
AATGATGCGACTCCTG-1_V12D07-335_A1,0,0,1,1,0,2
TGGAACCACTGACACA-1_V12D07-335_A1,0,0,1,1,0,2
GCCAATAGGGCATCTC-1_V12D07-335_A1,0,0,3,0,0,3
TTCTTTGGTCGCGACG-1_V12D07-335_A1,0,1,1,14,0,16
ATTAGATTCCTCAGCA-1_V12D07-335_A1,0,0,1,18,0,19
CCGTGGAACGATCCAA-1_V12D07-335_A1,1,0,0,0,0,1
GGGTCGTGGCAAGTGT-1_V12D07-335_A1,0,0,4,0,0,4
TCGCTCGGCACCAGCG-1_V12D07-335_A1,0,0,1,0,0,1
ACGCAATCACTACAGC-1_V12D07-335_A1,1,0,4,0,0,5
CTCTAATGCATTGATC-1_V12D07-335_A1,1,0,0,0,0,1
GTCTCGACTAAGTTTG-1_V12D07-335_A1,0,1,0,0,0,1
TGGTTTAAACGTGGGT-1_V12D07-335_A1,0,0,3,0,0,3
CGCAGATCTTCACCCG-1_V12D07-335_A1,1,1,1,0,0,3
TCCAGATGTACGCCAA-1_V12D07-335_A1,0,0,0,0,0,0
CATTGCGGGTCAATTC-1_V12D07-335_A1,1,0,2,0,0,3
GACGTTCGTAAATACA-1_V12D07-335_A1,1,0,1,0,0,2
TACACCGTCGTTAGTC-1_V12D07-335_A1,2,0,1,0,0,3
ACGGGCGTATGCGACA-1_V12D07-335_A1,1,0,0,0,0,1
GAAGGCTACCATTGTT-1_V12D07-335_A1,1,0,0,0,0,1
TAAATCTTTACACCTC-1_V12D07-335_A1,2,0,2,0,0,4
AGTTTATGTAAAGACA-1_V12D07-335_A1,0,0,3,0,0,3
AGGAGACATCCACAGT-1_V12D07-335_A1,2,0,1,0,0,3
CAACCTGAACCTGCCA-1_V12D07-335_A1,1,0,8,0,0,9
AGTCCCTCGCAGAAAG-1_V12D07-335_A1,2,0,2,0,0,4
TGTATACGGATGATGA-1_V12D07-335_A1,4,0,2,1,0,7
TTGTGGTATAGGTATG-1_V12D07-335_A1,7,1,0,1,0,9
TCTGCACCATTAGTAA-1_V12D07-335_A1,5,0,1,0,0,6
AAATGTATCTTATCCC-1_V12D07-335_A1,0,0,1,4,0,5
ACTCTAAACCTGGGAT-1_V12D07-335_A1,0,0,3,0,0,3
GCTGGCAGGTGCCGTG-1_V12D07-335_A1,0,0,4,0,0,4
CTCATTCGTGAACATC-1_V12D07-335_A1,1,0,1,0,0,2
TCGCCGGATGGGCAAG-1_V12D07-335_A1,0,0,0,0,0,0
GGACTAAGTCAGGAGT-1_V12D07-335_A1,1,0,1,0,0,2
TATCAAAGGTCTGTAA-1_V12D07-335_A1,1,0,2,0,0,3
TTCAGTTTGTGGCAGC-1_V12D07-335_A1,1,0,2,0,0,3
TGTTCATAAATGTGCT-1_V12D07-335_A1,1,1,0,1,0,3
CTTAGCCCGGATAGTG-1_V12D07-335_A1,0,0,2,0,0,2
GATGCGAATGGTATTA-1_V12D07-335_A1,0,1,0,1,0,2
TCTAACTGTATGTAAA-1_V12D07-335_A1,0,0,2,0,0,2
TTAAACCTGGTTCCTT-1_V12D07-335_A1,3,0,1,1,0,5
GCTAAGTAAAGGCGAT-1_V12D07-335_A1,0,1,2,0,0,3
AGTTACCGCACATGGT-1_V12D07-335_A1,0,1,1,0,0,2
GACTGCGGCACGTGTA-1_V12D07-335_A1,2,0,0,1,0,3
TGGTGATCGTATTTGT-1_V12D07-335_A1,1,0,4,0,0,5
TTATCGCCTGCGAAGC-1_V12D07-335_A1,0,0,2,0,0,2
TGGAATTAGACGCTTT-1_V12D07-335_A1,1,0,0,0,0,1
TCGTCACACTGTTAGC-1_V12D07-335_A1,0,0,2,1,0,3
TTATGTTTGCGATAGA-1_V12D07-335_A1,0,0,2,0,0,2
GGTGCTGATCACAAAG-1_V12D07-335_A1,0,0,0,0,0,0
CATAGCCGCCCGGGAT-1_V12D07-335_A1,1,0,1,1,0,3
GGTTAGTTACGGCGCC-1_V12D07-335_A1,0,0,6,0,0,6
ATTCCCACATAAACAA-1_V12D07-335_A1,1,0,2,0,0,3
ATTCAGTAGCAGGGTC-1_V12D07-335_A1,1,0,1,1,0,3
CAGTTCCGCGGGTCGA-1_V12D07-335_A1,0,0,1,0,0,1
AAGAGATGAATCGGTA-1_V12D07-335_A1,0,1,0,0,0,1
CGCAATTCTACAATAA-1_V12D07-335_A1,0,0,3,0,0,3
TAACGCTTTGAGAGCG-1_V12D07-335_A1,1,0,1,0,0,2
AGGCTATGGTTAGCTT-1_V12D07-335_A1,0,0,4,0,0,4
GAGGAATGGAGAGGTT-1_V12D07-335_A1,0,0,3,0,0,3
TCCTCTACGAGATGGC-1_V12D07-335_A1,0,0,2,0,0,2
TTGATTATGCAGATGA-1_V12D07-335_A1,1,0,0,0,0,1
TCAGTACTGACCCGCG-1_V12D07-335_A1,0,0,1,10,0,11
TTATGACAAACTGGAT-1_V12D07-335_A1,1,1,0,0,0,2
GTAAGTAGGGTATACC-1_V12D07-335_A1,0,0,1,22,0,23
CGCAAACACGAGTTAC-1_V12D07-335_A1,2,0,4,0,0,6
TGGCCGTATATTGACC-1_V12D07-335_A1,0,0,1,14,0,15
ACTGTAGCACTTTGGA-1_V12D07-335_A1,2,0,3,1,0,6
GCTCTATGTTACGTGC-1_V12D07-335_A1,0,0,1,20,0,21
TGCGCGATTAACGGAG-1_V12D07-335_A1,0,0,3,0,0,3
GAATCGACATGGTCAC-1_V12D07-335_A1,0,0,0,22,0,22
GACTAAGTAGGCTCAC-1_V12D07-335_A1,0,0,0,1,0,1
ATCTTGACCTGCAACG-1_V12D07-335_A1,0,1,4,6,0,11
ATGCACTACCGCATTG-1_V12D07-335_A1,2,0,2,1,0,5
CAGATACTAACATAGT-1_V12D07-335_A1,0,0,1,0,0,1
GATCGACACTATCTGA-1_V12D07-335_A1,0,0,0,0,0,0
ATAGAGTACTGGGACA-1_V12D07-335_A1,0,0,1,0,0,1
CCTACTGCTTACACTT-1_V12D07-335_A1,1,0,2,1,0,4
CCTGCTATTTGAGAAG-1_V12D07-335_A1,0,0,3,2,0,5
CGCGTTCATGAAATAC-1_V12D07-335_A1,0,0,1,1,0,2
CATTATGCTTGTTGTG-1_V12D07-335_A1,0,1,1,1,0,3
CCAGGGACGTGGCCTC-1_V12D07-335_A1,2,0,3,0,0,5
TATGGATGTGCTACGC-1_V12D07-335_A1,2,0,1,0,0,3
GTACTAAGATTTGGAG-1_V12D07-335_A1,0,1,1,0,0,2
AGACCCGCCCTCCTCG-1_V12D07-335_A1,0,0,4,3,0,7
CGCATTAGCTAATAGG-1_V12D07-335_A1,0,0,1,0,0,1
GCTCTCGGGTACCGAA-1_V12D07-335_A1,0,0,1,0,0,1
CACCGCCAGAAGGTTT-1_V12D07-335_A1,1,0,2,1,0,4
TCCCAAAGACGAAGGA-1_V12D07-335_A1,3,0,2,0,0,5
ATGGATTGACCAAACG-1_V12D07-335_A1,0,0,2,0,0,2
GTCATGGACATGACTA-1_V12D07-335_A1,1,1,2,0,0,4
CTACTGCCACCTGACC-1_V12D07-335_A1,1,0,1,0,0,2
TTATATTTGGCAATCC-1_V12D07-335_A1,0,0,1,0,0,1
AGCACCAGTACTCACG-1_V12D07-335_A1,0,0,2,0,0,2
CATGGTCTAGATACCG-1_V12D07-335_A1,1,0,0,0,0,1
TCTACCGTCCACAAGC-1_V12D07-335_A1,1,0,3,0,0,4
CTAGTTGGGCCCGGTA-1_V12D07-335_A1,0,0,1,0,0,1
TCCCGCGTACTCCTGG-1_V12D07-335_A1,0,0,3,0,0,3
CAGAGCATGAGCTTGC-1_V12D07-335_A1,0,0,1,0,0,1
ACACGGGAACTTAGGG-1_V12D07-335_A1,0,0,2,0,0,2
GGCTCTGCTCCAACGC-1_V12D07-335_A1,1,0,0,0,0,1
AGAACGTGGTACATTC-1_V12D07-335_A1,1,0,1,0,0,2
CAATAAACCTTGGCCC-1_V12D07-335_A1,1,0,0,1,0,2
ACTTCGCCATACGCAC-1_V12D07-335_A1,2,0,0,0,0,2
ATCTGGTTAAGACTGT-1_V12D07-335_A1,1,0,1,0,0,2
TCGTAAGACGACATTG-1_V12D07-335_A1,1,1,0,0,0,2
GTGTACCTTGGCTACG-1_V12D07-335_A1,0,1,3,0,0,4
GCCCGTAATACCTTCT-1_V12D07-335_A1,2,1,3,0,0,6
CGGTCAAGTGGGAACC-1_V12D07-335_A1,0,0,0,0,0,0
TTGTAAGGCCAGTTGG-1_V12D07-335_A1,0,0,1,0,0,1
GGAGCACCAAGAACTA-1_V12D07-335_A1,1,1,1,0,0,3
TAATAGTGACGACCAG-1_V12D07-335_A1,0,0,0,0,0,0
CTAAATCCTATTCCGG-1_V12D07-335_A1,0,0,2,0,0,2
CGAGTTCTGTCCCACC-1_V12D07-335_A1,0,0,0,0,0,0
AGGCAGATGCGTAAAC-1_V12D07-335_A1,0,0,0,0,0,0
AAGGATGAGGGACCTC-1_V12D07-335_A1,0,0,0,0,0,0
AGAGAACCGTCTAGGA-1_V12D07-335_A1,0,0,3,0,0,3
GAGGGCGCAGCTCTGC-1_V12D07-335_A1,0,0,2,0,0,2
AAGATTGGCGGAACGT-1_V12D07-335_A1,1,0,3,0,0,4
CCAGTAGTCTGATCCA-1_V12D07-335_A1,0,1,2,0,0,3
AAGGGACAGATTCTGT-1_V12D07-335_A1,0,0,1,0,0,1
ATAGAGTTATCAACTT-1_V12D07-335_A1,1,1,5,0,0,7
AAATTACCTATCGATG-1_V12D07-335_A1,2,0,1,1,0,4
GATCCTAAATCGGGAC-1_V12D07-335_A1,0,2,3,0,0,5
TTACAGACCTAAATGA-1_V12D07-335_A1,1,0,0,0,0,1
CCTCACCTTAGCATCG-1_V12D07-335_A1,2,1,2,1,0,6
CATGCGACCAGTTTAA-1_V12D07-335_A1,0,0,5,0,0,5
AACATATCAACTGGTG-1_V12D07-335_A1,1,0,6,0,0,7
CTATAAGAGCCAATCG-1_V12D07-335_A1,0,0,4,0,0,4
AATATCGAGGGTTCTC-1_V12D07-335_A1,0,0,2,1,0,3
GTACTCCTGGGTATGC-1_V12D07-335_A1,0,0,2,0,0,2
ATAAGTAGGATTCAGA-1_V12D07-335_A1,0,0,1,0,0,1
AGGTCGCGGAGTTACT-1_V12D07-335_A1,3,2,3,1,0,9
CTAATTCTCAGATATT-1_V12D07-335_A1,2,0,3,0,0,5
GCCAACCATTTCCGGA-1_V12D07-335_A1,0,0,1,15,0,16
TGATCCCAGCATTAGT-1_V12D07-335_A1,0,0,1,11,0,12
CGTTGTAAGATTGATT-1_V12D07-335_A1,1,0,0,2,0,3
GAAACCATGGTGCGCT-1_V12D07-335_A1,0,0,2,2,0,4
AATCTATGCCGGAGCC-1_V12D07-335_A1,0,0,0,0,0,0
GACTCCCAGAATAAGG-1_V12D07-335_A1,0,0,3,0,0,3
TATGATCCGGCACGCC-1_V12D07-335_A1,0,0,2,0,0,2
CCGCTTGCTGACATGG-1_V12D07-335_A1,0,0,2,0,0,2
TGGTTAAGGGCGCTGG-1_V12D07-335_A1,0,0,3,0,0,3
TTGATAGTCAATACAT-1_V12D07-335_A1,0,0,2,0,0,2
GGTTTAATTGAGCAGG-1_V12D07-335_A1,1,0,3,0,0,4
CATTACATAGATTGTG-1_V12D07-335_A1,0,0,1,0,0,1
GGTACACCAGATTTAT-1_V12D07-335_A1,1,0,2,0,0,3
GGCCCGTATACCATGC-1_V12D07-335_A1,0,0,0,0,0,0
ATCTTTCGTATAACCA-1_V12D07-335_A1,2,0,1,0,0,3
GAGATGACAATCCTTA-1_V12D07-335_A1,2,0,1,0,0,3
AAAGCTTGCCTACATA-1_V12D07-335_A1,2,0,3,0,0,5
GAACGATAAGTTAAAG-1_V12D07-335_A1,5,1,2,0,0,8
TAATAGCTAAATGATG-1_V12D07-335_A1,1,1,7,0,0,9
TATGGCTAGGCTAATT-1_V12D07-335_A1,2,1,13,0,0,16
AGGAGAGTCTGGCTAC-1_V12D07-335_A1,3,1,3,0,0,7
TGCTCTGCCGGTTCAC-1_V12D07-335_A1,0,0,1,0,0,1
CCAATAGATTTCATCT-1_V12D07-335_A1,0,0,2,0,0,2
GGGCACGAATTGGCCG-1_V12D07-335_A1,0,0,1,0,0,1
TCGTTGACAGGGTCCC-1_V12D07-335_A1,1,1,1,0,0,3
ATCGTATTCCGAGAAC-1_V12D07-335_A1,0,0,1,0,0,1
GGGAATTCTGTCCAGT-1_V12D07-335_A1,1,0,1,0,0,2
ACGCGTTTCTTAAGAG-1_V12D07-335_A1,0,0,1,0,0,1
GAGAGCGCAGTCCCTG-1_V12D07-335_A1,0,0,2,0,0,2
GTCCTATTGTTGTGGT-1_V12D07-335_A1,0,0,1,0,0,1
CATCTGCAGGATCATT-1_V12D07-335_A1,0,0,1,0,0,1
GAGTCGACAGACCCTC-1_V12D07-335_A1,1,0,2,0,0,3
AAGTGCAAAGGTAGAC-1_V12D07-335_A1,1,0,1,0,0,2
AGGGTGGATAGTGCAT-1_V12D07-335_A1,2,0,1,0,0,3
TGATAGCGGGATTCTA-1_V12D07-335_A1,0,0,1,0,0,1
GTCAGTTTGGTAGTCG-1_V12D07-335_A1,0,0,5,0,0,5
GCATTCGAAATGAACA-1_V12D07-335_A1,3,0,2,0,0,5
AAAGACTGGGCGCTTT-1_V12D07-335_A1,0,0,5,0,0,5
TAACAATATTTGTTGC-1_V12D07-335_A1,0,1,1,1,0,3
CCAGCTTCCGCCCGCA-1_V12D07-335_A1,0,0,3,0,0,3
GATATGGATTACGCGG-1_V12D07-335_A1,0,1,3,0,0,4
AGAGCAGTTATGAGAC-1_V12D07-335_A1,1,0,1,0,0,2
TCACATCTTATCTGAT-1_V12D07-335_A1,1,0,3,0,0,4
TATGAAGACAGGTGCG-1_V12D07-335_A1,0,0,1,0,0,1
TACCTGCTGCACTGTG-1_V12D07-335_A1,1,0,2,0,0,3
TAGGTCCAAGTAAGGA-1_V12D07-335_A1,1,0,2,0,0,3
GAAACTCGTGCGATGC-1_V12D07-335_A1,3,0,0,0,0,3
AACAATTACTCTACGC-1_V12D07-335_A1,2,0,0,0,0,2
CCGCACGTGACCTCGG-1_V12D07-335_A1,2,1,0,0,0,3
AACTTGCCCGTATGCA-1_V12D07-335_A1,0,0,3,0,0,3
GGGTATGTATGCACTT-1_V12D07-335_A1,1,0,1,0,0,2
TTCGTACTCCAGAACG-1_V12D07-335_A1,0,0,0,1,0,1
GAATTTCTCGCTGCAG-1_V12D07-335_A1,0,1,4,1,0,6
AACAGGATGGGCCGCG-1_V12D07-335_A1,0,0,0,0,0,0
GACGTGTAGGGATTAT-1_V12D07-335_A1,0,0,0,1,0,1
TAGGTGAGCCCTACTC-1_V12D07-335_A1,0,0,1,0,0,1
CTAATTCGCACGCGCT-1_V12D07-335_A1,1,0,0,0,0,1
GAAGCTTGCTGACCGC-1_V12D07-335_A1,3,0,0,0,0,3
GGTTAGGCTTGGAGAA-1_V12D07-335_A1,0,1,1,0,0,2
ACAAGGACAAGAGGTT-1_V12D07-335_A1,0,0,3,0,0,3
AGGCCACCCGTTATGA-1_V12D07-335_A1,1,0,0,1,0,2
GTGGGCTTAGACACAC-1_V12D07-335_A1,0,0,0,0,0,0
CGTGTCCCATTCGCGA-1_V12D07-335_A1,1,0,3,1,0,5
TGGAGTGATGCGATGA-1_V12D07-335_A1,0,0,0,0,0,0
AACAACTGGTAGTTGC-1_V12D07-335_A1,0,1,0,0,0,1
CCTGGCTAGACCCGCC-1_V12D07-335_A1,1,0,3,1,0,5
CGCAATTAGGGTAATA-1_V12D07-335_A1,1,0,2,0,0,3
TCGAAATTTAGGACCA-1_V12D07-335_A1,0,0,0,0,0,0
AGACTAGCCTTCCAGA-1_V12D07-335_A1,1,0,5,0,0,6
TTGATCTAACTTTGTC-1_V12D07-335_A1,0,0,2,0,0,2
AAGGAGCGGTTGGTGC-1_V12D07-335_A1,0,0,1,0,0,1
ACTTGGGACCCGGTGG-1_V12D07-335_A1,0,0,2,0,0,2
TGATCTCCGGCGCCAG-1_V12D07-335_A1,0,0,2,0,0,2
CAGTTCAAATTGACAC-1_V12D07-335_A1,0,1,0,1,0,2
GTCCGGCTGAATTGCG-1_V12D07-335_A1,0,0,3,0,0,3
CTGGAAATGGATGCTT-1_V12D07-335_A1,0,0,2,0,0,2
TGATCGGTTTGACCCT-1_V12D07-335_A1,2,0,1,0,0,3
TAGAGTCTAAGCGAAC-1_V12D07-335_A1,0,0,0,0,0,0
GAGACTGATGGGTAGA-1_V12D07-335_A1,0,0,1,0,0,1
TAGCTAAGTCCGGGAG-1_V12D07-335_A1,1,0,2,1,0,4
GGGCGATATGTGTGAA-1_V12D07-335_A1,0,0,2,0,0,2
CTCGAGGTCGAACAGT-1_V12D07-335_A1,2,0,1,0,0,3
GATCCCTTTATACTGC-1_V12D07-335_A1,0,0,1,0,0,1
GTCATGCACCTCCGTT-1_V12D07-335_A1,1,0,0,0,0,1
ACTTTCCTATAGCTTC-1_V12D07-335_A1,1,0,2,0,0,3
TCGCTCGATATATTCC-1_V12D07-335_A1,1,0,0,1,0,2
ATAGGTTGGGCAGATG-1_V12D07-335_A1,0,0,1,0,0,1
CAATTAAGGGTGATGA-1_V12D07-335_A1,0,0,4,0,0,4
ACCGACTGAGTCCCAC-1_V12D07-335_A1,0,0,1,0,0,1
CCTGTCACCCGGGCTC-1_V12D07-335_A1,0,0,0,1,0,1
GATCGGTGGCCATAAC-1_V12D07-335_A1,0,0,2,0,0,2
CCTATGGGTTACCGTC-1_V12D07-335_A1,0,0,0,1,0,1
TTGGGACACTGCCCGC-1_V12D07-335_A1,1,0,4,0,0,5
CGAGGCTAAATATGGC-1_V12D07-335_A1,1,0,0,0,0,1
TCAGGGTGTAACGTAA-1_V12D07-335_A1,0,0,1,0,0,1
CGAGAGATGTGAACCT-1_V12D07-335_A1,0,0,2,0,0,2
TCGCTGGGCGGATTGT-1_V12D07-335_A1,0,0,1,0,0,1
AGATCTCAGGTGTGAT-1_V12D07-335_A1,1,1,2,0,0,4
TGGCCAAACTGAAGTA-1_V12D07-335_A1,0,0,1,0,0,1
GCTTCCGTCCCTAGAC-1_V12D07-335_A1,1,0,2,0,0,3
CAGCAGCCCGTTCCTT-1_V12D07-335_A1,0,0,4,0,0,4
TGTATAACAGATCCTG-1_V12D07-335_A1,0,0,1,0,0,1
CGCGGGAATTAGGCAG-1_V12D07-335_A1,1,0,1,0,0,2
TGCATGTGGTAATCTA-1_V12D07-335_A1,0,0,1,2,0,3
ACAATTTGAGCAGTGG-1_V12D07-335_A1,0,0,1,0,0,1
GAGCTAAGGGCATATC-1_V12D07-335_A1,0,2,3,0,0,5
CCAGATAGTTGAGTGA-1_V12D07-335_A1,0,0,1,1,0,2
CCACAATGTACGTCTT-1_V12D07-335_A1,0,0,0,0,0,0
CAATGGATCTCTACCA-1_V12D07-335_A1,0,0,0,0,0,0
TGTGGCAAAGCGTATG-1_V12D07-335_A1,0,0,0,0,0,0
TAAAGCGTTAGGAGAA-1_V12D07-335_A1,1,1,1,0,0,3
TCCGTTTAGCCTTGAA-1_V12D07-335_A1,1,0,0,0,0,1
CAGCTCGACAAGTTAA-1_V12D07-335_A1,1,0,0,1,0,2
GCCTATAGTGTCAGGG-1_V12D07-335_A1,1,1,1,1,0,4
ATAGACAACGGGACCT-1_V12D07-335_A1,1,0,1,0,0,2
CTACTATCTTTCAGAG-1_V12D07-335_A1,0,0,4,0,0,4
GCGCTGCTTTGCATTT-1_V12D07-335_A1,0,0,5,1,0,6
GCGCATCCAGTCAGCA-1_V12D07-335_A1,1,0,1,0,0,2
GACTCGCGGGAATGAC-1_V12D07-335_A1,0,0,0,0,0,0
CTGGTAACGAGCTCTT-1_V12D07-335_A1,0,0,1,0,0,1
TCCGGCCTAGCGTACA-1_V12D07-335_A1,2,0,3,0,0,5
TCTAGGTGGCGACGCT-1_V12D07-335_A1,1,0,1,1,0,3
ACGCTAGTGATACACT-1_V12D07-335_A1,0,0,4,0,0,4
ATCTGCACCTCTGCGA-1_V12D07-335_A1,0,1,2,0,0,3
CCTCACCTGAGGGAGC-1_V12D07-335_A1,0,1,2,0,0,3
AGTGAGCCTCGCCGCC-1_V12D07-335_A1,0,0,2,0,0,2
ACGAGTACGGATGCCC-1_V12D07-335_A1,1,0,0,3,0,4
GGTACCATTAAGACGG-1_V12D07-335_A1,0,0,3,0,0,3
TTCTGCTAGACTCCAA-1_V12D07-335_A1,0,0,4,0,0,4
TAACTATTACGCCAAA-1_V12D07-335_A1,2,0,1,1,0,4
GCATTCAAGGCAACGC-1_V12D07-335_A1,0,0,2,10,0,12
AGTACATCATTTATCA-1_V12D07-335_A1,1,0,4,4,0,9
GTCGTGTCTGGTCATC-1_V12D07-335_A1,1,0,1,8,0,10
AGTCTAAAGTATACTC-1_V12D07-335_A1,0,0,4,7,0,11
CGGCCCAACCTGTAGT-1_V12D07-335_A1,0,0,1,0,0,1
AGGGAGACATACTTCG-1_V12D07-335_A1,0,0,1,0,0,1
TCCCTAGATCAATAGG-1_V12D07-335_A1,0,0,0,0,0,0
TCCCGTCGCGTCATAG-1_V12D07-335_A1,0,0,1,0,0,1
CGCATCCATCAGCCAG-1_V12D07-335_A1,2,0,1,0,0,3
CTGCACCTAGTCCACA-1_V12D07-335_A1,0,0,0,0,0,0
CGAGGATCGGGAACGA-1_V12D07-335_A1,0,1,2,0,0,3
CAATGAGGTTCGACTA-1_V12D07-335_A1,0,0,2,0,0,2
TCTGACGGGCTAACCC-1_V12D07-335_A1,0,0,0,0,0,0
TTCTATGCCTTTCGCA-1_V12D07-335_A1,0,0,4,0,0,4
AGAGTATAGTGTTACG-1_V12D07-335_A1,5,0,0,0,0,5
CCATTGTTTCCTCCAT-1_V12D07-335_A1,2,0,3,0,0,5
CTCATCACTTAGTGAT-1_V12D07-335_A1,2,0,2,0,0,4
CCGAAGGGCGTACCGC-1_V12D07-335_A1,0,0,0,0,0,0
TCAAGCTGCCTTGAAA-1_V12D07-335_A1,2,0,1,0,0,3
CTCATTAACGTTGCCC-1_V12D07-335_A1,6,0,1,0,0,7
GTCTTCCTCACCTAAG-1_V12D07-335_A1,1,1,3,0,0,5
GGTGATGAAGGAAGTG-1_V12D07-335_A1,2,0,1,0,0,3
TCAATACAATTGCTGC-1_V12D07-335_A1,1,1,3,0,0,5
GCAACCCAAGTTGTTT-1_V12D07-335_A1,3,0,3,0,0,6
ATGAAGTGGACCCAGC-1_V12D07-335_A1,0,0,6,0,0,6
GAGAATCTCACGATCA-1_V12D07-335_A1,0,1,2,0,0,3
TATATCATTGATCAGT-1_V12D07-335_A1,1,0,2,1,0,4
AACTTTACGGGAGCTT-1_V12D07-335_A1,0,0,1,1,0,2
TTCTTGTGTCCATCAG-1_V12D07-335_A1,0,0,3,0,0,3
ACAATTTAGGAGGCTC-1_V12D07-335_A1,0,0,1,0,0,1
ATACTTGTTCTCGAGC-1_V12D07-335_A1,1,0,1,0,0,2
CACGGGATTGAGGGTT-1_V12D07-335_A1,1,0,2,0,0,3
GTTAATGTCTATCTTA-1_V12D07-335_A1,2,0,4,1,0,7
GCGTTATATTTGGAAC-1_V12D07-335_A1,2,1,0,0,0,3
CGTCAAGGCTATAAAT-1_V12D07-335_A1,0,1,1,0,0,2
TTAGCTCTGTAATCCG-1_V12D07-335_A1,3,0,2,0,0,5
AATGGTCCACCGTTCA-1_V12D07-335_A1,1,0,1,0,0,2
GTCATTGCATTGACCC-1_V12D07-335_A1,0,0,1,0,0,1
TGTCCGTGGCGCCTTT-1_V12D07-335_A1,1,0,0,0,0,1
TCAACTAACGTATAAC-1_V12D07-335_A1,0,0,0,1,0,1
TCCTCTCCAGTTGTCC-1_V12D07-335_A1,2,0,2,0,0,4
TGTGTTCGTATCCAAG-1_V12D07-335_A1,3,0,2,0,0,5
CCGCGTAGGTAAGGGC-1_V12D07-335_A1,0,0,3,1,0,4
CTGCGGGTGAAATGTT-1_V12D07-335_A1,0,1,2,0,0,3
TATCTACAGAGGTAAT-1_V12D07-335_A1,1,0,1,0,0,2
CTACTCTAGGCCCGGC-1_V12D07-335_A1,0,0,0,0,0,0
ACAAGCAGTGCCTAGC-1_V12D07-335_A1,0,0,1,1,0,2
TACAAGTCTCGTGCAT-1_V12D07-335_A1,0,1,1,1,0,3
TCGGAATGCGCTCTGA-1_V12D07-335_A1,0,0,1,0,0,1
TCGCGTCCAGAAGGTC-1_V12D07-335_A1,1,0,2,0,0,3
TATGGCCCGGCCTCGC-1_V12D07-335_A1,0,0,3,0,0,3
GCTGGCATATTCACCT-1_V12D07-335_A1,0,0,0,0,0,0
GTCAGAATAGTCTATG-1_V12D07-335_A1,1,0,1,0,0,2
GGCGTCCTATCCGCTG-1_V12D07-335_A1,0,0,2,0,0,2
CGGAGTTTGAGAGACA-1_V12D07-335_A1,0,1,2,1,0,4
AGCACTTAAGGACGCC-1_V12D07-335_A1,1,0,1,0,0,2
TCCACAATGGTTTACG-1_V12D07-335_A1,0,0,0,0,0,0
CCAACGATGCACTGAT-1_V12D07-335_A1,1,0,4,2,0,7
ATTTACAGTTTACTGG-1_V12D07-335_A1,3,0,1,1,0,5
CCCTGAAATGAGTTGA-1_V12D07-335_A1,0,0,0,0,0,0
CAAACGGTCGCACTTT-1_V12D07-335_A1,1,0,0,1,0,2
TGATTCGTCTATCACT-1_V12D07-335_A1,0,0,2,0,0,2
TCAGGTTCTTTGAGAA-1_V12D07-335_A1,0,1,1,0,0,2
CACGCAGCGAGGCTTT-1_V12D07-335_A1,1,0,0,0,0,1
TTAAGCGCCTGACCCA-1_V12D07-335_A1,0,0,3,0,0,3
CTTACACGGTATTCCA-1_V12D07-335_A1,2,0,0,1,0,3
AAGGCTGTGCTCATCG-1_V12D07-335_A1,0,0,1,0,0,1
GACCAGAGCCCTGTAG-1_V12D07-335_A1,0,0,1,0,0,1
TCCCAGGCTTAGCTAA-1_V12D07-335_A1,0,0,0,0,0,0
ATTGAAGATCTTAGTG-1_V12D07-335_A1,0,0,1,0,0,1
AGTTCCTACAGAATTA-1_V12D07-335_A1,0,0,0,2,0,2
GGGCTGGTTAGTCGCG-1_V12D07-335_A1,0,0,1,0,0,1
GAAATGGCGGTGTTAG-1_V12D07-335_A1,0,0,1,0,0,1
TACGAACACGACTTCA-1_V12D07-335_A1,0,0,3,0,0,3
ACCACAAGTTTCTATC-1_V12D07-335_A1,0,0,1,0,0,1
ATATTTAACCCTCAAG-1_V12D07-335_A1,1,0,2,1,0,4
GATCATTCCAAACATT-1_V12D07-335_A1,0,0,0,0,0,0
TCCAGGCGAGTACGGT-1_V12D07-335_A1,1,0,2,0,0,3
GTTTGACCAAATCCTA-1_V12D07-335_A1,0,0,0,0,0,0
CACAGCACCCACGGCA-1_V12D07-335_A1,1,3,0,0,0,4
TGCAAGAATGACGTAA-1_V12D07-335_A1,1,2,2,0,0,5
GCGAAGCCATACCCGT-1_V12D07-335_A1,0,0,5,0,0,5
TCCTTTCTTACGCTTA-1_V12D07-335_A1,0,0,3,0,0,3
GCTGCTCTCCGGACAC-1_V12D07-335_A1,1,0,1,1,0,3
ACTGTCTTCTTTAGAA-1_V12D07-335_A1,1,0,1,1,0,3
TCAAACTTAGATTGTT-1_V12D07-335_A1,1,0,0,1,0,2
CTATGTCACTAGCCCA-1_V12D07-335_A1,0,0,1,1,0,2
TGCGCAAAGCATTTGG-1_V12D07-335_A1,0,0,2,1,0,3
TTAATGTAGACCAGGT-1_V12D07-335_A1,0,0,1,0,0,1
GGCGGTAGGATCATTG-1_V12D07-335_A1,0,0,3,0,0,3
GGCAATAGTCAATGAG-1_V12D07-335_A1,0,0,2,0,0,2
ACACGAGACTCCTTCT-1_V12D07-335_A1,1,1,2,0,0,4
GACACAAGGGAAGAAA-1_V12D07-335_A1,1,2,1,0,0,4
TCAGCAAATGCATCTC-1_V12D07-335_A1,0,0,1,1,0,2
GAGATCTGTCACTCCG-1_V12D07-335_A1,0,0,1,1,0,2
ATGCCGGTCTTGCATA-1_V12D07-335_A1,0,0,1,0,0,1
TTGGGCGGCGGTTGCC-1_V12D07-335_A1,0,1,0,1,0,2
TTGTTGTGTGTCAAGA-1_V12D07-335_A1,0,0,3,1,0,4
ACTGTACGATACACAT-1_V12D07-335_A1,0,1,2,1,0,4
TCCACTTTATCTAGGT-1_V12D07-335_A1,2,0,3,0,0,5
GGTCTGAGAATCTGGA-1_V12D07-335_A1,2,0,1,2,0,5
TAGAAAGGTGGCGCTA-1_V12D07-335_A1,0,0,4,0,0,4
TATGTCTCATTGTGCC-1_V12D07-335_A1,0,0,3,0,0,3
GGATTTCACTTCTATA-1_V12D07-335_A1,0,0,2,1,0,3
TGAGTGGTCCGTGACG-1_V12D07-335_A1,1,0,0,0,0,1
CGCTTTCTTGCATTCG-1_V12D07-335_A1,2,0,0,0,0,2
ACCCAACGCCCGTGGC-1_V12D07-335_A1,1,0,2,0,0,3
GAACGTCTCATGGTCG-1_V12D07-335_A1,1,0,3,0,0,4
AGGGTTCCCTTTGGTT-1_V12D07-335_A1,1,0,2,1,0,4
GTAGCTTCCTCTTGTT-1_V12D07-335_A1,0,0,2,0,0,2
GCATGAGGGACGCGGC-1_V12D07-335_A1,0,0,1,1,0,2
CTACCCTAAGGTCATA-1_V12D07-335_A1,1,0,1,0,0,2
TCACCGCTCGGCACTC-1_V12D07-335_A1,1,0,1,0,0,2
GGCTCGCGTTGAGGTA-1_V12D07-335_A1,1,0,0,0,0,1
CTAACGAAACTTGCTG-1_V12D07-335_A1,0,0,0,0,0,0
TTAAACTCGAATTCAT-1_V12D07-335_A1,1,0,1,0,0,2
TACTTTACTGAGCCGG-1_V12D07-335_A1,0,0,2,1,0,3
GCTTGGATCGATTAGG-1_V12D07-335_A1,0,0,3,0,0,3
CGGTTATCCAACAGTG-1_V12D07-335_A1,0,0,3,0,0,3
CAGACCTGTAAGTGTT-1_V12D07-335_A1,0,0,2,1,0,3
GACGGTCAATAGAAGC-1_V12D07-335_A1,1,1,1,1,0,4
CTGACTGCGCAGCTCG-1_V12D07-335_A1,0,0,2,1,0,3
CCATACCTTTACTTGT-1_V12D07-335_A1,3,0,2,0,0,5
GTAATAAAGGGCTCCC-1_V12D07-335_A1,0,0,1,0,0,1
GTGAACTCCCATTCGA-1_V12D07-335_A1,2,0,3,0,0,5
GTGGTTACTTCTTTCG-1_V12D07-335_A1,0,1,2,0,0,3
TCAGAACCTCCACAGG-1_V12D07-335_A1,1,0,3,0,0,4
TCCCACTCTCTTCCGG-1_V12D07-335_A1,0,0,1,0,0,1
ATCTTGACTTGTCCAA-1_V12D07-335_A1,1,0,2,0,0,3
TCGGGAACGTGCCTAG-1_V12D07-335_A1,1,0,2,0,0,3
GTTAGCCGTAAATCAA-1_V12D07-335_A1,1,0,3,3,0,7
ATTTACTAAGTCCATT-1_V12D07-335_A1,1,2,3,2,0,8
GGGTGCATATGAAAGC-1_V12D07-335_A1,0,0,0,13,0,13
TCCGAATGGTCCTGAG-1_V12D07-335_A1,0,0,2,17,0,19
TGATGGCTGTTTCTGA-1_V12D07-335_A1,1,0,2,2,0,5
AAATAAGGTAGTGCCC-1_V12D07-335_A1,0,1,3,8,0,12
CCACTATCCGGGTCAC-1_V12D07-335_A1,0,0,4,0,0,4
ACACCACATAATTAGC-1_V12D07-335_A1,0,0,1,1,0,2
CGCGGTAAGTCTAGCT-1_V12D07-335_A1,0,0,1,0,0,1
GCGGGCATTACGATGC-1_V12D07-335_A1,0,1,3,1,0,5
AGGATTGCTTACGACA-1_V12D07-335_A1,2,0,1,0,0,3
CTCGGGATAACACCTA-1_V12D07-335_A1,0,0,1,0,0,1
GTCGTCTGGTTGGCTA-1_V12D07-335_A1,2,1,3,0,0,6
GCAATTAGTCGCACCG-1_V12D07-335_A1,0,0,0,0,0,0
GTGACCTAAAGAATAA-1_V12D07-335_A1,1,0,1,0,0,2
CTGAGCGAGACTTATT-1_V12D07-335_A1,0,0,0,0,0,0
CAAGACTCAGAAGCGC-1_V12D07-335_A1,0,0,1,0,0,1
ACTTCGCTAGCGAGTG-1_V12D07-335_A1,2,0,2,0,0,4
CCATACTCGCCTCTCC-1_V12D07-335_A1,4,0,3,0,0,7
ACGATACCTATCCTGA-1_V12D07-335_A1,2,0,1,0,0,3
CTCACCAGTACAAGTG-1_V12D07-335_A1,4,0,1,0,0,5
CGAAGACGGTGAGTGC-1_V12D07-335_A1,2,0,2,0,0,4
AAATTAATAAGCGCGA-1_V12D07-335_A1,4,2,2,1,0,9
GGGCCCTTATCTATAC-1_V12D07-335_A1,1,0,2,0,0,3
CTGCCCACGAAGCGTT-1_V12D07-335_A1,2,1,1,0,0,4
GGACAAGTTGCAGTGA-1_V12D07-335_A1,2,1,2,0,0,5
GTCCGAGAGCAATCAT-1_V12D07-335_A1,1,0,1,0,0,2
ATGGCAGCCGAGAAAC-1_V12D07-335_A1,2,0,5,0,0,7
CCTCGGATGCTACCTG-1_V12D07-335_A1,1,0,6,1,0,8
ATACGGTGAAGATGCA-1_V12D07-335_A1,2,0,1,0,0,3
ACATCAGCTGGGACGC-1_V12D07-335_A1,0,1,6,0,0,7
GGTTGTGTAGCCTGGC-1_V12D07-335_A1,2,0,2,0,0,4
CCTGCGTTCTACGCTT-1_V12D07-335_A1,2,0,0,0,0,2
GAACGTTAGGAAGACG-1_V12D07-335_A1,2,0,1,0,0,3
CTGATAGTGTATCTCA-1_V12D07-335_A1,0,0,0,1,0,1
TTCTGCGAGCGCCCTT-1_V12D07-335_A1,0,0,5,0,0,5
CTTTGGCGCTTTATAC-1_V12D07-335_A1,1,0,3,0,0,4
TCCGAACTTGGCTTAC-1_V12D07-335_A1,0,0,1,0,0,1
TAGATTCCTGGTTATT-1_V12D07-335_A1,0,0,0,0,0,0
CCGACAAAGGGAGTGC-1_V12D07-335_A1,0,0,1,0,0,1
CCATGGCCCTTGTACC-1_V12D07-335_A1,1,0,2,0,0,3
GAAATATCACCATCAG-1_V12D07-335_A1,2,0,2,0,0,4
ACGAAATGGGCGGCAC-1_V12D07-335_A1,1,1,1,0,0,3
GTGAGCGTGCTGCACT-1_V12D07-335_A1,0,0,0,0,0,0
CCGCGGGTACGAAGAA-1_V12D07-335_A1,0,0,2,2,0,4
TCCCTGGCTCGCTGGA-1_V12D07-335_A1,0,0,1,0,0,1
CAGCTTAGTAGGTAGC-1_V12D07-335_A1,1,1,1,2,0,5
CACGAAAGTTAGTCCC-1_V12D07-335_A1,0,0,3,0,0,3
ACCTAATCGACTTCCT-1_V12D07-335_A1,0,0,0,0,0,0
AAGTAGTGACGCGAGG-1_V12D07-335_A1,0,0,1,0,0,1
TCCGATTACATTGCCG-1_V12D07-335_A1,1,0,4,0,0,5
CCTCCGACAATTCAAG-1_V12D07-335_A1,0,0,1,0,0,1
GTTCACAGGAGTCTAG-1_V12D07-335_A1,1,0,0,1,0,2
CGAAGTTGCTCTGTGT-1_V12D07-335_A1,2,0,0,1,0,3
GTCGGATATCTCAGAC-1_V12D07-335_A1,1,0,0,0,0,1
CGCTCTCCGTAGATTA-1_V12D07-335_A1,0,0,1,1,0,2
CAAGCAACGTCGGAGT-1_V12D07-335_A1,0,0,0,0,0,0
CCATTCCCTGCCCACA-1_V12D07-335_A1,0,0,4,0,0,4
CTTTGGCTTTAGTAAA-1_V12D07-335_A1,1,0,2,0,0,3
GGCTATTAAGTTGTAT-1_V12D07-335_A1,0,0,4,1,0,5
CCATTAGCGATAATCC-1_V12D07-335_A1,0,0,0,0,0,0
TGTTCTTCCATTGACT-1_V12D07-335_A1,2,0,2,0,0,4
AGATAACTTCAGGGCC-1_V12D07-335_A1,0,0,0,0,0,0
ATAGACGAAGAGAAAG-1_V12D07-335_A1,1,1,0,0,0,2
GGCGGAGTAATATTAG-1_V12D07-335_A1,0,1,0,0,0,1
TGACCCACGTTAGACA-1_V12D07-335_A1,0,0,2,0,0,2
TCACAGGTTATTGGGC-1_V12D07-335_A1,1,0,0,0,0,1
TCACGCATTGTAGATC-1_V12D07-335_A1,1,0,1,0,0,2
TTGAAGAATTCCCAGG-1_V12D07-335_A1,2,1,2,1,0,6
AAATGGTCAATGTGCC-1_V12D07-335_A1,1,0,2,0,0,3
TAGTGCCCTCCAGAGT-1_V12D07-335_A1,1,0,0,0,0,1
GGTATTGCCGAGTTTA-1_V12D07-335_A1,0,0,2,0,0,2
CGTATTAAGAGATCTA-1_V12D07-335_A1,0,0,3,0,0,3
ACTGTCCAGGATTATA-1_V12D07-335_A1,0,1,0,1,0,2
CGGGCAGCTAAACCGC-1_V12D07-335_A1,1,2,1,1,0,5
TTGCTGATCATGTTCG-1_V12D07-335_A1,0,0,2,1,0,3
TATGGGTACGTATCGT-1_V12D07-335_A1,0,0,0,0,0,0
CAGCTCACTGAGACAT-1_V12D07-335_A1,0,0,0,0,0,0
GGGACTGCATAGATAG-1_V12D07-335_A1,0,1,0,0,0,1
ACGCATTCGTGAGTAC-1_V12D07-335_A1,0,0,0,1,0,1
CTCTGGACGCCTGGTG-1_V12D07-335_A1,0,0,0,0,0,0
AGGGTTTAGTTCGGGA-1_V12D07-335_A1,0,0,1,0,0,1
GGGAGAACTCACAGTA-1_V12D07-335_A1,0,0,2,0,0,2
ATCAATCTGGGCTGCA-1_V12D07-335_A1,1,1,1,0,0,3
TCTTCGATACCAATAA-1_V12D07-335_A1,0,0,0,0,0,0
ACGTAGATTGCTGATG-1_V12D07-335_A1,0,0,0,0,0,0
TCTTGATGCGTAGCGA-1_V12D07-335_A1,0,2,2,0,0,4
GGGCTGCCTAGGGCGA-1_V12D07-335_A1,1,0,1,3,0,5
CTCTCACAATCGATGA-1_V12D07-335_A1,0,0,0,0,0,0
CCAAGCGTAACTCGTA-1_V12D07-335_A1,0,0,1,0,0,1
ACAACAGCATGAGCTA-1_V12D07-335_A1,0,0,1,1,0,2
GTCCCAACGTAAAGTA-1_V12D07-335_A1,0,0,1,0,0,1
TCGGAGTACATGAGTA-1_V12D07-335_A1,1,0,1,1,0,3
GGGAGTTAATGAGGCG-1_V12D07-335_A1,0,0,0,0,0,0
CCGGGCGGTCTCGTCA-1_V12D07-335_A1,0,0,1,1,0,2
CCGTAAGTTGGTCCCA-1_V12D07-335_A1,1,0,0,0,0,1
GGAGGGCTTGGTTGGC-1_V12D07-335_A1,1,0,1,0,0,2
TCGGACGCCCAGCCCA-1_V12D07-335_A1,0,0,2,1,0,3
TCTGTGCCATCATAGT-1_V12D07-335_A1,0,0,0,0,0,0
GTACTGGAGTTAGACC-1_V12D07-335_A1,1,1,2,0,0,4
GGAATGCGCTAGCGTG-1_V12D07-335_A1,0,0,3,0,0,3
GTGTGAATAACTTAGG-1_V12D07-335_A1,0,0,1,0,0,1
GGTCGGCCAGGAGCTT-1_V12D07-335_A1,0,0,1,0,0,1
TAGCCGGCGGTCAGCG-1_V12D07-335_A1,0,0,1,0,0,1
CGGGTGTACCCATTTA-1_V12D07-335_A1,0,0,1,1,0,2
AGTGATTCAAGCAGGA-1_V12D07-335_A1,0,0,1,0,0,1
GTTGGATTGAGAACAC-1_V12D07-335_A1,0,0,2,0,0,2
CACACGCGCTGTCTTA-1_V12D07-335_A1,0,0,2,0,0,2
TAGACGCCCGTACCGG-1_V12D07-335_A1,0,0,0,2,0,2
GGTTTCAATCGGTCAG-1_V12D07-335_A1,0,0,1,0,0,1
AATCTGCGTTGGGACG-1_V12D07-335_A1,0,0,2,0,0,2
TTACGGATGGTTCGAG-1_V12D07-335_A1,1,0,1,1,0,3
CGGCAGGGTCGGGTTG-1_V12D07-335_A1,1,0,2,0,0,3
GCTTTCAGAGGAGGTG-1_V12D07-335_A1,0,3,4,0,0,7
TCTTCCCATGGGCACA-1_V12D07-335_A1,0,0,1,0,0,1
TACCGCGGACTTGCAG-1_V12D07-335_A1,0,0,0,1,0,1
AGAATTATGGATTCGA-1_V12D07-335_A1,2,0,1,0,0,3
ATTGATGAGTCCTAAC-1_V12D07-335_A1,2,0,0,1,0,3
TAGGTCGCCGGAACTG-1_V12D07-335_A1,1,0,1,0,0,2
TAACCTACCGTCCGAG-1_V12D07-335_A1,1,0,2,0,0,3
CTTAGTAGGCCTACAG-1_V12D07-335_A1,0,1,1,0,0,2
CTAGATGTGAGTGTAA-1_V12D07-335_A1,2,0,0,0,0,2
ACTCCCGAATTCGTTT-1_V12D07-335_A1,0,0,2,0,0,2
GTTCATCGTTTGGCTG-1_V12D07-335_A1,0,0,3,0,0,3
ACTTTACCCTCATGAA-1_V12D07-335_A1,0,0,1,0,0,1
GCGAGAGTTGCGTCCA-1_V12D07-335_A1,0,0,1,0,0,1
GTTCGGGCGTACCATT-1_V12D07-335_A1,0,0,3,0,0,3
CGACTTTGTATAGCCT-1_V12D07-335_A1,1,0,4,0,0,5
GCCATCGATGCTGCAT-1_V12D07-335_A1,0,0,1,0,0,1
GCATTTCCAAGGCTCC-1_V12D07-335_A1,0,2,7,1,0,10
ATGTAAGGCTGCTCTT-1_V12D07-335_A1,0,1,2,0,0,3
ACGTTCGCAATCAATT-1_V12D07-335_A1,0,0,0,0,0,0
GTGACGAGGGTGACCC-1_V12D07-335_A1,0,1,1,10,0,12
ATTATAGCTACTTTAC-1_V12D07-335_A1,0,0,4,12,0,16
CGTGTGTTAAACCCTG-1_V12D07-335_A1,3,0,0,8,0,11
TTGGTATGGCTTGTGT-1_V12D07-335_A1,1,0,1,15,0,17
CATTCCCATTCCGTCG-1_V12D07-335_A1,0,0,6,2,0,8
TGCCGAAAGCGTATTC-1_V12D07-335_A1,2,0,0,12,0,14
CAACACATCTCCTGCC-1_V12D07-335_A1,0,0,2,0,0,2
CTGCCTCATATGCAAC-1_V12D07-335_A1,0,1,2,0,0,3
TCCCGCCTATGTGCGT-1_V12D07-335_A1,0,0,1,0,0,1
GGTTACCCGACACTTT-1_V12D07-335_A1,0,0,0,0,0,0
CCAGCGGGATCACCAG-1_V12D07-335_A1,1,0,0,0,0,1
ATGTTTCGGCCCGGAG-1_V12D07-335_A1,1,0,0,0,0,1
GCGTCTAACCTCCTAA-1_V12D07-335_A1,1,0,2,0,0,3
ATCAGGTAGCTGACAG-1_V12D07-335_A1,1,0,1,0,0,2
GGTATGAAAGAACTGA-1_V12D07-335_A1,6,0,1,0,0,7
GTGGCCTAATATCATT-1_V12D07-335_A1,1,0,2,0,0,3
CCTGTGAAACCGTAAC-1_V12D07-335_A1,2,0,0,0,0,2
GGCAGAGAGATCGGGA-1_V12D07-335_A1,1,0,0,0,0,1
TAGCGTCGAATATTGA-1_V12D07-335_A1,2,2,1,0,0,5
CGCCGACTATTCGCTA-1_V12D07-335_A1,0,2,2,0,0,4
TCTGGCGCAAGCCGGG-1_V12D07-335_A1,3,1,1,0,0,5
AGTGGTTGCGTATAGG-1_V12D07-335_A1,1,0,3,0,0,4
ATCGGTTACCTAGTAA-1_V12D07-335_A1,1,2,0,0,0,3
CCTGCCCGTTGTCTAG-1_V12D07-335_A1,7,0,3,0,0,10
GCACACGCCCATGGTC-1_V12D07-335_A1,1,1,5,0,0,7
AGTACGGCCCGTATCG-1_V12D07-335_A1,2,0,2,0,0,4
TATCTAGCCTAAAGGA-1_V12D07-335_A1,0,0,2,0,0,2
CACTCGGTTAGGAGGA-1_V12D07-335_A1,3,2,4,0,0,9
ATGTTCGTCGACCCAC-1_V12D07-335_A1,2,0,2,0,0,4
TTCCTCTGCCCGAATA-1_V12D07-335_A1,0,0,5,1,0,6
TTACTATCGGCTTCTC-1_V12D07-335_A1,1,0,3,0,0,4
GCCGCATTAGTCCGGC-1_V12D07-335_A1,2,0,4,0,0,6
TAAGGGCTGGGAGAGG-1_V12D07-335_A1,1,0,2,0,0,3
TAAGCAGGCGACACGC-1_V12D07-335_A1,5,0,2,0,0,7
AGCACTACCGGCCTGT-1_V12D07-335_A1,0,0,1,1,0,2
GAAAGCCCTTTGGACC-1_V12D07-335_A1,2,0,1,0,0,3
GACCGACTGAAGCGTC-1_V12D07-335_A1,0,1,1,0,0,2
CGGTGAAGACTAAAGT-1_V12D07-335_A1,1,0,1,0,0,2
CCCTGCGCTACGCATA-1_V12D07-335_A1,1,1,2,0,0,4
TACTGGACAGCTCGGC-1_V12D07-335_A1,1,0,3,0,0,4
TTAGTAGGGCGGCGGG-1_V12D07-335_A1,1,0,2,0,0,3
GAGGCTATCAAAGTCG-1_V12D07-335_A1,2,0,0,2,0,4
TTACCATTGATTACCC-1_V12D07-335_A1,0,1,1,1,0,3
ATACCACGGGCAACTT-1_V12D07-335_A1,0,0,2,1,0,3
TGTCCTAAGTCACCGC-1_V12D07-335_A1,0,1,1,0,0,2
AGGTAGGTACAAAGCT-1_V12D07-335_A1,0,1,0,2,0,3
GGCATACAGGTAGCGG-1_V12D07-335_A1,1,0,2,0,0,3
TGTAGTGATCTATAAT-1_V12D07-335_A1,1,1,1,0,0,3
TCCCGGGTGTGCTGCT-1_V12D07-335_A1,0,0,4,1,0,5
TACGATGTTGATCATC-1_V12D07-335_A1,1,0,0,0,0,1
CCTCTCTCCCATCTAG-1_V12D07-335_A1,0,0,0,0,0,0
GCAGGACTATAGAATA-1_V12D07-335_A1,0,1,3,0,0,4
CTAGTGAAGGACAGGA-1_V12D07-335_A1,0,0,1,0,0,1
TACGAGAACTTCACGT-1_V12D07-335_A1,0,0,1,0,0,1
CGTTGTTTCAATTCCC-1_V12D07-335_A1,0,0,0,1,0,1
GCAAATATTACGCTTT-1_V12D07-335_A1,0,0,0,1,0,1
CCAATAGTGCCGTCGA-1_V12D07-335_A1,1,0,2,0,0,3
ATTGCTGCTCCTCCAT-1_V12D07-335_A1,0,0,3,0,0,3
GAGATCTGCTTGGCAT-1_V12D07-335_A1,0,3,2,1,0,6
GCCGAAATTCCTACGT-1_V12D07-335_A1,0,0,1,1,0,2
GGCACTCCACTGGGCA-1_V12D07-335_A1,0,0,0,1,0,1
GGGTCACCGTGACGGT-1_V12D07-335_A1,1,0,1,0,0,2
CACTTAATCAGACGGA-1_V12D07-335_A1,0,0,4,0,0,4
CGTTTCGCTCATTACA-1_V12D07-335_A1,0,0,3,2,0,5
ATAAAGGCTCGGTCGT-1_V12D07-335_A1,0,0,2,0,0,2
CACTAAAGTTGCCTAT-1_V12D07-335_A1,1,0,2,0,0,3
GTGCTCAAGTACTGTC-1_V12D07-335_A1,1,0,0,1,0,2
CCATGCCTGTTTAGTA-1_V12D07-335_A1,0,0,0,1,0,1
TCTAGTTATCAGAAGA-1_V12D07-335_A1,3,1,2,0,0,6
TTGTAATCCGTACTCG-1_V12D07-335_A1,0,0,0,2,0,2
TCCCAGCTTTAGTCTG-1_V12D07-335_A1,0,1,0,0,0,1
CTACGCACGGAGTACC-1_V12D07-335_A1,1,0,2,1,0,4
AAATTAACGGGTAGCT-1_V12D07-335_A1,0,0,1,0,0,1
CGGCCACGCACAAAGT-1_V12D07-335_A1,1,0,2,0,0,3
GAAGCGTGAGGAATTT-1_V12D07-335_A1,0,0,0,2,0,2
ATATCTTAGGGCCTTC-1_V12D07-335_A1,0,0,2,0,0,2
ACGCGGGCCAAGGACA-1_V12D07-335_A1,0,1,0,1,0,2
GCGAGTTCTGCAAAGA-1_V12D07-335_A1,0,0,1,0,0,1
TATTCGTGCCAGAATA-1_V12D07-335_A1,0,0,0,1,0,1
AGGGCTGCAGTTACAG-1_V12D07-335_A1,0,0,2,2,0,4
CTAGCATAGTATAATG-1_V12D07-335_A1,3,1,1,1,0,6
TAGGTTCGAGTTCGTC-1_V12D07-335_A1,0,0,0,0,0,0
GAATTATAGTGAAAGG-1_V12D07-335_A1,0,1,0,0,0,1
CTATCGGGTCTCAACA-1_V12D07-335_A1,0,0,2,0,0,2
GCGCTAATTGAATAGA-1_V12D07-335_A1,0,1,2,0,0,3
ATGCGACAGTCCCATT-1_V12D07-335_A1,0,1,0,0,0,1
GGTAGTGCTCGCACCA-1_V12D07-335_A1,1,0,0,0,0,1
AAGCTCGTGCCAAGTC-1_V12D07-335_A1,0,0,0,0,0,0
TATTCAATTCTAATCC-1_V12D07-335_A1,1,1,1,0,0,3
TTCAAAGTCTCTAGCC-1_V12D07-335_A1,0,0,0,0,0,0
TTGAATATGGACTTTC-1_V12D07-335_A1,0,0,1,0,0,1
AAGAGCTCTTTATCGG-1_V12D07-335_A1,0,1,0,1,0,2
TTACTCCGGCCGGGAA-1_V12D07-335_A1,0,0,2,1,0,3
AAACGAGACGGTTGAT-1_V12D07-335_A1,0,0,2,0,0,2
GCTAAGTAGTTTCTCT-1_V12D07-335_A1,0,0,1,0,0,1
ATAACGCCGGAGGGTC-1_V12D07-335_A1,0,0,3,0,0,3
GGATCCGGAATATACT-1_V12D07-335_A1,0,0,1,0,0,1
TGAAAGGACCTGACTC-1_V12D07-335_A1,0,0,1,0,0,1
TCCGCGGCAGCATCTG-1_V12D07-335_A1,3,0,2,2,0,7
TGCATATGTCTGTCAC-1_V12D07-335_A1,0,0,0,0,0,0
TGTAGGAGAAATTTCC-1_V12D07-335_A1,0,1,0,2,0,3
AGTGAGACTTCCAGTA-1_V12D07-335_A1,0,1,2,0,0,3
CCCAAACATGCTGCTC-1_V12D07-335_A1,0,0,2,0,0,2
GCTTATGAAGCAGGAA-1_V12D07-335_A1,2,0,0,0,0,2
TTCTAACCGAAGCTTA-1_V12D07-335_A1,0,0,0,0,0,0
GGATGTCCTTACCGCA-1_V12D07-335_A1,0,0,1,0,0,1
AGGGTGCTCTCGAGGG-1_V12D07-335_A1,0,0,0,0,0,0
AACTCTCAATAGAGCG-1_V12D07-335_A1,0,0,1,0,0,1
TCTGAATTCCGTACAA-1_V12D07-335_A1,0,0,2,0,0,2
GCGTGGTACTGGGTTA-1_V12D07-335_A1,0,3,0,0,0,3
CGTCGGATAGTGTTGA-1_V12D07-335_A1,2,0,1,0,0,3
ATATGTCTCCCTAGCC-1_V12D07-335_A1,0,0,0,1,0,1
TCTTTAAGACTATGAA-1_V12D07-335_A1,1,0,2,0,0,3
TCATTTAAGTCTCCGA-1_V12D07-335_A1,1,0,0,0,0,1
GATATTGAGATTGGCG-1_V12D07-335_A1,1,0,1,0,0,2
TGACATCGAGCGGACC-1_V12D07-335_A1,0,0,3,0,0,3
GCGTAAATGGCCATAA-1_V12D07-335_A1,0,0,0,0,0,0
ATTGTACAACTCGGCT-1_V12D07-335_A1,0,0,1,0,0,1
TACGCTATAGAAACCT-1_V12D07-335_A1,1,0,2,0,0,3
CACCCAAATCTTATGT-1_V12D07-335_A1,1,0,2,0,0,3
AGATGATGGAGTCTGG-1_V12D07-335_A1,1,0,5,0,0,6
CCACGGTGCCCGGTAG-1_V12D07-335_A1,0,0,3,0,0,3
TCAAGAAATACTAGCT-1_V12D07-335_A1,1,1,4,1,0,7
AGGTATAATTGATAGT-1_V12D07-335_A1,0,0,0,1,0,1
CAAGGTCCTATAGGCT-1_V12D07-335_A1,0,0,3,0,0,3
CCGGCACGACCGTTTC-1_V12D07-335_A1,1,1,1,0,0,3
ACCTCCGTTATTCACC-1_V12D07-335_A1,0,1,4,0,0,5
GCAGCCTATATCACAT-1_V12D07-335_A1,0,1,4,0,0,5
GGTATAGTGACACATA-1_V12D07-335_A1,0,3,2,1,0,6
AAATTCCAGGTCCAAA-1_V12D07-335_A1,1,0,5,1,0,7
TCTTTAGCAGGCGAAC-1_V12D07-335_A1,0,1,1,12,0,14
TATTGACATTTCTGCC-1_V12D07-335_A1,1,1,3,12,0,17
TCTGATCGGGTGCTAG-1_V12D07-335_A1,0,0,3,15,0,18
GGCCCGGAGCATGTCT-1_V12D07-335_A1,0,1,1,13,0,15
GGGCGCAGCGTTACTC-1_V12D07-335_A1,0,0,0,20,0,20
TTGGCGATCCGAATAT-1_V12D07-335_A1,0,0,1,12,0,13
CCACGTAAATTAGACT-1_V12D07-335_A1,1,0,0,0,0,1
TCTGATTGGAAATGGA-1_V12D07-335_A1,0,0,2,0,0,2
ATGGCGGAATAGTCGC-1_V12D07-335_A1,0,0,1,0,0,1
ATCGCTTTACGTCTCA-1_V12D07-335_A1,2,0,0,0,0,2
TACGTGCAAGGTTCCT-1_V12D07-335_A1,1,1,0,0,0,2
CAGGACAGCTGCCCTT-1_V12D07-335_A1,1,0,2,0,0,3
CAAACCAGGTCTGCAT-1_V12D07-335_A1,4,2,2,0,0,8
ACAAGCTATATGGAAG-1_V12D07-335_A1,3,3,0,0,0,6
TCGCCCACTGCGAGAG-1_V12D07-335_A1,1,0,2,0,0,3
AGCCGCAAATTCAAAT-1_V12D07-335_A1,0,1,2,0,0,3
TTAACGTTAAAGCCTG-1_V12D07-335_A1,2,0,1,0,0,3
CAGCGCCAACACGATA-1_V12D07-335_A1,0,0,3,0,0,3
ATCCAATGGTACCGAA-1_V12D07-335_A1,6,0,0,0,0,6
GTGCTGCAGATAAGGA-1_V12D07-335_A1,1,0,1,0,0,2
GGCCTTTGCAACTGGC-1_V12D07-335_A1,3,0,1,0,0,4
GTCGTACCTACGATTG-1_V12D07-335_A1,4,0,1,0,0,5
TAGAAATTCACGTATA-1_V12D07-335_A1,1,0,1,0,0,2
AGAATAAATCTTCAGG-1_V12D07-335_A1,1,0,6,0,0,7
CATTGCGAAATGGGCG-1_V12D07-335_A1,0,0,4,0,0,4
GTCTACTCAATTACAA-1_V12D07-335_A1,0,1,0,0,0,1
TGTAATGACCACAATA-1_V12D07-335_A1,1,1,2,0,0,4
AAAGTCGACCCTCAGT-1_V12D07-335_A1,1,1,2,0,0,4
TACTCGGCACGCCGGG-1_V12D07-335_A1,1,1,4,0,0,6
AGGTGTATCGCCATGA-1_V12D07-335_A1,0,0,2,0,0,2
TGTGCTTTACGTAAGA-1_V12D07-335_A1,1,0,9,0,0,10
AAACCTCATGAAGTTG-1_V12D07-335_A1,1,0,9,0,0,10
TATAGGGTACTCATGA-1_V12D07-335_A1,1,0,3,0,0,4
CCAGCTGATGGTACTT-1_V12D07-335_A1,0,0,7,0,0,7
AATATTGGAGTATTGA-1_V12D07-335_A1,1,0,2,0,0,3
GGCCCTCACCCACTTA-1_V12D07-335_A1,0,0,6,0,0,6
AACCAAGACTTCTCTG-1_V12D07-335_A1,0,0,3,0,0,3
TCGTATTACCCATTGC-1_V12D07-335_A1,1,0,2,1,0,4
ATTCGACGCCGGGCCT-1_V12D07-335_A1,1,0,3,0,0,4
GGCGCAGGACATCTTC-1_V12D07-335_A1,2,0,1,0,0,3
GTACTCCCTTATCGCT-1_V12D07-335_A1,1,0,0,0,0,1
TGGTCTGTTGGGCGTA-1_V12D07-335_A1,0,0,4,0,0,4
AATAACAACGCTCGGC-1_V12D07-335_A1,1,0,0,1,0,2
CATACCCGTACCCAGT-1_V12D07-335_A1,0,0,0,0,0,0
ACAATCCATTTAAACC-1_V12D07-335_A1,0,0,0,0,0,0
GTTACAATTGGTGACG-1_V12D07-335_A1,0,0,2,2,0,4
TTGCCCTGATCACGGG-1_V12D07-335_A1,0,0,3,0,0,3
CTAACCGCGCGCCCGT-1_V12D07-335_A1,1,0,0,0,0,1
CTAAAGAATGCCTACT-1_V12D07-335_A1,1,0,2,0,0,3
ACCCATCTTGAGGGTA-1_V12D07-335_A1,1,1,1,0,0,3
GATCTTTGCAGGGTAT-1_V12D07-335_A1,0,0,0,1,0,1
GGGTACTTCATGAACT-1_V12D07-335_A1,2,0,0,0,0,2
GCCGCTTGTGAGAAAC-1_V12D07-335_A1,0,0,1,2,0,3
CCTGTAAGACATGATA-1_V12D07-335_A1,0,1,1,0,0,2
CGACAGTTCGCGTTAT-1_V12D07-335_A1,0,0,2,0,0,2
ACGATGCATATGTTAT-1_V12D07-335_A1,0,0,0,0,0,0
TGTTCCGCTTCCATGA-1_V12D07-335_A1,0,0,2,2,0,4
GGATGACGCGAGTTTA-1_V12D07-335_A1,1,0,1,1,0,3
GAAGTTTCCACTCAAT-1_V12D07-335_A1,0,1,0,1,0,2
GCGAGGCCCGAGCAGA-1_V12D07-335_A1,0,0,1,0,0,1
CATACTATGTAATTGT-1_V12D07-335_A1,1,0,1,0,0,2
CCAATGTCACAGCAAG-1_V12D07-335_A1,0,0,2,2,0,4
GTTGGATTTGCGTTGG-1_V12D07-335_A1,0,0,2,0,0,2
GGGAGGATGCCCGAAA-1_V12D07-335_A1,1,0,3,1,0,5
GATCGCGGGCTCTCCA-1_V12D07-335_A1,0,0,1,0,0,1
GTTCGCCATAAGTGCC-1_V12D07-335_A1,0,0,0,0,0,0
AGATTATAGGACGTTT-1_V12D07-335_A1,1,0,1,0,0,2
TCGAGACCAACACCGT-1_V12D07-335_A1,1,0,0,1,0,2
TATGGGACCGAGCAGG-1_V12D07-335_A1,0,0,2,0,0,2
GATGCGTCCTGCATTC-1_V12D07-335_A1,0,0,1,0,0,1
TATGGTCTGAGTAACA-1_V12D07-335_A1,2,0,2,1,0,5
GCATAGAGCACTCAGG-1_V12D07-335_A1,0,0,3,1,0,4
CTTCATTGTCAGTGGA-1_V12D07-335_A1,0,0,0,0,0,0
GCAGATTAGGGATATC-1_V12D07-335_A1,0,0,3,0,0,3
CCTGTCGCCCGTAAAT-1_V12D07-335_A1,0,0,1,0,0,1
CAATTTCGTATAAGGG-1_V12D07-335_A1,0,0,0,0,0,0
GTACACTTACCTGAAG-1_V12D07-335_A1,0,0,2,0,0,2
CCAGCCTGGACCAATA-1_V12D07-335_A1,1,0,2,0,0,3
ATGGAGCAGGCCGTGA-1_V12D07-335_A1,0,0,1,2,0,3
GTCATTAGAGCGAACG-1_V12D07-335_A1,0,0,1,1,0,2
AAGACTGCAAGCTACT-1_V12D07-335_A1,0,1,1,1,0,3
CTAGTCACGTCTTAAG-1_V12D07-335_A1,0,0,2,1,0,3
ACTCTTGTATAGTAAC-1_V12D07-335_A1,0,0,1,0,0,1
ATTAGGCGATGCTTTC-1_V12D07-335_A1,0,0,0,1,0,1
TTCGGGACTAATCGCG-1_V12D07-335_A1,0,2,1,0,0,3
TGGACTGTTCGCTCAA-1_V12D07-335_A1,0,0,1,0,0,1
AACGTGCGAAAGTCTC-1_V12D07-335_A1,1,0,2,0,0,3
CCACCCAAGGAAAGTG-1_V12D07-335_A1,0,0,1,1,0,2
CCGCACAAAGACCAAC-1_V12D07-335_A1,0,0,2,1,0,3
GCGATTGTTAACGTTA-1_V12D07-335_A1,1,1,1,4,0,7
ACTCGTCAGTAATCCC-1_V12D07-335_A1,0,0,2,0,0,2
GGTGATAAGGAGCAGT-1_V12D07-335_A1,0,0,1,0,0,1
AAGAGGCATGGATCGC-1_V12D07-335_A1,0,0,1,0,0,1
CACGTTCGTGCTCTAG-1_V12D07-335_A1,0,0,2,0,0,2
CTATTTGGTTACGGAT-1_V12D07-335_A1,1,0,1,0,0,2
GTACAGAGGCAAGGGT-1_V12D07-335_A1,0,2,2,1,0,5
GGGCCGGCCGAAGTAC-1_V12D07-335_A1,0,1,0,1,0,2
CCTGAACGATATATTC-1_V12D07-335_A1,0,0,4,1,0,5
CCGGGCTGCTCCATAC-1_V12D07-335_A1,0,0,1,0,0,1
TACTTGTTAGTAGTCC-1_V12D07-335_A1,0,0,2,0,0,2
CCTAGGCGTAGCGATC-1_V12D07-335_A1,0,0,0,0,0,0
CTGGCGCACAGGTCTG-1_V12D07-335_A1,0,0,1,0,0,1
ACTTATACTTACCCGG-1_V12D07-335_A1,0,0,2,0,0,2
GAAGTCTCCCTAGCGA-1_V12D07-335_A1,0,2,1,1,0,4
ACCGATGGTAGCATCG-1_V12D07-335_A1,0,0,0,0,0,0
CGAGTTTATCGGACTG-1_V12D07-335_A1,1,0,0,0,0,1
CATAACGGACAGTCGT-1_V12D07-335_A1,0,0,2,0,0,2
TGACGATGCACTAGAA-1_V12D07-335_A1,0,2,5,0,0,7
TAGGGAGCTTGGGATG-1_V12D07-335_A1,2,2,0,0,0,4
AGGGTCGATGCGAACT-1_V12D07-335_A1,0,0,3,1,0,4
TATATCCCTGGGAGGA-1_V12D07-335_A1,0,0,0,0,0,0
CATCTTACACCACCTC-1_V12D07-335_A1,1,0,1,0,0,2
GTGCGACAGGGAGTGT-1_V12D07-335_A1,0,0,2,0,0,2
CCGATCTCAACCTTAT-1_V12D07-335_A1,1,1,0,0,0,2
ACGATCATCTTGTAAA-1_V12D07-335_A1,0,0,2,0,0,2
GAAAGAACAGCGTTAT-1_V12D07-335_A1,1,0,1,0,0,2
CTAGGTCTGAAGGAAT-1_V12D07-335_A1,0,0,6,1,0,7
ATATCAACCTACAGAG-1_V12D07-335_A1,0,0,4,0,0,4
AAATAGCTTAGACTTT-1_V12D07-335_A1,0,0,2,0,0,2
GCGACATGTAAACATC-1_V12D07-335_A1,1,0,1,0,0,2
ATAAGTAGGGCGACTC-1_V12D07-335_A1,0,0,4,0,0,4
GCGAGCGCATGCTCCC-1_V12D07-335_A1,1,0,3,1,0,5
AGGGACCGGCTGCGTT-1_V12D07-335_A1,1,0,1,0,0,2
CCTATGAAGTGGTGCC-1_V12D07-335_A1,1,0,1,0,0,2
GCTTACGTAGTTAGTA-1_V12D07-335_A1,1,0,0,0,0,1
CATACTTAGGCAATAC-1_V12D07-335_A1,0,0,1,0,0,1
CCTGTCCCTCACGTTA-1_V12D07-335_A1,1,1,1,1,0,4
CAATGTGCCAACCCTT-1_V12D07-335_A1,0,1,1,1,0,3
GTTAAGTTAGAGTGGG-1_V12D07-335_A1,1,0,4,2,0,7
CTGGGATACGCTACCC-1_V12D07-335_A1,2,1,3,2,0,8
AACCTGTCACGGAATT-1_V12D07-335_A1,1,0,4,4,0,9
ACTGCGGACACACCGT-1_V12D07-335_A1,0,0,3,3,0,6
CCGTGAGGCATTCATG-1_V12D07-335_A1,0,0,1,10,0,11
GCCCAGATGCTGGAGA-1_V12D07-335_A1,0,0,1,14,0,15
TCTGGCCGTTCAAGTT-1_V12D07-335_A1,1,0,1,15,0,17
ATACGAAGGCTTTCCA-1_V12D07-335_A1,0,0,2,22,0,24
GATCCGAATATAAGTG-1_V12D07-335_A1,0,0,0,1,0,1
GTGGAGCATGTCGGCC-1_V12D07-335_A1,0,0,0,0,0,0
ACTCTTCAGCTCCCGC-1_V12D07-335_A1,0,0,2,0,0,2
CCCGATAGCCTCGCCT-1_V12D07-335_A1,1,0,0,0,0,1
ACAGGTGTGTTGTTGC-1_V12D07-335_A1,2,0,2,0,0,4
TGAACTGCTATGACTT-1_V12D07-335_A1,2,1,2,0,0,5
TGACATATATGACGAT-1_V12D07-335_A1,1,1,0,0,0,2
AAGTCTTCTGTGGCCT-1_V12D07-335_A1,2,0,0,0,0,2
ACCAGACCATAACAAC-1_V12D07-335_A1,1,1,3,0,0,5
TGAGACGTACCTCTCA-1_V12D07-335_A1,2,3,1,0,0,6
GACCGTTACATGCGAC-1_V12D07-335_A1,2,0,3,0,0,5
GGTTCGGATTATACTA-1_V12D07-335_A1,2,0,3,0,0,5
CCTCCTGAGCCCACAT-1_V12D07-335_A1,5,0,2,0,0,7
CCGCGATTTGGTAGGT-1_V12D07-335_A1,1,0,0,0,0,1
AATCTCTACTGTGGTT-1_V12D07-335_A1,4,0,0,0,0,4
ACTTTGACTGCATCCT-1_V12D07-335_A1,1,0,0,0,0,1
CCCTGACTAACAAATT-1_V12D07-335_A1,2,1,2,0,0,5
ACGCTGTGAGGCGTAG-1_V12D07-335_A1,0,0,2,0,0,2
GCATACGAGGTCTTTA-1_V12D07-335_A1,2,1,1,0,0,4
TCGGGATTCAAACATA-1_V12D07-335_A1,1,1,3,0,0,5
GGGCCCTACGAAAGGG-1_V12D07-335_A1,3,0,0,0,0,3
CGCCAAGAAGCCGAGT-1_V12D07-335_A1,3,1,1,0,0,5
GGTACATCTGGGACGA-1_V12D07-335_A1,2,1,2,0,0,5
GGATGCTGGCGTTCCT-1_V12D07-335_A1,2,0,1,0,0,3
CCGATTCGAGGGACCC-1_V12D07-335_A1,0,1,5,0,0,6
CCACTGGTGGCTGGTT-1_V12D07-335_A1,1,0,2,0,0,3
GACAGGCACACACTAT-1_V12D07-335_A1,0,0,5,0,0,5
TCAACGCGACCGGCAG-1_V12D07-335_A1,0,0,5,0,0,5
CTACGACTAGCTATAA-1_V12D07-335_A1,0,0,6,0,0,6
CGGTTGACCTGGCATA-1_V12D07-335_A1,1,0,4,0,0,5
ATCCTGAATCGCTGCG-1_V12D07-335_A1,0,0,2,0,0,2
GTTTCATATCGTCGCT-1_V12D07-335_A1,0,0,3,0,0,3
ATAAATATTAGCAGCT-1_V12D07-335_A1,0,0,6,0,0,6
AAGAGGATGTACGCGA-1_V12D07-335_A1,0,1,3,3,0,7
TCCTGCGTTGATACTC-1_V12D07-335_A1,1,0,2,0,0,3
CGTGCATTGTCGACGC-1_V12D07-335_A1,1,0,1,0,0,2
CCGGGTTCGAGGTTAC-1_V12D07-335_A1,0,0,1,0,0,1
CCCAATTTCACAACTT-1_V12D07-335_A1,0,1,1,0,0,2
TGATTTATTAGCTGTG-1_V12D07-335_A1,0,0,2,0,0,2
TGGAAGAAGGGAACGT-1_V12D07-335_A1,1,2,1,0,0,4
GACGCTTGCTTCTAAA-1_V12D07-335_A1,2,0,0,0,0,2
GGGAACGGGAGGTTAG-1_V12D07-335_A1,0,0,1,0,0,1
GCGGCTCTGACGTACC-1_V12D07-335_A1,0,0,0,0,0,0
ACGTTAGATTTGCCCG-1_V12D07-335_A1,0,0,3,1,0,4
GAGAGGGCGCGAGGTT-1_V12D07-335_A1,0,0,0,1,0,1
GCGTCTCTGCATTGGG-1_V12D07-335_A1,0,0,2,0,0,2
GCAGCACACAGCCCAG-1_V12D07-335_A1,0,0,3,1,0,4
CAGGCCGTTTGGGTGT-1_V12D07-335_A1,0,1,1,1,0,3
AACTCAAGTTAATTGC-1_V12D07-335_A1,0,0,5,0,0,5
CTTCGTAGATAGGTGA-1_V12D07-335_A1,0,1,2,0,0,3
TGCAGAGTACCGAGCA-1_V12D07-335_A1,0,0,1,1,0,2
GAAGTGATTTATCGTG-1_V12D07-335_A1,0,1,0,0,0,1
CGCTACGGGACATTTA-1_V12D07-335_A1,0,0,1,0,0,1
CCACACTGAGATATTA-1_V12D07-335_A1,0,0,1,0,0,1
CGATCCGACCCAGTGC-1_V12D07-335_A1,2,0,2,2,0,6
CTGTACTTCTTAGCAT-1_V12D07-335_A1,0,0,1,0,0,1
ACTTATTAGGATCGGT-1_V12D07-335_A1,0,0,1,0,0,1
TAGTCCGCAGAGAATG-1_V12D07-335_A1,0,0,0,0,0,0
TTCACGAAAGGATCAC-1_V12D07-335_A1,0,0,2,0,0,2
TACATTTCTAACGTGC-1_V12D07-335_A1,0,0,0,0,0,0
ACCATATCCGCAATAA-1_V12D07-335_A1,1,1,1,0,0,3
CACTCAAGAGCTATGG-1_V12D07-335_A1,0,0,1,2,0,3
TGTACGAACAAATCCG-1_V12D07-335_A1,0,0,1,1,0,2
ATCATCCAATATTTGT-1_V12D07-335_A1,1,1,3,0,0,5
CGCTATTCTTAGGCTC-1_V12D07-335_A1,0,0,0,1,0,1
TGGCAGCAGTAATAGT-1_V12D07-335_A1,0,0,0,0,0,0
TCACGTGCCCGATTCA-1_V12D07-335_A1,1,0,2,2,0,5
CATACGGCGTCTGGGC-1_V12D07-335_A1,2,0,1,0,0,3
CACATGATTCAGCAAC-1_V12D07-335_A1,0,0,1,1,0,2
GCTAGTAGAGCTTGTA-1_V12D07-335_A1,0,0,0,2,0,2
TGCTGTTGAAGAACTC-1_V12D07-335_A1,0,0,2,1,0,3
CGGAGCATGGCGATCC-1_V12D07-335_A1,0,0,1,0,0,1
TAGCGTTGGGTCTTAC-1_V12D07-335_A1,1,0,1,1,0,3
GTAGCGGCTATACACT-1_V12D07-335_A1,0,0,2,0,0,2
TAACATACAATGTGGG-1_V12D07-335_A1,0,0,0,0,0,0
TCTTCGAATAGACGTT-1_V12D07-335_A1,0,1,0,2,0,3
GATCGTGACTGATATC-1_V12D07-335_A1,0,0,1,0,0,1
GATCCGGGAATTAACA-1_V12D07-335_A1,0,0,3,0,0,3
TTATATACGCTGTCAC-1_V12D07-335_A1,1,0,2,0,0,3
GTCGCGTAACCCGTTG-1_V12D07-335_A1,1,1,3,0,0,5
AGCTCTAGACGTTCCA-1_V12D07-335_A1,1,0,2,2,0,5
GTCAAGCGGACTCGGG-1_V12D07-335_A1,0,0,1,0,0,1
CGAGGGACTGCGGTCG-1_V12D07-335_A1,0,0,2,0,0,2
AATCGCCTCAGCGCCA-1_V12D07-335_A1,1,1,2,0,0,4
CTTGTTGCTGAGTCAA-1_V12D07-335_A1,1,0,1,0,0,2
GATATGAGACACTAAC-1_V12D07-335_A1,0,0,0,0,0,0
TTATGATCTTAACGAA-1_V12D07-335_A1,1,0,3,2,0,6
CGCCGCCCATGCCTGT-1_V12D07-335_A1,1,2,0,1,0,4
CTGGGATAAATAATGG-1_V12D07-335_A1,0,2,1,0,0,3
GTGCCCGTTCGGATTC-1_V12D07-335_A1,0,1,0,1,0,2
TTCAATACTCTGAATC-1_V12D07-335_A1,0,0,1,0,0,1
CGCACATGTCCACTAC-1_V12D07-335_A1,1,0,1,0,0,2
AGAAGAGCGCCGTTCC-1_V12D07-335_A1,0,0,3,0,0,3
GATAACTCGCACTGTG-1_V12D07-335_A1,2,0,2,0,0,4
AGTCGACGGTCTCAAG-1_V12D07-335_A1,1,0,3,1,0,5
GTGACCGCACACTACG-1_V12D07-335_A1,1,0,3,0,0,4
GTATGTGGGTCTAGTT-1_V12D07-335_A1,0,0,1,0,0,1
CTTGAGTTAGGGTAAT-1_V12D07-335_A1,0,0,1,0,0,1
TTAGCTGATTTGCCGT-1_V12D07-335_A1,0,0,1,1,0,2
GCTGTTGCTACCGAAC-1_V12D07-335_A1,2,0,1,0,0,3
TATTACCATCCTGCTT-1_V12D07-335_A1,0,0,1,1,0,2
TTGAATTCACGTGAGG-1_V12D07-335_A1,1,0,3,0,0,4
CCATCTCACCAGTGAA-1_V12D07-335_A1,1,0,2,0,0,3
CGCACGTGCGCTATCA-1_V12D07-335_A1,0,0,1,0,0,1
ACCCGGATGACGCATC-1_V12D07-335_A1,0,0,1,0,0,1
CGCTAGAGACCGCTGC-1_V12D07-335_A1,1,0,2,0,0,3
ATAGTTCCACCCACTC-1_V12D07-335_A1,0,0,3,0,0,3
GCAGACCCAGCACGTA-1_V12D07-335_A1,1,0,1,1,0,3
TAGACTACCTAGCGTT-1_V12D07-335_A1,0,0,2,0,0,2
GGTTCTACTCGTCTGA-1_V12D07-335_A1,0,0,2,0,0,2
GACTCACCCACGTGAG-1_V12D07-335_A1,2,0,0,0,0,2
AGCTCTTCGTAACCTT-1_V12D07-335_A1,0,0,1,0,0,1
ACTATCCAGGGCATGG-1_V12D07-335_A1,0,1,2,0,0,3
AAGGATCGATCGCTTG-1_V12D07-335_A1,1,1,1,0,0,3
ATATCGGTAGGGAGAT-1_V12D07-335_A1,0,0,1,0,0,1
TTCCAGACGAGATTTA-1_V12D07-335_A1,1,1,0,1,0,3
GACCGACGTGAAAGCA-1_V12D07-335_A1,0,0,2,0,0,2
CCTGGAAACGTTCTGC-1_V12D07-335_A1,0,0,2,0,0,2
CCGGTAATGGCTAGTC-1_V12D07-335_A1,0,1,3,0,0,4
GCCGTGGAAGAAATGT-1_V12D07-335_A1,0,0,4,2,0,6
GTCTTGAGGAGCAGTG-1_V12D07-335_A1,2,0,4,1,0,7
TCCCAAAGCCCTAAAT-1_V12D07-335_A1,2,0,5,0,0,7
TTGAGCGCCACGTGAT-1_V12D07-335_A1,0,0,1,1,0,2
TTGAGTCCCGCTGCTG-1_V12D07-335_A1,2,0,2,3,0,7
ATGGAACCTTTGCACA-1_V12D07-335_A1,0,0,2,2,0,4
GCTAGCACCTGGGCCA-1_V12D07-335_A1,0,0,3,2,0,5
CGCCGTCTACCCATCG-1_V12D07-335_A1,0,0,1,15,0,16
GATAGGTGTCCCGGGC-1_V12D07-335_A1,0,0,1,15,0,16
AGGTATGCGGACATTA-1_V12D07-335_A1,0,0,0,14,0,14
TTGGTTCGCTCAAAGG-1_V12D07-335_A1,0,0,6,6,0,12
TCTGGAGCGTAAGAGT-1_V12D07-335_A1,0,0,3,0,0,3
TGCCTAAATTTAATAG-1_V12D07-335_A1,0,0,1,0,0,1
TAATTTCCGTCCAGTA-1_V12D07-335_A1,3,4,0,0,0,7
TCCTTCAATCCCTACG-1_V12D07-335_A1,2,2,0,0,0,4
TACCTATCCCTAGAGG-1_V12D07-335_A1,6,1,0,0,0,7
GCATGGGTACTGACGC-1_V12D07-335_A1,0,0,2,0,0,2
GTCGGGAACATGGTAG-1_V12D07-335_A1,3,3,2,0,0,8
GCAAATGAGGACACTT-1_V12D07-335_A1,3,2,2,0,0,7
GAATGGGCTTATCGAC-1_V12D07-335_A1,5,2,0,0,0,7
TGGTCGTGCAAGGCAA-1_V12D07-335_A1,3,0,0,0,0,3
CACCACGCCACACAGA-1_V12D07-335_A1,0,3,0,0,0,3
GAACCTCGACCTACAC-1_V12D07-335_A1,3,3,2,0,0,8
CAATACGCTCTGAGGC-1_V12D07-335_A1,1,1,0,0,0,2
TGGTAAGCAGGATTGA-1_V12D07-335_A1,1,1,2,0,0,4
AGTGGCTCCGTCGGCC-1_V12D07-335_A1,0,1,0,0,0,1
GATCGGATAGAACCAT-1_V12D07-335_A1,1,0,2,0,0,3
GCTACAGTACGGACCG-1_V12D07-335_A1,1,0,2,0,0,3
TCTATTACTAGAGGAT-1_V12D07-335_A1,1,1,0,0,0,2
TTCAGGCGTCAAAGCC-1_V12D07-335_A1,3,0,2,0,0,5
AGACCGGGAAACCCTG-1_V12D07-335_A1,0,2,2,0,0,4
AGAGATCTCTAAAGCG-1_V12D07-335_A1,0,0,0,0,0,0
CCCTGCCCAATCCGCT-1_V12D07-335_A1,0,0,1,0,0,1
GTGGCGGTCCCAGCGT-1_V12D07-335_A1,2,2,3,0,0,7
GCATTGTAATTCATAT-1_V12D07-335_A1,2,2,2,0,0,6
CCGTTCCGAATCTCGG-1_V12D07-335_A1,1,0,2,0,0,3
AGCTTGATCTTAACTT-1_V12D07-335_A1,4,1,2,0,0,7
CCTGTACTCACGCCCA-1_V12D07-335_A1,1,0,2,0,0,3
AAGTGACGACCGAATT-1_V12D07-335_A1,1,1,3,0,0,5
CTCACTTGGCTGGTAA-1_V12D07-335_A1,2,0,2,0,0,4
CGCCTGGCCTACGTAA-1_V12D07-335_A1,2,0,3,0,0,5
CCCGTAAGTCTAGGCC-1_V12D07-335_A1,2,0,2,0,0,4
TTGGACATGTGGCTTA-1_V12D07-335_A1,0,0,1,2,0,3
ATTACGCGCTGGCAGG-1_V12D07-335_A1,0,0,5,1,0,6
ACGCGCTACACAGGGT-1_V12D07-335_A1,4,0,1,0,0,5
TACGTTTACCGGCAAT-1_V12D07-335_A1,0,0,0,0,0,0
CGAAACGCAATTCATG-1_V12D07-335_A1,3,0,2,0,0,5
TAGTCTAACAACGAGA-1_V12D07-335_A1,0,1,0,0,0,1
TTGCATGCTGATCACG-1_V12D07-335_A1,0,0,2,0,0,2
TCTGGGTAGCGCTCAT-1_V12D07-335_A1,0,0,0,0,0,0
ACATCGGTCAGCCGCG-1_V12D07-335_A1,1,1,5,0,0,7
AGATACCGGTGTTCAC-1_V12D07-335_A1,0,0,5,1,0,6
GATTACTGAATTTGGG-1_V12D07-335_A1,0,0,1,0,0,1
TCCAACTTTAAATTCT-1_V12D07-335_A1,1,1,1,0,0,3
TCCTAGCAAAGAAGCT-1_V12D07-335_A1,0,0,0,0,0,0
GTCTATCTGAGTTTCT-1_V12D07-335_A1,0,0,0,0,0,0
GATGTTCAATCCACGA-1_V12D07-335_A1,1,0,0,0,0,1
AGTTAAACACTTGCGA-1_V12D07-335_A1,1,1,3,0,0,5
AGCTCTTTACTCAGTT-1_V12D07-335_A1,1,1,0,0,0,2
ATCCAGGATTCGTGAA-1_V12D07-335_A1,0,0,0,0,0,0
AGTCAACACCACCATC-1_V12D07-335_A1,1,0,0,2,0,3
CGATACCTCGCGGACA-1_V12D07-335_A1,0,1,2,0,0,3
TACAACGCACAACTCA-1_V12D07-335_A1,1,0,4,1,0,6
AATTAAAGGTCGGCGT-1_V12D07-335_A1,0,1,1,0,0,2
TACGCAGTTCTTTCCT-1_V12D07-335_A1,0,0,1,0,0,1
GACCGTGCTGACGGTG-1_V12D07-335_A1,0,0,3,0,0,3
GGCAAATTACTTTACT-1_V12D07-335_A1,1,0,0,0,0,1
GGTACAAACATGCTAT-1_V12D07-335_A1,2,0,0,0,0,2
CGGGCCTTCTTTGTAA-1_V12D07-335_A1,2,0,0,2,0,4
CGTGAAGTTAATTCAC-1_V12D07-335_A1,0,0,0,0,0,0
ATAGTGAAGCGTTCTC-1_V12D07-335_A1,1,0,1,1,0,3
TACGCCATATTCTAAT-1_V12D07-335_A1,0,2,1,0,0,3
GCCGGGTTAGGGTCGC-1_V12D07-335_A1,2,1,2,1,0,6
TACATAGGCATACACC-1_V12D07-335_A1,1,0,0,0,0,1
GCCGATTGGCCAAGCT-1_V12D07-335_A1,0,0,1,1,0,2
CTGCCATGCATCACAT-1_V12D07-335_A1,1,0,1,0,0,2
TTATGAATGAAAGGGA-1_V12D07-335_A1,1,0,3,0,0,4
GCTGAGGCGTGAGTAT-1_V12D07-335_A1,0,0,0,1,0,1
GCGCCGTTCCACGATA-1_V12D07-335_A1,0,0,0,0,0,0
CGCATGGTGCGATGCT-1_V12D07-335_A1,1,1,1,1,0,4
AGGTTTCACACACCTT-1_V12D07-335_A1,0,1,1,0,0,2
CAAGGATCGCATGTTC-1_V12D07-335_A1,0,1,0,0,0,1
ACGTTAATGTCGAAGA-1_V12D07-335_A1,1,1,0,0,0,2
TCCAGAGCACCGGTTC-1_V12D07-335_A1,0,0,0,0,1,1
GATTCGACGGTTCACG-1_V12D07-335_A1,1,0,3,0,0,4
GTTTCTGCAGTCTCCC-1_V12D07-335_A1,0,0,2,1,0,3
GCTGCACGGTTTCTTA-1_V12D07-335_A1,0,0,3,0,0,3
CGTGCAGACTGGGACA-1_V12D07-335_A1,1,0,4,0,0,5
GTGTTACTATGCGTCC-1_V12D07-335_A1,0,0,0,1,0,1
TCCTCGGGCTGGGCTT-1_V12D07-335_A1,0,0,0,0,0,0
GTGAGGACACTTAAGG-1_V12D07-335_A1,0,0,2,0,0,2
ATACGCCGGCGAAACC-1_V12D07-335_A1,0,0,0,1,0,1
TCTGCCAGAAACTGCA-1_V12D07-335_A1,0,0,1,0,0,1
TTCTGCGGGTTAGCGG-1_V12D07-335_A1,2,0,0,1,0,3
CTCGGTACCACTGCTC-1_V12D07-335_A1,0,0,4,0,0,4
GTAAGTAACAGTCTGG-1_V12D07-335_A1,1,1,1,0,0,3
GTGCGTGTATATGAGC-1_V12D07-335_A1,0,0,2,0,0,2
ATTTGTCTTGGGAGCT-1_V12D07-335_A1,0,0,1,0,0,1
CCTCGGACCGGGATAG-1_V12D07-335_A1,0,0,1,0,0,1
TAGGTGCTCGCCTAGC-1_V12D07-335_A1,0,2,4,0,0,6
CTTTAGGAACACTGTT-1_V12D07-335_A1,0,0,1,0,0,1
TCGGGCCGTCGTGGTA-1_V12D07-335_A1,0,0,1,0,0,1
AGTGCTTGCACGAATA-1_V12D07-335_A1,0,0,0,0,0,0
TGCAGTTTCCTCCCAT-1_V12D07-335_A1,0,0,0,0,0,0
TGAGAGATTTACCACG-1_V12D07-335_A1,0,0,5,0,0,5
GAAACAGATGACCACC-1_V12D07-335_A1,1,0,1,0,0,2
AGCAACATATCTTATT-1_V12D07-335_A1,0,0,3,0,0,3
CAAGTGTGGTTGCAAA-1_V12D07-335_A1,1,0,2,0,0,3
GCCTCATCTGGAAATA-1_V12D07-335_A1,1,0,1,0,0,2
AACCCTACTGTCAATA-1_V12D07-335_A1,1,0,3,0,0,4
ACGTATTACTCCGATC-1_V12D07-335_A1,0,1,1,2,0,4
TCTGGGAACCTTTGAA-1_V12D07-335_A1,2,0,0,0,0,2
GCTCGCTCATGTCCAA-1_V12D07-335_A1,0,0,2,0,0,2
GCGCAAGAGCGCGCTG-1_V12D07-335_A1,0,0,2,0,0,2
TTGACGCTCCATGAGC-1_V12D07-335_A1,1,0,1,2,0,4
TATAGATGGTCGCAGT-1_V12D07-335_A1,2,0,5,1,0,8
TTACATGCCACAACTA-1_V12D07-335_A1,0,1,1,1,0,3
ACATGGCGCCAAAGTA-1_V12D07-335_A1,0,0,3,0,0,3
TATGGTTAGTGGGAGA-1_V12D07-335_A1,0,0,0,0,0,0
CATGACTTCGCTGAAT-1_V12D07-335_A1,0,0,1,0,0,1
ACCACCAATGTAACAA-1_V12D07-335_A1,0,0,1,0,0,1
TCTTAGAGCTCCAATT-1_V12D07-335_A1,1,0,2,0,0,3
CCACGAATTTAACCTC-1_V12D07-335_A1,1,0,2,2,0,5
TTCTTGCTAGCATCTC-1_V12D07-335_A1,3,0,0,1,0,4
ACACCTTACTACTTGC-1_V12D07-335_A1,1,2,1,2,0,6
AGTCGGTTGCGTGAGA-1_V12D07-335_A1,0,0,0,0,0,0
ACCTACAGTATGTGGT-1_V12D07-335_A1,1,1,4,1,0,7
GAGGATAAACAGTGCT-1_V12D07-335_A1,2,0,2,0,0,4
TTCCGGTATCTGTGTC-1_V12D07-335_A1,1,0,4,1,0,6
GGAGGCCGAAGTCGTC-1_V12D07-335_A1,2,0,1,1,0,4
TTCGCTAGGAAGTTGT-1_V12D07-335_A1,0,0,2,1,0,3
TAAAGACAACCCTTTA-1_V12D07-335_A1,0,0,2,1,0,3
GTTGCGCTAACATTAC-1_V12D07-335_A1,0,0,2,7,0,9
GCTGAACTCTCCAGGG-1_V12D07-335_A1,0,0,3,3,0,6
AGCCCTGTCGCACCGT-1_V12D07-335_A1,2,0,0,5,0,7
AGCGCTAGAGCGATGT-1_V12D07-335_A1,0,0,1,4,0,5
TGCGCCGTTAATAACG-1_V12D07-335_A1,0,0,2,13,0,15
TGACAACGCATGTCGC-1_V12D07-335_A1,0,0,1,22,0,23
CGTCTTGAGTGTGACG-1_V12D07-335_A1,0,1,0,20,0,21
GATAGGATTAATTACA-1_V12D07-335_A1,2,0,3,2,0,7
GATACCGTGTCGGAGT-1_V12D07-335_A1,0,0,4,0,0,4
TGTGTCGAAGTCGAGG-1_V12D07-335_A1,2,2,0,0,0,4
GGATCAGAGCCATCAG-1_V12D07-335_A1,1,1,2,0,0,4
GTCCCAATCATCCCGC-1_V12D07-335_A1,0,2,2,0,0,4
TGCCACACTAGAGGAA-1_V12D07-335_A1,2,0,4,0,0,6
TGAATTTCACTTGCCT-1_V12D07-335_A1,2,6,0,0,0,8
CTCAGATTGTGATAAG-1_V12D07-335_A1,4,3,1,0,0,8
CGGACGTTACTTGAAG-1_V12D07-335_A1,3,1,0,0,0,4
CCGCCTTGCGATGTCG-1_V12D07-335_A1,1,1,1,0,0,3
CCAGTCAAATCTCTTA-1_V12D07-335_A1,6,0,0,0,0,6
AAACAGCTTTCAGAAG-1_V12D07-335_A1,1,2,0,0,0,3
TAGCTGATGTGAAGCG-1_V12D07-335_A1,1,2,2,0,0,5
CTTATGCGCTCAGGGC-1_V12D07-335_A1,1,1,1,0,0,3
TGGCTCTTGTCGCGTA-1_V12D07-335_A1,1,1,1,0,0,3
TTGTGAGGCATGACGC-1_V12D07-335_A1,3,0,1,0,0,4
CATAAGCTCTCCGTCT-1_V12D07-335_A1,2,1,1,0,0,4
CCTTCTCAGCGTTCCT-1_V12D07-335_A1,1,0,3,0,0,4
TGCAGCTACGTACTTC-1_V12D07-335_A1,1,0,0,0,0,1
CTCTACACTGGCGATT-1_V12D07-335_A1,1,2,1,0,0,4
TGCAGATCGTCCTAGG-1_V12D07-335_A1,2,0,1,0,0,3
TGCCAAAGTCAGACTT-1_V12D07-335_A1,1,1,1,0,0,3
ACAATAGTCGTACGTT-1_V12D07-335_A1,0,1,1,0,0,2
CATGCCAACTCGCAAA-1_V12D07-335_A1,3,3,1,0,0,7
TGCAGAACTATATCGT-1_V12D07-335_A1,0,1,1,0,0,2
TCGTGTCACGCTGACA-1_V12D07-335_A1,3,2,2,0,0,7
TGATCAGGGAACTGCT-1_V12D07-335_A1,3,1,3,0,0,7
CTTGCAACCGCCTCCT-1_V12D07-335_A1,1,2,2,0,0,5
AGCCCATACATGTAAG-1_V12D07-335_A1,3,0,2,0,0,5
ATCCAATGGAGGGTCC-1_V12D07-335_A1,2,1,2,0,0,5
AAACCGGGTAGGTACC-1_V12D07-335_A1,0,0,0,4,0,4
GCAACCACGGCCGCGT-1_V12D07-335_A1,2,2,0,0,0,4
CGCTTATTCCCGGTCG-1_V12D07-335_A1,0,0,1,0,0,1
TTACTCTGGTACGTAC-1_V12D07-335_A1,2,1,3,0,0,6
GTGGTTTCCGCCTTTC-1_V12D07-335_A1,1,0,2,0,0,3
ATAGGCGGCTATAGAA-1_V12D07-335_A1,0,0,1,0,0,1
GTGCCATCACACGGTG-1_V12D07-335_A1,1,0,0,0,0,1
CCCAACATACGTCGCG-1_V12D07-335_A1,0,0,2,0,0,2
CGGTGCAGATAGAACG-1_V12D07-335_A1,2,0,1,0,0,3
GGGCGGGTTCCCTACG-1_V12D07-335_A1,1,0,0,0,0,1
TGAGCCATACAGTCTC-1_V12D07-335_A1,1,0,1,0,0,2
CTCCGCCCACATGAGG-1_V12D07-335_A1,0,0,2,0,0,2
GTTGAACCGGTTCCAT-1_V12D07-335_A1,0,0,1,0,0,1
TTGACTACCATATGGT-1_V12D07-335_A1,0,0,4,0,0,4
ACCATCGTATATGGTA-1_V12D07-335_A1,0,0,1,0,0,1
TGCGTAAGAACCTGAT-1_V12D07-335_A1,1,0,3,0,0,4
AGAAGGTTGCCGAATT-1_V12D07-335_A1,0,0,3,0,0,3
AGGACGACCCATTAGA-1_V12D07-335_A1,1,0,0,1,0,2
GGTGCTGGTACACATT-1_V12D07-335_A1,1,0,0,0,0,1
GCGCTATGCCGAGGCA-1_V12D07-335_A1,0,0,0,1,0,1
ACCCGGTTACACTTCC-1_V12D07-335_A1,1,0,1,1,0,3
TAACTCATCCGCGCGG-1_V12D07-335_A1,1,2,1,0,0,4
CACAATGAGCTGCTAT-1_V12D07-335_A1,0,0,5,0,0,5
GTTACTTTGGGCCTAG-1_V12D07-335_A1,1,0,1,0,0,2
GGGCCCGTCTTAAACA-1_V12D07-335_A1,0,0,2,0,0,2
GAAATTGTCTCTATAA-1_V12D07-335_A1,0,0,1,0,0,1
GGCGCATGAATTGATG-1_V12D07-335_A1,1,1,2,1,0,5
CATATAGGTACAGTCA-1_V12D07-335_A1,0,1,2,1,0,4
TCAACGAGGAGACAAA-1_V12D07-335_A1,0,0,1,0,0,1
TTGCACAATTCAGAAA-1_V12D07-335_A1,1,1,0,2,0,4
CATCGGACGGGTTAAT-1_V12D07-335_A1,1,0,1,2,0,4
ATTAAACATGCGGACC-1_V12D07-335_A1,0,0,1,0,0,1
TATCTACCACAGCGGG-1_V12D07-335_A1,0,0,1,0,0,1
CGAGACCCTAGAGTGT-1_V12D07-335_A1,0,0,3,0,1,4
ACATCGATCGTTTACC-1_V12D07-335_A1,0,1,3,2,0,6
ATCGACCCAATACAGA-1_V12D07-335_A1,0,1,1,0,0,2
GAATCTGAACATTCTC-1_V12D07-335_A1,0,0,0,0,0,0
AGTTCCTATTTATGTT-1_V12D07-335_A1,0,0,0,1,0,1
CAGTCTGTATACTGGG-1_V12D07-335_A1,1,0,2,0,0,3
GGAGACGACACCTTTG-1_V12D07-335_A1,0,0,0,1,0,1
CCTAAATTAACGGTTC-1_V12D07-335_A1,1,0,2,0,0,3
GCTACGACTTATTGGG-1_V12D07-335_A1,0,1,2,1,0,4
CTGTGCAGGGTAGGTC-1_V12D07-335_A1,0,0,1,1,0,2
ACGCCGCTAGACGACC-1_V12D07-335_A1,0,0,1,0,0,1
ACTTGACTCCCTCTTT-1_V12D07-335_A1,1,0,1,0,0,2
CGCCTCCCTCCTCTAT-1_V12D07-335_A1,0,0,1,0,0,1
CTAGATTTACGACGGC-1_V12D07-335_A1,0,0,1,1,0,2
GATGCTGTATTTCATC-1_V12D07-335_A1,0,0,0,0,0,0
TGCGTTTGTTGACACT-1_V12D07-335_A1,0,0,0,0,0,0
CGTGCCCTCCCGAAGA-1_V12D07-335_A1,2,0,1,0,0,3
ACTCTCTGACTTAGGT-1_V12D07-335_A1,0,0,0,0,0,0
CTGGGTAGGCAGTTAA-1_V12D07-335_A1,1,0,0,0,0,1
GTTTGGCCCAAGTTAT-1_V12D07-335_A1,1,0,0,0,0,1
GAATGTGGTCCGGATT-1_V12D07-335_A1,0,0,0,0,0,0
CCCAGTTAAGGCGCCG-1_V12D07-335_A1,0,0,0,0,0,0
CGGTACTAGAATCAAA-1_V12D07-335_A1,0,0,6,0,0,6
GCTTAATGTAACTAAC-1_V12D07-335_A1,1,1,2,0,0,4
AGGACAGTCGAATCCC-1_V12D07-335_A1,3,0,1,0,0,4
GACAGCCAGACCTGAC-1_V12D07-335_A1,0,0,0,0,0,0
GGCGAAATCTAACTTG-1_V12D07-335_A1,0,0,0,0,0,0
CTGGTAACACATAGAA-1_V12D07-335_A1,0,0,0,0,0,0
TAGCCATTTCAAAGTC-1_V12D07-335_A1,0,0,2,0,0,2
GGGATTTACCGCACCT-1_V12D07-335_A1,2,0,1,0,0,3
ATGCCATTTGCGACCA-1_V12D07-335_A1,1,1,1,0,0,3
GAATAGACGCGACCCA-1_V12D07-335_A1,2,0,1,0,0,3
TGTATGGCGCAGACAG-1_V12D07-335_A1,0,0,3,1,0,4
GGATGAAGATCGCTGA-1_V12D07-335_A1,0,0,1,0,0,1
CGACAATTTGATCTAA-1_V12D07-335_A1,0,1,0,2,0,3
AAAGTTGACTCCCGTA-1_V12D07-335_A1,1,0,3,0,0,4
CGCGGCTCAACTTGAA-1_V12D07-335_A1,2,0,1,0,0,3
CACGCGGAACTGTTGC-1_V12D07-335_A1,1,0,0,0,0,1
TCTTAGAGTGAACTCT-1_V12D07-335_A1,0,0,3,0,0,3
AGTCCATTGGCTGATG-1_V12D07-335_A1,1,1,1,2,0,5
TTAAGATAGGATTGAC-1_V12D07-335_A1,1,0,3,0,0,4
ACATCCTGGTAACTGT-1_V12D07-335_A1,0,1,3,1,0,5
CACCTTGGCGCCTTTG-1_V12D07-335_A1,0,6,2,0,0,8
GCTAGACCGTCTACTG-1_V12D07-335_A1,1,0,3,0,0,4
CGGCCCAGGTATATCC-1_V12D07-335_A1,0,0,1,2,0,3
GTCCATTACTGCTACG-1_V12D07-335_A1,0,1,3,0,0,4
GGGTTTAGGATAGGAT-1_V12D07-335_A1,1,1,3,13,0,18
TAATTAGGACATCCGT-1_V12D07-335_A1,0,1,3,3,0,7
GCTCCCAGTCGGTCCA-1_V12D07-335_A1,2,0,2,13,0,17
ATTCGTGCTATCTCTT-1_V12D07-335_A1,1,1,1,5,0,8
GTTAACTATGTTGTCA-1_V12D07-335_A1,0,0,2,9,0,11
GCTCCGCTCGCTTCAG-1_V12D07-335_A1,0,1,0,7,0,8
GCAACGGCTAGTTATG-1_V12D07-335_A1,0,0,2,19,0,21
AATCGCGCAGAGGACT-1_V12D07-335_A1,0,0,0,8,0,8
AGGTTACACCATGCCG-1_V12D07-335_A1,0,0,1,18,0,19
CGAGATTTCGCTCGGG-1_V12D07-335_A1,1,0,2,7,0,10
CGATAATACTCAGGTT-1_V12D07-335_A1,0,0,3,11,0,14
AAGGCAGGCTGTCTCC-1_V12D07-335_A1,0,0,2,11,0,13
GTAAGTCCACACTCTA-1_V12D07-335_A1,0,0,6,6,0,12
ATGAGGGCAGCGGCTA-1_V12D07-335_A1,0,0,5,8,0,13
GCCGCACTCCGTTTCA-1_V12D07-335_A1,0,0,3,9,0,12
GAGCACGGCGCCTCTT-1_V12D07-335_A1,0,1,7,3,0,11
ACAATTTGGCCATATT-1_V12D07-335_A1,0,0,2,21,0,23
CTGGTTCGCGAGCTAC-1_V12D07-335_A1,0,0,0,9,0,9
GACGGTCCTAGGGTGT-1_V12D07-335_A1,0,0,2,11,0,13
ACTCGCGATCTGACGC-1_V12D07-335_A1,1,0,4,10,0,15
GTGTACGAACCGTTCC-1_V12D07-335_A1,0,1,3,0,0,4
CTTTGACGTCGCTTCT-1_V12D07-335_A1,4,0,0,0,0,4
CGTTATCATACTTCCA-1_V12D07-335_A1,4,2,4,0,0,10
GCTATGCCAGCTTATG-1_V12D07-335_A1,2,2,1,0,0,5
CAGTCGGCCTAGATAT-1_V12D07-335_A1,5,1,1,0,0,7
CCCGTGAGGGCGGTGA-1_V12D07-335_A1,5,2,0,0,0,7
TCTCGTGTTACGAGGA-1_V12D07-335_A1,3,2,1,0,0,6
ACGTCTCGTTCCGGGA-1_V12D07-335_A1,2,3,5,0,0,10
CGAGAGCGCGTAGATA-1_V12D07-335_A1,1,1,1,0,0,3
GACAGATTTCTGGCTC-1_V12D07-335_A1,1,3,2,0,0,6
GGGCCTAAATGGGCTA-1_V12D07-335_A1,2,2,0,0,0,4
ACTTGTAGTCCCTTCA-1_V12D07-335_A1,0,2,3,0,0,5
CCCGAAGTTTCGCGAA-1_V12D07-335_A1,1,0,3,0,0,4
ACCATCCGCCAACTAG-1_V12D07-335_A1,1,2,1,0,0,4
TGCGAATATGGGATTT-1_V12D07-335_A1,1,1,1,0,0,3
TACATCCCTATCCCTG-1_V12D07-335_A1,1,0,1,0,0,2
GTGGGAAGACTGAATC-1_V12D07-335_A1,1,0,3,0,0,4
TCAACATCGACCGAGA-1_V12D07-335_A1,3,0,0,0,0,3
CTATGTGAGTCACGGC-1_V12D07-335_A1,2,1,1,0,0,4
CCGAACACTGGGCCTC-1_V12D07-335_A1,1,0,1,0,0,2
AAACTTGCAAACGTAT-1_V12D07-335_A1,0,0,1,0,0,1
AGGGCGAGCAGCTGAT-1_V12D07-335_A1,4,0,3,0,0,7
AACACGAGACGCGGCC-1_V12D07-335_A1,1,1,0,0,0,2
TGACGAATATTTCCCT-1_V12D07-335_A1,1,0,2,0,0,3
TCGGAGAGTATCGGGA-1_V12D07-335_A1,3,1,1,0,0,5
CAAATCTCTCACAAGG-1_V12D07-335_A1,3,2,0,0,0,5
AGGCCCTAGAACGCCA-1_V12D07-335_A1,5,3,1,0,0,9
TAGAGATCATGCAACT-1_V12D07-335_A1,4,1,0,0,0,5
TTGTTTCCATACAACT-1_V12D07-335_A1,3,1,0,0,0,4
GAGAGGTGCATTCTGG-1_V12D07-335_A1,1,0,2,0,0,3
GTGGACCAACCCGATT-1_V12D07-335_A1,1,1,1,0,0,3
CTGGGCCTGCTATATC-1_V12D07-335_A1,6,1,2,0,0,9
CATAGTCCACAAGAAC-1_V12D07-335_A1,1,0,1,0,0,2
TTGACATGAACGTGGA-1_V12D07-335_A1,3,0,0,0,0,3
GGTTACCACCCTCGGG-1_V12D07-335_A1,1,1,6,0,0,8
TACCGGTCGTTTCCAT-1_V12D07-335_A1,1,0,0,0,0,1
CGAGTACTAAAGAGGA-1_V12D07-335_A1,3,1,1,0,0,5
GCAAGAATTCCTTGGC-1_V12D07-335_A1,0,0,3,0,0,3
TCGCCGAAGTTGCGTC-1_V12D07-335_A1,2,0,1,0,0,3
TTGAGAGTACTGCTAA-1_V12D07-335_A1,0,1,1,0,0,2
GCCACAATTTAAGGAC-1_V12D07-335_A1,0,0,1,0,0,1
ATATTCAGTTAAACCT-1_V12D07-335_A1,1,1,1,0,0,3
TGAGTGCCTCTTAAAT-1_V12D07-335_A1,2,0,5,0,0,7
ATCAGACGGCACGCCG-1_V12D07-335_A1,1,0,2,0,0,3
GTGCGAAATCGAACAC-1_V12D07-335_A1,0,0,1,0,0,1
GTGCCGCTTCAAAGGT-1_V12D07-335_A1,0,0,2,0,0,2
GATACGATGGGAGTCA-1_V12D07-335_A1,0,1,0,0,0,1
GACACTGAGTTCAGTG-1_V12D07-335_A1,0,0,1,0,0,1
ATCCTGCGTGGAATGG-1_V12D07-335_A1,0,0,1,0,0,1
ATCCTACCTAAGCTCT-1_V12D07-335_A1,1,1,0,0,0,2
AGTGATATGAGTAGTT-1_V12D07-335_A1,0,0,1,0,0,1
ATGATGCAATGGTACA-1_V12D07-335_A1,1,1,1,0,0,3
GAAACCGAATTACCTT-1_V12D07-335_A1,0,0,0,1,0,1
AGTGACCTACTTTACG-1_V12D07-335_A1,0,0,2,0,1,3
CAAATGTCCTTCCGTG-1_V12D07-335_A1,0,0,3,0,0,3
TTACTGGGATATTTCA-1_V12D07-335_A1,0,0,1,0,0,1
CTTGCCCAGGCTCTAC-1_V12D07-335_A1,0,0,4,0,0,4
AAATCGTGTACCACAA-1_V12D07-335_A1,0,0,1,0,0,1
GTGATCATAGATCTGC-1_V12D07-335_A1,1,1,2,0,0,4
TGGCAGATTACGATCA-1_V12D07-335_A1,0,0,0,3,0,3
TCACCCTCTTAAGATT-1_V12D07-335_A1,0,2,3,0,0,5
CAGGATATATCGTTGT-1_V12D07-335_A1,1,0,2,2,0,5
CCTGACCACCGATGGT-1_V12D07-335_A1,0,0,0,3,0,3
CTAAAGGGAAATAGGA-1_V12D07-335_A1,0,0,4,0,0,4
CCGCTATCAGCACCAG-1_V12D07-335_A1,1,0,1,1,0,3
CTTTAGTGCTATTATT-1_V12D07-335_A1,0,0,1,0,0,1
CGGGAATTTATGTAAA-1_V12D07-335_A1,0,0,0,0,0,0
TACGACTGCCTCTTAG-1_V12D07-335_A1,1,0,1,0,0,2
AAACTGCTGGCTCCAA-1_V12D07-335_A1,0,0,0,0,0,0
GTACGTTTGCCCGTCA-1_V12D07-335_A1,0,1,2,0,0,3
GGCAAGGCGAAATAGC-1_V12D07-335_A1,0,0,3,0,0,3
GATCTTGGAGGGCATA-1_V12D07-335_A1,0,0,0,0,1,1
AGCGTGGTATTCTACT-1_V12D07-335_A1,0,0,1,0,0,1
CTAAGGGAATGATTGG-1_V12D07-335_A1,0,0,1,0,0,1
CATGGTAAGTAGCGTT-1_V12D07-335_A1,0,0,0,0,0,0
CGTTGAGCGACCGTCG-1_V12D07-335_A1,0,0,1,0,0,1
TGCCCGTACCGTTAAA-1_V12D07-335_A1,0,0,0,1,0,1
ACAAGGGCAGGCTCTG-1_V12D07-335_A1,0,0,1,0,0,1
GAGATCTTCCATGACA-1_V12D07-335_A1,3,0,0,1,0,4
AATGACGTAGGATGTC-1_V12D07-335_A1,3,0,1,0,0,4
GTGGTGGCCAAGTGAA-1_V12D07-335_A1,0,0,0,0,0,0
TCCCGTGTGCAATTTG-1_V12D07-335_A1,0,0,3,0,0,3
ACATCGTATGCAATGG-1_V12D07-335_A1,0,2,2,0,0,4
GCGAAACTTAACTGGA-1_V12D07-335_A1,0,0,1,0,0,1
AATTGAACGCTCTGGT-1_V12D07-335_A1,1,0,3,0,0,4
ACAAATGGTAGTGTTT-1_V12D07-335_A1,2,0,2,0,0,4
ATGGTCGCGTGGTTTC-1_V12D07-335_A1,2,0,0,0,0,2
TGTTATTGTATGTGGC-1_V12D07-335_A1,0,0,2,0,0,2
TTCCGGTTACCCACTT-1_V12D07-335_A1,0,0,2,0,0,2
GAGTGTGCGGTACCCA-1_V12D07-335_A1,2,0,2,2,0,6
CAAGATATTATAACGT-1_V12D07-335_A1,0,0,3,0,0,3
ACACACCAGGACCAGT-1_V12D07-335_A1,0,0,0,29,0,29
ATGGGCCTCGGCCTCT-1_V12D07-335_A1,0,0,4,17,0,21
AAGGTGATAAACCAGC-1_V12D07-335_A1,1,0,3,5,0,9
TCTTACTTATGCCTCT-1_V12D07-335_A1,0,0,0,15,0,15
AAAGTGTGATTTATCT-1_V12D07-335_A1,0,2,0,0,0,2
TGCTCCACAGTTCTTA-1_V12D07-335_A1,0,2,1,13,0,16
CTGGCTGATTCATCCT-1_V12D07-335_A1,1,1,1,1,0,4
TAAGGCTGAATCCCTC-1_V12D07-335_A1,0,0,4,15,0,19
TCTAGTGATATCGTGG-1_V12D07-335_A1,2,1,2,1,0,6
TCGAAGAACCGAGCAC-1_V12D07-335_A1,0,0,3,17,0,20
GACAAACATATGCAGG-1_V12D07-335_A1,0,0,5,4,0,9
AAGTCAATTGTCGTCA-1_V12D07-335_A1,0,0,0,19,0,19
AGTGAACAAACTTCTC-1_V12D07-335_A1,0,0,3,5,0,8
CATGATGGAAGTTAGC-1_V12D07-335_A1,0,0,1,18,0,19
AAGTGCCTTGACTGTA-1_V12D07-335_A1,0,0,5,14,0,19
ATCGCCAGTCAACATT-1_V12D07-335_A1,1,0,1,2,0,4
ACCGCGGTGGAAGTCG-1_V12D07-335_A1,1,0,1,13,0,15
TCTTCTATAACCCGCC-1_V12D07-335_A1,0,1,2,0,0,3
CACATTTCTTGTCAGA-1_V12D07-335_A1,1,0,0,4,0,5
TAGCGTCCCTCGATTG-1_V12D07-335_A1,0,1,1,0,0,2
GTTCGGATCGGGAACA-1_V12D07-335_A1,0,0,0,0,0,0
CAAACTCGCGACGCCG-1_V12D07-335_A1,0,1,1,0,0,2
GTCTTGTAGCTATTCA-1_V12D07-335_A1,0,0,0,1,0,1
TCTCGACGTATCGCCG-1_V12D07-335_A1,0,0,1,0,0,1
TTGCCAAGCAGAACCC-1_V12D07-335_A1,1,0,2,1,0,4
AAACCCGAACGAAATC-1_V12D07-335_A1,0,0,1,0,0,1
TTGAGCAGCCCACGGT-1_V12D07-335_A1,1,0,0,0,0,1
CGCCTTTAGCATGCTC-1_V12D07-335_A1,0,0,1,0,0,1
TGTGGCTCCCACCAAC-1_V12D07-335_A1,0,0,2,0,0,2
CCGCCGTTGAGGATAA-1_V12D07-335_A1,0,0,2,0,0,2
CAATACGAGAGTCTGA-1_V12D07-335_A1,0,0,0,0,0,0
CATCTAGTGAAGGGAA-1_V12D07-335_A1,0,0,2,0,0,2
GGTGGAGGTTGATACG-1_V12D07-335_A1,1,0,2,1,0,4
CCGCACACGAACGTGT-1_V12D07-335_A1,0,0,1,0,0,1
AGAACCCAGCGTGACA-1_V12D07-335_A1,0,0,1,3,0,4
GCGCTCGATCACCTGT-1_V12D07-335_A1,0,0,0,0,0,0
ATCATGGACTACCGAC-1_V12D07-335_A1,0,0,2,0,0,2
TACGCCGCCTCAGAAG-1_V12D07-335_A1,0,0,1,0,0,1
CGACCTACTAGACAAT-1_V12D07-335_A1,1,2,2,1,0,6
GAGTCTTGTAAAGGAC-1_V12D07-335_A1,0,1,0,0,0,1
AATATCCTAGCAAACT-1_V12D07-335_A1,4,0,1,0,0,5
CCCTAGGCAACAAGAG-1_V12D07-335_A1,3,0,1,0,0,4
ACAAAGAAGGTAGGCC-1_V12D07-335_A1,2,2,1,0,0,5
CCCTGGCTGTTCCTTC-1_V12D07-335_A1,2,0,1,0,0,3
TCGCCGCACCGCGTGA-1_V12D07-335_A1,4,1,2,0,0,7
TATAGCGCACGTTATC-1_V12D07-335_A1,1,0,3,0,0,4
TTATCTGACATTAGGA-1_V12D07-335_A1,4,1,0,0,0,5
AGTGGTGTTACCCGTG-1_V12D07-335_A1,2,1,0,0,0,3
GCCAAGAATACTTCTG-1_V12D07-335_A1,1,2,3,0,0,6
CCGGCGTGAGACTCTG-1_V12D07-335_A1,1,1,1,0,0,3
TTCCCGGCGCCAATAG-1_V12D07-335_A1,1,1,1,0,0,3
AAACAGGGTCTATATT-1_V12D07-335_A1,1,1,1,0,0,3
ACAGTAATACAACTTG-1_V12D07-335_A1,3,0,2,0,0,5
CGAACGGCCGGACAAC-1_V12D07-335_A1,2,1,0,0,0,3
GCAACACACTAGAACT-1_V12D07-335_A1,4,2,0,0,0,6
ACTCCCATTCCTAAAG-1_V12D07-335_A1,1,1,0,0,0,2
ACCTGCGTGTCATGTT-1_V12D07-335_A1,0,3,1,0,0,4
TACTTTCCGCACGCCA-1_V12D07-335_A1,0,0,2,0,0,2
AGGTCAGGTGAGAGTG-1_V12D07-335_A1,1,2,1,0,0,4
TCCTCCTAAGACATTC-1_V12D07-335_A1,1,2,0,0,0,3
ATGTGAAAGCCTAATG-1_V12D07-335_A1,0,1,0,0,0,1
AGTCGGCTCAACTTTA-1_V12D07-335_A1,5,0,1,0,0,6
CGATCTGTTGGAGGAC-1_V12D07-335_A1,0,1,1,0,0,2
ACGGGAGTGTCGGCCC-1_V12D07-335_A1,1,0,2,0,0,3
TTAACTTCAGGTAGGA-1_V12D07-335_A1,1,0,5,0,0,6
CCACGGAGCCATAAGA-1_V12D07-335_A1,0,1,2,0,0,3
CTTCTATGTTGAAGTA-1_V12D07-335_A1,3,0,2,0,0,5
CACCGTTGCGCGATAT-1_V12D07-335_A1,0,0,3,0,0,3
TCTAGCAATCTCCGCC-1_V12D07-335_A1,2,0,0,0,0,2
AGTTTGGCCAGACCTA-1_V12D07-335_A1,2,2,1,0,0,5
TTGTAAGGACCTAAGT-1_V12D07-335_A1,3,0,1,0,0,4
AAATTTGCGGGTGTGG-1_V12D07-335_A1,2,0,3,0,0,5
AAGTTCGGCCAACAGG-1_V12D07-335_A1,0,2,0,0,0,2
CCGCTTACCTCACTCT-1_V12D07-335_A1,0,0,2,0,0,2
ATCACGTGCTAATTAA-1_V12D07-335_A1,1,1,3,0,0,5
GGTGAAGTACAGGGAT-1_V12D07-335_A1,0,1,2,0,0,3
GCTGTATTACTGGCCC-1_V12D07-335_A1,1,0,1,0,0,2
AACGGCCATCTCCGGT-1_V12D07-335_A1,2,1,1,0,0,4
TAAGTAACATCTTGAC-1_V12D07-335_A1,0,0,0,0,0,0
TTCTTGAGCCGCGCTA-1_V12D07-335_A1,0,0,1,0,0,1
AGTGCGTAGCTCGTAA-1_V12D07-335_A1,2,0,3,1,0,6
GGGATGGTCGTAACCG-1_V12D07-335_A1,1,0,0,0,0,1
GTCTGGGCGGTCGAGA-1_V12D07-335_A1,0,1,2,0,0,3
CGGAACGTAAACATAG-1_V12D07-335_A1,1,0,0,0,0,1
TGCGACACCCTAGTGC-1_V12D07-335_A1,0,0,0,0,0,0
CAAACGAGTATCGCAG-1_V12D07-335_A1,0,1,1,0,0,2
TCAGTAGGGACTATAA-1_V12D07-335_A1,0,0,6,0,0,6
GCGGTTCCCTATCATG-1_V12D07-335_A1,0,0,3,0,0,3
GTGACTTCAGTAGTGC-1_V12D07-335_A1,1,0,4,0,0,5
CGTCACGTCCATTGGT-1_V12D07-335_A1,0,1,1,1,0,3
ATAAGTTACCGCGACG-1_V12D07-335_A1,0,0,2,0,0,2
CTGAATCCGAGACCTC-1_V12D07-335_A1,1,1,3,3,0,8
TACGACGCTTGCTGCG-1_V12D07-335_A1,0,0,2,0,0,2
GAATTCACCCGGGTGT-1_V12D07-335_A1,2,0,0,0,0,2
GGGTGACACCTTAACT-1_V12D07-335_A1,1,0,2,0,0,3
TGAGTAAATTAGCGTA-1_V12D07-335_A1,0,0,2,2,0,4
GAGTCCGCTTACCGGA-1_V12D07-335_A1,1,2,0,0,0,3
GGCGCGTTCGAGTTTA-1_V12D07-335_A1,0,1,0,2,0,3
ATTCATATACTGTCCA-1_V12D07-335_A1,0,0,3,0,0,3
ATAAACGGACCCGTAA-1_V12D07-335_A1,0,0,0,0,0,0
GTCGTACCATCTCGGG-1_V12D07-335_A1,0,0,3,0,0,3
ATAATAGCTGTTGAAT-1_V12D07-335_A1,1,0,2,0,0,3
TTCCGCGTGAGGCGAT-1_V12D07-335_A1,1,1,2,1,0,5
TACCGGCTCACTGCCC-1_V12D07-335_A1,0,1,0,0,0,1
GTATCTTTCATAACCA-1_V12D07-335_A1,0,0,1,0,0,1
GTTACCTACAACTTGC-1_V12D07-335_A1,0,0,0,1,0,1
TGACTATAATCCTTTC-1_V12D07-335_A1,0,0,2,0,0,2
AAATACCTATAAGCAT-1_V12D07-335_A1,1,1,3,0,0,5
TTATTAGAGCGTGTTC-1_V12D07-335_A1,2,0,1,0,0,3
ATGTGGACATCTTGAT-1_V12D07-335_A1,1,0,1,0,0,2
GTACGCTTCATTGCAC-1_V12D07-335_A1,0,0,0,0,0,0
CACATATTAGCAGGAT-1_V12D07-335_A1,1,0,1,0,0,2
CAAGAGGGCGGAGTAC-1_V12D07-335_A1,0,0,0,0,0,0
TCGCAAAGATGCATTT-1_V12D07-335_A1,1,0,2,0,0,3
GTCGTTATTCGCTTAT-1_V12D07-335_A1,1,0,2,0,0,3
TCGTGTACTATGGATG-1_V12D07-335_A1,2,0,0,0,0,2
GCGGAGAGGGAGAACG-1_V12D07-335_A1,5,0,0,0,0,5
TCACAGGGAATCGCAA-1_V12D07-335_A1,1,0,0,0,0,1
GACTGCACCAGCCCAG-1_V12D07-335_A1,0,0,2,0,0,2
TCCGCTGTCATCCCGG-1_V12D07-335_A1,0,0,2,0,0,2
AGATACTCAAGATCGA-1_V12D07-335_A1,1,0,2,0,0,3
ACTGAATGGCGAAAGT-1_V12D07-335_A1,3,0,2,0,0,5
TCCTACATCCACGGCC-1_V12D07-335_A1,0,0,1,0,0,1
TTCAGCCCTGGTCCAC-1_V12D07-335_A1,0,0,1,0,0,1
TTAGAGTTTAGAAGGA-1_V12D07-335_A1,3,0,0,1,0,4
GGTTAGCTATATGTCT-1_V12D07-335_A1,0,0,2,0,0,2
CTGGTTTCGAGCAAGA-1_V12D07-335_A1,0,0,3,0,0,3
TGGGCCCATACTAATT-1_V12D07-335_A1,1,0,0,0,0,1
ACTTATTTATGTGCCA-1_V12D07-335_A1,0,1,3,0,0,4
TTAGTTATTCGTGGCA-1_V12D07-335_A1,1,1,1,1,0,4
AACCGCTAAGGGATGC-1_V12D07-335_A1,0,0,2,1,0,3
ATACGTCCACTCCTGT-1_V12D07-335_A1,0,0,4,0,0,4
CGACACGCTCCGACAG-1_V12D07-335_A1,1,0,3,13,0,17
TCTGAACTCGTACCCG-1_V12D07-335_A1,0,0,1,0,0,1
AGGATATAGGGATTTA-1_V12D07-335_A1,1,0,0,10,0,11
GTGATCACTAACGCCT-1_V12D07-335_A1,0,0,4,0,0,4
ACCGGGCCTTTGTTGA-1_V12D07-335_A1,0,2,3,6,0,11
TTGACAGGAGCTCCCG-1_V12D07-335_A1,0,1,3,0,0,4
CTCTTCTATTGACTGG-1_V12D07-335_A1,0,0,0,2,0,2
CGTGGCCGAATATCTA-1_V12D07-335_A1,1,0,4,0,0,5
GGTTTAGCCTTTCTTG-1_V12D07-335_A1,0,0,2,0,0,2
TCAAGGTTACTACACC-1_V12D07-335_A1,0,0,0,0,0,0
TTGACTATTGTCCGGC-1_V12D07-335_A1,1,0,3,0,0,4
CGGGAATATAGTATAC-1_V12D07-335_A1,0,0,2,0,0,2
GCAACAGCAGTATGCG-1_V12D07-335_A1,0,0,2,0,0,2
ATCAAACACTGTTCCA-1_V12D07-335_A1,0,0,0,1,0,1
TGGGCAATAGTTGGGT-1_V12D07-335_A1,0,0,0,0,0,0
TGAATGTCAGCCGGCC-1_V12D07-335_A1,0,0,2,0,0,2
CGGCTCTAAAGCTGCA-1_V12D07-335_A1,0,1,0,0,0,1
GGACACAAGTTTACAC-1_V12D07-335_A1,0,0,0,0,0,0
CCGAGAAGTCGCATAA-1_V12D07-335_A1,0,1,3,0,0,4
AACTACCCGTTTGTCA-1_V12D07-335_A1,0,0,0,0,0,0
GCACAAACGAGGCGTG-1_V12D07-335_A1,0,0,0,0,0,0
CACACAGCTTGCGCTC-1_V12D07-335_A1,0,0,1,0,0,1
GTGCTTACATCAGCGC-1_V12D07-335_A1,0,0,1,0,0,1
GCAAACGTCGCCAGGT-1_V12D07-335_A1,1,0,0,0,0,1
GAATAGCATTTAGGGT-1_V12D07-335_A1,0,0,2,0,0,2
TACTGTTTCTCTGGTA-1_V12D07-335_A1,1,0,0,0,0,1
TCCTATCATAGGTAAC-1_V12D07-335_A1,0,0,0,0,0,0
TTCGGTGGAGACGCCC-1_V12D07-335_A1,0,0,1,0,0,1
TGTTGCCGTCGTCCCA-1_V12D07-335_A1,0,1,1,0,0,2
CCAACTTGATAGATCC-1_V12D07-335_A1,1,0,0,0,0,1
CAAAGGTCATCTGAAA-1_V12D07-335_A1,0,0,0,0,0,0
CTAGCTTAATGGTCCC-1_V12D07-335_A1,1,1,1,0,0,3
AGGCCACATTGGTTAC-1_V12D07-335_A1,2,0,1,0,0,3
TTAGGATGGGAGGGTA-1_V12D07-335_A1,3,0,2,0,0,5
TATGACCTTGCGCTGG-1_V12D07-335_A1,3,2,2,0,0,7
ATATACATGTATGGTA-1_V12D07-335_A1,6,0,2,0,0,8
TGTGTGACCATGAATC-1_V12D07-335_A1,2,2,1,0,0,5
CCCACTCCACGGTATC-1_V12D07-335_A1,4,2,0,0,0,6
GGGCAGACGTCACTGC-1_V12D07-335_A1,4,0,1,0,0,5
TCAAAGAGCTATCTGT-1_V12D07-335_A1,2,1,2,0,0,5
AGATGCATCCTGTGTC-1_V12D07-335_A1,0,1,3,0,0,4
GTGAAGTCACGACTCG-1_V12D07-335_A1,1,1,0,0,0,2
TGATTCAGGTCCCGCG-1_V12D07-335_A1,3,2,4,0,0,9
CGCCACAGGTCGCGAT-1_V12D07-335_A1,0,2,1,0,0,3
TTGAATCGTTGTATAA-1_V12D07-335_A1,1,1,0,0,0,2
TGGCCAATTTGGTACT-1_V12D07-335_A1,0,1,2,0,0,3
CGACCCTTAACGCCGG-1_V12D07-335_A1,1,1,4,0,0,6
TCGGCGTACTGCACAA-1_V12D07-335_A1,0,0,1,0,0,1
GAGTAAGGCCACGGGA-1_V12D07-335_A1,1,0,1,0,0,2
ATCAGCTCGTCCACTA-1_V12D07-335_A1,0,1,1,0,0,2
AGGATCACGCGATCTG-1_V12D07-335_A1,1,1,4,0,0,6
AAATGGCCCGTGCCCT-1_V12D07-335_A1,3,0,1,0,0,4
CAGTACCAGTTTACGT-1_V12D07-335_A1,3,0,0,0,0,3
GGTCGTAAGCTCGCAC-1_V12D07-335_A1,0,3,2,0,0,5
CGTTCATGGTGCGCGT-1_V12D07-335_A1,1,0,0,0,0,1
GACTACAAAGCGGTGG-1_V12D07-335_A1,0,1,1,0,0,2
CAGCTGGCGTAACCGT-1_V12D07-335_A1,0,1,1,0,0,2
ACTCGTAACCCGTCCT-1_V12D07-335_A1,2,1,3,0,0,6
CATATGTCAGGCTACG-1_V12D07-335_A1,2,3,0,0,0,5
GCCCGACTTCTTCCCG-1_V12D07-335_A1,2,1,1,0,0,4
CTGGCATCCGAATGAG-1_V12D07-335_A1,0,1,2,0,0,3
AAGTGCGTTAGAATCT-1_V12D07-335_A1,1,3,2,0,0,6
AGAAGTGATTCGTGAT-1_V12D07-335_A1,1,1,3,0,0,5
TACCTTAAGATTTCCC-1_V12D07-335_A1,1,0,5,0,0,6
AATGACAGCAATGTCT-1_V12D07-335_A1,1,0,3,0,0,4
TCAACGCAGGAAATAA-1_V12D07-335_A1,0,2,1,0,0,3
TATTCCTCCGCCCACT-1_V12D07-335_A1,2,0,4,0,0,6
ATCAAACGAAGGTTTG-1_V12D07-335_A1,5,1,0,0,0,6
TTGATTAGCTGTTTCT-1_V12D07-335_A1,2,1,1,0,0,4
CTGCTGAGGCCACGAA-1_V12D07-335_A1,3,1,2,0,0,6
CCGTGTTAAATTCCAT-1_V12D07-335_A1,1,0,1,0,0,2
CACGTCGGCAACCTCT-1_V12D07-335_A1,1,0,1,0,0,2
GTATTCTGAGAAACGA-1_V12D07-335_A1,2,0,3,0,0,5
CGGTGCGCGTTGGTCC-1_V12D07-335_A1,0,0,2,0,0,2
GTGATTCGCCGCTCAA-1_V12D07-335_A1,1,0,2,0,0,3
GCCCGCGCGTAAACGG-1_V12D07-335_A1,0,0,2,0,0,2
AACGTACTGTGGGTAC-1_V12D07-335_A1,0,0,3,0,0,3
GAGTATGCCCGCCTTG-1_V12D07-335_A1,0,1,1,0,0,2
TGATTCTGTCGCCGGT-1_V12D07-335_A1,0,0,3,1,0,4
GGGCGGCAAATGAATT-1_V12D07-335_A1,0,0,2,0,0,2
TTCCAATCTGGCTATC-1_V12D07-335_A1,0,0,0,0,0,0
GGAACCGTGTAAATTG-1_V12D07-335_A1,0,1,2,0,0,3
TTGGTCACACTCGTAA-1_V12D07-335_A1,0,0,1,0,0,1
CGAACCCGCATGCGTC-1_V12D07-335_A1,1,0,2,0,0,3
GGGCGTCACCACGTAA-1_V12D07-335_A1,0,0,1,0,0,1
TACCAGAAGTAGGTTC-1_V12D07-335_A1,1,1,2,0,0,4
TTGGATATCGTCTACG-1_V12D07-335_A1,1,0,0,2,0,3
TAGATATGGACTGGAA-1_V12D07-335_A1,0,0,0,1,0,1
GCGACGATAGTTGTAC-1_V12D07-335_A1,0,1,4,1,0,6
CTGGATTTACACTTGA-1_V12D07-335_A1,1,0,1,1,0,3
GTTATATTATCTCCCT-1_V12D07-335_A1,0,0,0,0,0,0
TATTCCACTCAGCTCG-1_V12D07-335_A1,0,0,6,1,0,7
CTGTTACCCAATCTAG-1_V12D07-335_A1,2,0,1,0,0,3
ACGCGAAGTCAGACGA-1_V12D07-335_A1,0,0,0,0,0,0
GATAGGTAACGTTGAC-1_V12D07-335_A1,0,0,3,0,0,3
TGTTCGTATTGCGGTG-1_V12D07-335_A1,2,0,0,1,0,3
GGTCAGTGGGTCCCAC-1_V12D07-335_A1,0,0,0,0,0,0
AATTCTAGAGTTAGGC-1_V12D07-335_A1,0,0,2,0,0,2
GTTTACGTTCCATCTG-1_V12D07-335_A1,0,0,0,0,0,0
AGACCCACCGCTGATC-1_V12D07-335_A1,0,0,1,0,0,1
TCTAGCATGCCCAGAA-1_V12D07-335_A1,1,0,0,1,0,2
CCCGCAGCGCGAACTA-1_V12D07-335_A1,0,0,2,0,0,2
CTCTATTTGGCTGCAG-1_V12D07-335_A1,1,0,0,0,0,1
TTCTGCCGCGCCTAGA-1_V12D07-335_A1,0,0,2,0,0,2
ACTCCCTAGAATAGTA-1_V12D07-335_A1,0,0,1,0,0,1
CCGAACCTTCCCGGCC-1_V12D07-335_A1,1,0,1,0,0,2
TCAGACGCTATAGAAG-1_V12D07-335_A1,0,0,0,0,0,0
CAGGCGCCATGCTAGG-1_V12D07-335_A1,2,0,1,0,0,3
CACTCGAGCTGAACAA-1_V12D07-335_A1,3,0,3,0,0,6
ACAAGGAAATCCGCCC-1_V12D07-335_A1,0,0,1,0,0,1
ACCACGTGCAGCTATA-1_V12D07-335_A1,3,0,3,0,0,6
ACGGCGACGATGGGAA-1_V12D07-335_A1,4,0,3,0,0,7
TTACTAAAGGACTTTA-1_V12D07-335_A1,2,0,3,0,1,6
GGCTGAAATAGCAAAG-1_V12D07-335_A1,1,0,1,0,0,2
TTAGACGAGTCACCTC-1_V12D07-335_A1,0,1,1,0,2,4
GTAGTCGCGGGAATCA-1_V12D07-335_A1,3,0,0,0,1,4
GCAAACCCTACATTAT-1_V12D07-335_A1,4,0,3,0,0,7
GTTAAAGTAGGACTGG-1_V12D07-335_A1,2,0,1,0,0,3
ACCCTCCCTTGCTATT-1_V12D07-335_A1,1,0,0,1,0,2
CATGTCTCATTTATGG-1_V12D07-335_A1,3,0,3,0,0,6
AATAGAATCTGTTTCA-1_V12D07-335_A1,0,0,0,0,0,0
TCTCATGAGATAGGGT-1_V12D07-335_A1,0,0,0,0,0,0
ATGACTATGCGACATT-1_V12D07-335_A1,0,0,1,0,0,1
CCTAACCCAAACAAGT-1_V12D07-335_A1,1,0,1,0,1,3
AGTCAAGATGACACTT-1_V12D07-335_A1,0,0,2,0,0,2
CGGGAGCTTCAGTGTA-1_V12D07-335_A1,0,0,0,0,0,0
CCACAGTACCCATCCT-1_V12D07-335_A1,0,0,2,0,0,2
GAGCGCGCACGAGTAG-1_V12D07-335_A1,0,1,1,0,0,2
ACCAGTGCGGGAGACG-1_V12D07-335_A1,0,0,3,0,0,3
TCCTTACGACGGTCCG-1_V12D07-335_A1,0,0,3,0,0,3
TAGTCGATCACGGGTT-1_V12D07-335_A1,1,0,0,0,0,1
AGACGAAGTGCCGGTC-1_V12D07-335_A1,1,0,3,0,0,4
CGCTGGTGACTACCCT-1_V12D07-335_A1,1,0,0,0,0,1
AGGCATTGTCGTAGGG-1_V12D07-335_A1,0,0,1,0,0,1
TGGTAGAATATATGGG-1_V12D07-335_A1,0,0,1,0,0,1
TTCTTATCCGCTGGGT-1_V12D07-335_A1,1,2,0,0,0,3
AGTTTGGCACGGGTTG-1_V12D07-335_A1,0,0,1,0,0,1
GCATCGGCCGTGTAGG-1_V12D07-335_A1,0,0,1,0,0,1
ATGCGAGTCCCACCAC-1_V12D07-335_A1,0,0,3,0,0,3
TCGGCGAACCCAAACC-1_V12D07-335_A1,1,0,3,0,0,4
AGAGTAAACTTCACTA-1_V12D07-335_A1,0,0,3,0,0,3
AAGCCGAAGCGGTTTA-1_V12D07-335_A1,0,0,2,0,0,2
CCCGAGTTTCTCCGTA-1_V12D07-335_A1,0,0,3,0,0,3
AATATCGAATCAATGC-1_V12D07-335_A1,1,0,2,0,0,3
GCGCCTCCCACTCCGA-1_V12D07-335_A1,0,0,2,0,0,2
CGTTAAACTAGTTAGG-1_V12D07-335_A1,0,0,1,0,0,1
TGAGTTAAAGACATTC-1_V12D07-335_A1,1,0,0,0,0,1
AACAGGTAGTATGGAT-1_V12D07-335_A1,3,0,0,0,0,3
GAACGCGGGTCACACG-1_V12D07-335_A1,3,0,2,0,0,5
TGTTTGAGATCGTCAG-1_V12D07-335_A1,2,0,1,0,0,3
ATCTCGTGAGCGAAAC-1_V12D07-335_A1,1,0,0,0,0,1
CTGAGAAAGTTCGGCG-1_V12D07-335_A1,0,0,9,0,0,9
ATTACCACACTGCCTG-1_V12D07-335_A1,1,0,0,0,0,1
CTGCTGTCTAACGAGC-1_V12D07-335_A1,0,1,5,0,0,6
CGTGGAAGCCTCGTAC-1_V12D07-335_A1,1,0,2,1,0,4
GGACTCACAAATTAGG-1_V12D07-335_A1,2,0,2,0,0,4
CTTTGCTGTCATGGAT-1_V12D07-335_A1,0,0,5,0,0,5
GGTGTTGGGCGTCTTA-1_V12D07-335_A1,0,0,0,0,0,0
TACCATGTATTGATTT-1_V12D07-335_A1,0,0,0,0,0,0
GGTCTCCAAGTAGTGC-1_V12D07-335_A1,1,0,2,0,0,3
ATCCTTCTGAAAGAAC-1_V12D07-335_A1,2,0,3,0,0,5
CCGGAAGTTATCAGTC-1_V12D07-335_A1,1,0,4,0,0,5
TTAGAGGGATATACAG-1_V12D07-335_A1,4,0,3,0,0,7
TTGTACACCTCGAACA-1_V12D07-335_A1,2,3,2,0,0,7
GTGGGTACTGAGCGTA-1_V12D07-335_A1,1,1,3,0,0,5
CTTAAGCAGCGAGCCG-1_V12D07-335_A1,0,2,2,0,0,4
GCATTGACTTGCGGAA-1_V12D07-335_A1,2,0,1,0,0,3
CCATAACCTGTGCAGT-1_V12D07-335_A1,1,2,1,0,0,4
GGGCTACTATTTCGTG-1_V12D07-335_A1,2,0,1,0,0,3
GGCGAGCGAAACGGCA-1_V12D07-335_A1,1,0,2,0,0,3
GGAGACCATCTACATA-1_V12D07-335_A1,2,0,1,0,0,3
AGACCAAACCACACCT-1_V12D07-335_A1,3,4,2,0,0,9
CGACGCATCCGTACCT-1_V12D07-335_A1,2,2,1,0,0,5
CCTAGGTAAAGGTAGC-1_V12D07-335_A1,4,2,2,0,0,8
AGCGGCGGTTAGCGGT-1_V12D07-335_A1,4,0,0,0,0,4
CTGGACGCAGTCCGGC-1_V12D07-335_A1,5,3,1,0,0,9
AGCCTAATACCCACGT-1_V12D07-335_A1,1,1,2,0,0,4
AATCTGGCTTTCTAGT-1_V12D07-335_A1,2,2,1,0,0,5
CACCCTTGGTGAGACC-1_V12D07-335_A1,2,0,6,0,0,8
GGATCTTGACTCAACC-1_V12D07-335_A1,2,3,1,0,0,6
ACGAGGATACCACTCT-1_V12D07-335_A1,1,1,0,0,0,2
GAGTTGATGGCAATTT-1_V12D07-335_A1,2,2,1,0,0,5
GTGGCAAACAGCGGCA-1_V12D07-335_A1,3,2,1,0,0,6
GATGTAACGAACCACC-1_V12D07-335_A1,1,0,2,0,0,3
AGCCGTGGCTAAATGT-1_V12D07-335_A1,4,1,0,0,0,5
CTCCCTCCTTTCGATC-1_V12D07-335_A1,1,2,2,0,0,5
TTGGAAGAATACAGTC-1_V12D07-335_A1,2,0,0,0,0,2
AGTTAAGTCAACCGCT-1_V12D07-335_A1,3,0,0,0,0,3
CTCATGGTAATTTGCG-1_V12D07-335_A1,0,2,1,0,0,3
AAAGTAGCATTGCTCA-1_V12D07-335_A1,2,1,2,0,0,5
TTGTGGTAGGAGGGAT-1_V12D07-335_A1,1,3,4,0,0,8
AGTCGTGGGCATTACG-1_V12D07-335_A1,2,1,0,0,0,3
ACCTAAGTACCTTTCA-1_V12D07-335_A1,3,2,1,0,0,6
GTAGAGGGAGACAAGT-1_V12D07-335_A1,1,1,1,0,0,3
GATCCTCGACACTGGC-1_V12D07-335_A1,2,1,2,0,0,5
CCTACATTCACAGACG-1_V12D07-335_A1,1,2,2,0,0,5
TTGACCGTGTTAATGA-1_V12D07-335_A1,2,0,2,0,0,4
TCTGTTACCCAGCATA-1_V12D07-335_A1,3,0,1,0,0,4
CTAACTGGTCCGGTTC-1_V12D07-335_A1,1,0,1,0,0,2
AGCGACAGGAACGGTC-1_V12D07-335_A1,1,0,0,0,0,1
TAATAGAACAGAGTTA-1_V12D07-335_A1,1,0,4,0,0,5
ACAGGTGGAGGTGAGG-1_V12D07-335_A1,1,0,2,0,0,3
TGCGAGAATATTACCC-1_V12D07-335_A1,1,0,4,0,0,5
TTGCGTCGGCCAACCG-1_V12D07-335_A1,1,0,2,0,0,3
AGGCTTCCCGAAGAAG-1_V12D07-335_A1,1,0,0,0,0,1
GCGGACCGCGTTGTGG-1_V12D07-335_A1,2,0,2,0,0,4
GTAATCTGATTCTTCG-1_V12D07-335_A1,0,1,2,0,0,3
CCGCGGAATGCGTCAC-1_V12D07-335_A1,0,0,0,0,0,0
TTCCACACAGATTTGA-1_V12D07-335_A1,0,0,2,0,0,2
CTTCTATTAATGCTAG-1_V12D07-335_A1,0,1,1,2,0,4
CATTTGAGTGGTACGT-1_V12D07-335_A1,0,0,3,0,0,3
TCACAGCAAACTCGAA-1_V12D07-335_A1,0,0,2,0,0,2
CAGACGAACCTGATAC-1_V12D07-335_A1,0,2,0,1,0,3
TAGCTAGAAGGCATGA-1_V12D07-335_A1,0,1,0,1,0,2
ATCCAGAGCAACAACC-1_V12D07-335_A1,0,0,4,0,0,4
TCCGGTTCGTCCGGTC-1_V12D07-335_A1,0,0,1,0,0,1
CGCGCATGTTTGATTG-1_V12D07-335_A1,0,0,2,0,0,2
TGGCGATCAAGTTATG-1_V12D07-335_A1,0,0,2,2,0,4
CCCTTTGACAGGTCTT-1_V12D07-335_A1,0,1,1,0,0,2
CAGAGACGGTCACCCA-1_V12D07-335_A1,2,0,1,2,0,5
TAGCTCGCCTGATAAC-1_V12D07-335_A1,3,1,0,1,0,5
TTGTGTTTCCCGAAAG-1_V12D07-335_A1,0,0,0,0,0,0
TATACACAGACGCCTT-1_V12D07-335_A1,1,1,2,1,0,5
ACATTAGTTTATATCC-1_V12D07-335_A1,0,1,3,0,0,4
CCATCGCAGTTAAACT-1_V12D07-335_A1,0,0,1,0,0,1
AATTAGCGCTGCAGCG-1_V12D07-335_A1,0,0,3,0,0,3
TCCGCTTATCCCATTA-1_V12D07-335_A1,0,0,3,0,0,3
GTTTGGGCTTGTGAGC-1_V12D07-335_A1,2,1,0,2,0,5
CTTGTCAACATTCGAG-1_V12D07-335_A1,0,0,1,1,0,2
GGACCAACAGGATAAC-1_V12D07-335_A1,1,0,0,0,0,1
AAGCTAGATCGAGTAA-1_V12D07-335_A1,0,0,0,0,0,0
TACCGTGCCTCGGACC-1_V12D07-335_A1,1,1,0,0,0,2
GTAGCCAAACATGGGA-1_V12D07-335_A1,1,0,0,0,0,1
TGCCAGTACGTGGAGA-1_V12D07-335_A1,0,0,1,0,0,1
ATAAGGTGGAGAACAT-1_V12D07-335_A1,1,0,1,0,0,2
CTTTAATATTGGTCGA-1_V12D07-335_A1,1,0,2,0,0,3
TGGTTCAACGGGTAAT-1_V12D07-335_A1,3,0,1,0,0,4
GCTGCTACTGCGTAGC-1_V12D07-335_A1,1,0,0,0,0,1
CTGCACAACTACATAT-1_V12D07-335_A1,0,0,0,0,0,0
ATATTCCACATAGTGA-1_V12D07-335_A1,3,0,0,0,0,3
TGGCAAACTAAATTAC-1_V12D07-335_A1,2,0,2,0,0,4
ACCGCAATAACTGCCT-1_V12D07-335_A1,1,0,2,0,0,3
TCGCACCAGGAGGCAG-1_V12D07-335_A1,4,1,2,0,0,7
ACTTCAGGCTGATCCC-1_V12D07-335_A1,1,0,0,0,1,2
ACAAATCGCACCGAAT-1_V12D07-335_A1,4,0,0,0,0,4
TCTGATGTATTCTGTC-1_V12D07-335_A1,1,1,0,0,0,2
CTTTACCGAATAGTAG-1_V12D07-335_A1,1,0,0,0,0,1
GCAGATCCATAAGACT-1_V12D07-335_A1,3,0,3,0,0,6
TTCCTCGGACTAACCA-1_V12D07-335_A1,2,1,0,0,0,3
TTATCCGGGATCTATA-1_V12D07-335_A1,1,0,3,1,0,5
CTGGAAGACACGGTGG-1_V12D07-335_A1,2,1,0,1,0,4
GTTCGTCTAAAGAACT-1_V12D07-335_A1,1,0,1,0,0,2
GTCTATTGGTTCCGGT-1_V12D07-335_A1,1,0,3,0,0,4
CTAGGCGCCCTATCAG-1_V12D07-335_A1,0,0,0,0,0,0
AACGGACGTACGTATA-1_V12D07-335_A1,1,0,1,0,0,2
AACACACGCTCGCCGC-1_V12D07-335_A1,1,0,3,0,0,4
GCTACTATAGTAGAGT-1_V12D07-335_A1,0,0,0,0,0,0
AGCATATCAATATGCT-1_V12D07-335_A1,2,3,7,2,0,14
CGAACAGTATGGGCGT-1_V12D07-335_A1,0,0,3,0,0,3
ACAATTGTGTCTCTTT-1_V12D07-335_A1,1,0,1,0,0,2
GATCGCTACCCGATTT-1_V12D07-335_A1,1,0,1,0,0,2
ATTGCGATCAGTAACT-1_V12D07-335_A1,1,0,1,0,0,2
CAGCAGTCCAGACTAT-1_V12D07-335_A1,0,0,2,0,0,2
AGAGGCTTCGGAAACC-1_V12D07-335_A1,0,0,0,0,0,0
AAACAAGTATCTCCCA-1_V12D07-335_A1,0,0,0,0,0,0
GGCAGCAAACCTATGC-1_V12D07-335_A1,0,0,1,0,0,1
ACTAGTTGCGATCGTC-1_V12D07-335_A1,0,0,3,0,0,3
TTGGACCATCTGGCAA-1_V12D07-335_A1,1,0,1,0,0,2
CCCTCCTCGCTCGTAT-1_V12D07-335_A1,1,0,2,0,0,3
GAGCGCAAATACTCCG-1_V12D07-335_A1,0,0,1,0,0,1
ATTACATGTCAGTCTT-1_V12D07-335_A1,0,0,2,0,0,2
TTGGGACGTAAGAGTT-1_V12D07-335_A1,0,1,3,0,0,4
CTTCGGCCAATTGTTT-1_V12D07-335_A1,1,0,1,0,0,2
AGACCGCTCCGCGGTT-1_V12D07-335_A1,1,1,4,0,2,8
GACCGCGTCTGACGTG-1_V12D07-335_A1,1,0,1,0,0,2
CCAAATAACAAGATTC-1_V12D07-335_A1,0,0,1,0,0,1
TCTTTAGAGTCTAACA-1_V12D07-335_A1,1,0,0,0,0,1
CTCCCAATGAGTCGCG-1_V12D07-335_A1,0,0,4,0,0,4
TAGTCTTTCCGAATTG-1_V12D07-335_A1,1,1,0,0,0,2
GAGTAAACCGGAAAGT-1_V12D07-335_A1,2,2,6,0,0,10
GATCTCGACGCTGTGG-1_V12D07-335_A1,1,0,2,0,0,3
CTGACATAGAAATAGA-1_V12D07-335_A1,1,0,2,0,0,3
TATACCGAGTGCCACA-1_V12D07-335_A1,1,1,5,0,0,7
TCCGAACGTTGCCGCT-1_V12D07-335_A1,2,0,4,1,0,7
GCAGAAGGTAATCTCC-1_V12D07-335_A1,0,0,9,0,0,9
GGTACTAAGTGCTTTG-1_V12D07-335_A1,1,0,4,0,0,5
CAGAATATTCGTTATC-1_V12D07-335_A1,0,1,3,0,0,4
TAATCAACCAAATGGG-1_V12D07-335_A1,4,0,2,0,0,6
TCTGCTTAGAACAAGC-1_V12D07-335_A1,1,0,4,1,0,6
AACTGAGTTATACTGA-1_V12D07-335_A1,1,1,1,0,0,3
CCTCAACGATCGCTGT-1_V12D07-335_A1,1,2,1,0,0,4
CGGTACGGCAAACCCA-1_V12D07-335_A1,3,2,2,0,0,7
CAGATGTTTGTCCCAA-1_V12D07-335_A1,6,1,4,0,0,11
GTTTGTTAGCCAAGTA-1_V12D07-335_A1,9,1,1,0,0,11
ACGTGACAAAGTAAGT-1_V12D07-335_A1,4,0,1,0,0,5
TTGTCACCGCGGTATC-1_V12D07-335_A1,4,2,0,0,0,6
GATCTAACCGTATTCA-1_V12D07-335_A1,2,1,0,0,0,3
ATGGAAATTTAAGGAG-1_V12D07-335_A1,0,0,3,0,0,3
ATTGATCACCACATTT-1_V12D07-335_A1,1,2,0,0,0,3
ACTGCTCGGAAGGATG-1_V12D07-335_A1,3,3,1,0,0,7
TCTAAAGAACAGTCTC-1_V12D07-335_A1,2,1,1,0,0,4
CTGGGTTGAGTTAAAG-1_V12D07-335_A1,3,1,1,0,0,5
CCCAGTAAACTTGGGA-1_V12D07-335_A1,1,1,1,0,0,3
AGATTCACAACCGATA-1_V12D07-335_A1,3,0,2,0,0,5
AGAAGGTACACTTCAC-1_V12D07-335_A1,0,1,0,0,0,1
GCAGGAACTTAGATCT-1_V12D07-335_A1,2,0,3,0,0,5
AATCTAGGTTTACTTG-1_V12D07-335_A1,3,0,1,0,0,4
CCCGGTGTATCGGAAT-1_V12D07-335_A1,4,0,1,0,0,5
TTATCCTCAAGGAATA-1_V12D07-335_A1,2,1,2,0,1,6
AGCATCATTTCGAAAG-1_V12D07-335_A1,2,0,3,0,0,5
CGCGAGTCTGCCGGGT-1_V12D07-335_A1,1,3,4,0,0,8
TGCGTCATGACTGAGC-1_V12D07-335_A1,3,0,1,0,0,4
GTATGAAATTTCACTC-1_V12D07-335_A1,1,1,0,0,0,2
TTGGTTGCGGTGCGCG-1_V12D07-335_A1,0,1,2,0,0,3
ACAGAACTGAGAACAA-1_V12D07-335_A1,2,0,1,0,0,3
CTACTATCATAGGTTT-1_V12D07-335_A1,0,0,0,0,0,0
CCTCTATCGATTAGCA-1_V12D07-335_A1,3,1,1,0,0,5
CCGTATCTCGTCGTAG-1_V12D07-335_A1,2,2,2,0,0,6
TCACGATGTCCGTGGA-1_V12D07-335_A1,0,1,3,0,0,4
TCAACAAAGATAATTC-1_V12D07-335_A1,2,1,5,0,0,8
ATGACGCGTTCTATCC-1_V12D07-335_A1,1,0,4,0,0,5
ATTTGCGCGAGTAGCT-1_V12D07-335_A1,3,0,1,0,0,4
TTCTTGGACGATCTGC-1_V12D07-335_A1,4,0,1,0,0,5
AGACGACGATGCCGCT-1_V12D07-335_A1,2,0,2,0,0,4
GGTCTCTGAATGGACT-1_V12D07-335_A1,0,0,3,0,0,3
GCTCAATCCGTTTATT-1_V12D07-335_A1,4,0,1,0,0,5
CCAGAAAGCAACTCAT-1_V12D07-335_A1,2,1,1,0,0,4
CACCGTTAGGGATCAC-1_V12D07-335_A1,1,0,0,0,0,1
AATAACACTAGAACAA-1_V12D07-335_A1,1,1,1,0,0,3
CACCCGGTTTGTGACT-1_V12D07-335_A1,0,1,0,0,0,1
CCACCAACTTTACTGT-1_V12D07-335_A1,3,1,3,0,0,7
AACTCTCAGTGTGCTC-1_V12D07-335_A1,1,0,2,0,0,3
AAACCGTTCGTCCAGG-1_V12D07-335_A1,1,1,0,0,0,2
CAGCGATTCCCTTCAA-1_V12D07-335_A1,3,0,1,0,0,4
GCTAGCTTGAATAGCT-1_V12D07-335_A1,1,0,2,0,0,3
TTGCGGCATCAGAAAG-1_V12D07-335_A1,0,0,0,0,0,0
AATAGAACAGAGTGGC-1_V12D07-335_A1,0,2,3,0,0,5
GCCATCGAGCTGCGTG-1_V12D07-335_A1,0,0,1,0,0,1
ACACTGATCAAGGTGT-1_V12D07-335_A1,0,1,0,0,0,1
ACCAACGCTTATTTAT-1_V12D07-335_A1,0,1,3,1,0,5
GACATCGATTTATAAC-1_V12D07-335_A1,0,0,0,1,0,1
CAGACACCGATCGCTG-1_V12D07-335_A1,0,0,1,0,0,1
CCAAGAAAGTGGGCGA-1_V12D07-335_A1,1,2,4,0,0,7
GGTAGACCGTTGGGCG-1_V12D07-335_A1,0,0,2,0,0,2
TCGTTAGGAGTCCCTA-1_V12D07-335_A1,2,1,0,1,0,4
ACGGCCAACATGGACT-1_V12D07-335_A1,1,0,1,1,0,3
GTGAGTGGTACAACGC-1_V12D07-335_A1,1,0,0,1,0,2
GAGACTTCGCGACCGA-1_V12D07-335_A1,0,0,0,0,0,0
GAAGTCAGTTGCACTA-1_V12D07-335_A1,2,1,2,0,0,5
GTTTGGTAGGGTCAAC-1_V12D07-335_A1,1,1,2,0,0,4
ACGGCACTTGCTTGGG-1_V12D07-335_A1,0,0,0,0,0,0
CCTCTGTACTATTCTA-1_V12D07-335_A1,0,0,1,0,0,1
CTATTCATGTGTCCCA-1_V12D07-335_A1,1,0,2,0,0,3
GCCCGATCTGTGGTCG-1_V12D07-335_A1,0,0,5,0,0,5
TTAGAAGAACATGACT-1_V12D07-335_A1,0,0,1,1,0,2
AGGATAAAGTCGGGAT-1_V12D07-335_A1,0,0,1,0,0,1
CGGCAAACATCGTGCG-1_V12D07-335_A1,0,0,0,0,0,0
CTAGTTACAACCCGGT-1_V12D07-335_A1,0,0,2,0,0,2
TTCGACAGAGCCCGTG-1_V12D07-335_A1,1,0,0,0,0,1
AAGCATACTCTCCTGA-1_V12D07-335_A1,1,0,0,0,0,1
GACGACGATCCGCGTT-1_V12D07-335_A1,3,1,1,0,0,5
GGTAGAAGACCGCCTG-1_V12D07-335_A1,2,0,2,0,0,4
GAGATGGGAGTCGACA-1_V12D07-335_A1,2,0,1,0,0,3
AACGATAATGCCGTAG-1_V12D07-335_A1,1,0,1,0,0,2
TGGTCCCACGCTACGG-1_V12D07-335_A1,2,0,0,0,0,2
CTGCTTGGCGATAGCT-1_V12D07-335_A1,0,0,1,0,0,1
ATCGGAGACAGACGGC-1_V12D07-335_A1,3,0,0,1,0,4
TAGCGTCCGGTGTGGT-1_V12D07-335_A1,3,0,2,0,0,5
GTTGAGTCCCGCCGGT-1_V12D07-335_A1,2,2,1,0,0,5
AAATAGGGTGCTATTG-1_V12D07-335_A1,1,0,1,0,0,2
AAGTGTTTGGAGACGG-1_V12D07-335_A1,2,0,0,0,0,2
AGCACTACCTCACCAG-1_V12D07-335_A1,1,0,2,0,0,3
TGCCTTGGCCAGGCAA-1_V12D07-335_A1,0,0,1,0,0,1
TCGTCTTAGGCGTTAA-1_V12D07-335_A1,3,1,1,0,0,5
TTCTGACCGGGCTCAA-1_V12D07-335_A1,3,0,1,0,0,4
CAGAACTTAGCCCTCT-1_V12D07-335_A1,1,0,0,0,0,1
AGCTCCTTCGCACATC-1_V12D07-335_A1,0,0,5,0,0,5
ACAGGCTTGCCCGACT-1_V12D07-335_A1,2,0,0,0,0,2
GCTATACGTCTCGGAC-1_V12D07-335_A1,0,0,1,0,0,1
GAGCCAGCTACCTGTG-1_V12D07-335_A1,3,0,2,0,0,5
TGCTAAGTGTCTATTT-1_V12D07-335_A1,0,1,0,0,0,1
GTCCTACGAATAGTCT-1_V12D07-335_A1,1,0,0,0,0,1
CAGTGTCGGCTGGCCC-1_V12D07-335_A1,2,0,1,0,0,3
CTATCGACGAAATACA-1_V12D07-335_A1,2,0,0,0,0,2
CATCATTACCCTGAGG-1_V12D07-335_A1,0,0,1,0,0,1
TAAGTTGCGACGTAGG-1_V12D07-335_A1,2,0,0,0,0,2
AGTGCACGCTTAAGAA-1_V12D07-335_A1,2,1,1,0,0,4
TGTGCCGGTGCCGGAA-1_V12D07-335_A1,1,1,2,0,0,4
AGGAGGCCTTCGCGCG-1_V12D07-335_A1,2,1,3,0,0,6
TCCGCGGCCCAATGAA-1_V12D07-335_A1,4,1,3,0,0,8
TCCGTTAAGCTAATAT-1_V12D07-335_A1,0,0,2,1,1,4
AAATCTAGCCCTGCTA-1_V12D07-335_A1,3,1,1,0,0,5
CGCAGGCGATCCAAAC-1_V12D07-335_A1,0,1,1,0,0,2
CCATATGGAAACTATA-1_V12D07-335_A1,1,0,2,0,0,3
CACCGTATCCCATCCG-1_V12D07-335_A1,0,0,2,0,0,2
GGTCAAGACTACTTCG-1_V12D07-335_A1,2,0,3,0,1,6
CCCGTTTCGCAGATGT-1_V12D07-335_A1,1,0,0,0,0,1
GTTATAATACGGTGAA-1_V12D07-335_A1,5,2,2,0,0,9
ACTTGTGGATGGAACG-1_V12D07-335_A1,1,0,3,0,0,4
GTTCGCTGAGACGTCT-1_V12D07-335_A1,0,1,1,0,0,2
GACACTGGAACCCGAT-1_V12D07-335_A1,1,0,6,0,0,7
CCCAGGTCTGAAGGCT-1_V12D07-335_A1,4,1,1,0,0,6
TCTCGAGGAGGTTCGC-1_V12D07-335_A1,3,0,2,0,0,5
ACTATCTGCCCGCGTA-1_V12D07-335_A1,2,0,1,0,0,3
CCTAAATTGTATCCTA-1_V12D07-335_A1,0,1,3,0,1,5
AGAAATTATGACTCGC-1_V12D07-335_A1,3,2,0,0,0,5
TCCAGCGCTATAAGCG-1_V12D07-335_A1,4,0,1,0,1,6
TCGTGTATTGGTCACG-1_V12D07-335_A1,2,1,1,0,0,4
CCACATACTGCACCCA-1_V12D07-335_A1,1,1,0,0,0,2
GTTGCGGACGGTCAGG-1_V12D07-335_A1,4,0,1,0,0,5
GTATTTAATGGCATAA-1_V12D07-335_A1,5,0,2,0,0,7
GTCGATAGGTGACTTT-1_V12D07-335_A1,2,0,1,0,0,3
AATAATCTTCGTATCG-1_V12D07-335_A1,0,0,1,0,0,1
ATTGTTCAACGATCCG-1_V12D07-335_A1,1,0,2,0,0,3
GTGCAGCGTAGAGTAG-1_V12D07-335_A1,2,0,0,0,0,2
TGTGGTAGGGTGCCTT-1_V12D07-335_A1,5,0,1,0,0,6
TGTGGACTATCTACGT-1_V12D07-335_A1,3,0,1,0,0,4
GGCGGGCTCTAAGAGT-1_V12D07-335_A1,2,0,5,0,0,7
TGTGCCAGAGGCAAAG-1_V12D07-335_A1,1,1,6,2,0,10
TGGCTTATGTATAATG-1_V12D07-335_A1,0,0,2,0,0,2
GCAAGCTGGAAACCGC-1_V12D07-335_A1,3,2,3,0,0,8
GATATCAAGCAGGAGC-1_V12D07-335_A1,2,2,4,0,0,8
CACCAATCATCCGTCT-1_V12D07-335_A1,3,0,4,0,0,7
CCACATGGCTCTTTAT-1_V12D07-335_A1,4,0,1,0,0,5
GTCCTACTCTACGGGC-1_V12D07-335_A1,2,0,0,0,0,2
CTCGAGACATACGATA-1_V12D07-335_A1,1,0,0,0,0,1
TATCAGTGGCGTAGTC-1_V12D07-335_A1,1,1,6,0,0,8
TGACAGGACAAGTCCA-1_V12D07-335_A1,3,3,1,0,0,7
TATTAACACCAAAGCA-1_V12D07-335_A1,5,0,2,0,0,7
TAGGCGATGAGGTCTC-1_V12D07-335_A1,1,1,4,0,0,6
CCGCCGGAACTTCTCG-1_V12D07-335_A1,2,1,3,0,0,6
GCCATTAGCCTCAAAC-1_V12D07-335_A1,3,1,0,0,0,4
GTTAGGCTACCCGTTT-1_V12D07-335_A1,1,0,0,0,0,1
GGGTATTCTAGCAAAC-1_V12D07-335_A1,0,1,2,0,0,3
GCCCTAGCCGTCGCGA-1_V12D07-335_A1,1,1,0,0,0,2
CAGATCCTGGTTTGAA-1_V12D07-335_A1,2,1,2,0,0,5
CTTCAGTGGTCGCCTA-1_V12D07-335_A1,2,2,1,0,0,5
GGGCAACCGCACGTGC-1_V12D07-335_A1,0,4,0,0,0,4
GACCCAATTATGATAC-1_V12D07-335_A1,2,2,1,0,0,5
GAAGCTCGGACCCGTC-1_V12D07-335_A1,1,2,4,0,0,7
CGTCGGGTCTAAGCGC-1_V12D07-335_A1,0,0,0,0,0,0
GAGGCCCGACTCCGCA-1_V12D07-335_A1,2,0,1,0,0,3
TTGCCATAGCCCGCTC-1_V12D07-335_A1,0,1,1,0,0,2
TAACATACACGCGATC-1_V12D07-335_A1,1,1,0,0,0,2
CCGACGGGCATGAGGT-1_V12D07-335_A1,0,1,3,0,0,4
AATGTGCCCGAGGTGT-1_V12D07-335_A1,0,0,1,0,0,1
AGCTGTAACCTCAATC-1_V12D07-335_A1,5,1,2,0,0,8
CGAGTGAAGGTACCAG-1_V12D07-335_A1,1,3,2,0,0,6
AGTCTCACAAGACTAC-1_V12D07-335_A1,0,3,2,0,0,5
AAATTGATAGTCCTTT-1_V12D07-335_A1,2,4,3,0,0,9
TAAGTCGCCGAGTATC-1_V12D07-335_A1,1,1,1,0,0,3
GCGGAGAAACTTCGCA-1_V12D07-335_A1,3,1,1,0,0,5
GGCAAAGGCGCCAATA-1_V12D07-335_A1,0,1,0,0,0,1
ATTTCCGGGTTCTGCG-1_V12D07-335_A1,1,1,1,0,0,3
TAAACCCAGGAGGGCA-1_V12D07-335_A1,1,3,2,0,0,6
TTCGGGCGCTAGTCTT-1_V12D07-335_A1,3,0,0,0,0,3
GTGGAGTCGGCGGTTG-1_V12D07-335_A1,1,0,1,0,0,2
GCACGCCTACTTAGAT-1_V12D07-335_A1,3,1,1,0,0,5
CAATATTCTTGACCTA-1_V12D07-335_A1,1,0,1,0,0,2
CGTTTGTGTAGAGGGT-1_V12D07-335_A1,2,0,2,0,0,4
CATAGCGTTGCCCACC-1_V12D07-335_A1,0,1,0,0,0,1
TGATACATTTAGCCGT-1_V12D07-335_A1,1,0,2,0,0,3
TTCCGGCCTTGAGGCT-1_V12D07-335_A1,1,0,1,0,0,2
CCTATACCGTCCTGTC-1_V12D07-335_A1,1,0,1,0,0,2
TCGTTGCTATCCGGTC-1_V12D07-335_A1,1,0,3,0,0,4
TGGCGACTGCTCCAAA-1_V12D07-335_A1,0,0,2,0,0,2
CAGAGGCGATGCATGA-1_V12D07-335_A1,0,0,3,0,0,3
TCACAGGAGAATAAGA-1_V12D07-335_A1,0,2,2,1,0,5
GGGTTAACATTTGAGT-1_V12D07-335_A1,1,0,1,0,0,2
GCGGGCGAGCCTTACC-1_V12D07-335_A1,2,0,1,0,0,3
TGCCAATGGGTACTCT-1_V12D07-335_A1,0,1,1,0,0,2
AGGGACTCTACGCGAC-1_V12D07-335_A1,0,0,5,0,0,5
GACGCCGTAAAGGCTA-1_V12D07-335_A1,0,1,1,1,0,3
AAAGGCTCTCGCGCCG-1_V12D07-335_A1,0,1,4,0,0,5
CTGGCTGGTTGTCAGT-1_V12D07-335_A1,0,1,2,0,0,3
ACATCCCGGCCATACG-1_V12D07-335_A1,3,0,0,2,0,5
CTCTTGTCCCGCTTGG-1_V12D07-335_A1,1,0,3,1,0,5
TACGCCTCCATTCCGA-1_V12D07-335_A1,1,0,2,1,0,4
CGGAGCAATTTAATCG-1_V12D07-335_A1,0,1,0,0,0,1
AACTAGGCTTGGGTGT-1_V12D07-335_A1,0,0,1,0,0,1
GCGTCGCCAGGGTGAT-1_V12D07-335_A1,0,0,2,0,0,2
GTTGGTCATGCTATCC-1_V12D07-335_A1,0,0,0,0,0,0
GCTGGCGGCGCATGCT-1_V12D07-335_A1,3,0,0,1,0,4
TGAGCGGAAAGTGTTC-1_V12D07-335_A1,1,0,0,1,0,2
CTTTCTGTGCGGGCTT-1_V12D07-335_A1,0,0,3,0,0,3
ATCTAATATCCTACGG-1_V12D07-335_A1,0,1,1,1,0,3
AACCTTTAAATACGGT-1_V12D07-335_A1,2,0,1,1,0,4
TTCACTCGAGCACCTA-1_V12D07-335_A1,1,0,3,0,0,4
CTGCACTCCAGTACAG-1_V12D07-335_A1,3,0,2,0,0,5
CCATTTCTACCTATTA-1_V12D07-335_A1,3,0,0,0,0,3
CAAGCGGCACATAATT-1_V12D07-335_A1,2,0,2,0,0,4
GTTAACATCACTTAAA-1_V12D07-335_A1,3,0,1,0,0,4
ATATAAATGTAGCTGC-1_V12D07-335_A1,1,0,0,0,0,1
GCCTCTATACATAGCA-1_V12D07-335_A1,0,0,3,0,0,3
GTGTCGTATAGCGTTC-1_V12D07-335_A1,3,0,2,0,0,5
ATACGTACTTAGCCAC-1_V12D07-335_A1,4,0,1,0,0,5
GCTATCATACTCATGG-1_V12D07-335_A1,4,1,0,0,0,5
TATCCAATTGGTTATC-1_V12D07-335_A1,4,0,1,0,0,5
TCTCCCTGGGCAGCGT-1_V12D07-335_A1,1,0,0,0,0,1
CCTATAATGAGTGCCC-1_V12D07-335_A1,0,0,1,0,0,1
CAATGCGAGAAGTATC-1_V12D07-335_A1,6,0,0,0,0,6
TACCAATAAAGTACCA-1_V12D07-335_A1,1,0,0,0,0,1
GCTAGGCACCACGGAG-1_V12D07-335_A1,4,0,2,0,0,6
GGTGGACTGCTCTGGC-1_V12D07-335_A1,1,0,2,0,0,3
TATTCCGAGCTGTTAT-1_V12D07-335_A1,1,2,0,0,0,3
TTGAGAAGTTTAGCAT-1_V12D07-335_A1,2,2,1,0,0,5
GTCCGGACCTGAAATT-1_V12D07-335_A1,2,0,1,0,0,3
CTGTGGTCGGGAGATA-1_V12D07-335_A1,2,0,0,0,0,2
CATGTAAGAGACATTT-1_V12D07-335_A1,1,1,1,0,0,3
CACGTTTCGTACACAC-1_V12D07-335_A1,0,2,2,0,0,4
CATCCTCTCAAAGATC-1_V12D07-335_A1,6,1,3,0,0,10
GATTAACCGAAAGCCC-1_V12D07-335_A1,2,1,1,0,0,4
AACGCTGTTGCTGAAA-1_V12D07-335_A1,0,2,2,0,0,4
TTCAGCTGGCGTGCCC-1_V12D07-335_A1,4,1,0,0,0,5
TAGAGGTTCTACTTGT-1_V12D07-335_A1,2,0,1,0,0,3
GTATCAAACGTTAGCT-1_V12D07-335_A1,2,2,3,0,0,7
AATCATGTAAAGACTC-1_V12D07-335_A1,0,0,4,0,0,4
AGTCACTAGCTCTCGA-1_V12D07-335_A1,3,0,2,0,0,5
GCGAAACGATCGGGAG-1_V12D07-335_A1,2,1,1,0,0,4
CATGGATTGTCTTCCG-1_V12D07-335_A1,2,0,1,0,0,3
ATTGGATTACAGCGTA-1_V12D07-335_A1,2,1,0,0,0,3
CACACACGCTAACGAG-1_V12D07-335_A1,0,0,0,0,0,0
CTATGGGAAGCGGAAT-1_V12D07-335_A1,1,0,1,0,0,2
TGCCTAATTGAAGATT-1_V12D07-335_A1,2,1,0,0,0,3
TGGCAATGGGACGGCG-1_V12D07-335_A1,2,0,1,0,0,3
ACCTCCGCCCTCGCTG-1_V12D07-335_A1,2,0,2,0,0,4
CGGCAATAAGATCGCC-1_V12D07-335_A1,4,0,3,0,0,7
CCTTGACCACTTTATT-1_V12D07-335_A1,4,3,1,0,0,8
TCATTTAGAAGTGTGA-1_V12D07-335_A1,2,1,0,0,0,3
CAGAATAACACACGGA-1_V12D07-335_A1,4,0,1,0,0,5
TCTGAGCAATTGACTG-1_V12D07-335_A1,1,0,6,1,0,8
CAACGTGGTGGAGTCT-1_V12D07-335_A1,2,0,0,1,0,3
CACAGTTCGCTTCCCA-1_V12D07-335_A1,3,0,0,1,0,4
TCTCTCGCCGCACATA-1_V12D07-335_A1,3,2,1,0,0,6
TGGGCAGGCCACCGCA-1_V12D07-335_A1,1,0,3,0,0,4
CTCCTGTTCAAGGCAG-1_V12D07-335_A1,4,0,1,0,0,5
TATTTGATTTGCACAG-1_V12D07-335_A1,5,6,2,0,0,13
GCCACTCCTTACGGTA-1_V12D07-335_A1,4,0,1,0,0,5
ACCGATATTTAATCAT-1_V12D07-335_A1,2,0,1,0,0,3
TTATTATCTGGAAGGC-1_V12D07-335_A1,3,0,3,0,1,7
TACATGCCGGAATTGT-1_V12D07-335_A1,1,0,3,0,0,4
GGCACTCAGCCGACCC-1_V12D07-335_A1,2,0,1,0,0,3
AAACCGGAAATGTTAA-1_V12D07-335_A1,1,0,2,0,0,3
AGACAGGCATCTCAGC-1_V12D07-335_A1,5,0,1,0,0,6
GTGGTGATGGTTTGTG-1_V12D07-335_A1,4,0,3,0,0,7
CCGATATGACGTAAGG-1_V12D07-335_A1,3,0,1,0,0,4
CATACACAAAGTCAGC-1_V12D07-335_A1,0,0,3,2,0,5
TGCCGTTCTTAATCGG-1_V12D07-335_A1,0,0,1,8,0,9
TCGAGTCTACGATTCG-1_V12D07-335_A1,0,0,0,0,0,0
ACTTCCAGTGGAAGCT-1_V12D07-335_A1,0,0,2,0,0,2
CAATTGGGCCGCACTC-1_V12D07-335_A1,3,1,3,0,0,7
AAATCGCGGAAGGAGT-1_V12D07-335_A1,2,0,3,0,0,5
ATATCAATTCCAGCCT-1_V12D07-335_A1,4,1,4,0,0,9
CTTTGTCGAATGCTCC-1_V12D07-335_A1,2,0,2,0,0,4
TGAGGCATGTACTGTG-1_V12D07-335_A1,2,1,3,0,0,6
TTCGCCGCTCGCGCTA-1_V12D07-335_A1,1,1,1,0,0,3
GACTCCTTCCAATTGA-1_V12D07-335_A1,2,2,5,0,1,10
ACCGAAGAGTCTGGTT-1_V12D07-335_A1,3,1,2,0,0,6
TGGCATGAAGTTTGGG-1_V12D07-335_A1,1,1,1,0,0,3
ACGAGGTTTACAACGT-1_V12D07-335_A1,1,0,4,0,0,5
AACCCATCCCATGATC-1_V12D07-335_A1,1,3,2,0,0,6
TCGACAACTGAACCCG-1_V12D07-335_A1,2,5,4,0,0,11
TATCTTGCAATACAAC-1_V12D07-335_A1,0,0,2,0,0,2
TATTATGTTTGCCTGC-1_V12D07-335_A1,0,0,5,0,0,5
GTCAAAGAAGTGGTGT-1_V12D07-335_A1,1,3,2,0,0,6
GGGACAGAGTTACTCC-1_V12D07-335_A1,0,2,1,0,0,3
AGCAACCGAAAGTAAT-1_V12D07-335_A1,1,1,1,0,0,3
CTCTCTAACTGCCTAG-1_V12D07-335_A1,0,1,1,0,0,2
ATACGGAACGTCGTTT-1_V12D07-335_A1,0,2,0,0,0,2
TCGGTCCCGACAATAG-1_V12D07-335_A1,1,1,2,0,0,4
CGCGCAAATGTCCAGA-1_V12D07-335_A1,0,2,0,0,0,2
TCTAATACTGCCTCAG-1_V12D07-335_A1,0,0,4,0,0,4
CTCGGTTGTCGGCCCT-1_V12D07-335_A1,0,1,3,0,0,4
GGTAACCGGGAGGATA-1_V12D07-335_A1,1,1,2,0,0,4
CAGGCGCACGGTGGTC-1_V12D07-335_A1,1,0,3,0,0,4
TCATCGATGGTCCCAA-1_V12D07-335_A1,0,0,3,0,0,3
CAAAGATTATTGGGCC-1_V12D07-335_A1,1,1,5,0,0,7
ACAATGAATACGGAGA-1_V12D07-335_A1,1,3,3,0,0,7
GCTCCTGACATACTGG-1_V12D07-335_A1,0,2,1,0,0,3
GATGACAAGTAGGGCA-1_V12D07-335_A1,3,0,1,0,0,4
TACGCCGAGGGTACCC-1_V12D07-335_A1,1,0,1,0,0,2
AAGCGTCCCTCATCGA-1_V12D07-335_A1,0,1,3,0,0,4
CACTCCTATGTAAGAT-1_V12D07-335_A1,2,1,2,0,0,5
TCGAGCCAGGCAGGCC-1_V12D07-335_A1,0,0,1,0,0,1
TCGTCAAGTACGCGCA-1_V12D07-335_A1,0,2,0,0,0,2
CCCGTAGCTGGGAAGA-1_V12D07-335_A1,2,1,2,0,0,5
ACCCTATGCCATATCG-1_V12D07-335_A1,1,1,1,0,0,3
GTGGTATAGTCTGCCG-1_V12D07-335_A1,1,3,4,0,0,8
CCGGTTTGTAATTGTG-1_V12D07-335_A1,2,2,0,0,0,4
GTCGCCGTTGTGTGTT-1_V12D07-335_A1,2,0,1,0,0,3
TACTGAACAGATTTAG-1_V12D07-335_A1,1,0,2,0,0,3
TATTAACCTGACCGCG-1_V12D07-335_A1,0,0,2,0,0,2
CTGTAGCCATCTCACT-1_V12D07-335_A1,0,0,1,0,0,1
TACTATGGTTCCTCAG-1_V12D07-335_A1,1,0,2,0,0,3
GAGTCAGACCAGAATC-1_V12D07-335_A1,1,0,1,0,0,2
TAAGGCATAACATCAA-1_V12D07-335_A1,1,1,4,0,0,6
CTTCCGCTCCGTGAAG-1_V12D07-335_A1,0,0,3,0,0,3
GGGCTATGATCGATGG-1_V12D07-335_A1,0,1,0,0,0,1
GGTCGGTCGTCCACAG-1_V12D07-335_A1,1,0,0,0,0,1
GGGACCCGTATATCTT-1_V12D07-335_A1,2,0,3,0,0,5
GAAAGCAGTGCACTTT-1_V12D07-335_A1,2,0,0,0,0,2
AGCGCATAATGAATCG-1_V12D07-335_A1,0,0,2,1,0,3
GCTGCTAAGTAGTCGA-1_V12D07-335_A1,2,0,1,0,0,3
AATAGTCCGTCCCGAC-1_V12D07-335_A1,2,0,1,0,0,3
AGCAGCCAGATGAATA-1_V12D07-335_A1,0,0,0,0,0,0
CCTCGCGCTGTGCGAT-1_V12D07-335_A1,0,2,2,2,0,6
TTGTGTATGCCACCAA-1_V12D07-335_A1,0,0,1,1,0,2
TGCTCGGCGAAACCCA-1_V12D07-335_A1,0,0,1,2,0,3
CGATTAAATATCTCCT-1_V12D07-335_A1,1,0,0,1,0,2
TGCCGTGGATCGTCCT-1_V12D07-335_A1,3,0,1,1,0,5
GTGGACGCATTTGTCC-1_V12D07-335_A1,0,0,1,0,0,1
ACCCGGAAACTCCCAG-1_V12D07-335_A1,0,0,0,0,0,0
CCGCATGTGGTACGAT-1_V12D07-335_A1,2,0,0,0,0,2
GCAAACCTTGGCCATA-1_V12D07-335_A1,1,0,0,0,0,1
ATTCACTGATGTTGGA-1_V12D07-335_A1,0,1,1,0,0,2
ACTCCCTAATGCTAAA-1_V12D07-335_A1,0,0,2,0,0,2
TCCTAAATTGGGAAGC-1_V12D07-335_A1,0,0,2,0,0,2
GAACAGATTACTAAAT-1_V12D07-335_A1,0,0,0,0,0,0
ATACAGGCCCTCCAAT-1_V12D07-335_A1,3,0,1,0,0,4
CGATTCGCCTGGCTGC-1_V12D07-335_A1,2,0,3,0,0,5
TCCGCCTGTCTACAAG-1_V12D07-335_A1,2,0,2,0,0,4
CACATCTCACCGACGA-1_V12D07-335_A1,1,0,4,0,0,5
CGTCGTCCTTCGCGAA-1_V12D07-335_A1,3,0,0,0,0,3
CGTTGAATACCGCGCT-1_V12D07-335_A1,1,0,1,0,0,2
ACCAATATGCAAGTTA-1_V12D07-335_A1,0,0,0,0,0,0
ACGGATGGTGCGGATA-1_V12D07-335_A1,0,0,6,0,0,6
CACCCTAACAAGATCT-1_V12D07-335_A1,2,0,0,0,0,2
AAGCTCTTTCATGGTG-1_V12D07-335_A1,1,0,1,0,0,2
CATGGGTATGCCTTAT-1_V12D07-335_A1,3,0,1,0,0,4
GCGCGTCATTGGTACA-1_V12D07-335_A1,2,0,1,0,0,3
TCTGAAGCACGTGGTC-1_V12D07-335_A1,0,0,1,0,0,1
AAGTTCACTCCAAGCT-1_V12D07-335_A1,1,0,2,0,0,3
TTGGACCTATAACAGT-1_V12D07-335_A1,1,0,1,0,0,2
ATCAGCCTCATGCTGC-1_V12D07-335_A1,0,0,1,0,0,1
AGTACTCTTATGCCCA-1_V12D07-335_A1,1,1,2,0,0,4
GCGCTTAAATAATTGG-1_V12D07-335_A1,8,4,1,0,0,13
TTGTGAACCTAATCCG-1_V12D07-335_A1,2,0,2,0,0,4
AGTCGTCGACCACCAA-1_V12D07-335_A1,2,1,2,0,0,5
TCCTTTAAATCCGCTT-1_V12D07-335_A1,3,0,0,0,0,3
ACTGAAACGCCGTTAG-1_V12D07-335_A1,1,0,0,0,0,1
GCACACACTGGTAGCC-1_V12D07-335_A1,0,0,1,0,0,1
TAAGGGCCTGTCCGAT-1_V12D07-335_A1,1,0,1,0,0,2
GCTAGAGTAGAGATGT-1_V12D07-335_A1,2,1,1,0,2,6
CACAGGGCCATATAGT-1_V12D07-335_A1,3,0,4,0,0,7
CCATGCCCTAGATTTC-1_V12D07-335_A1,1,0,0,0,0,1
TCGCGTAGCAGTGTCC-1_V12D07-335_A1,4,1,2,0,0,7
GACGAGGCTAATAAAC-1_V12D07-335_A1,5,0,2,0,0,7
CTACACTCGCAGATGG-1_V12D07-335_A1,0,0,0,0,0,0
ACGCATACGTTTACTA-1_V12D07-335_A1,2,0,2,0,0,4
GGAGCAACATTTCAAG-1_V12D07-335_A1,2,1,0,0,0,3
CGAGAGGGTAGCCGCG-1_V12D07-335_A1,0,0,0,0,0,0
TCGTGTTCGACCACAA-1_V12D07-335_A1,3,0,0,0,0,3
TCTACCCAATAGAGAG-1_V12D07-335_A1,3,0,2,0,0,5
ATAAACGTTGCACCAC-1_V12D07-335_A1,3,1,0,0,0,4
TCAACTGCAGAGTCAG-1_V12D07-335_A1,2,0,0,0,0,2
AGCTCCATATATGTTC-1_V12D07-335_A1,1,0,2,0,0,3
GTAACATCTAAGATAA-1_V12D07-335_A1,3,1,2,0,0,6
CCGACAATAGGCCGCC-1_V12D07-335_A1,2,0,1,0,0,3
ATGCTTAGGAGTTGAT-1_V12D07-335_A1,1,0,2,0,0,3
AACCCGAGCAGAATCG-1_V12D07-335_A1,0,1,0,0,0,1
CGGGTTTGTTAGGGCT-1_V12D07-335_A1,0,2,2,0,0,4
AGGCACGTGACTGTCC-1_V12D07-335_A1,0,1,2,0,0,3
GACAAGAGATGAGATT-1_V12D07-335_A1,1,0,0,0,0,1
AGCCCTTGGACATCCC-1_V12D07-335_A1,2,0,2,0,0,4
GCAGTTCGATCCGAGC-1_V12D07-335_A1,4,1,1,0,0,6
TCGAGGGCAACAGACG-1_V12D07-335_A1,2,0,6,0,0,8
ACTTTGTCGACGCACT-1_V12D07-335_A1,3,0,1,0,0,4
GAGTATCAAAGTTACA-1_V12D07-335_A1,3,5,1,0,0,9
CCAGGCTGGCGTCTGA-1_V12D07-335_A1,1,0,2,0,0,3
GGACTCTTCCGGTTGA-1_V12D07-335_A1,2,0,1,0,0,3
TCCCAGCACACGACAT-1_V12D07-335_A1,2,0,0,0,0,2
GCTCCATGAGTGCAGA-1_V12D07-335_A1,0,0,1,0,1,2
GCAGTGCGGGCGGATG-1_V12D07-335_A1,3,0,0,0,1,4
GCGTTCTGACTAAGCG-1_V12D07-335_A1,9,0,4,0,0,13
ATTTGGAGATTGCGGT-1_V12D07-335_A1,0,0,4,6,0,10
AAGGGTTTGATTTCAG-1_V12D07-335_A1,0,0,0,2,0,2
CCGGCCGCGAGCATAT-1_V12D07-335_A1,0,0,2,0,0,2
GAGTTCTGTGGGTGCT-1_V12D07-335_A1,2,0,4,0,0,6
AAACGAAGATGGAGTA-1_V12D07-335_A1,0,0,1,0,0,1
AATTACGAGACCCATC-1_V12D07-335_A1,0,0,4,0,0,4
CCTTTGAATTATGGCT-1_V12D07-335_A1,3,1,3,0,0,7
CATGGTATTAGTTTGT-1_V12D07-335_A1,4,0,3,0,0,7
AACGAAAGTCGTCCCA-1_V12D07-335_A1,2,0,3,0,0,5
ACATAAGTCGTGGTGA-1_V12D07-335_A1,2,0,2,0,0,4
GCACAACCTCGGGCGT-1_V12D07-335_A1,3,0,3,0,0,6
ATGCACGCGCTGTTCA-1_V12D07-335_A1,1,0,6,0,0,7
CGATGTTGTTATCTAC-1_V12D07-335_A1,0,2,2,0,0,4
GTCTCCTGCCAGTATG-1_V12D07-335_A1,1,3,2,0,0,6
GATGCCTTCTGCGGCA-1_V12D07-335_A1,0,3,5,0,0,8
ACCGGTCAGGTACACC-1_V12D07-335_A1,0,5,4,0,0,9
GTGGAGCGTTTACCGA-1_V12D07-335_A1,2,0,4,4,0,10
AGGCGGTTTGTCCCGC-1_V12D07-335_A1,4,1,3,0,0,8
TCCCTGGCGTATTAAC-1_V12D07-335_A1,0,3,0,0,0,3
AAACACCAATAACTGC-1_V12D07-335_A1,0,2,3,0,0,5
TGGACGCAATCCAGCC-1_V12D07-335_A1,0,0,2,0,0,2
GGAACCTTGACTCTGC-1_V12D07-335_A1,0,3,4,0,0,7
GTATCTCAGTCTTGAC-1_V12D07-335_A1,0,0,2,0,0,2
GCTGAATCTTCCAATC-1_V12D07-335_A1,0,0,3,0,0,3
AGATGCAAGACGTGCA-1_V12D07-335_A1,0,1,3,0,0,4
TTAAGGCCCGTACTTT-1_V12D07-335_A1,0,1,0,0,0,1
AGTATGCTGGAGACCA-1_V12D07-335_A1,0,1,1,0,0,2
GCGGCAAAGTATTGCC-1_V12D07-335_A1,1,2,2,0,0,5
GCGCAAATATATTCAA-1_V12D07-335_A1,0,1,2,0,0,3
GAAGAAACGATATTGT-1_V12D07-335_A1,0,0,4,0,0,4
GGACCTCTAGGCCGCC-1_V12D07-335_A1,0,1,2,0,0,3
AACAGCTGTGTGGCAA-1_V12D07-335_A1,0,1,3,0,0,4
TCGAATATCCCGCAGG-1_V12D07-335_A1,0,0,4,0,0,4
GCGACCCAACCATCTG-1_V12D07-335_A1,0,0,1,0,0,1
AGAGAAGGAGTACAAT-1_V12D07-335_A1,0,0,2,0,0,2
GGCTCCTCCACCTGTT-1_V12D07-335_A1,3,2,1,0,0,6
TCAGTGTATACGTCAT-1_V12D07-335_A1,0,0,3,0,0,3
ATTATTATGTCCGTCA-1_V12D07-335_A1,0,2,2,0,0,4
TTAGGTCATAACCGAC-1_V12D07-335_A1,3,0,0,0,0,3
AAGATGGCACCGGACC-1_V12D07-335_A1,1,1,3,0,0,5
CTACAAGAAATAACCC-1_V12D07-335_A1,0,0,3,0,0,3
ACTATTTCCGGGCCCA-1_V12D07-335_A1,1,2,1,0,0,4
TTGTTTCACATCCAGG-1_V12D07-335_A1,1,0,1,0,0,2
CGCTGTGTGGATGTTG-1_V12D07-335_A1,0,0,0,0,0,0
TCAACATAGCGCCCTA-1_V12D07-335_A1,0,0,2,0,0,2
GGCCGTTTGGGTTTCA-1_V12D07-335_A1,1,1,1,0,0,3
TACTCTTTCGTCTTCA-1_V12D07-335_A1,2,0,2,0,0,4
TTCGCGCGCCATACGA-1_V12D07-335_A1,0,0,0,0,0,0
CGGAAAGAATCAAACG-1_V12D07-335_A1,1,0,2,0,0,3
AGGCAGGGAGCGTACT-1_V12D07-335_A1,1,0,1,0,0,2
CCTTTAAGGGAGCACT-1_V12D07-335_A1,2,0,1,0,0,3
CGCCCAGCACGCCTAG-1_V12D07-335_A1,0,0,1,0,0,1
AGTATTTGGCACGACC-1_V12D07-335_A1,0,0,2,0,0,2
TATCCGCACCGTCGGG-1_V12D07-335_A1,0,0,0,0,0,0
ACCCGTGTCATCAGTA-1_V12D07-335_A1,1,0,2,0,0,3
CAACTGCTCATCCGAT-1_V12D07-335_A1,0,0,1,0,0,1
CCGGAGCGTACTTTCT-1_V12D07-335_A1,0,1,0,2,0,3
TACCGTAGGTTAACTA-1_V12D07-335_A1,0,0,1,1,0,2
TGAGGAGTGCCAGCTT-1_V12D07-335_A1,0,0,0,1,0,1
CCAGTCTTGTCATAGA-1_V12D07-335_A1,0,2,0,0,0,2
GGGCAGAGCAATCGTT-1_V12D07-335_A1,0,0,2,2,0,4
TACCAAATAGCCCAGA-1_V12D07-335_A1,2,0,0,2,0,4
TACCTACTCCCAGTAT-1_V12D07-335_A1,2,0,1,2,0,5
TGTGAGACTAGCCCAA-1_V12D07-335_A1,0,1,0,3,0,4
ATACCTAACCAAGAAA-1_V12D07-335_A1,2,0,3,0,0,5
GTCGGGAAGCAGAAAC-1_V12D07-335_A1,0,0,1,0,0,1
AATTAACGGATTTCCA-1_V12D07-335_A1,1,2,0,0,0,3
GAACCCTCTGTGTTCT-1_V12D07-335_A1,2,0,1,1,0,4
ATATAAAGCGCTCGTG-1_V12D07-335_A1,0,0,3,0,0,3
CCTGGTCGAATGTGGG-1_V12D07-335_A1,0,1,1,0,0,2
CTAGGTTCGGACGTGA-1_V12D07-335_A1,5,0,1,0,0,6
TCGGGAGACAGCGTAC-1_V12D07-335_A1,0,1,2,0,0,3
CATAAGAAGCTTGGCT-1_V12D07-335_A1,3,2,1,0,0,6
AAGCACCCTGCGTATC-1_V12D07-335_A1,1,0,2,0,0,3
AGTTTGCACCTGCCTC-1_V12D07-335_A1,0,0,3,0,0,3
GACTGCAAATCGAGCT-1_V12D07-335_A1,0,0,1,0,0,1
GTGTATATCAGCGGGC-1_V12D07-335_A1,0,0,1,0,0,1
CTTCAACTCCACTTGG-1_V12D07-335_A1,1,2,0,0,0,3
ACTTACGCATCCACGC-1_V12D07-335_A1,2,1,1,0,0,4
CATGAGATGCACTCTC-1_V12D07-335_A1,2,0,0,0,0,2
GAGCACCTGTGTCCAG-1_V12D07-335_A1,2,0,1,0,0,3
CGCGACCGCGACAGAT-1_V12D07-335_A1,2,0,1,0,0,3
GTCCCGCGACGTTATG-1_V12D07-335_A1,1,1,0,0,0,2
GCAGTGTGGCTATAGG-1_V12D07-335_A1,2,1,0,0,0,3
ATACTGCCTTACACCG-1_V12D07-335_A1,0,0,1,0,0,1
TACAGAAACGGTGGGC-1_V12D07-335_A1,4,2,1,0,0,7
GGCGCGGAGATCTTTC-1_V12D07-335_A1,3,1,0,0,0,4
CGTTAATGTCCCGACG-1_V12D07-335_A1,1,1,2,0,0,4
GCTAACTGAAGTCTGA-1_V12D07-335_A1,2,1,2,0,0,5
AGTGATAACCTGCGCG-1_V12D07-335_A1,3,0,3,0,0,6
TATGATCTTCTCTTTA-1_V12D07-335_A1,2,0,1,0,0,3
TGTACCTACACGAGGG-1_V12D07-335_A1,2,0,1,0,0,3
ATATCGTTCCTCGAAC-1_V12D07-335_A1,5,0,1,0,0,6
CGGCGCCATCAATCCC-1_V12D07-335_A1,3,0,3,0,0,6
CCTGTTTGAAGACACG-1_V12D07-335_A1,1,0,1,0,0,2
GCCACTCAGAGCGCGA-1_V12D07-335_A1,0,0,2,0,0,2
TCGGCTTGTATCGACG-1_V12D07-335_A1,0,0,3,0,0,3
TAGATGGTTCCTTACT-1_V12D07-335_A1,4,0,0,0,0,4
ATCGTTAGCTAGCGGA-1_V12D07-335_A1,3,0,3,0,0,6
ACAGCGACATTCTCAT-1_V12D07-335_A1,2,0,2,0,0,4
ATTCAACCATTTAAGG-1_V12D07-335_A1,4,1,1,0,0,6
CACTCTTCTGCTAGCC-1_V12D07-335_A1,1,0,2,0,0,3
CTAACTGATAATCGCC-1_V12D07-335_A1,4,0,0,0,0,4
TGATGTCAATTAAGTG-1_V12D07-335_A1,3,0,0,0,0,3
CGCCGTTCAGCATAGT-1_V12D07-335_A1,3,7,1,0,0,11
ATACTACCCGTACCAC-1_V12D07-335_A1,5,0,2,0,0,7
CCACTGTTTGGATTAA-1_V12D07-335_A1,3,1,2,0,0,6
CACTACGGGAGCTGCC-1_V12D07-335_A1,1,0,0,0,0,1
GACCAAACGTTGACTG-1_V12D07-335_A1,4,2,2,0,0,8
AAGAGGCCCTTTGGAA-1_V12D07-335_A1,1,0,2,0,0,3
ACACGTAGGCCACAAG-1_V12D07-335_A1,2,0,0,0,0,2
TACTCTTACTTTACTG-1_V12D07-335_A1,3,0,0,0,0,3
AGAGCCGCCGAGATTT-1_V12D07-335_A1,2,1,1,0,0,4
GGCCTGCTTCTCCCGA-1_V12D07-335_A1,1,0,2,0,0,3
TCAAGCGCGGACGGTA-1_V12D07-335_A1,3,0,0,0,0,3
ACACTGGGACAGTCGT-1_V12D07-335_A1,0,0,2,0,0,2
TGTGTAGTAGCACGTG-1_V12D07-335_A1,3,0,0,0,0,3
CTAGCCACAGGCGAGC-1_V12D07-335_A1,2,0,0,0,0,2
CTATCGCGTAGAGAAC-1_V12D07-335_A1,0,0,6,2,1,9
GTTCCCGTAAACATAT-1_V12D07-335_A1,3,0,3,0,0,6
TCTTTCCTTCGAGATA-1_V12D07-335_A1,6,0,2,0,0,8
ATATTGGAGAGGCCTT-1_V12D07-335_A1,2,0,2,0,1,5
AGGCGATAACTGGCGT-1_V12D07-335_A1,3,0,1,0,0,4
ACCCGGAGCACCACAA-1_V12D07-335_A1,2,0,1,0,0,3
TGAGCTCAACTGTATA-1_V12D07-335_A1,3,0,4,0,0,7
ACGACCCATGAGTTGC-1_V12D07-335_A1,2,0,0,0,0,2
CGGTCAGTCCATATTT-1_V12D07-335_A1,7,0,1,0,0,8
TCCGGCTGTCGGGTCG-1_V12D07-335_A1,3,0,0,0,0,3
ATTCCCGAAGGTACAG-1_V12D07-335_A1,0,0,0,0,0,0
CTAACAGCACAATAAC-1_V12D07-335_A1,0,1,3,0,0,4
TTGTGCGGAAGCGGAT-1_V12D07-335_A1,0,0,4,4,0,8
GGGCACTATTGACCAT-1_V12D07-335_A1,0,0,1,0,0,1
CCATAGAGGCTGCCAG-1_V12D07-335_A1,0,0,1,3,0,4
CCGAAGCATTGACCAA-1_V12D07-335_A1,0,0,0,0,0,0
TACTGAGGGAAGAAAG-1_V12D07-335_A1,0,0,2,0,0,2
TATGTAGAAACCCGGC-1_V12D07-335_A1,1,0,3,1,0,5
TGGTTAACTTACATTT-1_V12D07-335_A1,0,0,2,0,0,2
AGAACCCTCAATTGGG-1_V12D07-335_A1,1,1,6,0,0,8
CCTATATCGTGTCACG-1_V12D07-335_A1,1,1,3,0,0,5
ACGGCTGGATGTAGAA-1_V12D07-335_A1,0,0,3,0,0,3
CTCGCATTGCATAGCC-1_V12D07-335_A1,0,2,2,0,0,4
ACTTTGGTCGTGCTCC-1_V12D07-335_A1,1,0,5,0,0,6
GCTGGTTTAGGCCATA-1_V12D07-335_A1,6,2,4,0,0,12
TGTCGTTATCACATAT-1_V12D07-335_A1,1,3,5,0,0,9
ACACATGATCAAATCT-1_V12D07-335_A1,0,1,4,0,0,5
TATCCATCTCGGTTAG-1_V12D07-335_A1,0,0,2,0,0,2
CTCGTCGAGGGCTCAT-1_V12D07-335_A1,0,4,1,0,0,5
ATCAATGCCGTGGCTG-1_V12D07-335_A1,0,1,5,0,0,6
GAAACATAGGAAACAG-1_V12D07-335_A1,0,1,1,0,0,2
TAATAGGTCACCAGAA-1_V12D07-335_A1,0,0,2,0,0,2
CACCAGTCAGCATGCA-1_V12D07-335_A1,0,0,2,0,0,2
GAGCGCTGTTAGGTAA-1_V12D07-335_A1,0,3,3,0,0,6
CCCTATGTAGAGCAGA-1_V12D07-335_A1,0,1,1,0,0,2
GATCGCTATATCTCAG-1_V12D07-335_A1,0,4,7,0,0,11
AAGGGACTATGCATTC-1_V12D07-335_A1,0,2,4,0,0,6
CTCGGGTTCTCTGGCC-1_V12D07-335_A1,0,2,1,0,0,3
TATATATCGAGAAATG-1_V12D07-335_A1,0,1,5,0,0,6
ACCCGAGCGAAATTAC-1_V12D07-335_A1,0,1,0,0,0,1
TTGTTTCATTAGTCTA-1_V12D07-335_A1,2,3,3,0,0,8
ATGGGACCTGCTGAAC-1_V12D07-335_A1,0,1,4,0,0,5
TGCGACGGCCGAACGT-1_V12D07-335_A1,1,0,1,0,0,2
AGCTAACAAGCAATGT-1_V12D07-335_A1,0,1,1,0,0,2
CGTGTCTCGTTACGAC-1_V12D07-335_A1,0,0,3,0,0,3
CTAAATCCGGTGTACA-1_V12D07-335_A1,0,0,2,0,0,2
GAATAGTGCTCGATTA-1_V12D07-335_A1,0,1,2,0,0,3
AACAATACATTGTCGA-1_V12D07-335_A1,0,1,3,0,0,4
CACATCGTGCACGCGC-1_V12D07-335_A1,1,1,2,0,0,4
ACCGTGACCACGTGGG-1_V12D07-335_A1,0,2,1,0,0,3
CCCAATGAGATTTGCA-1_V12D07-335_A1,2,4,1,0,0,7
TCAGCAGTAGGCCCTG-1_V12D07-335_A1,2,0,1,0,0,3
CTACTCAAGGTATAGT-1_V12D07-335_A1,1,0,0,0,0,1
TAGTAGCTTATACCAG-1_V12D07-335_A1,4,0,0,0,0,4
ACGTTCGTTCAGGAAA-1_V12D07-335_A1,2,1,3,0,0,6
TTAGAATAAGGGTCGG-1_V12D07-335_A1,0,0,0,0,0,0
TTCTAGAAAGTCTTAT-1_V12D07-335_A1,0,0,2,0,0,2
CCTTCAGTTAAAGTGA-1_V12D07-335_A1,3,1,0,0,0,4
TAGCTAGTGATGATGG-1_V12D07-335_A1,2,0,4,0,0,6
AGCCCGGTAGCCTGTA-1_V12D07-335_A1,2,0,3,0,0,5
TACCTCAGTTGTCTGT-1_V12D07-335_A1,2,0,2,0,0,4
GACGGGTTGGCCCGTA-1_V12D07-335_A1,2,1,0,2,0,5
GAAACCTATACAAATG-1_V12D07-335_A1,0,0,0,0,0,0
TCCACCTCTAGCCTTT-1_V12D07-335_A1,1,1,0,0,0,2
AAGACCCAACTGAACA-1_V12D07-335_A1,0,0,1,0,0,1
CATACACGGTTCCCAC-1_V12D07-335_A1,1,0,2,0,0,3
ACTACGCGTTAGAATT-1_V12D07-335_A1,1,0,2,0,0,3
CTTGGCCAAGCTGGGA-1_V12D07-335_A1,1,0,0,0,0,1
TTACCCTAGGGATTGG-1_V12D07-335_A1,2,0,0,1,0,3
TTCGCACTGTACGACA-1_V12D07-335_A1,1,0,1,1,0,3
TAGGTGTTCCACAGAT-1_V12D07-335_A1,1,0,0,0,0,1
GAAGCCTGCACATTCC-1_V12D07-335_A1,0,0,2,2,0,4
GGCTTTCAATAAGGGT-1_V12D07-335_A1,2,1,0,0,0,3
TCCAGGGTATATACGA-1_V12D07-335_A1,1,0,0,0,0,1
CTCGCCGAATGTAGGG-1_V12D07-335_A1,0,0,0,2,0,2
AGGAAGCTGTCCGCCG-1_V12D07-335_A1,1,2,0,1,0,4
GTCTCAAGGCCCGGCT-1_V12D07-335_A1,0,0,3,1,0,4
ACCGACACATCTCCCA-1_V12D07-335_A1,2,0,1,0,0,3
TATACGCGTCATCACT-1_V12D07-335_A1,0,1,2,0,0,3
ATCTGGGCTGTTCTTG-1_V12D07-335_A1,0,0,4,0,0,4
TCAAATTTGAGACTCA-1_V12D07-335_A1,1,2,3,2,0,8
GTTAAGGGTGCGATGT-1_V12D07-335_A1,1,0,0,2,0,3
AGCAAAGGCCGCTAGT-1_V12D07-335_A1,1,0,0,0,0,1
TTATAGGTAATTGTCT-1_V12D07-335_A1,0,0,1,0,0,1
TTGTGCAGCCACGTCA-1_V12D07-335_A1,1,0,3,0,0,4
ACGGACTCTCAAAGCG-1_V12D07-335_A1,0,0,0,0,0,0
ATGCTCTGGCGCGGTA-1_V12D07-335_A1,0,0,2,0,0,2
ATAATCTTGGAGAACC-1_V12D07-335_A1,0,0,0,0,0,0
CTCATTGCTCTAACAA-1_V12D07-335_A1,5,0,2,0,0,7
TAGGTGACGATAACCT-1_V12D07-335_A1,2,0,0,0,0,2
CGGATCCTCAAGGACT-1_V12D07-335_A1,0,0,0,0,0,0
GGGCGTGGTTTCCCAG-1_V12D07-335_A1,1,0,0,0,0,1
TGGCTATGTGACATAC-1_V12D07-335_A1,2,0,1,0,0,3
CTTAGTGTAGTAGCAT-1_V12D07-335_A1,4,0,1,0,0,5
GGATTGCTGTGACTCC-1_V12D07-335_A1,5,0,1,0,0,6
ACTTCCATGCGGGACA-1_V12D07-335_A1,1,0,0,0,0,1
ACTCAAGTGCAAGGCT-1_V12D07-335_A1,4,0,3,0,0,7
ACAAGGATGCTTTAGG-1_V12D07-335_A1,0,1,2,0,0,3
TTGAACGACGTGCTGA-1_V12D07-335_A1,2,0,1,0,0,3
ATTCATCGTTGAGGCA-1_V12D07-335_A1,1,0,0,0,0,1
TGCAACCCATCTGCGG-1_V12D07-335_A1,2,0,0,0,0,2
AGTGCTAAACACAGCA-1_V12D07-335_A1,1,1,3,0,0,5
AACTCCAGAGCGTGTT-1_V12D07-335_A1,1,0,1,0,0,2
TCTCCACAAGTTGAAT-1_V12D07-335_A1,1,0,1,0,0,2
CTTTGCATCGCTCTTG-1_V12D07-335_A1,0,1,3,0,0,4
TCACAAACCGAGGTAC-1_V12D07-335_A1,1,0,2,0,0,3
CCGTAGGAAATCCCTG-1_V12D07-335_A1,2,0,1,0,0,3
AAACATTTCCCGGATT-1_V12D07-335_A1,2,0,1,0,0,3
GCCTCCGACAATTCAC-1_V12D07-335_A1,3,3,0,0,0,6
TCTGCATACCTTGCTT-1_V12D07-335_A1,0,0,0,0,1,1
ACCCATTTGTCCCTCT-1_V12D07-335_A1,5,0,1,0,0,6
CTGCAGAGAATCAGAG-1_V12D07-335_A1,2,0,0,0,0,2
GGAAACTAAATGGGCC-1_V12D07-335_A1,2,0,3,0,0,5
CAACCTACCGAGCAGT-1_V12D07-335_A1,4,0,3,0,1,8
CCGTAGGGTTGTTTAC-1_V12D07-335_A1,0,0,2,0,0,2
GGTTTGTGACCTGAGG-1_V12D07-335_A1,0,0,0,0,0,0
TAACCTAGGGAGTCCA-1_V12D07-335_A1,1,0,0,0,0,1
TTCCATCGACAGCGTG-1_V12D07-335_A1,1,0,2,0,0,3
ATCTCCCACGGAATAT-1_V12D07-335_A1,0,1,1,0,0,2
GTTTCAAACGAGTTGT-1_V12D07-335_A1,1,0,2,0,0,3
GGAACTTTGGCGATTA-1_V12D07-335_A1,2,2,4,0,0,8
CTGCAAGCACGTTCCG-1_V12D07-335_A1,2,0,2,0,0,4
CACAGTCCCGCTTCGC-1_V12D07-335_A1,0,0,2,0,0,2
TACGCTCGGTATTGGA-1_V12D07-335_A1,3,0,0,0,0,3
CTGGTAAAGTGTGGGC-1_V12D07-335_A1,3,0,2,0,0,5
CAACCAGTGGCCTACC-1_V12D07-335_A1,1,1,4,0,0,6
TCTTCGCGGTGAGAGG-1_V12D07-335_A1,1,1,0,0,0,2
TTCGGGTTGCCACGGG-1_V12D07-335_A1,1,0,1,0,0,2
ACCGATAGGCATAACC-1_V12D07-335_A1,1,0,0,0,0,1
CTTATAGATGGCTGTT-1_V12D07-335_A1,2,0,1,0,0,3
AGACGCCCACTTCGCC-1_V12D07-335_A1,0,0,2,0,0,2
AGGTCGCCTCCCAACA-1_V12D07-335_A1,2,0,1,0,1,4
CCTCACGTCAGCTAAT-1_V12D07-335_A1,2,0,2,0,0,4
CCACCTGTATGGAATA-1_V12D07-335_A1,1,0,0,0,0,1
GGACTCGAAGCTTTCA-1_V12D07-335_A1,1,0,0,0,0,1
AAGCCGGAGAGCAGGA-1_V12D07-335_A1,1,0,2,0,0,3
GCCTATCAGGTAAGAT-1_V12D07-335_A1,4,0,0,0,0,4
TCAGAGTGTGAGCATG-1_V12D07-335_A1,1,0,1,0,0,2
AAACATGGTGAGAGGA-1_V12D07-335_A1,0,0,3,0,0,3
ATCATTGTACCGCATT-1_V12D07-335_A1,0,0,1,0,0,1
TCAGCTTGAGCTTTCG-1_V12D07-335_A1,1,0,0,0,0,1
CCGCGCAAGATACCCA-1_V12D07-335_A1,0,0,2,0,0,2
CTATACTTAAAGCGAG-1_V12D07-335_A1,0,0,0,0,0,0
ACCGTCCACTGGGCCC-1_V12D07-335_A1,0,0,0,0,0,0
AAGACCAAATAACTCA-1_V12D07-335_A1,0,1,1,0,0,2
TGTTTCTGAAGCGTGC-1_V12D07-335_A1,0,0,5,0,0,5
TTCTCTTACAGGTGAT-1_V12D07-335_A1,0,0,5,0,0,5
AATTCATTGTCATGCA-1_V12D07-335_A1,3,0,4,0,0,7
GCCCGAGAGTCTAAAT-1_V12D07-335_A1,1,1,3,0,0,5
ATATAGAGTATTGGTC-1_V12D07-335_A1,0,0,3,0,0,3
TTGAAGGATGGGCGCC-1_V12D07-335_A1,1,1,5,0,0,7
TAGTACCACAACTTTC-1_V12D07-335_A1,1,0,4,0,0,5
ATCCCATCCACAGCGC-1_V12D07-335_A1,0,1,5,0,0,6
CTTAGGTATAGACCAG-1_V12D07-335_A1,0,1,3,0,0,4
TGACTCCGAATCATAC-1_V12D07-335_A1,0,2,3,0,0,5
ACTACATCCCGACAAG-1_V12D07-335_A1,0,1,3,0,0,4
TTGCCGCAGACCTACA-1_V12D07-335_A1,0,4,5,0,0,9
TAAGAGGGACAGGGAC-1_V12D07-335_A1,1,2,7,0,0,10
CGAATGAAGTCATTGC-1_V12D07-335_A1,0,2,0,0,0,2
AAGGGAACGACTGGCT-1_V12D07-335_A1,0,2,3,1,0,6
CGAATCTGCTCGACGC-1_V12D07-335_A1,0,5,5,0,0,10
ATCGTGGAAAGTCTGG-1_V12D07-335_A1,1,1,4,0,0,6
CCTATGGCTCCTAGTG-1_V12D07-335_A1,0,3,1,0,0,4
CGTCGCTTGGTTATAC-1_V12D07-335_A1,1,1,5,0,0,7
TGCTTAGAGAGAATGC-1_V12D07-335_A1,0,3,2,0,0,5
GATTGCTCCAGTTGCA-1_V12D07-335_A1,0,4,2,0,0,6
CGTGCTTCTACCTAAA-1_V12D07-335_A1,2,2,1,0,0,5
ACTCCAATATCATCAT-1_V12D07-335_A1,0,2,1,0,0,3
GCCGACCCACGACTGC-1_V12D07-335_A1,0,1,5,0,0,6
GAGGGTAGTAACAAAG-1_V12D07-335_A1,1,2,0,0,0,3
GGCCGAGACTCTGGTG-1_V12D07-335_A1,0,1,3,0,0,4
TATATAGGGCTTTACG-1_V12D07-335_A1,0,2,2,0,0,4
TGCCGGATGTACGAGC-1_V12D07-335_A1,0,0,1,0,0,1
AGGTAGATCGAGATAT-1_V12D07-335_A1,0,0,4,0,0,4
GATCAACATAAAGGGA-1_V12D07-335_A1,0,1,3,0,0,4
TAACAGCGTTTGTGCT-1_V12D07-335_A1,0,2,0,0,0,2
CTATAGGCGTTGATGT-1_V12D07-335_A1,0,0,1,0,0,1
GGTTTAATTACCATCG-1_V12D07-335_A1,1,1,0,0,0,2
CTCTTCTGGAAGTTAG-1_V12D07-335_A1,2,0,0,0,0,2
ATCTGACATGGAAGGA-1_V12D07-335_A1,5,1,2,0,0,8
TACGTACTAGTGCTGA-1_V12D07-335_A1,2,2,1,0,0,5
ATGACTATCAGCTGTG-1_V12D07-335_A1,1,0,1,0,0,2
CTTTGGGATTGTTGCA-1_V12D07-335_A1,1,0,0,0,0,1
AGACTGTTACCGGGTC-1_V12D07-335_A1,3,1,0,0,0,4
TCCTAACCGTCGGGCA-1_V12D07-335_A1,2,0,2,0,0,4
ACGCAAACTAATAGAT-1_V12D07-335_A1,4,0,1,0,0,5
AAGTGAGTCGGGTTTA-1_V12D07-335_A1,1,0,3,0,0,4
TAAAGCGGTATTTCCA-1_V12D07-335_A1,4,2,1,0,0,7
CTCCTCCAGCTCACAC-1_V12D07-335_A1,1,0,0,0,0,1
CGGTCCGTCGCAAGCC-1_V12D07-335_A1,1,0,0,0,0,1
CCTATATTTGTCCTGG-1_V12D07-335_A1,1,1,0,0,0,2
TCCAATAAAGGCTACC-1_V12D07-335_A1,1,2,0,0,0,3
AAAGGCTACGGACCAT-1_V12D07-335_A1,2,0,1,0,0,3
CGTGACCAGTCCTCTG-1_V12D07-335_A1,3,0,1,0,0,4
GATCTGCTATCTAAGG-1_V12D07-335_A1,0,0,1,0,0,1
CGAATGACGCATAATG-1_V12D07-335_A1,0,0,3,0,0,3
GCTCAATGTAATACCG-1_V12D07-335_A1,0,0,1,0,0,1
CTATGCCCGAATGCAA-1_V12D07-335_A1,0,0,1,0,0,1
CACAGGGCCGTTGTCA-1_V12D07-335_A1,0,0,1,0,0,1
TCAATACGCCGTCATG-1_V12D07-335_A1,0,0,2,0,2,4
AGCGGACACTTCGTAG-1_V12D07-335_A1,0,0,1,0,0,1
ATACGTTATGCACGGA-1_V12D07-335_A1,1,1,0,2,0,4
GAGTAGATACTAGTTG-1_V12D07-335_A1,1,0,2,0,0,3
CCAGCTCGAACGCATT-1_V12D07-335_A1,0,1,1,0,0,2
TGCTTCCCAAGCAGTA-1_V12D07-335_A1,1,0,3,1,0,5
GTAGACACGCCTGACT-1_V12D07-335_A1,1,1,1,0,0,3
CTCACATTTACTAAAT-1_V12D07-335_A1,0,1,0,1,0,2
GAATGCGAATCGGTTC-1_V12D07-335_A1,0,1,1,1,0,3
TAAGGCCCGTCACCCT-1_V12D07-335_A1,0,1,1,1,0,3
GAGTATGCGCGTGCAT-1_V12D07-335_A1,0,0,2,3,0,5
ATCCACATCGACAGAA-1_V12D07-335_A1,0,2,1,0,0,3
TAGACGAAACGCCAAT-1_V12D07-335_A1,1,0,1,1,0,3
CAGCAGTCTGTGCTGC-1_V12D07-335_A1,0,1,1,1,0,3
CTCACTGTGATACTTA-1_V12D07-335_A1,0,0,2,0,0,2
TTAATTGCTTTGGGTG-1_V12D07-335_A1,2,0,2,0,0,4
GTAGTCTACGATATTG-1_V12D07-335_A1,1,2,2,0,0,5
TTGCCGCTTTCTAGTA-1_V12D07-335_A1,0,0,1,0,0,1
GAACCTTTAACGATCC-1_V12D07-335_A1,0,0,1,0,0,1
TGGACCAATCTAAGAT-1_V12D07-335_A1,1,0,2,0,0,3
CTAGTAGAAAGGGATT-1_V12D07-335_A1,0,0,0,0,0,0
AACCTCGCTTTAGCCC-1_V12D07-335_A1,1,1,1,0,0,3
GAGTGTCAACCAGAAA-1_V12D07-335_A1,0,0,0,1,0,1
GTGATCCTTGTCATGA-1_V12D07-335_A1,4,0,1,0,0,5
CTCAACTAACCCGGAT-1_V12D07-335_A1,2,0,1,0,0,3
AGTGGCGTCTGAAGGT-1_V12D07-335_A1,2,0,1,0,0,3
GGGAAGGGCTTTCTCA-1_V12D07-335_A1,1,0,0,0,0,1
AGGCCTGAGAATCTCG-1_V12D07-335_A1,1,0,0,0,0,1
AGCCACAGGTTACCCG-1_V12D07-335_A1,5,0,1,0,0,6
TGCAATCTAACACGGT-1_V12D07-335_A1,1,0,1,0,0,2
GTTTGGGTTTCGCCCG-1_V12D07-335_A1,2,0,1,0,0,3
CCTATGTCCACTCCAC-1_V12D07-335_A1,0,0,1,0,0,1
CTGCCTTTCTAGTAAA-1_V12D07-335_A1,1,0,0,0,0,1
TTAGTAAACCTGCTCT-1_V12D07-335_A1,5,0,2,0,0,7
TTGTGGTGGTACTAAG-1_V12D07-335_A1,2,1,4,0,0,7
CCTCCTGTTGTGTCGT-1_V12D07-335_A1,0,0,1,0,0,1
ACAAAGCATGACCTAG-1_V12D07-335_A1,2,0,2,0,0,4
ATAGCAACTAGGGAAG-1_V12D07-335_A1,3,1,0,0,0,4
CCGCTCTTCCGAACTA-1_V12D07-335_A1,2,0,2,0,0,4
TAGAATAGCCGATGAA-1_V12D07-335_A1,1,0,1,0,0,2
GGTCTCCGTCCAGGTT-1_V12D07-335_A1,3,1,4,0,0,8
TAATTACGTCAGTAGA-1_V12D07-335_A1,6,0,0,0,0,6
TACGTAAAGCGGAGTG-1_V12D07-335_A1,1,0,1,0,0,2
GCTACAATCGAGGATA-1_V12D07-335_A1,2,1,1,0,0,4
TCAGCCAATCCGTAAA-1_V12D07-335_A1,1,0,0,0,0,1
ATCATAGCCCTATGTA-1_V12D07-335_A1,2,0,1,0,0,3
GAGGCCTGTTGATACA-1_V12D07-335_A1,1,0,0,0,0,1
ATATACGCTCGTGACG-1_V12D07-335_A1,1,0,0,0,0,1
CCCTTTAATGGAGTTC-1_V12D07-335_A1,3,0,1,0,0,4
TTACACGATCTGCGAC-1_V12D07-335_A1,6,0,1,0,0,7
TCGCATAAAGGGCGCA-1_V12D07-335_A1,2,0,2,0,0,4
TGTAGCCATCCCATTC-1_V12D07-335_A1,2,0,1,0,0,3
GGGTCTATCGCTTTCC-1_V12D07-335_A1,2,0,3,0,0,5
GGAGGGTCAAGTAAGA-1_V12D07-335_A1,1,0,0,0,0,1
TACGGCATGGACGCTA-1_V12D07-335_A1,2,0,0,0,0,2
CACGTCAATCAATGGA-1_V12D07-335_A1,1,0,1,0,0,2
CGCTTGGACGGATAGA-1_V12D07-335_A1,2,0,0,0,0,2
CGCGGTACGGTATACA-1_V12D07-335_A1,1,0,1,0,0,2
CCTACTCAACACGATT-1_V12D07-335_A1,2,0,3,0,0,5
CGTTTGGTGTTGTGGG-1_V12D07-335_A1,3,0,0,0,0,3
GTTGTTGCAAGATGGC-1_V12D07-335_A1,3,0,1,0,0,4
CATTCGTCGTAGCGGT-1_V12D07-335_A1,2,0,0,0,0,2
CAGCCTCGATAGCGGT-1_V12D07-335_A1,3,0,1,0,0,4
TCATAAGTCCAAGAAG-1_V12D07-335_A1,4,0,2,0,0,6
AAAGTGCCATCAATTA-1_V12D07-335_A1,2,0,2,0,1,5
GTTGCAGTCGACAACA-1_V12D07-335_A1,1,1,3,0,0,5
TAAATGGGCTACTGAG-1_V12D07-335_A1,3,0,0,0,0,3
GGACAAGCCATGATCG-1_V12D07-335_A1,1,1,1,0,0,3
TCCAATGCGTCGCCGC-1_V12D07-335_A1,1,0,4,0,0,5
AAAGAATGACCTTAGA-1_V12D07-335_A1,0,0,1,0,0,1
CCTATTATTCCGGCCG-1_V12D07-335_A1,2,0,1,0,0,3
CAGTAAGGGACGTCTC-1_V12D07-335_A1,0,0,1,0,0,1
GGGATGGACCCGCGTC-1_V12D07-335_A1,0,0,2,0,0,2
GACGCATACCCGTCGG-1_V12D07-335_A1,0,0,0,0,0,0
GGGCAGGATTTCTGTG-1_V12D07-335_A1,0,0,1,0,0,1
TATCTGAGCCGATATT-1_V12D07-335_A1,0,1,2,0,0,3
AATGTATGGCACTGTA-1_V12D07-335_A1,0,0,1,0,0,1
GCCTTTGTCAGTGGAC-1_V12D07-335_A1,0,0,4,0,0,4
AACCATAGGGTTGAAC-1_V12D07-335_A1,0,0,1,0,0,1
AAACTTAATTGCACGC-1_V12D07-335_A1,0,0,6,0,0,6
TAGGCGGCTGCAAAGA-1_V12D07-335_A1,0,1,1,0,0,2
TCCATCAATACTAATC-1_V12D07-335_A1,0,2,0,0,0,2
ACCTCGAACTTATGCT-1_V12D07-335_A1,0,1,3,0,0,4
ACAAACCATGCGTCCT-1_V12D07-335_A1,0,1,5,0,0,6
ACACCGGTCTGACCGC-1_V12D07-335_A1,0,0,3,0,0,3
ATGGCAGCATTACGAT-1_V12D07-335_A1,0,1,2,1,0,4
CTGGTGAATGGGCCTA-1_V12D07-335_A1,0,0,5,0,0,5
CACAGAGACGAGGACG-1_V12D07-335_A1,0,1,1,0,0,2
GCACAAACCCTAGATG-1_V12D07-335_A1,1,1,1,1,0,4
ACTATGTCCAGCTGCC-1_V12D07-335_A1,0,1,5,0,0,6
AAGCCGCCGTGAAATC-1_V12D07-335_A1,1,3,0,0,0,4
ATGGGTGTATACCTCC-1_V12D07-335_A1,0,2,3,0,0,5
TAAGCGCGAATCAAAT-1_V12D07-335_A1,0,2,2,0,0,4
AGCCCGGCATTAGAGG-1_V12D07-335_A1,0,1,3,0,0,4
GTGATCAAGCGTGCAC-1_V12D07-335_A1,0,1,2,0,0,3
CTGCCTTTAATACCTT-1_V12D07-335_A1,0,1,2,0,0,3
TACCTCCACACCAATG-1_V12D07-335_A1,2,0,3,0,0,5
GAGCATCAACAACTTG-1_V12D07-335_A1,0,1,0,0,0,1
CATACGAACTAGCTGG-1_V12D07-335_A1,0,1,3,0,0,4
GGGAACGGTTTCAGAT-1_V12D07-335_A1,0,2,2,0,0,4
AGGGTGCCGTTCTTTA-1_V12D07-335_A1,0,1,0,0,0,1
ACGACTGGTCATACTC-1_V12D07-335_A1,0,0,7,0,0,7
GGATCTTACTGCCCTT-1_V12D07-335_A1,1,0,1,0,0,2
TACTCCTCTAGTTGAC-1_V12D07-335_A1,0,2,4,0,0,6
GTAGCTCCGGGAGGCT-1_V12D07-335_A1,1,0,1,0,0,2
GGACTCGTGAGTGGTC-1_V12D07-335_A1,1,2,1,0,0,4
GTAGTTCGAAGGCGAA-1_V12D07-335_A1,0,2,2,0,0,4
CTCAAACCACTGCCCG-1_V12D07-335_A1,2,0,0,0,0,2
GAGGGAGTCAGATCGC-1_V12D07-335_A1,2,2,0,0,0,4
GCGTCCCTAAGACATA-1_V12D07-335_A1,1,1,1,0,0,3
TCTCTTACCGCGAACC-1_V12D07-335_A1,2,1,1,0,0,4
GGCTACTATACACTCC-1_V12D07-335_A1,3,0,1,0,0,4
CGTTGCCCGCGTGGGA-1_V12D07-335_A1,2,1,2,0,0,5
TATAGAGTCGCTTGAA-1_V12D07-335_A1,0,0,1,0,0,1
ATGTTGTAGTCTGTTT-1_V12D07-335_A1,2,1,2,0,0,5
AGTATACACAGCGACA-1_V12D07-335_A1,1,4,0,0,0,5
TGTGGTTGCTAAAGCT-1_V12D07-335_A1,0,3,0,0,0,3
TGATTCCCGGTTACCT-1_V12D07-335_A1,2,1,0,0,0,3
CACTGACGATTGTGGA-1_V12D07-335_A1,3,0,1,0,0,4
AACATTGTGACTCGAG-1_V12D07-335_A1,2,0,3,0,0,5
GTCCAATATTTAGCCT-1_V12D07-335_A1,1,0,0,0,0,1
GCTCTTTCCGCTAGTG-1_V12D07-335_A1,2,0,0,0,0,2
GGGTCAGGAGCTAGAT-1_V12D07-335_A1,4,0,1,0,0,5
AGGTGGTGACCTTCGC-1_V12D07-335_A1,1,0,2,0,0,3
CCCGGGTCGTTCAGGG-1_V12D07-335_A1,1,1,0,0,0,2
AGCCAAGCTTTGTGTC-1_V12D07-335_A1,4,0,2,0,0,6
TGTGGCGGGCTTCTGG-1_V12D07-335_A1,0,0,1,0,2,3
CGAGGGTATCCAGGTG-1_V12D07-335_A1,0,0,0,0,0,0
CGTTCAGACCCGCGAA-1_V12D07-335_A1,0,0,0,0,1,1
TCATATGAGCTTTGTT-1_V12D07-335_A1,0,1,1,0,0,2
AGTTGACGGTCCTTGC-1_V12D07-335_A1,0,0,0,0,0,0
ATAATTAGCTAAGTAG-1_V12D07-335_A1,1,0,1,0,0,2
GGTCTTGAGCGCTCTT-1_V12D07-335_A1,0,0,1,1,0,2
CGTTGTCGGCAATTGA-1_V12D07-335_A1,0,0,1,0,0,1
TCTTGCTCCCGATACT-1_V12D07-335_A1,2,0,1,2,0,5
AGCAGAAGGAGAAAGA-1_V12D07-335_A1,2,2,2,2,0,8
GAAGCCACTGATTATG-1_V12D07-335_A1,0,0,1,1,0,2
TGCTCTTGAGAGTTTG-1_V12D07-335_A1,1,0,2,0,0,3
GACATCCGTCGAACTG-1_V12D07-335_A1,0,0,1,2,0,3
AGATATAATACGACTA-1_V12D07-335_A1,2,1,2,2,0,7
TCGCTACTGGCTTTGA-1_V12D07-335_A1,0,0,1,1,0,2
GTGACAGCTTCCCACT-1_V12D07-335_A1,1,0,0,0,0,1
GTGACGCAGGTTTCAT-1_V12D07-335_A1,0,4,1,1,0,6
GGGAAGACGGTCTGTC-1_V12D07-335_A1,0,1,1,0,0,2
CGTCGCATGTGAGCCA-1_V12D07-335_A1,1,0,0,1,0,2
AGAAGGTTGTAGGTCG-1_V12D07-335_A1,1,0,1,0,0,2
GGCCGGCGTCTGCTAT-1_V12D07-335_A1,1,0,0,0,0,1
TTGACCAGGAACAACT-1_V12D07-335_A1,0,0,0,0,0,0
AGTCGTATAAAGCAGA-1_V12D07-335_A1,0,0,3,0,0,3
GGCGTAGGGAAAGCTG-1_V12D07-335_A1,3,0,1,0,0,4
AAACCTAAGCAGCCGG-1_V12D07-335_A1,0,0,1,0,0,1
ATTGCCTTTATGTTTG-1_V12D07-335_A1,2,0,0,0,0,2
CAGGCAGTCTTACCAG-1_V12D07-335_A1,0,0,0,0,0,0
AGCTAAGTACGCAGGC-1_V12D07-335_A1,3,0,2,0,0,5
AAATCCGATACACGCC-1_V12D07-335_A1,2,0,1,0,0,3
CGAGAGCTTTCACTAC-1_V12D07-335_A1,3,0,0,0,0,3
CGCCCAGCGTTTCACG-1_V12D07-335_A1,0,0,0,0,0,0
TTAAGTATTGTTATCC-1_V12D07-335_A1,1,0,0,0,0,1
AAACGGGCGTACGGGT-1_V12D07-335_A1,1,0,0,0,0,1
GTATCCTTTGGTAACC-1_V12D07-335_A1,0,0,0,0,0,0
CATAGTCAAATACATA-1_V12D07-335_A1,2,0,3,0,0,5
TCTATGCTATAACGAC-1_V12D07-335_A1,1,0,0,0,0,1
ACGTTCTGTACAAGTC-1_V12D07-335_A1,3,0,1,0,0,4
CGCGAAGTGGCATACT-1_V12D07-335_A1,4,0,1,0,0,5
ACCAACCGCACTCCAC-1_V12D07-335_A1,0,1,0,0,0,1
GTCATGCGCGAGGGCT-1_V12D07-335_A1,1,0,1,0,0,2
TAGGCTAAAGTGGCAC-1_V12D07-335_A1,3,0,2,0,0,5
TGGCTACACTCTACCT-1_V12D07-335_A1,2,0,0,0,0,2
TGTCCACGGCTCAACT-1_V12D07-335_A1,4,1,2,0,0,7
AATTGCAGCAATCGAC-1_V12D07-335_A1,5,2,0,0,0,7
GTCAACCAGGCCTATA-1_V12D07-335_A1,3,0,1,0,0,4
ATCTTATCGCACACCC-1_V12D07-335_A1,5,0,0,0,0,5
GTCTATTGCATGCTCG-1_V12D07-335_A1,4,0,0,0,0,4
GCACGTGGTTTACTTA-1_V12D07-335_A1,3,0,2,0,0,5
ATTCGCGCCTTGAGAG-1_V12D07-335_A1,0,0,0,0,0,0
AGCGATGCGCCTAATA-1_V12D07-335_A1,1,0,2,0,0,3
TCTATAGGTGGGTAAT-1_V12D07-335_A1,0,0,0,0,0,0
AGATACCAATAGAACC-1_V12D07-335_A1,6,0,1,0,0,7
CGTGTATGGGAGCTGA-1_V12D07-335_A1,6,0,0,1,0,7
ATGTACATGCGGTGAG-1_V12D07-335_A1,0,0,3,0,0,3
TTGGCTCAATATGTGT-1_V12D07-335_A1,3,1,3,0,0,7
GTTCGGAGCACTCAAC-1_V12D07-335_A1,2,0,2,0,0,4
TCCCTCTTCTCAAGGG-1_V12D07-335_A1,2,0,1,0,0,3
TTACGTATCTATGACA-1_V12D07-335_A1,0,0,0,0,0,0
CCCATATAGGTCGATT-1_V12D07-335_A1,0,0,3,0,1,4
GTCCACGTCGCATTCG-1_V12D07-335_A1,2,0,1,0,0,3
AATTGTGGTTGCCAAA-1_V12D07-335_A1,9,0,0,0,0,9
AGGAACGAACGACTTC-1_V12D07-335_A1,5,0,2,0,0,7
TAATTCCAATGCTTCA-1_V12D07-335_A1,0,0,2,0,0,2
AGGGCCCTAATGTTCT-1_V12D07-335_A1,0,0,2,0,0,2
AGGTGTTGCCGACCAC-1_V12D07-335_A1,4,0,0,0,0,4
CTGAGAGTAGAAATAC-1_V12D07-335_A1,4,0,1,0,0,5
TAGAAGAAGGGTTACA-1_V12D07-335_A1,3,0,2,0,0,5
GGTGACTGATAGAGAG-1_V12D07-335_A1,0,0,3,0,0,3
TACCCTCGGTAACCCT-1_V12D07-335_A1,3,0,1,0,0,4
TGTAAGACTGATAAGA-1_V12D07-335_A1,3,0,1,0,0,4
GTCACTCATGAGCGAT-1_V12D07-335_A1,1,0,1,0,0,2
CGGTTTACTGAACATT-1_V12D07-335_A1,0,0,3,0,0,3
GAGATCGATCTTACTC-1_V12D07-335_A1,1,0,0,0,0,1
TCTTTCATCCGTCCTT-1_V12D07-335_A1,0,0,1,0,0,1
TCGGATCTGGATGACC-1_V12D07-335_A1,2,1,4,0,0,7
GTCCTAGGATACCTTA-1_V12D07-335_A1,0,0,1,0,0,1
TGTACCCGACCCTAAT-1_V12D07-335_A1,2,1,2,0,0,5
AGGTTCTCCTTTCCGG-1_V12D07-335_A1,0,0,0,0,0,0
AATTGCGTGGATTACA-1_V12D07-335_A1,0,0,1,0,0,1
CGATAGCGATACAGTG-1_V12D07-335_A1,0,0,1,0,0,1
CGCCCTAATTGTTCAA-1_V12D07-335_A1,0,0,0,0,0,0
ATTATGAGACCCAATT-1_V12D07-335_A1,0,0,3,0,0,3
CCTCCTAGCTAGAGTC-1_V12D07-335_A1,1,0,3,0,0,4
CGAAGGGTTTCAGATT-1_V12D07-335_A1,0,0,2,0,0,2
CACAAGCTAAGAAAGG-1_V12D07-335_A1,0,0,1,0,0,1
CACCGGTAGAGACATT-1_V12D07-335_A1,0,0,5,0,0,5
ACTCATGGCAGCCTTC-1_V12D07-335_A1,1,0,2,0,0,3
CATCCAATATAGTTTG-1_V12D07-335_A1,0,0,7,0,0,7
CAGATATGAAGATGAC-1_V12D07-335_A1,0,1,8,0,0,9
GCAAAGGGCGTTAGCC-1_V12D07-335_A1,0,1,5,0,0,6
CTGTTGTTCAGTCGTA-1_V12D07-335_A1,0,2,3,0,0,5
AAAGGCCCTATAATAC-1_V12D07-335_A1,0,0,3,0,0,3
AACATTGAAGTTGATC-1_V12D07-335_A1,0,0,3,0,0,3
GCTAGCGATAGGTCTT-1_V12D07-335_A1,3,1,3,0,0,7
ATTGCCTATTAGACCG-1_V12D07-335_A1,1,1,3,0,0,5
GGGCGTTTACATTCAT-1_V12D07-335_A1,0,1,4,0,0,5
CCTCTACAAGGATTGG-1_V12D07-335_A1,0,1,0,0,0,1
AGTGACTGTGACACAA-1_V12D07-335_A1,0,0,6,0,0,6
AGCCCTCCCTGGTGGC-1_V12D07-335_A1,0,0,5,0,0,5
CGGTTGAGTATCCTTC-1_V12D07-335_A1,0,3,3,0,0,6
CATTATCCCATTAACG-1_V12D07-335_A1,0,2,2,0,0,4
AATGTGCTAATCTGAG-1_V12D07-335_A1,1,0,1,0,0,2
CTTAGTTGAGGAATCG-1_V12D07-335_A1,0,0,1,0,0,1
CTTCTGGGCGTACCTA-1_V12D07-335_A1,0,2,6,0,0,8
AGTCAAATGATGTGAT-1_V12D07-335_A1,0,1,3,0,0,4
TGAACAAGCAGGGACT-1_V12D07-335_A1,3,3,1,0,0,7
AATACCGGAGGGCTGT-1_V12D07-335_A1,1,3,1,0,0,5
GTTTGGTGATCGGTGC-1_V12D07-335_A1,1,0,2,0,0,3
GACTGCTGGTGAGAAA-1_V12D07-335_A1,1,1,1,0,0,3
CGATCCTCGCAACATA-1_V12D07-335_A1,1,0,1,0,0,2
CCAACCTTATGTAACT-1_V12D07-335_A1,3,1,0,0,0,4
CGTGGTACCCAAAGGC-1_V12D07-335_A1,2,0,1,0,0,3
AACCCGACAACCCGTG-1_V12D07-335_A1,1,1,1,0,0,3
TATGTAAAGTGCTTAA-1_V12D07-335_A1,2,0,0,0,0,2
GCAAGTGTAAAGCATG-1_V12D07-335_A1,3,2,0,0,0,5
GTAACTGCCCAAGGAG-1_V12D07-335_A1,2,0,1,0,0,3
GGTGCATAAATGATTA-1_V12D07-335_A1,4,2,1,0,2,9
TAGTCCCGGAGACCAC-1_V12D07-335_A1,2,2,0,0,1,5
CGGCCAGAGCGACCAT-1_V12D07-335_A1,2,2,1,0,0,5
TGAATGAGTGTTTCCC-1_V12D07-335_A1,1,1,0,0,2,4
TTCACTTCCTAGAACG-1_V12D07-335_A1,1,0,1,0,0,2
CGCTTAGTATTGATAC-1_V12D07-335_A1,0,0,0,0,0,0
AACGCGACCTTGGGCG-1_V12D07-335_A1,2,1,2,0,0,5
GTGCACCAGCTTCAAC-1_V12D07-335_A1,1,0,0,0,0,1
TTCTATTAAACGCAGC-1_V12D07-335_A1,2,0,2,0,0,4
TGGCAAGCACAAGTCG-1_V12D07-335_A1,3,0,0,0,0,3
ATCTGCTGTTATCGCC-1_V12D07-335_A1,2,0,0,0,0,2
AATTCCAAGCATGTAC-1_V12D07-335_A1,3,0,0,0,0,3
AAACGGTTGCGAACTG-1_V12D07-335_A1,1,1,2,0,0,4
GAAGGAGTCGAGTGCG-1_V12D07-335_A1,2,0,1,0,0,3
GGCAAGCCCATAGTGG-1_V12D07-335_A1,0,0,0,0,0,0
TGACCAAATCTTAAAC-1_V12D07-335_A1,2,0,1,0,1,4
TTCGGTACTGTAGAGG-1_V12D07-335_A1,0,0,0,0,0,0
ATGTACGATGACGTCG-1_V12D07-335_A1,0,0,2,0,0,2
ATCTAGCTTGTGAGGG-1_V12D07-335_A1,1,1,1,0,0,3
AGCGGGTCTGACACTC-1_V12D07-335_A1,0,0,3,0,0,3
GAGGTACGCGTGTCCC-1_V12D07-335_A1,0,0,0,1,0,1
GCACTGCCTACCTTTA-1_V12D07-335_A1,4,1,3,0,0,8
GGAGCGAGGCCTACTT-1_V12D07-335_A1,2,1,1,0,0,4
AAACTCGGTTCGCAAT-1_V12D07-335_A1,4,0,0,0,0,4
GGCGCTTCATTCCCTG-1_V12D07-335_A1,0,0,0,1,0,1
TGCTCGGTGGGTCACC-1_V12D07-335_A1,1,0,1,1,0,3
AAGCGCAGGGCTTTGA-1_V12D07-335_A1,1,0,1,1,0,3
GACCTTCCACGTCTAC-1_V12D07-335_A1,2,0,2,2,0,6
GTTAGCCCATGACATC-1_V12D07-335_A1,0,0,2,3,0,5
AATTCGATTCGAGGAT-1_V12D07-335_A1,1,0,2,1,0,4
AGTCTTTAAAGTGTCC-1_V12D07-335_A1,0,0,0,1,0,1
GACTAGGCCGTTAGGT-1_V12D07-335_A1,1,0,1,1,0,3
TCCAAGCCTAGACACA-1_V12D07-335_A1,1,0,0,1,0,2
GATTGGGAAAGGTTGT-1_V12D07-335_A1,1,0,3,1,1,6
GATGAGGAACCTTCGG-1_V12D07-335_A1,1,0,1,0,0,2
TGAATACCGACGCGTA-1_V12D07-335_A1,1,0,3,0,0,4
AATCGTGAGCCGAGCA-1_V12D07-335_A1,0,0,0,0,0,0
GCGAAGAATCTGACGG-1_V12D07-335_A1,1,2,0,0,0,3
GAACAACTGGGATGAA-1_V12D07-335_A1,0,0,1,1,0,2
TCGCCGACATATTCGC-1_V12D07-335_A1,0,0,1,0,0,1
CGTAGAGAGTAATTAT-1_V12D07-335_A1,2,0,0,0,0,2
CGATAGTCGTACTGCA-1_V12D07-335_A1,0,0,1,0,0,1
CGCATGCCGAATGCGT-1_V12D07-335_A1,1,0,4,0,0,5
CTCTAGCCCTCGGAAA-1_V12D07-335_A1,0,0,1,0,0,1
TCCAACTCAGCTATCT-1_V12D07-335_A1,0,0,1,0,0,1
GTCTAGTGAGCCGCTT-1_V12D07-335_A1,3,0,1,0,0,4
TACCGAATAATTGTAA-1_V12D07-335_A1,2,0,2,0,0,4
ATATAACACGGGCGCA-1_V12D07-335_A1,1,1,1,0,1,4
GCATGCTAATAACGAT-1_V12D07-335_A1,1,0,1,0,0,2
TCCGGGCTTGACGGGA-1_V12D07-335_A1,1,0,2,0,0,3
ATTATTCAGAGTCACT-1_V12D07-335_A1,0,0,0,0,1,1
TAGCAGTATGACTAAA-1_V12D07-335_A1,1,0,3,0,0,4
TATGAAGAATTAAGGT-1_V12D07-335_A1,5,1,0,0,0,6
CAAGGCCAGTGGTGCA-1_V12D07-335_A1,0,0,1,0,0,1
TGCGTACGGCTAATTG-1_V12D07-335_A1,3,0,1,0,0,4
CAGATAATGGGCGGGT-1_V12D07-335_A1,2,0,1,0,0,3
GAGAACGGTTCTGACT-1_V12D07-335_A1,1,0,1,0,0,2
CGCTTCGGTCTAAGAC-1_V12D07-335_A1,4,0,1,0,0,5
AGCATTACGAGGCAAG-1_V12D07-335_A1,1,1,4,0,0,6
AAGTTGTGATGTTATA-1_V12D07-335_A1,1,4,1,0,0,6
TTGCTCATAGTACGTG-1_V12D07-335_A1,0,0,1,0,0,1
TACTTAAACATGTACA-1_V12D07-335_A1,3,0,3,0,0,6
AGTGAGTCGAATTAAC-1_V12D07-335_A1,4,0,2,0,0,6
TAGGCCTATATAGTCT-1_V12D07-335_A1,4,0,1,0,0,5
ACTCGCCGTTCGATAA-1_V12D07-335_A1,0,0,1,0,0,1
GGTACGTTGCGGCCGG-1_V12D07-335_A1,3,0,0,0,0,3
TATTGCCGGGCTTGTA-1_V12D07-335_A1,0,0,0,0,0,0
GGTAAACTCTGCGCTG-1_V12D07-335_A1,2,0,2,0,0,4
TCCCTTGTCTGAAACT-1_V12D07-335_A1,0,0,0,0,0,0
CATGATCGCTTTGAGA-1_V12D07-335_A1,6,0,1,0,0,7
GGACGGGCGACCAACC-1_V12D07-335_A1,2,0,1,0,0,3
GAGAGGCCTATGTGTA-1_V12D07-335_A1,3,2,1,0,0,6
TCGTAACTCCCAAGAC-1_V12D07-335_A1,1,0,3,0,0,4
CGTATCTAGAACTAAG-1_V12D07-335_A1,1,0,1,0,0,2
GCACCTTCCCGAAGGT-1_V12D07-335_A1,0,0,1,0,0,1
TACCTCTTTACCATCC-1_V12D07-335_A1,0,0,0,0,0,0
TGACTCTAACTGGTAA-1_V12D07-335_A1,0,0,0,0,0,0
GAGAAACTGGATCCCA-1_V12D07-335_A1,1,0,0,0,0,1
ATCCGGACCAGCCTGA-1_V12D07-335_A1,3,1,1,0,0,5
TTATTTAGGTTCCTTA-1_V12D07-335_A1,2,0,0,0,0,2
CGAATTCCCGGTTCAA-1_V12D07-335_A1,1,0,0,0,0,1
TAGTTTGATCGGTCGC-1_V12D07-335_A1,0,0,2,0,0,2
AGTCGAAACGATTCAG-1_V12D07-335_A1,1,1,1,0,0,3
ACGTCGGGCAACTCGG-1_V12D07-335_A1,0,3,3,0,0,6
ACTTGCTCTATCTACC-1_V12D07-335_A1,0,0,1,0,0,1
ATTACGGGCTACGGTT-1_V12D07-335_A1,0,0,2,0,0,2
GCAAACGTAAGCGACC-1_V12D07-335_A1,1,0,2,0,0,3
TTCGGACTGGGCATGG-1_V12D07-335_A1,0,0,2,0,0,2
GGGCCATTCGTGCTGG-1_V12D07-335_A1,0,1,2,0,0,3
GAGTTGTCACCAGTCT-1_V12D07-335_A1,0,0,0,0,0,0
AGTAATTTGCAAGCGT-1_V12D07-335_A1,0,0,0,0,0,0
GTGGCCGGTTTCTCGG-1_V12D07-335_A1,0,0,0,0,0,0
ATCTTAGGGCATTAAT-1_V12D07-335_A1,0,0,1,0,0,1
CTACATATCGCGGGAC-1_V12D07-335_A1,0,0,1,0,0,1
ATGGTATTTACTGATT-1_V12D07-335_A1,0,0,1,0,0,1
CCGTCAACCTCTGGCG-1_V12D07-335_A1,1,0,1,0,0,2
GCTTCGACGTTCAATC-1_V12D07-335_A1,0,0,0,0,0,0
GACCGATTAAATATGT-1_V12D07-335_A1,1,0,5,0,0,6
GTCGAATTTGGGCGCT-1_V12D07-335_A1,0,0,1,0,0,1
TCACGGCCCAAGAGAG-1_V12D07-335_A1,0,2,4,0,0,6
CTACGATCCTATCCTA-1_V12D07-335_A1,2,0,1,0,0,3
TGCAGTGGTAGGGAAC-1_V12D07-335_A1,2,2,5,0,0,9
TTGCCTAATCCAAAGT-1_V12D07-335_A1,2,0,2,0,0,4
AGCGAGACGTGAAGGC-1_V12D07-335_A1,1,2,4,0,0,7
TTCTACCTCAATCGGT-1_V12D07-335_A1,4,1,2,0,0,7
TACGCTGCTGTGTTAA-1_V12D07-335_A1,0,1,3,0,0,4
TAGTCCTGCACTAAGC-1_V12D07-335_A1,3,0,2,0,0,5
AGCACACGTTTAGACT-1_V12D07-335_A1,1,1,2,0,0,4
GTTCGACAATTGTATA-1_V12D07-335_A1,6,0,1,0,0,7
CCATGTTCATCTATAT-1_V12D07-335_A1,1,0,1,0,0,2
CCCTCGATAATACACA-1_V12D07-335_A1,3,0,7,0,0,10
ACTGCCCGCCATTCTC-1_V12D07-335_A1,0,1,3,0,0,4
CTATATCCAGCCTGGC-1_V12D07-335_A1,1,1,2,0,0,4
CGCACGTCTGTTTATG-1_V12D07-335_A1,1,1,10,0,0,12
AATCAGGTTTCATTTA-1_V12D07-335_A1,0,0,3,0,0,3
AGAGAAACACCAGAAA-1_V12D07-335_A1,1,0,2,0,0,3
ACCCGATTGGTTCCGA-1_V12D07-335_A1,1,0,3,0,0,4
TACCAGGAATCCCGTC-1_V12D07-335_A1,1,2,3,0,0,6
AAGTGCTTCTCTATTG-1_V12D07-335_A1,3,0,0,0,0,3
TGCATGTGACCCATAG-1_V12D07-335_A1,5,0,2,0,0,7
TAGATTCAAAGTGCGG-1_V12D07-335_A1,3,2,2,0,0,7
AGGGTCAGAGCACTCG-1_V12D07-335_A1,1,1,2,0,0,4
GTGAGATAACCTTATA-1_V12D07-335_A1,3,0,0,0,0,3
GTGTCAGTGTACGTGG-1_V12D07-335_A1,0,1,3,0,0,4
CTGTAGTGAGGATCGA-1_V12D07-335_A1,3,2,0,0,0,5
GATAGTGCGAGTAAGT-1_V12D07-335_A1,2,0,3,0,0,5
AGGGTTCAGACGGTCC-1_V12D07-335_A1,1,0,0,0,0,1
GGACTCGACAGCGCAT-1_V12D07-335_A1,1,0,1,0,1,3
CACTCTCAAGCATCGA-1_V12D07-335_A1,4,1,0,0,0,5
GAGCGGAATGCGGTGT-1_V12D07-335_A1,1,0,3,0,0,4
CAGTTCGAGGACCCGA-1_V12D07-335_A1,3,0,0,0,0,3
CGTAACTTCGACACTT-1_V12D07-335_A1,1,0,1,0,0,2
TGATCACCACACTGAC-1_V12D07-335_A1,1,1,0,0,0,2
CATACTTCTTTCTCCG-1_V12D07-335_A1,3,0,0,0,0,3
CAAGTAAGTGATAGAC-1_V12D07-335_A1,1,1,4,0,0,6
AGCCCGCAACAAGCAG-1_V12D07-335_A1,0,3,0,0,0,3
GCTCCATGCAAAGCAA-1_V12D07-335_A1,0,0,2,0,0,2
TCGTACCGACGTCAAG-1_V12D07-335_A1,3,0,0,0,0,3
ATTATCGGAATGTACG-1_V12D07-335_A1,2,0,1,0,0,3
ACCTACTATAAATCTA-1_V12D07-335_A1,0,0,1,0,2,3
TATCCTATCAACTGGT-1_V12D07-335_A1,2,0,1,0,1,4
GCGCGGTCTAGTAACT-1_V12D07-335_A1,3,1,0,0,1,5
CCTTCGTATAGAATCC-1_V12D07-335_A1,0,0,1,0,0,1
TGGGCGATACAATAAG-1_V12D07-335_A1,5,1,0,0,0,6
TGACATGTAACGTGAC-1_V12D07-335_A1,1,1,1,0,0,3
TTGGGAAGACGAGCCG-1_V12D07-335_A1,2,0,3,0,0,5
GGTGTAAATCGATTGT-1_V12D07-335_A1,1,0,1,1,0,3
GAACTGTGGAGAGACA-1_V12D07-335_A1,2,0,3,0,0,5
TCCACATCGTATATTG-1_V12D07-335_A1,0,1,0,0,0,1
CCTATGGTCAAAGCTG-1_V12D07-335_A1,1,1,3,0,0,5
TCCTTGTCCTTTAATT-1_V12D07-335_A1,0,0,0,0,0,0
AAGTTTATGGGCCCAA-1_V12D07-335_A1,0,0,2,0,0,2
GTCCGGGTTCACATTA-1_V12D07-335_A1,0,0,1,0,0,1
ATGTAGCGCGCGTAGG-1_V12D07-335_A1,2,0,3,0,0,5
TACGGAAGCCAAACCA-1_V12D07-335_A1,0,0,1,1,0,2
GCCCTGAGGATGGGCT-1_V12D07-335_A1,0,1,2,1,0,4
CGGGCGATGGATCACG-1_V12D07-335_A1,1,0,2,2,0,5
TGCGGACTTGACTCCG-1_V12D07-335_A1,0,0,2,1,0,3
TAATACTAGAACAGAC-1_V12D07-335_A1,1,0,1,1,0,3
TCAAATTGTTGTGCCG-1_V12D07-335_A1,2,0,1,2,0,5
GGGCAGTCAACGCCAA-1_V12D07-335_A1,1,0,2,0,0,3
TCGCTGCCAATGCTGT-1_V12D07-335_A1,0,1,1,1,0,3
TACGTGGGCCCAGGGC-1_V12D07-335_A1,0,1,3,0,0,4
GCCTACGTTCTGTGCA-1_V12D07-335_A1,0,0,1,2,0,3
TTGCGTGTGTAGGCAT-1_V12D07-335_A1,0,0,2,1,0,3
TCCTAAAGATTCAGAC-1_V12D07-335_A1,0,0,1,0,0,1
TGGGTGCACAAGCCAT-1_V12D07-335_A1,1,0,4,0,0,5
GGGAGCGACCGTAGTG-1_V12D07-335_A1,1,1,2,0,0,4
CATAGAGGAGATACTA-1_V12D07-335_A1,0,0,3,1,0,4
CTTCGATTGCGCAAGC-1_V12D07-335_A1,0,0,2,0,0,2
GTGCCTGAGACCAAAC-1_V12D07-335_A1,1,0,2,0,0,3
TCATCCTCAGCTGCTT-1_V12D07-335_A1,0,0,0,0,0,0
TGCAACTACTGGTTGA-1_V12D07-335_A1,1,0,0,0,0,1
ATGTTGATTAGAGACT-1_V12D07-335_A1,1,0,0,0,0,1
GTTTCTAGAGGCGCGG-1_V12D07-335_A1,0,0,3,0,0,3
TACAAGGGCTTCTTTA-1_V12D07-335_A1,0,0,0,0,0,0
ACAGGCACGGATCCTT-1_V12D07-335_A1,1,0,2,0,0,3
CCCAAGTCATTACACT-1_V12D07-335_A1,0,0,1,0,0,1
ACTCTGACCTAATAGA-1_V12D07-335_A1,1,0,0,0,0,1
GGATGGCTTGAAGTAT-1_V12D07-335_A1,1,0,0,0,0,1
ACCCTCCCGTCAGGGC-1_V12D07-335_A1,0,0,0,0,1,1
AGCTTCTTCTCGAGCA-1_V12D07-335_A1,6,1,0,0,0,7
TTGCGCTTGATCAATA-1_V12D07-335_A1,2,1,2,0,0,5
TGGGTGTAATAGATTT-1_V12D07-335_A1,0,0,0,0,0,0
CATGGTTTATTAATCA-1_V12D07-335_A1,2,1,1,0,0,4
TTGCCTTCTCGCCGGG-1_V12D07-335_A1,0,0,0,0,0,0
TTAAAGTAAGTCGCCA-1_V12D07-335_A1,0,0,0,0,0,0
AGTTGGCAAGGCTAGA-1_V12D07-335_A1,1,0,0,0,0,1
CCGCACTTGCAATGAC-1_V12D07-335_A1,3,0,1,1,0,5
AATGTTGTCGTGAGAC-1_V12D07-335_A1,4,0,2,0,0,6
CCAAGGTTGCCCTTTC-1_V12D07-335_A1,1,0,2,0,0,3
TGTGACTAGAGTTTGC-1_V12D07-335_A1,2,0,0,1,0,3
TTGTGATCTGTTCAGT-1_V12D07-335_A1,5,0,1,0,0,6
GGAGTTGATTCTGTGT-1_V12D07-335_A1,1,0,0,0,0,1
GTAGTGAGCAACCTCA-1_V12D07-335_A1,1,0,1,0,0,2
AAGACATACGTGGTTT-1_V12D07-335_A1,2,0,0,0,0,2
CATCCCGAGATTCATA-1_V12D07-335_A1,0,0,0,0,0,0
GGCCGCAGGAACCGCA-1_V12D07-335_A1,1,0,3,0,0,4
CCAGAAACTGATGCGA-1_V12D07-335_A1,0,0,1,0,0,1
ACCCGTAGTCTAGTTG-1_V12D07-335_A1,3,0,3,1,0,7
AGGGTCTGGACGCAGT-1_V12D07-335_A1,0,0,3,0,0,3
TTGAAACCCTCATTCC-1_V12D07-335_A1,2,0,2,0,0,4
TCAATCCCGCGCCAAA-1_V12D07-335_A1,2,0,0,1,0,3
AGGACATCGGCACACT-1_V12D07-335_A1,0,0,2,0,0,2
GACAAGACGCCCGTGC-1_V12D07-335_A1,1,0,1,0,0,2
GAGTAAATTAAGAACC-1_V12D07-335_A1,1,0,0,0,0,1
TAAGTCGGTGAGCTAG-1_V12D07-335_A1,2,0,1,0,0,3
CTTACTGACTCCTCTG-1_V12D07-335_A1,1,1,0,0,0,2
TTAACTGATCGTTTGG-1_V12D07-335_A1,1,0,1,0,0,2
GGGCGATCCATAGGCC-1_V12D07-335_A1,2,0,3,0,0,5
CGTATTGTTTGGCGCC-1_V12D07-335_A1,0,0,2,0,0,2
CGCGTGGGCCTGTGTT-1_V12D07-335_A1,0,0,1,0,0,1
AAATCTGCCCGCGTCC-1_V12D07-335_A1,1,2,3,1,0,7
GCTGAAGGGTTCTTGG-1_V12D07-335_A1,3,1,0,0,0,4
TAATTGCGCTGATTAC-1_V12D07-335_A1,3,1,2,0,0,6
TCGCGCGTTTACATGA-1_V12D07-335_A1,1,0,4,0,0,5
TAACTGAAATACGCCT-1_V12D07-335_A1,0,0,1,0,0,1
CCTGTCGTGTATGAAG-1_V12D07-335_A1,0,0,3,0,0,3
CGGGAACGCCCTGCAT-1_V12D07-335_A1,1,0,1,1,0,3
AGTTGCGGTCCTCAAC-1_V12D07-335_A1,0,0,4,0,0,4
GGGTCCTTGGAAGAAG-1_V12D07-335_A1,0,0,5,0,0,5
CGGGAAGTACCGTGGC-1_V12D07-335_A1,3,0,2,0,0,5
ACGGTCACCGAGAACA-1_V12D07-335_A1,0,1,1,0,0,2
TAGACTCAGTTGGCCT-1_V12D07-335_A1,0,0,0,0,0,0
CCTTCCGCAACGCTGC-1_V12D07-335_A1,1,1,0,0,0,2
CAGTGTTAATCTCTCA-1_V12D07-335_A1,0,0,0,0,0,0
CAGGCCAGTACCACCT-1_V12D07-335_A1,1,2,5,0,0,8
GATCGCTGTGGTGCGT-1_V12D07-335_A1,0,1,1,0,0,2
GTATCTCGGGCGCTTT-1_V12D07-335_A1,0,0,1,0,0,1
CCGGGCTAAGAATTTC-1_V12D07-335_A1,1,0,4,0,0,5
CTTCACGCCCTGGTAC-1_V12D07-335_A1,3,0,2,0,0,5
CGGATGAATGCTGTGA-1_V12D07-335_A1,2,0,0,0,0,2
CTCTGCAGGCATTCTT-1_V12D07-335_A1,2,0,1,0,0,3
TCAAAGTCACGGCGTC-1_V12D07-335_A1,3,2,1,0,0,6
TGGGTTTCGGGCGTAC-1_V12D07-335_A1,5,2,0,0,0,7
TGCTATGGCAAAGGGA-1_V12D07-335_A1,1,1,2,0,0,4
TTCACGGTCGTCACGT-1_V12D07-335_A1,1,0,1,0,0,2
CGTAAAGCAAGAAATC-1_V12D07-335_A1,0,1,6,0,0,7
CTGATCCCTTTATGCA-1_V12D07-335_A1,0,9,1,0,0,10
GAGTATACCCTAATCA-1_V12D07-335_A1,1,1,3,0,0,5
CCACGGCAGGTGTAGG-1_V12D07-335_A1,0,1,2,0,0,3
ACGTACTTTGGCACGG-1_V12D07-335_A1,2,0,2,1,0,5
CCTGAGAATAAATGCA-1_V12D07-335_A1,0,0,5,0,0,5
TTGATGCCGCTCGTCG-1_V12D07-335_A1,0,0,5,0,0,5
GCCAGGAAAGAACACT-1_V12D07-335_A1,1,1,1,1,0,4
TCCGACCGCTAATCAA-1_V12D07-335_A1,2,0,0,0,0,2
TATATCAAAGTGATCT-1_V12D07-335_A1,1,1,3,0,0,5
CCTCGGTTTCCTTGCC-1_V12D07-335_A1,2,0,2,0,0,4
TAAATTTAGTAACACC-1_V12D07-335_A1,2,0,3,0,0,5
CTCGTTACGGCTACCA-1_V12D07-335_A1,0,1,7,0,0,8
GCCGTCGGTTTCGGGC-1_V12D07-335_A1,1,2,4,0,0,7
GTTCCGTCCGCCTGCA-1_V12D07-335_A1,0,0,4,0,0,4
CTAGGGATAGGGACAA-1_V12D07-335_A1,0,1,6,0,0,7
GTCCAGGCACGTGTGC-1_V12D07-335_A1,0,0,0,0,0,0
GAGGAATATCTCTTTG-1_V12D07-335_A1,2,1,2,0,0,5
CGTTCAAGGAAACGGA-1_V12D07-335_A1,0,0,1,0,0,1
GTGGGAACAAACCGGG-1_V12D07-335_A1,3,0,1,0,0,4
GGGCACGTAGTACTGT-1_V12D07-335_A1,0,1,0,0,0,1
ACTACAAAGAGAGGTG-1_V12D07-335_A1,0,1,1,0,0,2
GGTGTAGGTAAGTAAA-1_V12D07-335_A1,4,0,1,0,0,5
CCTGTTCAACCTCGGG-1_V12D07-335_A1,4,1,1,0,0,6
TGAGGTGTGTGGCGGA-1_V12D07-335_A1,2,1,4,0,0,7
ATTGTCTGTTTCATGT-1_V12D07-335_A1,2,2,0,0,0,4
GCCGGTCGTATCTCTC-1_V12D07-335_A1,0,0,1,0,0,1
ATATGGGATAGCAACT-1_V12D07-335_A1,0,2,1,0,0,3
GATAGAACCCGCTAGG-1_V12D07-335_A1,2,0,0,0,0,2
ATCCCATTTCCGTGGG-1_V12D07-335_A1,2,0,4,0,0,6
GATGCTACCTTCGATG-1_V12D07-335_A1,2,0,0,0,0,2
TGCAAAGTTCGTCTGT-1_V12D07-335_A1,0,1,0,0,0,1
GTTCAGTCGCCAAATG-1_V12D07-335_A1,0,0,1,0,0,1
GTCTCCGCCTCAATAC-1_V12D07-335_A1,1,1,1,0,0,3
AGTAGAAGGCGCCTCA-1_V12D07-335_A1,3,0,1,0,0,4
GTTGTAGATTTATGAG-1_V12D07-335_A1,4,1,1,0,0,6
CTATTTGCTTGGAGGA-1_V12D07-335_A1,2,0,1,0,0,3
AGCCATATAGTATGTG-1_V12D07-335_A1,0,1,1,0,0,2
TGTTCCGGCCTGAGCT-1_V12D07-335_A1,1,0,2,0,0,3
TGCCGTGGGACCCAAT-1_V12D07-335_A1,4,1,1,1,0,7
TTGCAAGAAGACTCCT-1_V12D07-335_A1,0,1,1,0,0,2
CCGCTCCAGGGCGATC-1_V12D07-335_A1,0,0,2,0,0,2
CAAACCCTCCGGCGGG-1_V12D07-335_A1,2,0,2,0,0,4
CGGACCTTTACGTCCC-1_V12D07-335_A1,1,1,1,0,0,3
ACGTAGGAGAGTCGCT-1_V12D07-335_A1,1,0,0,0,0,1
CTGCGACCTCGCCGAA-1_V12D07-335_A1,1,0,3,0,0,4
GGCCCAGCTGGTTTGC-1_V12D07-335_A1,0,0,1,0,0,1
GGATTAATCATGGACC-1_V12D07-335_A1,3,0,4,0,0,7
GAGATGGCTTTAATCA-1_V12D07-335_A1,2,0,1,1,0,4
AGTACAGAAGCTTATA-1_V12D07-335_A1,3,0,1,0,0,4
GCGGCTTTAGCAAGTT-1_V12D07-335_A1,0,0,2,0,0,2
ACCGAGTCTCCTTATT-1_V12D07-335_A1,0,0,1,0,0,1
GACCACACTTCCCTTT-1_V12D07-335_A1,0,0,1,0,0,1
TGTAGCCAATTCCGTT-1_V12D07-335_A1,0,0,1,0,0,1
CTCGTCTGTGCCTTCG-1_V12D07-335_A1,2,0,1,0,0,3
GGACTCTTTGACTAAG-1_V12D07-335_A1,0,0,0,2,0,2
TCATCGACGACCGTCG-1_V12D07-335_A1,0,0,6,2,0,8
TACTACGTGCAATGCG-1_V12D07-335_A1,0,1,1,1,0,3
CCCTACTTGAACAATG-1_V12D07-335_A1,0,0,1,0,0,1
GCAGCTGTCAACGCAT-1_V12D07-335_A1,2,0,0,1,0,3
ATCTACCATCTGCTCC-1_V12D07-335_A1,0,0,1,0,0,1
TCTCAAATCAATCGGG-1_V12D07-335_A1,1,1,1,0,0,3
ACTCCGGCCGACCACT-1_V12D07-335_A1,0,2,1,0,0,3
TACACCTCTTCGAATC-1_V12D07-335_A1,0,0,2,1,0,3
GTGGCTGTTTCTGTTC-1_V12D07-335_A1,0,0,3,0,1,4
ACGACTCTAGGGCCGA-1_V12D07-335_A1,1,1,0,1,2,5
TCGTTTACGCGACCCT-1_V12D07-335_A1,1,0,4,0,0,5
AGGATATCCGACTGCA-1_V12D07-335_A1,0,0,2,0,0,2
GACACTTCCAATTACC-1_V12D07-335_A1,1,0,1,0,0,2
ACGGTACAGTTCAATG-1_V12D07-335_A1,0,0,3,0,1,4
CTTGATGACCATCCAG-1_V12D07-335_A1,0,0,0,0,0,0
CTGGTAAAGACTTACA-1_V12D07-335_A1,0,1,0,0,0,1
CTTGCCCACCCACGCA-1_V12D07-335_A1,0,0,1,0,0,1
CATTACGCAGGAAGGG-1_V12D07-335_A1,1,0,1,0,0,2
GGACAACCATGAAGCC-1_V12D07-335_A1,0,1,0,0,0,1
GTTATCAAGCTATCGA-1_V12D07-335_A1,0,0,0,0,0,0
AGGTGCACGTCCACAT-1_V12D07-335_A1,2,0,0,0,0,2
AAAGAATGTGGACTAA-1_V12D07-335_A1,0,1,1,0,0,2
ACCAAGTCATCGGCAG-1_V12D07-335_A1,0,0,0,0,0,0
AGTAACTATAGCAGCC-1_V12D07-335_A1,1,0,1,0,0,2
GGGAAAGAATGCCAAC-1_V12D07-335_A1,4,0,1,0,1,6
AATCGGTATAGCCCTC-1_V12D07-335_A1,0,1,0,0,0,1
GGCACTGCGGTGGTTT-1_V12D07-335_A1,0,0,0,0,0,0
CGTCCTCATCGCGTGC-1_V12D07-335_A1,0,0,2,0,0,2
CTTAACTTACAGTATA-1_V12D07-335_A1,1,0,0,0,0,1
GTGAGTCGACTAATAG-1_V12D07-335_A1,1,0,0,0,0,1
TGTACTTCCGGGCATG-1_V12D07-335_A1,0,0,1,0,0,1
CACAAACCGCAGAACT-1_V12D07-335_A1,0,0,1,0,0,1
GCTTTACACAACTGGG-1_V12D07-335_A1,0,0,1,0,0,1
CACCGATGATGGGTAC-1_V12D07-335_A1,0,0,0,0,1,1
TCAATATACAGGAGGC-1_V12D07-335_A1,2,0,1,1,1,5
AACGACCTCCTAGCCG-1_V12D07-335_A1,0,0,1,0,0,1
GTTACCAAGGCGTACG-1_V12D07-335_A1,0,0,0,0,0,0
TAGCTCACTGTGTTTG-1_V12D07-335_A1,0,0,0,0,0,0
TCGGCAGGGTTAAGGG-1_V12D07-335_A1,0,0,0,0,0,0
TGTTAACAAAGTGACT-1_V12D07-335_A1,1,0,0,0,0,1
CAGAGCGATGGATGCT-1_V12D07-335_A1,1,0,1,0,0,2
CATAGTGGGCACGCCT-1_V12D07-335_A1,2,0,1,0,0,3
AAACGCTGGGCACGAC-1_V12D07-335_A1,0,0,0,0,0,0
TGTTCTCATACTATAG-1_V12D07-335_A1,1,0,1,0,0,2
TCCGCTGGGTCGATCG-1_V12D07-335_A1,0,3,4,0,0,7
TTAGCATCCCTCACGT-1_V12D07-335_A1,1,0,3,0,0,4
AGCCTTGTCACTGATA-1_V12D07-335_A1,2,1,2,0,0,5
GTTTCTTGTTAGAGCT-1_V12D07-335_A1,1,0,1,0,0,2
TCGGAGTCCTGGTTGC-1_V12D07-335_A1,0,0,3,0,0,3
ACGGGTTGTGACCTGT-1_V12D07-335_A1,0,0,1,0,0,1
TGACAGAAATCTTGCT-1_V12D07-335_A1,0,0,2,0,0,2
TAGCCATGATTGCCTA-1_V12D07-335_A1,0,0,1,0,0,1
CGAAGCCACAGCATGG-1_V12D07-335_A1,0,0,0,0,0,0
ACCCGTAGCAGAGAAT-1_V12D07-335_A1,1,0,0,0,0,1
AGCTTGATCAGGGTAG-1_V12D07-335_A1,0,0,2,0,0,2
CTATAAGTAGGGTTTG-1_V12D07-335_A1,1,2,2,1,0,6
TATAGTTAGGTGTACT-1_V12D07-335_A1,0,0,0,0,0,0
TACGCTGATAGTTGTA-1_V12D07-335_A1,0,0,2,0,0,2
TTCTCAATTGCTACAA-1_V12D07-335_A1,0,0,0,0,0,0
GTTGCCCTAACGGGTG-1_V12D07-335_A1,0,1,0,0,0,1
GACATTTCGCCCAGCC-1_V12D07-335_A1,0,0,0,0,0,0
GTAACTACGTAGACCT-1_V12D07-335_A1,0,0,2,0,0,2
CCAGTGTACAGACCGA-1_V12D07-335_A1,1,0,0,0,0,1
GCCCGATGCCCAGTTC-1_V12D07-335_A1,0,1,4,0,0,5
CGAACCTCTTTCCTAG-1_V12D07-335_A1,1,1,1,0,0,3
CATGCACATGAGAGGC-1_V12D07-335_A1,0,0,2,0,0,2
CCAAATCAAAGGGCAA-1_V12D07-335_A1,3,0,4,0,0,7
GTAGTTTAAGCACACG-1_V12D07-335_A1,0,1,13,1,0,15
TAAGTGAATAGTCTAC-1_V12D07-335_A1,1,0,2,0,0,3
GGTCCACGTCTATTTG-1_V12D07-335_A1,2,0,4,0,0,6
CCCTCAGATCGAGAAC-1_V12D07-335_A1,5,0,1,0,0,6
ACATTCGCGCGGAATA-1_V12D07-335_A1,5,0,1,0,0,6
CTATGAACACCTTGCC-1_V12D07-335_A1,5,0,2,0,0,7
CGAATGGTAGGTCGTC-1_V12D07-335_A1,2,0,0,0,0,2
TCGACATAGCGTAGCG-1_V12D07-335_A1,3,0,2,0,0,5
GACGTTGCTCGGCGGC-1_V12D07-335_A1,1,0,2,0,0,3
CTCGAGGCAAGTTTCA-1_V12D07-335_A1,0,1,5,0,0,6
GCTGGGAGCGCGTCAA-1_V12D07-335_A1,4,1,1,0,0,6
GACGATATCACTGGGT-1_V12D07-335_A1,2,1,1,0,0,4
CAGCTCTGGGCTCACT-1_V12D07-335_A1,0,0,10,0,0,10
TAGTCTGCGGCACATT-1_V12D07-335_A1,2,1,0,0,0,3
TGGTCGATATACCTCT-1_V12D07-335_A1,2,1,2,0,0,5
TTCAGTTCAAGAGGAG-1_V12D07-335_A1,6,1,1,0,0,8
GTCTGTAGGTTGAACA-1_V12D07-335_A1,4,1,1,0,0,6
GAGAGTCTCGGGAGAG-1_V12D07-335_A1,0,0,1,0,0,1
TTGTTTGTATTACACG-1_V12D07-335_A1,1,1,3,0,0,5
GCACAGCACGGGCCGA-1_V12D07-335_A1,1,0,0,0,0,1
AAACAGTGTTCCTGGG-1_V12D07-335_A1,1,0,3,0,0,4
TGGAGAATAATCGTCC-1_V12D07-335_A1,0,0,2,0,0,2
CGCCGCGTTCTGAACG-1_V12D07-335_A1,4,0,0,0,0,4
CATGCGTTGAGAGGAG-1_V12D07-335_A1,5,3,1,0,0,9
TACGCTCCTAGAACTG-1_V12D07-335_A1,4,1,1,0,0,6
CCTTGTGAACGTGGTT-1_V12D07-335_A1,1,0,1,0,0,2
TTAAAGGCGATGCTCG-1_V12D07-335_A1,5,1,0,0,0,6
TAAAGTGCACGTCTCG-1_V12D07-335_A1,0,1,1,0,0,2
TGTCCGCAAACAATTC-1_V12D07-335_A1,3,2,0,0,0,5
AGGCCTATCATACCAA-1_V12D07-335_A1,0,0,1,0,0,1
ACTGGGATGCCAGTGC-1_V12D07-335_A1,2,1,1,0,0,4
CGATCCACCATTGTTG-1_V12D07-335_A1,1,0,1,0,0,2
GGGCATGCATGTCGAG-1_V12D07-335_A1,3,1,2,0,0,6
TCCAGGCAGGACGATC-1_V12D07-335_A1,0,0,2,0,0,2
CAATGACCCTTAATTT-1_V12D07-335_A1,0,1,1,0,0,2
ATCAAGATCCCAGGAC-1_V12D07-335_A1,3,1,0,0,0,4
CTCAGAGCTAATGTCG-1_V12D07-335_A1,3,1,0,0,0,4
CTGCGATTTCGAGATT-1_V12D07-335_A1,2,1,0,0,0,3
ATGGTATTGGGAACCG-1_V12D07-335_A1,0,0,0,0,0,0
TAGGTTCTGCTGAGAA-1_V12D07-335_A1,4,1,0,0,0,5
GCCTGTCCCGGTGCAT-1_V12D07-335_A1,0,2,0,0,0,2
GGCCTGCTCTGATGTT-1_V12D07-335_A1,0,0,1,0,0,1
TAGAGGGAGTTTATCT-1_V12D07-335_A1,4,0,2,0,0,6
CTCTACATCCTGCGTG-1_V12D07-335_A1,2,0,0,0,0,2
ACACATTTCCGTAGAC-1_V12D07-335_A1,0,1,0,0,0,1
TGGGTGTTAAGTAGAA-1_V12D07-335_A1,4,1,1,0,0,6
GAGCTCAACATGAGCG-1_V12D07-335_A1,1,1,1,0,0,3
GCACACAGCTATTACC-1_V12D07-335_A1,1,0,0,0,0,1
GCGACGGTAGTCTCCT-1_V12D07-335_A1,3,0,2,0,0,5
GTATCAAGGTACTTCC-1_V12D07-335_A1,2,0,3,0,0,5
GGAAAGGGAATTGAGC-1_V12D07-335_A1,1,0,1,0,0,2
TACACAGCCGTGGTGC-1_V12D07-335_A1,2,0,0,0,0,2
CGGTTGGGCAGGGTCC-1_V12D07-335_A1,1,0,2,0,0,3
GCACGCCGATTCCCGC-1_V12D07-335_A1,1,0,0,0,0,1
CGCTTTCCGCCAAGGT-1_V12D07-335_A1,0,0,5,0,0,5
TGCCCGATAGTTAGAA-1_V12D07-335_A1,4,0,0,0,0,4
TCAGAACGGCGGTAAT-1_V12D07-335_A1,1,0,0,0,0,1
CCACTCAGATCCGCAA-1_V12D07-335_A1,1,0,0,0,0,1
GAAGGGTCATTAAGAC-1_V12D07-335_A1,0,0,3,0,1,4
GCGGTCTTGCTTTCAC-1_V12D07-335_A1,0,1,0,0,0,1
GGAAGGACACCGTATA-1_V12D07-335_A1,0,1,1,0,0,2
CGCGGGAATTCCTTTC-1_V12D07-335_A1,0,0,1,1,1,3
TCTATCCGATTGCACA-1_V12D07-335_A1,2,1,1,0,0,4
TACTCGTTTGAATCAA-1_V12D07-335_A1,0,0,1,1,0,2
GTCTGCCGACTCGACG-1_V12D07-335_A1,0,1,0,0,0,1
TACGGGTAATAACATA-1_V12D07-335_A1,0,2,1,0,0,3
CCAGTTCGGTAACTCA-1_V12D07-335_A1,0,0,0,0,1,1
CGTGCACACCACTGTA-1_V12D07-335_A1,0,1,1,0,1,3
CTTCAGTTGGACAACG-1_V12D07-335_A1,0,0,1,0,0,1
TGATCTATCACACTCT-1_V12D07-335_A1,0,0,0,1,0,1
TAGCAGATACTTAGGG-1_V12D07-335_A1,0,6,0,0,0,6
CACCGGGCATCACAAG-1_V12D07-335_A1,0,2,3,2,0,7
AGTGGCCCGCAAATGG-1_V12D07-335_A1,0,0,0,0,0,0
CTCGCTAGGTAAGCGA-1_V12D07-335_A1,0,0,3,0,0,3
GATAGATAGTACAGTC-1_V12D07-335_A1,1,3,1,0,1,6
CGAGACTACTGCTGCT-1_V12D07-335_A1,1,0,2,1,1,5
ACATTTGAAACCTAAC-1_V12D07-335_A1,0,0,0,0,2,2
GACACAGCCGGGACTG-1_V12D07-335_A1,0,1,1,0,2,4
ACGGAACACGAGTGCC-1_V12D07-335_A1,0,0,0,0,1,1
ACGCCAGTGCGTTTGC-1_V12D07-335_A1,1,0,0,0,6,7
GCACCTAGGCGAGTCC-1_V12D07-335_A1,0,0,0,0,0,0
TCACTATCCCTTCGGT-1_V12D07-335_A1,2,0,1,2,0,5
TGAGTGTAACAACGGG-1_V12D07-335_A1,1,0,2,0,2,5
ATTGGTTGTGCATTAC-1_V12D07-335_A1,1,0,0,0,0,1
CTGGCGATTTACATGT-1_V12D07-335_A1,0,3,1,1,0,5
TCCACCAAGACATAGG-1_V12D07-335_A1,3,0,2,0,0,5
AACGTCGCTGCACTTC-1_V12D07-335_A1,0,0,1,0,0,1
GTCTCCCGAGTCCCGT-1_V12D07-335_A1,2,0,2,0,0,4
AGCCCGCACTACAATG-1_V12D07-335_A1,0,0,0,1,0,1
GGCACGCTGCTACAGT-1_V12D07-335_A1,2,0,0,0,0,2
GCTTGAGTGACCTCTG-1_V12D07-335_A1,0,0,1,0,0,1
ATAGCCATAACAGTCA-1_V12D07-335_A1,2,1,0,1,0,4
TAGGAGGCTCGAGAAC-1_V12D07-335_A1,0,0,3,0,0,3
GTCGGGTGAAGTACCG-1_V12D07-335_A1,1,0,0,0,0,1
CACCCGCGTTTGACAC-1_V12D07-335_A1,0,0,2,0,0,2
TCTCAGGCTACTCGCT-1_V12D07-335_A1,0,0,0,0,0,0
TAGATTCTCTAGCAAA-1_V12D07-335_A1,0,0,1,0,0,1
CCCATTATTGTATCCT-1_V12D07-335_A1,0,0,0,0,0,0
GTTAATAGCGTCATTA-1_V12D07-335_A1,0,2,0,0,1,3
TACTCATTGACGCATC-1_V12D07-335_A1,2,0,1,1,1,5
TAGTGACAAGCTCTAC-1_V12D07-335_A1,0,0,0,0,0,0
ATCGCCGTGGTTCATG-1_V12D07-335_A1,1,0,2,0,0,3
CTGCTCTCAACACACC-1_V12D07-335_A1,0,0,0,0,2,2
GCATGACACAAAGGAA-1_V12D07-335_A1,0,0,0,0,0,0
CAACGATCGATCCAAT-1_V12D07-335_A1,0,0,0,0,1,1
ATACAGCGTCCACTGA-1_V12D07-335_A1,2,0,1,0,0,3
TCACGATTAATACGTT-1_V12D07-335_A1,0,1,1,0,0,2
CGTGAACTGACCCGAT-1_V12D07-335_A1,1,2,2,0,0,5
TCGATGTTACGGCCGT-1_V12D07-335_A1,0,2,3,0,0,5
GACCGGTGATACTCTC-1_V12D07-335_A1,1,1,6,0,0,8
TCTGTTTAGATTGTTC-1_V12D07-335_A1,1,0,2,0,0,3
GCTACTCGGACGCAGA-1_V12D07-335_A1,0,1,3,0,0,4
AAGAAAGTTTGATGGG-1_V12D07-335_A1,3,0,5,0,0,8
CGCCAGTAGTACCTTG-1_V12D07-335_A1,1,2,0,0,0,3
CTCCCTTGTATCAAGG-1_V12D07-335_A1,2,0,3,0,0,5
ACTTTATACACCACTT-1_V12D07-335_A1,2,0,0,1,0,3
AGATCTGGAGAGGATA-1_V12D07-335_A1,1,0,1,0,0,2
TCATCCATCTGATCAC-1_V12D07-335_A1,0,0,3,0,0,3
AGAACACGGCGATGGT-1_V12D07-335_A1,0,0,0,0,0,0
CCGCTCCGGATAAGCT-1_V12D07-335_A1,0,0,4,0,0,4
TGGTCGGGTACAGGGC-1_V12D07-335_A1,1,1,3,0,0,5
ACGGACGCAGCGACAA-1_V12D07-335_A1,0,0,2,0,0,2
ACATGCTTACGGCAGC-1_V12D07-335_A1,1,0,0,0,0,1
CAGGGAGATAGGCCAG-1_V12D07-335_A1,3,1,2,0,0,6
TCGCCACCCGGATTAC-1_V12D07-335_A1,1,0,1,0,0,2
TCTTGGTCAATGATAC-1_V12D07-335_A1,0,0,4,0,0,4
CATAGGGACACTTGTG-1_V12D07-335_A1,0,3,7,0,0,10
CACGAGCAAACCAGAC-1_V12D07-335_A1,0,0,6,2,0,8
GGGATATTGATCGCCA-1_V12D07-335_A1,0,0,2,0,0,2
TAATGTCGGTTCATGG-1_V12D07-335_A1,0,0,1,0,0,1
CGATTTGTCATTAATG-1_V12D07-335_A1,0,0,4,0,0,4
TTAAGATACCCAGAGA-1_V12D07-335_A1,2,0,4,0,0,6
CGACCGTTGGTATTCG-1_V12D07-335_A1,3,0,3,0,0,6
ACTACCATCCGAGGGC-1_V12D07-335_A1,1,0,3,0,0,4
TCTACGCACGATCTCC-1_V12D07-335_A1,3,3,0,0,0,6
AAGCCACTTGCAGGTA-1_V12D07-335_A1,1,0,3,0,0,4
ACGTTGTCGTTGAAAG-1_V12D07-335_A1,2,0,3,0,0,5
ACCGCTAGTCATTGGT-1_V12D07-335_A1,1,2,1,0,0,4
CATGAGTCCATCACGG-1_V12D07-335_A1,3,0,1,0,0,4
ATGTCTTGTTTGACTC-1_V12D07-335_A1,2,0,3,0,0,5
TCCCAAACATCCTCTA-1_V12D07-335_A1,1,0,2,0,0,3
CAACGCGATGAGCCAA-1_V12D07-335_A1,0,0,1,0,0,1
GACACCCAAAGACGCG-1_V12D07-335_A1,1,0,2,0,0,3
ACGTTCACTATGCCGC-1_V12D07-335_A1,1,0,2,0,0,3
ATGGACTGCTTAGTTG-1_V12D07-335_A1,0,0,2,0,0,2
CCATGGCAAACGCTCA-1_V12D07-335_A1,2,1,0,0,0,3
TTGTCTCGGCAAGATG-1_V12D07-335_A1,0,1,0,0,0,1
TTCGAACGAAACATGC-1_V12D07-335_A1,2,0,1,0,0,3
GGAAAGTCTTGATTGT-1_V12D07-335_A1,2,1,0,0,0,3
ATCATAGATCGACGAG-1_V12D07-335_A1,3,0,0,0,0,3
GATTAGAAACAAGCGT-1_V12D07-335_A1,2,2,1,0,0,5
GCTGCGAAGAATTATT-1_V12D07-335_A1,2,1,0,0,0,3
TTCCAGTGGGTTTCGT-1_V12D07-335_A1,3,0,0,0,0,3
GCTCATTGATCATATC-1_V12D07-335_A1,2,2,1,0,0,5
ATACGAGGTTTGTAAG-1_V12D07-335_A1,0,1,0,0,0,1
GTCTATACACGCATGG-1_V12D07-335_A1,1,1,0,0,0,2
GATTTGCGCTAACACC-1_V12D07-335_A1,0,3,1,0,0,4
TGGTGCCCTGCCTTAC-1_V12D07-335_A1,2,2,0,0,0,4
TCGAATCGCAGGGTAG-1_V12D07-335_A1,0,1,1,0,0,2
GGTAGGCCAATATCAC-1_V12D07-335_A1,0,1,0,0,0,1
CGTAAATAACAAAGGG-1_V12D07-335_A1,2,1,0,0,0,3
GACTCTAGAGTTCCAA-1_V12D07-335_A1,0,0,4,0,0,4
ACTTGTTACCGGATCA-1_V12D07-335_A1,2,1,0,0,0,3
GGCATTGAACATCTCA-1_V12D07-335_A1,1,1,1,0,0,3
AACCCGCTGTATTCCA-1_V12D07-335_A1,1,0,0,0,0,1
TAACAGGTTCCCTTAG-1_V12D07-335_A1,2,1,0,0,0,3
GTTCTTGTAACTCAAT-1_V12D07-335_A1,1,1,1,0,0,3
GATTCTGTTAATGAGT-1_V12D07-335_A1,1,0,1,0,0,2
GGACACCTCGGTGTTG-1_V12D07-335_A1,1,1,0,0,0,2
CGATCGAGAAGCACCA-1_V12D07-335_A1,2,1,2,0,0,5
CTGCTCTGACGGCAAA-1_V12D07-335_A1,0,0,0,0,0,0
CCCAGGAAGAATTCGA-1_V12D07-335_A1,3,0,2,0,0,5
TGTCGTGGGTATAGGC-1_V12D07-335_A1,0,2,1,0,0,3
ATATGTCTAGAGCGTG-1_V12D07-335_A1,1,1,1,0,0,3
GCGGGCAGACGGGTGA-1_V12D07-335_A1,3,1,1,0,0,5
CGAAGATCAGTTTCAT-1_V12D07-335_A1,0,0,2,0,0,2
ACGCCACTCGAAACAG-1_V12D07-335_A1,3,2,0,0,1,6
CTTAGATGTTTCATCC-1_V12D07-335_A1,0,0,3,0,0,3
GCGAATGGACTAGCGA-1_V12D07-335_A1,1,0,3,0,0,4
TAAATTGTGGGTAAAG-1_V12D07-335_A1,1,2,1,0,0,4
ATTTATACTGGTAAAG-1_V12D07-335_A1,2,0,2,0,0,4
GCGTCGTAACATGGTC-1_V12D07-335_A1,4,0,5,0,0,9
CGGTATGGGCACTCTG-1_V12D07-335_A1,1,0,2,0,0,3
CTATCACAACGCTGGA-1_V12D07-335_A1,1,0,3,0,1,5
ACCACACGGTTGATGG-1_V12D07-335_A1,5,1,2,0,0,8
TCAGCGCACGCCGTTT-1_V12D07-335_A1,2,0,3,0,1,6
AATGTTAAGACCCTGA-1_V12D07-335_A1,0,0,1,0,0,1
CTTACATAGATTTCTT-1_V12D07-335_A1,1,0,2,0,0,3
AACATAGCGTGTATCG-1_V12D07-335_A1,0,1,0,0,0,1
AGCAGTCGAAGCATGC-1_V12D07-335_A1,1,0,0,0,0,1
GTACTACGGCCTCGTT-1_V12D07-335_A1,1,0,1,0,1,3
TTGGCCAAATTGTATC-1_V12D07-335_A1,1,0,1,0,4,6
TCAGAGGACGCGTTAG-1_V12D07-335_A1,0,0,0,0,1,1
AGTAATCTAAGGGTGG-1_V12D07-335_A1,1,0,1,0,0,2
AATTATACCCAGCAAG-1_V12D07-335_A1,2,0,0,0,0,2
CCCTACCCACACCCAG-1_V12D07-335_A1,0,0,2,0,3,5
CTCTGTCCATGCACCA-1_V12D07-335_A1,0,0,0,1,2,3
TCGCCTCCTTCGGCTC-1_V12D07-335_A1,0,0,0,0,0,0
CCTGATTCGCGAAGAA-1_V12D07-335_A1,0,1,0,0,2,3
GACTTCAACGCATCAA-1_V12D07-335_A1,0,0,1,0,0,1
GCTTCCCGTAAGCTCC-1_V12D07-335_A1,1,0,0,0,2,3
AGAACTGTACTTTGTA-1_V12D07-335_A1,2,0,0,0,8,10
CCTTAAGTACGCAATT-1_V12D07-335_A1,1,0,0,0,2,3
GGCCAATTGTATAGAC-1_V12D07-335_A1,0,0,0,0,0,0
AGAATACAGGCTATCC-1_V12D07-335_A1,2,0,0,0,1,3
AATACCTGATGTGAAC-1_V12D07-335_A1,1,0,0,0,2,3
TAGAGTGTTCCGGGTA-1_V12D07-335_A1,0,0,0,0,1,1
GCTTCCATGTAACCGC-1_V12D07-335_A1,0,0,0,0,0,0
GGTTCGCATTTGCCGT-1_V12D07-335_A1,0,0,0,0,1,1
TCAATCCGGGAAGTTT-1_V12D07-335_A1,0,0,0,0,1,1
CCGGAAGTGCAATATG-1_V12D07-335_A1,0,0,0,0,2,2
CTCATAAATGTGTATA-1_V12D07-335_A1,0,0,2,0,1,3
GACGGGCATCGAATTT-1_V12D07-335_A1,1,1,0,0,2,4
GCTAAGCCCAGTATGC-1_V12D07-335_A1,0,0,1,0,1,2
GCTATAAGGGCCAGGA-1_V12D07-335_A1,1,0,0,0,6,7
GCGGATTACTTGTTCT-1_V12D07-335_A1,0,0,1,0,3,4
TACAACAGCGCATACA-1_V12D07-335_A1,0,1,0,0,2,3
TCTAACCTAGCCTGCG-1_V12D07-335_A1,0,0,0,0,1,1
TCTACCCGCATCATTT-1_V12D07-335_A1,0,1,0,1,0,2
GTCTTACCACGCCAAG-1_V12D07-335_A1,0,1,1,0,2,4
AATAACGTCGCGCCCA-1_V12D07-335_A1,0,0,0,0,1,1
CGTTTCGGTTATATGC-1_V12D07-335_A1,0,0,3,0,4,7
TACGCTGCACGGTCGT-1_V12D07-335_A1,0,0,0,1,1,2
CGTTAAATACGACCAG-1_V12D07-335_A1,0,0,2,0,2,4
TCGACTGACGATGGCT-1_V12D07-335_A1,0,0,0,0,0,0
ACGCTACTGAATGGGC-1_V12D07-335_A1,0,0,2,0,0,2
AAGGGTTAGCCATGCG-1_V12D07-335_A1,0,0,0,0,1,1
ACGTTTCGGTGCACTT-1_V12D07-335_A1,0,0,0,0,0,0
TTAACCCGAGGCGTGT-1_V12D07-335_A1,0,0,0,0,2,2
GCCCGTCAAGCCCAAT-1_V12D07-335_A1,2,0,0,0,2,4
ATTCGTCCCGAGGTTA-1_V12D07-335_A1,0,0,0,1,1,2
TCAAATTATGTTCGAC-1_V12D07-335_A1,0,0,0,0,1,1
AACGTTCTACCATTGT-1_V12D07-335_A1,0,0,0,0,0,0
CTGTCCTGCGCACTAC-1_V12D07-335_A1,1,2,1,0,0,4
GCCCAGCGACACAAAG-1_V12D07-335_A1,1,1,2,0,0,4
TATAGCTATTATCTCT-1_V12D07-335_A1,0,3,5,0,0,8
AAGCTATGGATTGACC-1_V12D07-335_A1,0,0,5,0,0,5
CCGAAACACGACCTCT-1_V12D07-335_A1,0,0,2,0,0,2
ATCAGAAGCTGGTTGC-1_V12D07-335_A1,0,1,2,0,0,3
TGAACCTGAATGTGAG-1_V12D07-335_A1,1,0,1,0,0,2
TCAGAGCATGTCAACG-1_V12D07-335_A1,0,0,1,0,0,1
ATACCCTCCCGGCCAA-1_V12D07-335_A1,0,0,1,0,0,1
GCCACCTTATTCGCGA-1_V12D07-335_A1,0,0,0,0,0,0
CAACGAGCTTATTATG-1_V12D07-335_A1,0,1,0,0,0,1
GATCCAACCTTTAAAC-1_V12D07-335_A1,1,1,4,0,0,6
TTGTGGAGACAGCCGG-1_V12D07-335_A1,0,0,0,0,0,0
AGATAATCACACCTAT-1_V12D07-335_A1,1,0,3,0,0,4
GGTTAGGGATGCTAAT-1_V12D07-335_A1,3,0,2,0,0,5
TCATGAAGCGCTGCAT-1_V12D07-335_A1,0,0,2,0,0,2
CCAGGCGAGATGGTCT-1_V12D07-335_A1,0,0,2,0,0,2
CGACTTGCCGGGAAAT-1_V12D07-335_A1,0,1,2,0,0,3
GTGCCAAACGTTTCGA-1_V12D07-335_A1,1,0,1,0,0,2
TGCTCAAAGGATGCAC-1_V12D07-335_A1,3,0,1,0,0,4
GCCTCAGGTACCGGTC-1_V12D07-335_A1,1,0,3,0,0,4
ACAAGTAATTGTAAGG-1_V12D07-335_A1,0,1,3,0,0,4
TTAGAGTATTGTCGAG-1_V12D07-335_A1,0,0,5,0,0,5
GTCATCCCAAACTCAC-1_V12D07-335_A1,1,2,0,0,0,3
CTCCTAGTAATCGTGA-1_V12D07-335_A1,0,1,8,0,0,9
CCCTCATCACAGAGTA-1_V12D07-335_A1,0,0,1,0,0,1
GGAAACAGAGCTTGGG-1_V12D07-335_A1,3,0,2,1,0,6
ACATCGCAATATTCGG-1_V12D07-335_A1,2,0,3,0,0,5
TTAGCCATAGGGCTCG-1_V12D07-335_A1,2,2,3,0,0,7
CGGATTCTGCCTTATG-1_V12D07-335_A1,1,0,3,0,0,4
TTGTTGGCAATGACTG-1_V12D07-335_A1,1,2,1,0,0,4
GGATCTACCGTTCGTC-1_V12D07-335_A1,5,0,0,0,0,5
GGTGGGATTAGGTCCC-1_V12D07-335_A1,1,0,0,0,0,1
AATAGGCACGACCCTT-1_V12D07-335_A1,3,0,6,0,0,9
GAGGTCCGTTCGCTGT-1_V12D07-335_A1,3,1,1,0,0,5
TGACAACTTAAAGGTG-1_V12D07-335_A1,2,0,0,0,0,2
AGCTAAGCTCCGTCCG-1_V12D07-335_A1,2,0,1,0,0,3
CTAGCCCGGGAGACGA-1_V12D07-335_A1,2,0,2,0,0,4
CCCAGATTCCCGTGAC-1_V12D07-335_A1,0,0,1,0,0,1
GCCCGTTCACACAATT-1_V12D07-335_A1,0,0,0,0,0,0
ACAAACTCCATCAGAG-1_V12D07-335_A1,3,0,1,0,0,4
GGTTCCGTACGACTAA-1_V12D07-335_A1,2,1,1,0,0,4
TTGCGGAAAGCTGCCC-1_V12D07-335_A1,0,0,2,0,0,2
GGAACTCGTGAATACG-1_V12D07-335_A1,2,0,1,0,0,3
GGTTACCGCTCCCTAC-1_V12D07-335_A1,1,0,1,0,0,2
AGCGACTTTGAAGACA-1_V12D07-335_A1,1,0,0,0,0,1
CCGTTTCCTTTCCGTG-1_V12D07-335_A1,3,2,1,0,0,6
TGGATGGCATCTTGGA-1_V12D07-335_A1,4,0,0,0,0,4
CAAGTCGTTGAAATCT-1_V12D07-335_A1,0,1,3,0,0,4
TGCAAACGTACTAGTT-1_V12D07-335_A1,0,1,1,0,0,2
GGCTGTCCTACTGCGG-1_V12D07-335_A1,0,1,3,0,0,4
TACTGCATGATTAAAT-1_V12D07-335_A1,2,0,1,0,0,3
CGGACCTCTGTAGTTA-1_V12D07-335_A1,0,0,1,0,0,1
CCCTAGCTCTAAGGTC-1_V12D07-335_A1,2,0,1,0,0,3
GTAACAGGTTAACGGC-1_V12D07-335_A1,4,0,0,0,0,4
CCCGCAAATAATCATC-1_V12D07-335_A1,1,1,0,0,0,2
AATCCCGCTCAGAGCC-1_V12D07-335_A1,1,0,1,0,0,2
AACGTCATCCGGCTTG-1_V12D07-335_A1,3,3,3,0,0,9
CTCGTGGCACTGAAAG-1_V12D07-335_A1,1,1,1,0,0,3
CTTTATCCGACGCATG-1_V12D07-335_A1,0,0,1,0,0,1
AAATGACTGATCAAAC-1_V12D07-335_A1,1,0,1,0,0,2
TTCGTGCATGTTATAG-1_V12D07-335_A1,3,0,1,0,0,4
ATCAAAGAGCCGTGGT-1_V12D07-335_A1,0,0,0,0,0,0
ATGTCATAATAAACGA-1_V12D07-335_A1,2,0,0,0,0,2
CTTAATCGACTTAGTA-1_V12D07-335_A1,0,0,3,0,0,3
CTAAAGGATGAGATAC-1_V12D07-335_A1,3,0,0,0,0,3
GTGCTATCCAGCTGGA-1_V12D07-335_A1,2,0,0,0,0,2
GACAGAGGTCTTCAGT-1_V12D07-335_A1,2,1,0,0,0,3
TCGATTTACGAAACGA-1_V12D07-335_A1,3,2,3,0,0,8
AGGCTTAAGTTGCACA-1_V12D07-335_A1,9,0,0,0,0,9
TAGGATCTTAACCGCA-1_V12D07-335_A1,1,0,1,0,0,2
GACTTTCGAGCGGTTC-1_V12D07-335_A1,0,1,2,0,0,3
CCCTGGGAGGGATCCT-1_V12D07-335_A1,3,2,0,0,0,5
TAGTAGTTGCCGGACA-1_V12D07-335_A1,1,1,1,0,0,3
GCCCTAAGTGCAGGAT-1_V12D07-335_A1,0,1,4,0,0,5
ACTTGGGCTTTCGCCA-1_V12D07-335_A1,1,0,3,0,0,4
CATGATACGGTGAAAC-1_V12D07-335_A1,3,0,1,0,0,4
TCCTGCAGCCGCCAAT-1_V12D07-335_A1,1,1,1,0,0,3
GTCCGTTAGAGGGCCT-1_V12D07-335_A1,2,1,0,0,0,3
GCTTTATTAAGTTACC-1_V12D07-335_A1,0,1,0,0,0,1
AATCGAGGTCTCAAGG-1_V12D07-335_A1,2,0,0,0,0,2
GTGCTGTTAGAACATA-1_V12D07-335_A1,2,0,0,0,0,2
GGCTTCTCGTGGGTGG-1_V12D07-335_A1,2,0,0,0,0,2
CCTACAGTTGAGGGAG-1_V12D07-335_A1,1,0,0,0,2,3
TATCCCTCGATCTGCA-1_V12D07-335_A1,3,0,0,0,2,5
CCGGTATCTGGCGACT-1_V12D07-335_A1,1,0,0,0,1,2
CTCTAACACCGGCAGC-1_V12D07-335_A1,1,0,0,0,1,2
CTTCATCACCAGGGCT-1_V12D07-335_A1,0,2,1,0,1,4
GGCTGGCAATCCCACG-1_V12D07-335_A1,1,0,0,0,0,1
CAAACCATAAGCGTAT-1_V12D07-335_A1,0,0,0,0,1,1
CATGTGGGCTCATCAC-1_V12D07-335_A1,1,0,0,0,1,2
CCCGTGACAGTGCCTT-1_V12D07-335_A1,0,1,2,0,0,3
GATTATCTTGCATTAT-1_V12D07-335_A1,2,0,1,0,1,4
GAGTCCACCAGGTTTA-1_V12D07-335_A1,0,0,0,0,0,0
TGTACTATCGCTCGTT-1_V12D07-335_A1,1,0,0,1,1,3
TTAGCGAATAGATAGG-1_V12D07-335_A1,1,1,0,0,2,4
ACATACAATCAAGCGG-1_V12D07-335_A1,1,0,2,1,1,5
ATTCGTGTACCCATTC-1_V12D07-335_A1,0,0,0,0,1,1
GCTAGCAACGCACCTA-1_V12D07-335_A1,0,1,0,0,2,3
ACCTCAGCGAGGCGCA-1_V12D07-335_A1,0,0,0,0,1,1
TCCGGGCCACTAACGG-1_V12D07-335_A1,0,0,0,0,3,3
TCCCAATATCGACGAC-1_V12D07-335_A1,1,0,0,1,3,5
GGATTGAAGTAGCCTC-1_V12D07-335_A1,0,1,0,0,3,4
GGCGCACAGTTTACCT-1_V12D07-335_A1,0,0,0,0,1,1
CCCGGCACGTGTCAGG-1_V12D07-335_A1,0,0,0,0,5,5
AGTAAGGGACAGAATC-1_V12D07-335_A1,0,0,0,0,1,1
TTGCGCACAACCACGT-1_V12D07-335_A1,0,0,0,0,0,0
CCTGCTACAACCATAC-1_V12D07-335_A1,0,0,0,0,1,1
CTGGGCTACTGGAGAG-1_V12D07-335_A1,0,0,0,0,1,1
AGCTACGAATGGTGGT-1_V12D07-335_A1,0,0,0,0,2,2
ATTCGTTTATCGTATT-1_V12D07-335_A1,0,0,0,0,1,1
GGCATTCCCTCCCTCG-1_V12D07-335_A1,0,0,0,0,1,1
AGTTATTCAGACTGTG-1_V12D07-335_A1,0,0,0,0,5,5
CCACTTTCCTTCTAGG-1_V12D07-335_A1,0,0,0,0,2,2
CGCAGTTCTATCTTTC-1_V12D07-335_A1,0,0,0,0,5,5
AGGAGCGTTTATTATC-1_V12D07-335_A1,0,1,0,0,2,3
GACAGGTAATCCGTGT-1_V12D07-335_A1,0,0,0,0,1,1
TTCCCAAAGTACTGAT-1_V12D07-335_A1,0,0,0,0,2,2
CTGCAGGGTGACGCTC-1_V12D07-335_A1,0,0,0,0,0,0
TCATGGAGGCCTTTGT-1_V12D07-335_A1,0,0,0,0,1,1
ATGGCCCGAAAGGTTA-1_V12D07-335_A1,0,0,0,0,0,0
CGTAATATGGCCCTTG-1_V12D07-335_A1,1,0,0,0,1,2
AGAGTCTTAATGAAAG-1_V12D07-335_A1,1,0,0,0,2,3
GAACGTTTGTATCCAC-1_V12D07-335_A1,1,0,0,2,2,5
ATTGAATTCCCTGTAG-1_V12D07-335_A1,0,0,0,0,1,1
TACCTCACCAATTGTA-1_V12D07-335_A1,0,0,0,0,2,2
AGTCGAATTAGCGTAA-1_V12D07-335_A1,0,0,0,0,1,1
TTGAAGTGCATCTACA-1_V12D07-335_A1,0,0,0,0,0,0
