key,microglia,oligo,other,neuron,astrocyte,n_cells
TGTAATGCCTTCGGAC-1_V12D07-335_A1,0,0,2,0,0,2
TACGATCCAAGCCACT-1_V12D07-335_A1,0,0,1,0,0,1
AGATTCAAGCGGGTCG-1_V12D07-335_A1,0,0,2,0,0,2
GTAACATCAGCTCATC-1_V12D07-335_A1,0,0,1,0,0,1
GGGCCTATACAACCGG-1_V12D07-335_A1,0,0,2,0,0,2
AAACCACTACACAGAT-1_V12D07-335_A1,0,0,2,0,0,2
TTGAGGGTCGAACGCG-1_V12D07-335_A1,0,1,1,0,0,2
AGGGTGTGCTACACGC-1_V12D07-335_A1,1,0,4,0,0,5
AATGGCCGCCAATGCG-1_V12D07-335_A1,0,1,4,0,0,5
GGGTCACTGAGTAGTG-1_V12D07-335_A1,0,0,4,0,0,4
GATCTTAGTGAACGTG-1_V12D07-335_A1,1,1,6,0,0,8
CTAATGCGCCCAACAA-1_V12D07-335_A1,0,0,0,0,0,0
GCCACCCATTCCACTT-1_V12D07-335_A1,0,0,0,0,0,0
TAGAACGCCAGTAACG-1_V12D07-335_A1,0,1,0,0,0,1
TGATGGGACTAAGTCA-1_V12D07-335_A1,0,1,3,1,0,5
TCGCCTCGACCTGTTG-1_V12D07-335_A1,0,2,1,0,0,3
AGGAAAGCCTCTGATG-1_V12D07-335_A1,0,0,1,1,0,2
GTATCGGGACGAGCTG-1_V12D07-335_A1,0,0,1,11,0,12
CATACGGGTGCATGAT-1_V12D07-335_A1,0,0,3,10,0,13
AAATTGCGGCGGTTCT-1_V12D07-335_A1,0,1,1,7,0,9
CATTCAGGTCAGTGCG-1_V12D07-335_A1,0,0,2,0,0,2
TGCTATACAAACGGAC-1_V12D07-335_A1,1,3,7,0,0,11
TATTCCGGCAGTCCTA-1_V12D07-335_A1,0,0,1,0,0,1
ATGTGTAGTTTAGTCA-1_V12D07-335_A1,0,2,4,0,0,6
AAGTTTACTAATGGCA-1_V12D07-335_A1,0,2,3,0,0,5
GATTGACACTCTGCTC-1_V12D07-335_A1,0,1,2,0,0,3
ACCGTTCCCGCTCTGA-1_V12D07-335_A1,1,2,0,0,0,3
CATTCACTGACAGCTA-1_V12D07-335_A1,1,0,1,0,0,2
CATGAACCTCTTATCA-1_V12D07-335_A1,1,1,0,0,0,2
AATAAGTCCTCGAGAC-1_V12D07-335_A1,1,3,0,0,0,4
CTACGAACTAGGTCGA-1_V12D07-335_A1,1,2,3,0,0,6
CACTACTCAGTTCTGT-1_V12D07-335_A1,1,1,2,0,0,4
CATTTATCGTTCAAGA-1_V12D07-335_A1,2,0,0,0,0,2
TAGAAACCACTAAGTA-1_V12D07-335_A1,0,1,2,0,0,3
TCGTATTTCGTCCGGA-1_V12D07-335_A1,0,1,2,0,0,3
ATCCACGCTAAATGTT-1_V12D07-335_A1,3,1,1,0,0,5
ATAAAGGTCAAGTACG-1_V12D07-335_A1,0,3,3,0,0,6
TAGGAACAGCCTCCAG-1_V12D07-335_A1,0,0,2,0,0,2
CACACGTTTCAATGGG-1_V12D07-335_A1,1,2,3,0,0,6
AGTAACGTTCATCCTG-1_V12D07-335_A1,0,3,4,0,0,7
GTATAGTGGCCCATGT-1_V12D07-335_A1,0,4,1,0,0,5
TCTACACGTTCATGCA-1_V12D07-335_A1,0,1,1,0,0,2
AATCTGGGTAGACCCT-1_V12D07-335_A1,0,1,1,0,0,2
TCGGTTAGCCATGTAG-1_V12D07-335_A1,2,1,1,0,0,4
TGCCATGGCTTATAAG-1_V12D07-335_A1,0,6,2,0,0,8
TAAGTAAATGTGCCGC-1_V12D07-335_A1,0,2,3,0,0,5
GTGTCCGATAAGGCAT-1_V12D07-335_A1,0,1,3,0,0,4
TGGCACGAGCTCGAGT-1_V12D07-335_A1,0,4,4,0,0,8
ACCGGTCTGAGTACGG-1_V12D07-335_A1,1,0,5,0,0,6
GAACTTAGCGCCCGGT-1_V12D07-335_A1,0,7,3,0,0,10
AGTAGCTAGACGCCGA-1_V12D07-335_A1,0,0,1,0,0,1
ATAGGAATCTAAGCTT-1_V12D07-335_A1,1,0,3,0,0,4
CTTCCTGCATATTTAC-1_V12D07-335_A1,0,0,0,4,0,4
CAATATGTAGATTTAC-1_V12D07-335_A1,0,1,3,0,0,4
ACAAGGCCTACCAGCC-1_V12D07-335_A1,0,0,1,0,0,1
TTATAGTCCAAGGTGC-1_V12D07-335_A1,0,0,3,0,0,3
AAACGCCCGAGATCGG-1_V12D07-335_A1,0,0,5,0,0,5
CCTCGTTACGCCTGTT-1_V12D07-335_A1,0,0,3,0,0,3
GAACGGTGTAAAGCAG-1_V12D07-335_A1,0,0,1,0,0,1
ACGCATAAATGACATG-1_V12D07-335_A1,0,0,1,0,0,1
GGTTCGATGCTGAGTT-1_V12D07-335_A1,0,0,0,0,0,0
CTTTGGCAGACAGAGT-1_V12D07-335_A1,0,0,0,0,0,0
TTCGTGGGCTGGAAGC-1_V12D07-335_A1,0,0,1,0,0,1
CAAAGGTTAAATTCAG-1_V12D07-335_A1,1,2,2,0,0,5
GTTTGGCGTCAGGCAC-1_V12D07-335_A1,0,0,2,0,0,2
GCTTTCTATCTCAACT-1_V12D07-335_A1,1,1,1,0,0,3
TGCATCTCCGGATCTT-1_V12D07-335_A1,0,1,3,0,0,4
CTGAAACGGCCCTCAG-1_V12D07-335_A1,0,1,3,0,0,4
TAGCAGTAAATACGCG-1_V12D07-335_A1,0,2,3,0,0,5
CGGGCTACTTAAATTG-1_V12D07-335_A1,0,1,2,0,0,3
ATTATGCTCAGTATTG-1_V12D07-335_A1,0,0,0,1,0,1
TGATGCTCACGTAGTC-1_V12D07-335_A1,1,0,0,0,0,1
GTCTAAGATGCCCAGC-1_V12D07-335_A1,0,0,0,0,0,0
AACCCGATAGGGCTTC-1_V12D07-335_A1,0,0,0,0,0,0
CGCTATCGTGGCTTTA-1_V12D07-335_A1,1,0,0,0,0,1
CGTCTCTCGCCGAGGC-1_V12D07-335_A1,0,0,1,0,0,1
AGTGGGAGTATACACG-1_V12D07-335_A1,0,0,0,0,0,0
GGTCTTGGTGTTAACT-1_V12D07-335_A1,0,0,0,0,0,0
GGCTGGCAGCTTTATG-1_V12D07-335_A1,0,0,0,0,0,0
CGCCAATTATTGCGTT-1_V12D07-335_A1,0,0,0,0,0,0
GGTAACCGGCAAAGGT-1_V12D07-335_A1,0,0,0,0,0,0
TGGGACCATTGGGAGT-1_V12D07-335_A1,0,0,0,0,0,0
CTGCAGGTGCTCGGCC-1_V12D07-335_A1,0,0,0,0,0,0
CCGGTGCGAGTGATAG-1_V12D07-335_A1,0,0,0,0,0,0
GGGTACACTCTGGAGG-1_V12D07-335_A1,0,1,4,0,0,5
TAGCCAGAGGGTCCGG-1_V12D07-335_A1,0,0,0,0,0,0
CTTGTGAGGACAGCGG-1_V12D07-335_A1,0,0,1,0,0,1
GAAGGGCATAACCATG-1_V12D07-335_A1,0,3,1,0,0,4
CAACATGGCCTGATAA-1_V12D07-335_A1,0,0,0,0,0,0
CAATTTGACCGGGAAG-1_V12D07-335_A1,2,0,3,0,0,5
TCTGACTGTAATGGTT-1_V12D07-335_A1,1,1,0,5,0,7
TTCATAGCCTTGTAAC-1_V12D07-335_A1,0,0,0,2,0,2
TGGAAACGGAGTGAAC-1_V12D07-335_A1,0,0,1,16,0,17
ATCGCACGATTGTTCA-1_V12D07-335_A1,0,0,0,20,0,20
CGCCACCCGCATTAAC-1_V12D07-335_A1,0,0,3,18,0,21
TGGACCACGGCGTTGA-1_V12D07-335_A1,1,0,2,11,0,14
GTATATGTTACGGCGG-1_V12D07-335_A1,0,0,0,20,0,20
GTATTCTTACCGTGCT-1_V12D07-335_A1,0,1,3,5,0,9
TTCAGAGTAACCTGAC-1_V12D07-335_A1,0,0,1,11,0,12
GCGGTAACCCAAATGA-1_V12D07-335_A1,0,0,2,12,0,14
CTACGTGTTGCCACCA-1_V12D07-335_A1,0,2,0,3,0,5
CTAGATAAACTCCTCG-1_V12D07-335_A1,0,0,1,15,0,16
TCCATTAGTTGGATAG-1_V12D07-335_A1,0,0,0,0,0,0
CTGGCTCCTGCGGGAT-1_V12D07-335_A1,0,0,0,10,0,10
CAGTCTCTCGGCTAAT-1_V12D07-335_A1,0,1,0,0,0,1
GTATGACGTGGGAAAC-1_V12D07-335_A1,0,0,2,12,0,14
AGTCACTCCGCCTCAT-1_V12D07-335_A1,0,0,1,0,0,1
GCAGCGGTGGGCATTA-1_V12D07-335_A1,0,0,1,8,0,9
TATGGAGTTTCTCGTT-1_V12D07-335_A1,0,0,1,0,0,1
ACTCAACGAATGTATT-1_V12D07-335_A1,0,0,5,7,0,12
AACACGCGGCCGCGAA-1_V12D07-335_A1,0,0,0,17,0,17
CGATATTAGCCGCAGG-1_V12D07-335_A1,0,1,2,0,0,3
AGCGTCTGAACCCGCA-1_V12D07-335_A1,0,0,3,2,0,5
GATGTCCGGATCACAT-1_V12D07-335_A1,0,0,1,0,0,1
GGTCACGTTAGATTCA-1_V12D07-335_A1,1,0,1,3,0,5
TTAAGGATACGGAGGT-1_V12D07-335_A1,0,0,2,0,0,2
GTGCGGGACCATCGGC-1_V12D07-335_A1,1,0,1,1,0,3
CCATCTTGTTCACAAT-1_V12D07-335_A1,0,0,8,0,0,8
TCCGAGAAGGCTAAGC-1_V12D07-335_A1,0,0,1,0,0,1
TGGCGGTGTGCGATTG-1_V12D07-335_A1,0,0,1,1,0,2
ATCCTGCTGCAGATAG-1_V12D07-335_A1,1,0,1,0,0,2
TTATGCGTCCCGGTCC-1_V12D07-335_A1,1,0,3,0,0,4
CATAATGAGCGGGCGA-1_V12D07-335_A1,0,0,1,0,0,1
AGACATAGATCCTTCC-1_V12D07-335_A1,0,0,2,0,0,2
GGTGAAACCGGGAATG-1_V12D07-335_A1,0,0,2,0,0,2
AACTGGTGTGGGCCTT-1_V12D07-335_A1,0,3,2,1,0,6
GTAGCGCTGTTGTAGT-1_V12D07-335_A1,0,0,2,0,0,2
TTGTTTGTGTAAATTC-1_V12D07-335_A1,0,0,0,1,0,1
GGATCAAAGGACGAGG-1_V12D07-335_A1,0,1,0,0,0,1
CGTAGCGCCGACGTTG-1_V12D07-335_A1,0,0,3,0,0,3
CAAGTGAACTTTGGTT-1_V12D07-335_A1,1,0,5,0,0,6
GTAGACAACCGATGAA-1_V12D07-335_A1,0,1,1,0,0,2
CAATGGTCGGCCTGGG-1_V12D07-335_A1,0,2,7,0,0,9
ACAGATTAGGTTAGTG-1_V12D07-335_A1,1,1,3,0,0,5
GTTATCACCTTCTGAA-1_V12D07-335_A1,1,3,2,0,0,6
TGGTATCGGTCTGTAT-1_V12D07-335_A1,0,2,3,0,0,5
GGAATAACCTCAAGAA-1_V12D07-335_A1,0,0,4,0,0,4
ATTATCTCGACAGATC-1_V12D07-335_A1,0,1,0,0,0,1
CCGAGGGATGTTAGGC-1_V12D07-335_A1,0,3,0,0,0,3
TGAGATCAAATACTCA-1_V12D07-335_A1,0,0,0,0,0,0
AAACGAAGAACATACC-1_V12D07-335_A1,0,3,2,0,0,5
CTGGTCCTAACTTGGC-1_V12D07-335_A1,0,1,1,0,0,2
TGCACGAGTCGGCAGC-1_V12D07-335_A1,0,1,0,0,0,1
ATAGTCTTTGACGTGC-1_V12D07-335_A1,0,2,0,0,0,2
TGGAGCTAAAGTTCCC-1_V12D07-335_A1,0,1,4,0,0,5
GGGTGGTCCAGCCTGT-1_V12D07-335_A1,1,0,3,0,0,4
CATGCATGGAGACCCT-1_V12D07-335_A1,3,1,1,0,0,5
ACACGGCACTATGCAT-1_V12D07-335_A1,0,1,3,0,0,4
CCCTGGTATGGGCGGC-1_V12D07-335_A1,1,3,1,0,0,5
GGAGGATTGAAAGGAG-1_V12D07-335_A1,0,1,3,0,0,4
CCGCTGGTGCCATTCA-1_V12D07-335_A1,1,1,0,0,0,2
GTTAGAGTGTGCCGCT-1_V12D07-335_A1,2,0,3,0,0,5
TCGGAATGACCATCAA-1_V12D07-335_A1,0,1,1,0,0,2
TTCAATTAGCCATAAT-1_V12D07-335_A1,0,2,2,0,0,4
GATGTGTTGTCACAAG-1_V12D07-335_A1,4,0,1,0,0,5
TCTTTCTCTTAAGGAG-1_V12D07-335_A1,2,1,1,0,0,4
ACCCTTTAGTTCTCCA-1_V12D07-335_A1,1,1,0,0,0,2
ACCACAACTCAGAACA-1_V12D07-335_A1,1,1,3,0,0,5
TATGATAAATCTAACG-1_V12D07-335_A1,1,1,1,0,0,3
GATCCTCTTGCGCTTA-1_V12D07-335_A1,0,1,2,0,0,3
TTCTACCTTTATGTTG-1_V12D07-335_A1,2,1,1,0,0,4
GAAATACCTGCTGGCT-1_V12D07-335_A1,2,3,0,0,0,5
ATTCTGAGTATGAACT-1_V12D07-335_A1,2,0,1,0,0,3
GGATTAAGCTAAGGTC-1_V12D07-335_A1,2,3,2,0,0,7
AGTACGTGGCCTGTCT-1_V12D07-335_A1,3,7,0,0,0,10
TCAGGGTGCACGAAAC-1_V12D07-335_A1,0,1,1,0,0,2
AAATTTACCGAAATCC-1_V12D07-335_A1,3,2,1,0,0,6
TTGAGGCATTTAACTC-1_V12D07-335_A1,2,0,0,0,0,2
AACCAGTATCACTCTT-1_V12D07-335_A1,1,1,2,0,0,4
CACCGGAGATATCTCC-1_V12D07-335_A1,0,1,2,0,0,3
GACTGGGCGCCGCAAC-1_V12D07-335_A1,2,3,1,0,0,6
CACGTCTATGATGTGG-1_V12D07-335_A1,2,1,1,0,1,5
TTAAGACGAACGAACC-1_V12D07-335_A1,1,2,5,0,0,8
TGACCAGCTTCAAAGT-1_V12D07-335_A1,1,2,1,0,0,4
AGAGTTAGAGACCGAT-1_V12D07-335_A1,0,0,2,0,0,2
TTCGGACTGATGCCTT-1_V12D07-335_A1,1,2,5,0,0,8
CTCGAATGGAACGTAT-1_V12D07-335_A1,0,4,1,0,0,5
GGACGGCTTGCGCAAC-1_V12D07-335_A1,0,1,4,0,0,5
CTAAGTACAGGGCTAC-1_V12D07-335_A1,0,3,2,0,0,5
ACAAATTCAGATCTGA-1_V12D07-335_A1,2,1,2,0,0,5
CATGGAAATGGGACCA-1_V12D07-335_A1,1,2,4,0,0,7
GGTGGACCACGTGTTA-1_V12D07-335_A1,0,0,3,0,0,3
CACGACGTAATAGTAA-1_V12D07-335_A1,0,0,3,0,0,3
CGGGTTCGGCACGTAT-1_V12D07-335_A1,0,0,5,0,0,5
CTGGGCTATCCTTTGG-1_V12D07-335_A1,0,2,1,0,0,3
GTATTAGGGTTCGCGT-1_V12D07-335_A1,0,0,4,0,0,4
TCATTCGTATAATTTG-1_V12D07-335_A1,0,0,2,0,0,2
AATAGCAAGCCTCCTG-1_V12D07-335_A1,0,0,1,0,0,1
CATCTACCCGAGAACG-1_V12D07-335_A1,0,0,0,0,0,0
GCTTCAGTGGGATTAC-1_V12D07-335_A1,0,0,1,0,0,1
TCTGTGATGGAGGTTG-1_V12D07-335_A1,0,0,1,0,0,1
ATCCACTTTCAGACTA-1_V12D07-335_A1,0,1,0,0,0,1
ATGGTTACGAAACATG-1_V12D07-335_A1,1,1,1,0,0,3
GGCCCAATCTAGAGGG-1_V12D07-335_A1,0,0,1,0,0,1
GATGGTGAAATAACCC-1_V12D07-335_A1,0,0,0,0,0,0
AGAGGGACAATTGTCC-1_V12D07-335_A1,0,0,0,0,0,0
CGCGTACATTCTGGAA-1_V12D07-335_A1,0,0,4,0,0,4
CAAGAAACCCTAAACT-1_V12D07-335_A1,1,0,4,0,0,5
TTGGTGCGGTGTTGAA-1_V12D07-335_A1,1,1,0,0,0,2
GGTTCCCTAGTGTCTC-1_V12D07-335_A1,0,0,2,0,0,2
CGATAACCAATTTGAG-1_V12D07-335_A1,0,2,2,0,0,4
GCCCACTGGTCCACAA-1_V12D07-335_A1,2,1,2,1,0,6
GAGGGCCGGCAGAGTC-1_V12D07-335_A1,0,2,0,0,0,2
CGACACGGATGCCCAC-1_V12D07-335_A1,0,3,0,0,0,3
CTGTCTGTGGCTGGCT-1_V12D07-335_A1,0,0,0,0,0,0
ATATTATCCCGTATTT-1_V12D07-335_A1,0,0,0,0,0,0
GCGCTGGCGGAAAGTC-1_V12D07-335_A1,0,0,0,0,0,0
ATCTAACGTCCCTATG-1_V12D07-335_A1,0,0,0,0,0,0
GTCAGACAGCGTTGGA-1_V12D07-335_A1,0,0,0,0,0,0
GCCAGGCTTAGTGGTA-1_V12D07-335_A1,0,0,0,0,0,0
ATTCAAAGTACCTGTT-1_V12D07-335_A1,0,0,0,0,0,0
TGGACGTAGGCGAATC-1_V12D07-335_A1,0,0,0,0,0,0
ACACATTGACGCAACA-1_V12D07-335_A1,0,4,3,0,0,7
GATATCAGTATGTATC-1_V12D07-335_A1,0,1,0,1,0,2
TGGGCCTTGCCTGCAT-1_V12D07-335_A1,0,0,0,0,0,0
CAAAGTCAGGTTAGCT-1_V12D07-335_A1,1,6,0,0,0,7
GGATCCCTACCAGCTA-1_V12D07-335_A1,1,1,0,0,0,2
ATCGTCCAATCGAGTC-1_V12D07-335_A1,0,1,2,0,0,3
ACATGGCTCAATTTAG-1_V12D07-335_A1,0,0,3,0,0,3
AGGCCCAGTGACTGGT-1_V12D07-335_A1,0,0,0,0,0,0
GCTTCCAGCTTAGATT-1_V12D07-335_A1,0,0,3,1,0,4
TGCTTGAAACCATGCA-1_V12D07-335_A1,1,0,2,4,0,7
CAATATTGGACTAGTG-1_V12D07-335_A1,0,0,1,20,0,21
CGTGCTGGCCTAGTCG-1_V12D07-335_A1,0,0,0,28,0,28
CCTGCGATAGAACTGT-1_V12D07-335_A1,0,0,3,6,0,9
GGGTAATGCTGTGTTT-1_V12D07-335_A1,0,0,2,8,0,10
AACGCGAACGGCAACA-1_V12D07-335_A1,1,0,5,1,0,7
TGTCGGCATGGTGGAA-1_V12D07-335_A1,0,0,3,0,0,3
AGCGTACGAGAGCTAG-1_V12D07-335_A1,0,0,1,5,0,6
ATACTCTCGCCACTCT-1_V12D07-335_A1,1,0,2,0,0,3
AATCCATGCAAGGGTG-1_V12D07-335_A1,0,0,2,2,0,4
TTAAACAGAGTCCCGC-1_V12D07-335_A1,0,0,5,0,0,5
CCACAGCTGAAATCAT-1_V12D07-335_A1,0,2,2,2,0,6
CGGTTCCGGCTTCTTG-1_V12D07-335_A1,0,1,3,0,0,4
GACGTGAGACTCCATG-1_V12D07-335_A1,0,0,3,2,0,5
TCGTTGGCTCGTCAAT-1_V12D07-335_A1,1,2,0,1,0,4
GGTGAACGGGCTAGCC-1_V12D07-335_A1,0,0,1,1,0,2
GCACTGTGCAAATGTA-1_V12D07-335_A1,0,1,2,1,0,4
ACGAGAACCCATCACG-1_V12D07-335_A1,0,1,1,1,0,3
CCAGCTACGCCTCATA-1_V12D07-335_A1,0,0,3,0,0,3
TCCCGGTCAGGAATTT-1_V12D07-335_A1,0,1,3,0,0,4
TCGCATTCAATGACTT-1_V12D07-335_A1,0,3,1,1,0,5
CTGGTTCAACGCATCA-1_V12D07-335_A1,0,0,2,1,0,3
GGTGATTTCATCTTGT-1_V12D07-335_A1,0,0,3,1,0,4
CACCCTTTCCTCGCTC-1_V12D07-335_A1,0,1,0,0,0,1
CAACTTGTAGTGGGCA-1_V12D07-335_A1,0,0,0,0,0,0
AATATCAAGGTCGGAT-1_V12D07-335_A1,0,1,0,0,0,1
ACTCAGACCTGCTTCT-1_V12D07-335_A1,0,0,1,0,0,1
TTGGAGTCTCCCTTCT-1_V12D07-335_A1,0,1,2,0,0,3
GGATACTCATGAATTG-1_V12D07-335_A1,0,0,1,0,0,1
TGGGCACAAACAGAAC-1_V12D07-335_A1,0,0,3,1,0,4
GAGCCACGGTAGTAGG-1_V12D07-335_A1,0,3,2,0,0,5
TCGATAGGCTAGTCGC-1_V12D07-335_A1,1,0,3,0,0,4
TAACCGCCCGCAGTGC-1_V12D07-335_A1,0,0,3,0,0,3
GCCTATTTGCTACACA-1_V12D07-335_A1,0,2,2,1,0,5
TTGACGATTCAGCACG-1_V12D07-335_A1,1,2,0,0,0,3
TTAAACCGGTAGCGAC-1_V12D07-335_A1,0,0,0,0,0,0
ACCGAAAGGGCCCTGC-1_V12D07-335_A1,0,0,3,0,0,3
ACGTTCCGCGCTCCGT-1_V12D07-335_A1,1,0,4,0,0,5
ATACCAGGCTAATAGA-1_V12D07-335_A1,0,1,1,0,0,2
CGGCTTTGTATGATAA-1_V12D07-335_A1,0,0,5,0,0,5
CTTGACCCGAAAGATA-1_V12D07-335_A1,0,2,4,0,0,6
CGCAGAAACATTTGCG-1_V12D07-335_A1,1,0,7,0,0,8
GACCCGTCGCCGGCTA-1_V12D07-335_A1,1,1,6,0,0,8
AATCGGGACACTACGA-1_V12D07-335_A1,1,2,2,0,0,5
GTCACAAAGTTTCCAA-1_V12D07-335_A1,0,1,2,0,0,3
TATATTCGCGTCGATA-1_V12D07-335_A1,0,0,1,0,0,1
CCTCCCGACAATCCCT-1_V12D07-335_A1,1,1,3,0,0,5
CGACATGCGATCTTCT-1_V12D07-335_A1,2,3,3,0,0,8
AACACGACTGTACTGA-1_V12D07-335_A1,2,2,3,0,0,7
CCCAACCACACTAACA-1_V12D07-335_A1,0,1,2,0,0,3
CACCGCCGACCAGCGA-1_V12D07-335_A1,0,2,2,0,0,4
TGGTATCGCATCCCAA-1_V12D07-335_A1,1,5,1,0,0,7
CAGAGTGATTTAACGT-1_V12D07-335_A1,2,6,0,0,0,8
AACCCTGGTGGAACCA-1_V12D07-335_A1,0,2,2,0,0,4
GTCAGTTGTGCTCGTT-1_V12D07-335_A1,0,0,1,0,0,1
ATTGACGTAACTCGGT-1_V12D07-335_A1,0,4,0,0,0,4
GATGTCGGTCAACTGC-1_V12D07-335_A1,0,3,2,0,0,5
AGGGCAGCGGCGTGGT-1_V12D07-335_A1,3,0,2,0,0,5
ACATCGTTAACCTAGT-1_V12D07-335_A1,0,1,0,0,0,1
TCCATTGTGACCTCGT-1_V12D07-335_A1,1,3,2,0,0,6
TGTTTAATACTTCATC-1_V12D07-335_A1,0,0,2,0,0,2
TTGCTGGCCGGGCTTC-1_V12D07-335_A1,0,2,2,0,0,4
CATATTATTTGCCCTA-1_V12D07-335_A1,0,4,1,0,0,5
CTGCCTAGCCACCAAG-1_V12D07-335_A1,0,0,1,0,0,1
ACGAGATATTTGCTTA-1_V12D07-335_A1,0,2,1,0,0,3
GACTACAATTGCTCGT-1_V12D07-335_A1,0,0,2,0,0,2
AACGTGATGAAGGACA-1_V12D07-335_A1,0,1,1,0,0,2
ACTCTCTTATACACGA-1_V12D07-335_A1,0,2,1,0,0,3
CGCATCATGGCTTCAG-1_V12D07-335_A1,1,2,2,0,0,5
CGGCTCTTCGTCGAAC-1_V12D07-335_A1,0,2,0,0,0,2
ATTCTTCGTACTTATG-1_V12D07-335_A1,1,1,0,0,0,2
AGTGAGGGTTTCTGAC-1_V12D07-335_A1,1,1,4,0,0,6
GCCAGGCGTTCGCATG-1_V12D07-335_A1,0,1,0,0,0,1
GACTAACACAGCACCT-1_V12D07-335_A1,1,0,1,0,0,2
CAATGGAATCTACATA-1_V12D07-335_A1,2,0,2,0,0,4
GTGGTCAGCGAAGTAT-1_V12D07-335_A1,2,1,2,0,0,5
ATGGCTGGAAATGGCC-1_V12D07-335_A1,0,1,3,0,0,4
ATCAGGTCGCCATTGC-1_V12D07-335_A1,2,3,0,0,0,5
TATCACCATGTAAAGT-1_V12D07-335_A1,3,0,4,0,0,7
AGCGCTTATGGGCAAG-1_V12D07-335_A1,2,2,2,0,0,6
AAGCGGCGTCATGGGT-1_V12D07-335_A1,4,1,4,0,0,9
ACTAATACGTCAGGCG-1_V12D07-335_A1,0,0,1,0,0,1
GGCTGAGCATCGTAAG-1_V12D07-335_A1,1,0,5,0,0,6
CGGTTGGGTTCAAGTT-1_V12D07-335_A1,2,1,2,0,0,5
GACTGATTGGTCACAA-1_V12D07-335_A1,3,0,3,0,0,6
AGACGGGCCGATTTAA-1_V12D07-335_A1,3,0,6,0,0,9
ACCAGTGCCCGGTCAA-1_V12D07-335_A1,1,1,2,0,0,4
GTCCTTTAATGACTTC-1_V12D07-335_A1,0,1,2,0,0,3
CCTACAAGTCCGGAAT-1_V12D07-335_A1,1,1,8,0,0,10
GCCTGCTACACTGAGA-1_V12D07-335_A1,0,2,6,0,0,8
GACTCGGTCGGCGGAT-1_V12D07-335_A1,0,1,6,0,0,7
CTAGACATATATGTAG-1_V12D07-335_A1,0,1,5,0,0,6
TCGCCCAACTGACTCC-1_V12D07-335_A1,1,0,1,0,0,2
AAACTAACGTGGCGAC-1_V12D07-335_A1,0,0,6,0,0,6
AACTGAGGTCAGCGTC-1_V12D07-335_A1,0,0,5,0,0,5
ACAATGATTCTTCTAC-1_V12D07-335_A1,0,0,1,0,0,1
ATAAGTACCCGATTGT-1_V12D07-335_A1,0,0,1,0,0,1
ATTGGGAGTTCTGTAA-1_V12D07-335_A1,0,0,4,0,0,4
CGAACATAGTCAGAAA-1_V12D07-335_A1,0,0,2,0,0,2
TAGCTCAGATCCTAGT-1_V12D07-335_A1,0,0,4,0,0,4
GTGTCGTATTCACCTT-1_V12D07-335_A1,0,0,0,0,0,0
CTCACCGATCCAAACT-1_V12D07-335_A1,0,0,0,0,0,0
ATATGTGCACAAACCA-1_V12D07-335_A1,0,0,0,0,0,0
CAGTCCAACGCCTTCT-1_V12D07-335_A1,0,1,2,0,0,3
TCGTCCGGGTACACTC-1_V12D07-335_A1,0,0,0,0,0,0
GCAGAAACGTAATCCA-1_V12D07-335_A1,1,0,0,0,0,1
TTCGAGCCGGCGCTAC-1_V12D07-335_A1,0,0,0,0,0,0
GGAAGATAAGACTGTA-1_V12D07-335_A1,1,1,1,0,0,3
ATAAGCAAACACCGAG-1_V12D07-335_A1,0,1,1,0,0,2
GCATAAATTGAACGCC-1_V12D07-335_A1,0,1,4,0,0,5
CGCCGGTGTCGCAGTA-1_V12D07-335_A1,0,0,3,0,0,3
GACCTGGTCTGGGCGT-1_V12D07-335_A1,0,0,0,0,0,0
AGCCGCTTGATTAGCG-1_V12D07-335_A1,0,0,0,0,0,0
CCCGGCTAGGTGAGAA-1_V12D07-335_A1,0,0,0,0,0,0
CGAGCCGAGCACTCGA-1_V12D07-335_A1,0,0,0,0,0,0
TAGTGCTTGAATCCTT-1_V12D07-335_A1,0,0,0,0,0,0
CAACCGCACCTAGACA-1_V12D07-335_A1,0,0,0,0,0,0
ACCACTGTTCAAGAAG-1_V12D07-335_A1,0,0,0,0,0,0
AGATGCTATAACGAGC-1_V12D07-335_A1,0,0,0,0,0,0
AATTACTCGTACGCTC-1_V12D07-335_A1,1,5,0,0,0,6
CGTCAATCTTTAACAT-1_V12D07-335_A1,0,4,0,0,0,4
CCAAAGCAGTTGGTTG-1_V12D07-335_A1,0,0,2,1,0,3
CCATATTGGATCATGA-1_V12D07-335_A1,0,0,2,0,0,2
CGTACCGAAAGTCTAG-1_V12D07-335_A1,0,1,1,0,0,2
CTCGAGATCCAAAGCA-1_V12D07-335_A1,1,0,1,0,0,2
TGGATAGAGTAACAGA-1_V12D07-335_A1,0,0,0,0,0,0
TCACAGATCCTCAAAC-1_V12D07-335_A1,0,2,4,0,0,6
AGAGCTACGAAAGCAT-1_V12D07-335_A1,0,0,0,0,0,0
TGCGTGATTGGGTGTC-1_V12D07-335_A1,1,0,0,1,0,2
CACATGTTTGGACATG-1_V12D07-335_A1,0,1,2,4,0,7
TTCGCATCCGGAAGCA-1_V12D07-335_A1,0,0,1,6,0,7
CCCTAGTGTCAGGTGT-1_V12D07-335_A1,0,1,4,12,0,17
TTACCGCCTTAGGGAA-1_V12D07-335_A1,0,0,1,21,0,22
CCAGTCCATTATTCGA-1_V12D07-335_A1,0,0,0,9,0,9
CGTAAACGCTTGAGTG-1_V12D07-335_A1,0,0,4,5,0,9
ATTCCTTCCAGGCGGT-1_V12D07-335_A1,0,1,4,1,0,6
TTCCTTTCTGTGTTGC-1_V12D07-335_A1,0,1,2,3,0,6
AGTTGACATCGGCTGG-1_V12D07-335_A1,0,0,2,0,0,2
AACTCGATGGCGCAGT-1_V12D07-335_A1,0,0,3,0,0,3
GATAAGGCAGATGCAA-1_V12D07-335_A1,0,0,1,0,0,1
GGCTGGCTAGCTTAAA-1_V12D07-335_A1,0,0,1,0,0,1
CCTCATGCAGCTACGA-1_V12D07-335_A1,0,2,0,2,0,4
GACGCCTGTTGCAGGG-1_V12D07-335_A1,0,0,3,0,0,3
TAATTAGATGGATATG-1_V12D07-335_A1,0,0,1,1,0,2
GAGGGCATCGCGTATC-1_V12D07-335_A1,0,0,0,0,0,0
CTTGTGAGTCTTTGAC-1_V12D07-335_A1,0,0,0,0,0,0
TCAACACATTGGGTAA-1_V12D07-335_A1,0,0,0,1,0,1
ACTGTATACGCGAGCA-1_V12D07-335_A1,0,0,0,1,0,1
GTGAAACGTGCTCCAC-1_V12D07-335_A1,1,0,2,0,0,3
CGAGTGCTATAGTTCG-1_V12D07-335_A1,0,1,2,1,0,4
GTACTGCATGAAGCGT-1_V12D07-335_A1,0,0,0,0,0,0
GTAACTTGCGGCAGTC-1_V12D07-335_A1,0,2,1,1,0,4
GAATCGCCGGACACGG-1_V12D07-335_A1,0,1,4,0,0,5
GGGAGTAATGGCTGGC-1_V12D07-335_A1,0,0,2,0,0,2
CATGAACCGACATTTG-1_V12D07-335_A1,0,1,0,0,0,1
TCTGTCATACAAGAGC-1_V12D07-335_A1,1,0,5,0,0,6
GTCGTCAATTATAAGG-1_V12D07-335_A1,0,0,3,0,0,3
TAAAGAGCCCGAAACC-1_V12D07-335_A1,0,0,1,1,0,2
GTACTGAGGTCGTAAC-1_V12D07-335_A1,1,0,2,0,0,3
AAAGACCCAAGTCGCG-1_V12D07-335_A1,1,2,3,0,0,6
CGTCAGTGCGCACAAG-1_V12D07-335_A1,0,0,2,0,0,2
TGTATCCTTATTCCAT-1_V12D07-335_A1,0,0,3,0,0,3
ATTCTCGTCTCTTTAG-1_V12D07-335_A1,0,2,3,0,0,5
AAAGTCACTGATGTAA-1_V12D07-335_A1,2,0,0,0,0,2
TGTCTACAGTTTCTGT-1_V12D07-335_A1,0,1,0,0,0,1
TTAACGTCGCAAGACC-1_V12D07-335_A1,0,1,0,0,0,1
CTATGTCTATTGAAAC-1_V12D07-335_A1,0,0,1,0,0,1
TCGGGTGAAACTGCTA-1_V12D07-335_A1,0,1,3,0,0,4
TGTCCCGACATAGCAC-1_V12D07-335_A1,1,0,2,0,0,3
ACAGCATAGAGCCAGT-1_V12D07-335_A1,1,0,1,0,0,2
ATATTCCCACAGGTCA-1_V12D07-335_A1,0,1,3,0,0,4
TTGGATCGACTTCTGG-1_V12D07-335_A1,1,0,6,0,0,7
CACCATCGGAGGAGAC-1_V12D07-335_A1,0,3,9,0,0,12
TCGTTCGTTATTATGT-1_V12D07-335_A1,1,1,1,0,0,3
CTTAACTTCGAAGTAC-1_V12D07-335_A1,0,3,2,0,0,5
GCACAAGTGTCGGAAG-1_V12D07-335_A1,0,3,0,0,0,3
TACCAGCTAGGTTTAA-1_V12D07-335_A1,1,1,3,0,0,5
ACGTACAGATTTCTCT-1_V12D07-335_A1,3,2,2,0,0,7
AATTTGGTTCCAAAGA-1_V12D07-335_A1,2,4,0,0,0,6
GTAAGGATTTGTCGGA-1_V12D07-335_A1,0,4,1,0,0,5
CATCATCTACCCGGAC-1_V12D07-335_A1,1,0,2,0,0,3
ACGATGGATCCGATGC-1_V12D07-335_A1,0,1,1,0,0,2
CACTCAGCTCTTGAGG-1_V12D07-335_A1,0,2,2,0,0,4
TAGATCCGAAGTCGCA-1_V12D07-335_A1,1,3,0,0,0,4
TGAAACTTATGCAAGC-1_V12D07-335_A1,1,1,1,0,0,3
GCGATTCTGGAAGCAG-1_V12D07-335_A1,1,5,0,0,0,6
CAAACTATTGAGCTTC-1_V12D07-335_A1,0,0,3,0,0,3
TAGAATTAAGGGCAAC-1_V12D07-335_A1,1,0,1,0,0,2
CGAAACATAGATGGCA-1_V12D07-335_A1,2,1,1,0,0,4
GATGGTGCCCTAGGCA-1_V12D07-335_A1,1,4,0,0,0,5
CCCGCAGGGCCCAAAG-1_V12D07-335_A1,2,2,2,0,0,6
ACAGCGCACCCGCAGC-1_V12D07-335_A1,2,1,2,0,0,5
GGTAAATGTGCGTTAC-1_V12D07-335_A1,0,1,1,0,0,2
GTCCTTCTAGTGGGTT-1_V12D07-335_A1,1,1,4,0,0,6
GGAAGCTCGCTTACAG-1_V12D07-335_A1,1,1,1,0,0,3
CACCGATACACCGAGC-1_V12D07-335_A1,0,0,4,0,0,4
CAGCCGGGCCCTCTAT-1_V12D07-335_A1,0,0,0,0,0,0
CGGAGCTTATAACACC-1_V12D07-335_A1,1,1,1,0,0,3
ATTACAACTACCGGCC-1_V12D07-335_A1,3,1,1,0,0,5
TCCTCTGGCCCATTAG-1_V12D07-335_A1,1,3,2,0,0,6
CGGCACCGTTAGCGCC-1_V12D07-335_A1,0,2,2,0,1,5
TCGGTCCCTGACTCCA-1_V12D07-335_A1,3,3,4,0,0,10
TGGTTGGAGGATCCTG-1_V12D07-335_A1,0,2,3,0,0,5
CTGCGGTAGTCACGTG-1_V12D07-335_A1,1,2,0,0,0,3
GTGCCTCAGTGTACGG-1_V12D07-335_A1,0,1,1,0,0,2
ATCGTTCACTTTCGCC-1_V12D07-335_A1,0,2,1,0,0,3
ACTTACCGGGCGCGCA-1_V12D07-335_A1,1,3,0,0,0,4
CTAGACTGCATTTCGT-1_V12D07-335_A1,0,0,2,0,0,2
TTGCCGGTGATCCCTC-1_V12D07-335_A1,2,0,3,0,0,5
CTGTCACGCCAGGCGC-1_V12D07-335_A1,0,0,2,1,0,3
CGGTATAGGTATTAGC-1_V12D07-335_A1,3,0,0,0,0,3
CCAACGCTTGCCAGGG-1_V12D07-335_A1,2,0,3,0,0,5
CGTTGAGTAATTGCGT-1_V12D07-335_A1,2,0,1,0,0,3
TGTATTTACCTAATGC-1_V12D07-335_A1,2,0,3,0,0,5
TAAATGCCGTCTCATG-1_V12D07-335_A1,0,0,1,0,0,1
CGGTTTATGAAGGAAC-1_V12D07-335_A1,3,3,2,0,0,8
GCAAGATGTGTTCGCG-1_V12D07-335_A1,0,2,3,0,0,5
AAAGGTAAGCTGTACC-1_V12D07-335_A1,2,0,3,0,0,5
GTACGTCACGTATTAA-1_V12D07-335_A1,0,0,2,0,0,2
AGTACCTTCGAGTGCT-1_V12D07-335_A1,1,0,5,0,0,6
ATTGTGACTTCGCTGC-1_V12D07-335_A1,1,0,2,0,0,3
TGTATCAGACTGAAGC-1_V12D07-335_A1,1,0,5,0,0,6
GAGACCCTGCAACGCC-1_V12D07-335_A1,3,0,2,0,0,5
TGGGTGGGATGTCATT-1_V12D07-335_A1,0,0,5,0,0,5
GGCTAATGATTGAAAT-1_V12D07-335_A1,2,1,7,0,0,10
ATAACGTTACCTCCAC-1_V12D07-335_A1,1,0,2,0,0,3
TGCGAGATGGCGGCCA-1_V12D07-335_A1,0,2,4,0,0,6
CACACTTGTATTGCGA-1_V12D07-335_A1,0,0,4,0,0,4
GCTGGTGACTCGTAGT-1_V12D07-335_A1,1,0,6,0,0,7
CGACACCGCTTAAGGA-1_V12D07-335_A1,0,0,7,0,0,7
GTAACAACTGACCTTG-1_V12D07-335_A1,0,1,1,0,0,2
CAACTGAGGGTATGAC-1_V12D07-335_A1,0,0,1,0,0,1
CTAATTATGAAGCGTA-1_V12D07-335_A1,0,0,2,0,0,2
CCGATCTTAAGAGGCT-1_V12D07-335_A1,1,2,2,0,0,5
CGACTCGGTACACGGT-1_V12D07-335_A1,0,0,1,0,0,1
TGCTGCGTCAGAGTTA-1_V12D07-335_A1,0,0,0,0,0,0
AGAGTTGCAGGCCTCC-1_V12D07-335_A1,0,0,1,0,0,1
ACTGGCGAACCTGCGT-1_V12D07-335_A1,0,2,1,0,0,3
ACTAAGGACGCACACC-1_V12D07-335_A1,1,3,1,0,0,5
CGTCCAGATGGCTCCA-1_V12D07-335_A1,0,0,0,0,0,0
ACTATCGCCGGCTAAA-1_V12D07-335_A1,0,0,0,0,0,0
GATAGCGTACCACGCG-1_V12D07-335_A1,0,0,0,0,0,0
AGGACTTATAGGAGAA-1_V12D07-335_A1,0,0,0,0,0,0
TAGTCGGGATTCTTCG-1_V12D07-335_A1,0,0,0,0,0,0
ACCATTAAGGGTGTCA-1_V12D07-335_A1,0,0,0,0,0,0
TTAATGTGTTTGCAGG-1_V12D07-335_A1,0,0,0,0,0,0
TCCGCAGCCACCTAGC-1_V12D07-335_A1,0,1,0,0,0,1
GAGGAGATCCTCATGC-1_V12D07-335_A1,0,1,0,0,0,1
GGTCCTTCATACGACT-1_V12D07-335_A1,1,1,0,0,0,2
CCCTGTTGGCAAAGAC-1_V12D07-335_A1,0,2,1,0,0,3
GTGCCTAGCTATGCTT-1_V12D07-335_A1,1,1,1,0,0,3
GTCATCTCCTACAGCT-1_V12D07-335_A1,1,0,0,0,0,1
GCGAGAAACGGGAGTT-1_V12D07-335_A1,1,0,1,0,0,2
CGTCGCGGCGGGATTT-1_V12D07-335_A1,1,0,0,0,0,1
CATTGTGTGCTAGATC-1_V12D07-335_A1,0,1,2,0,0,3
CGCGGCAGTATTACGG-1_V12D07-335_A1,0,2,2,0,0,4
GAAATGGGATGTAAAC-1_V12D07-335_A1,0,2,0,0,0,2
CATTCCCTAAGTACAA-1_V12D07-335_A1,0,0,0,0,0,0
AGTTCTGCGTTGTATC-1_V12D07-335_A1,1,1,6,0,0,8
ACCCTATAGGACTGAG-1_V12D07-335_A1,0,1,2,0,0,3
TTAGATAGGTCGATAC-1_V12D07-335_A1,0,0,0,1,0,1
ATTGATAGCAACGAGA-1_V12D07-335_A1,0,0,1,21,0,22
TCTCGGCTCCAGGACT-1_V12D07-335_A1,0,0,1,7,0,8
CTTGAGGTTATCCCGA-1_V12D07-335_A1,0,0,1,16,0,17
AAGAAGGATCAGTTAG-1_V12D07-335_A1,0,0,1,20,0,21
GTACGACGGCGCTGCG-1_V12D07-335_A1,0,0,4,2,0,6
CTTATGTTGACTACCA-1_V12D07-335_A1,1,0,6,10,0,17
CGGCACTCAAGAAAGT-1_V12D07-335_A1,0,2,0,2,0,4
GTCAAAGTTTACATAG-1_V12D07-335_A1,0,1,1,10,0,12
CTCCTAAGTTATGTCT-1_V12D07-335_A1,0,1,2,1,0,4
ACTGTGCTAGTAGATC-1_V12D07-335_A1,0,0,2,1,0,3
GTTTGGCCGCTCAGCG-1_V12D07-335_A1,0,0,0,0,0,0
TTATCCAATCGAACTC-1_V12D07-335_A1,0,1,1,0,0,2
CCGTACCCAAGCGCCA-1_V12D07-335_A1,0,2,1,0,0,3
CATACAAAGCCGAACC-1_V12D07-335_A1,0,0,6,0,0,6
GGTCGGTAATTAGACA-1_V12D07-335_A1,1,0,0,0,0,1
AGCGGGAAGGGTCCAT-1_V12D07-335_A1,0,0,2,0,0,2
GCCCACCAAGGCTGTC-1_V12D07-335_A1,0,1,1,0,0,2
GTAGACGTCGTTACAT-1_V12D07-335_A1,0,0,1,1,0,2
GAGCATCATCCCTGGG-1_V12D07-335_A1,1,0,1,0,0,2
AGGTAACCTCCTATTC-1_V12D07-335_A1,0,0,1,0,0,1
GGTTTGAGTGCTGGAA-1_V12D07-335_A1,0,0,1,0,0,1
GCACTAGTCGCGCTAT-1_V12D07-335_A1,0,2,1,0,0,3
GGTAACTATGTATCTG-1_V12D07-335_A1,0,0,1,0,0,1
GCGGTCCCTAGACGCA-1_V12D07-335_A1,0,0,0,0,0,0
CGAGCGTTGATCAGCC-1_V12D07-335_A1,0,1,2,0,0,3
AATCCAAGGGCCTGAG-1_V12D07-335_A1,0,1,1,0,0,2
CCGTGCCCATGACGGC-1_V12D07-335_A1,0,2,0,0,0,2
GAAATTCACATCGCTG-1_V12D07-335_A1,0,0,3,0,0,3
CTCTGCGAAGCAAGCA-1_V12D07-335_A1,4,1,3,0,0,8
AGTAGGTAACATACAT-1_V12D07-335_A1,0,2,3,0,0,5
ATTGGGAATATCTTGG-1_V12D07-335_A1,0,0,1,1,0,2
TAGAGCTACGAAGAAC-1_V12D07-335_A1,0,0,0,0,0,0
TGCGGCATAGTTCAAC-1_V12D07-335_A1,0,0,0,0,0,0
CCGCCGGTCAACACAC-1_V12D07-335_A1,0,0,0,0,0,0
TCGTATAGTGCAATTA-1_V12D07-335_A1,0,0,0,0,0,0
TAGTTTATTCTTGCTT-1_V12D07-335_A1,0,0,1,0,0,1
GATATCTCATGCAATA-1_V12D07-335_A1,0,0,2,0,0,2
CGTTTAAGCGGAGCAC-1_V12D07-335_A1,0,2,1,0,0,3
CATGCTGGCTCCAATT-1_V12D07-335_A1,0,2,3,0,0,5
GAAACAGCCATGCAGT-1_V12D07-335_A1,0,1,4,0,0,5
AGTTTCGCAGGTCGGA-1_V12D07-335_A1,2,0,7,0,0,9
CTCATGGCTCACAATC-1_V12D07-335_A1,0,0,4,0,0,4
AACCGTTGTGTTTGCT-1_V12D07-335_A1,1,2,5,0,0,8
ACCCTTCATCTGCGAA-1_V12D07-335_A1,1,2,5,0,0,8
TGCGGTGAAATTTCAT-1_V12D07-335_A1,1,2,3,0,0,6
CAAATTGTCAGCAAGC-1_V12D07-335_A1,0,4,2,0,0,6
GAGGTACATCCATCTT-1_V12D07-335_A1,2,1,2,0,0,5
AAATGGCATGTCTTGT-1_V12D07-335_A1,3,0,3,0,0,6
TCATCCCAGAGGGTGG-1_V12D07-335_A1,0,0,1,0,0,1
CGTAGCGAATTGTCAG-1_V12D07-335_A1,2,1,0,0,0,3
CCTAGTTAGTCGCATG-1_V12D07-335_A1,0,3,1,0,0,4
GAAACTCTAATGAAGG-1_V12D07-335_A1,2,4,2,0,0,8
TTGTATCACACAGAAT-1_V12D07-335_A1,1,2,0,0,0,3
TTCAAGCCGAGCTGAG-1_V12D07-335_A1,0,3,0,0,0,3
AGGTACGATATTGCCA-1_V12D07-335_A1,1,0,1,0,0,2
TTAAGCCGACAACTTC-1_V12D07-335_A1,1,1,2,0,0,4
GTCTTAGTACAGCCGG-1_V12D07-335_A1,1,1,0,0,0,2
TGGGTAAGGTTCCCGC-1_V12D07-335_A1,1,2,0,0,0,3
CTACGCCATTTCCGAT-1_V12D07-335_A1,1,0,0,0,0,1
GACCGTCAGGTCGTGA-1_V12D07-335_A1,2,0,3,0,0,5
TAGTTAAGATAGGATA-1_V12D07-335_A1,2,1,0,0,0,3
GAATATTCGGAGTCCC-1_V12D07-335_A1,0,0,0,0,0,0
CAAACTACGATAGAGA-1_V12D07-335_A1,1,1,2,0,0,4
CAGGAAGACTTTATAT-1_V12D07-335_A1,1,5,0,0,0,6
TTCGTAATCCCAGCGG-1_V12D07-335_A1,0,1,0,0,0,1
GTGAGGAGCGGTTGAG-1_V12D07-335_A1,0,2,1,0,0,3
CAATCCCTATACCAGC-1_V12D07-335_A1,4,0,0,0,0,4
AGGGAAACGAGGTACT-1_V12D07-335_A1,0,1,0,0,0,1
TCCTGCCAACTGGAGA-1_V12D07-335_A1,1,0,2,0,0,3
AATTTGGGACATAGTA-1_V12D07-335_A1,0,1,2,0,0,3
AACTCCTAATCCCATG-1_V12D07-335_A1,0,0,0,0,0,0
GCTCATTACTGCATGT-1_V12D07-335_A1,0,3,3,0,0,6
TCTCGAACGAGGTCAC-1_V12D07-335_A1,2,1,1,0,0,4
TCACTACGACCAATGC-1_V12D07-335_A1,4,0,1,0,0,5
GTGATGCACAACATCT-1_V12D07-335_A1,4,2,0,0,0,6
CCGACGTAAACACAAC-1_V12D07-335_A1,1,0,1,0,0,2
TGGGATGCACTCATTC-1_V12D07-335_A1,3,0,3,0,0,6
TTCCATCATGCGGTGA-1_V12D07-335_A1,0,0,2,0,0,2
TGCACAGTGAAGTTAT-1_V12D07-335_A1,5,0,2,0,0,7
CTATTGTGTTTGGTCA-1_V12D07-335_A1,2,0,3,0,0,5
TGCGAGCCCTTCCGCG-1_V12D07-335_A1,3,0,0,0,0,3
TTGAAAGGTGTAAAGG-1_V12D07-335_A1,1,0,6,0,0,7
GGTGCAGAGCCTATCG-1_V12D07-335_A1,0,0,5,0,0,5
ACTATATGCTGTGTTC-1_V12D07-335_A1,3,0,4,0,0,7
TCCTGGCGCTGCCTGG-1_V12D07-335_A1,2,0,1,0,0,3
GAGCCGAGCGTTTATT-1_V12D07-335_A1,5,0,3,0,0,8
AGAATGCGGGTTCGGA-1_V12D07-335_A1,2,1,5,0,0,8
ATGCGACAATTGGTCC-1_V12D07-335_A1,2,1,2,0,0,5
TTCCGGCTCGACTTCT-1_V12D07-335_A1,1,0,3,0,0,4
TGATTATGGCACGCAG-1_V12D07-335_A1,4,0,3,1,0,8
GGTTTGACAAGAAGCT-1_V12D07-335_A1,1,1,4,0,0,6
GCAGCTATGGACAGGT-1_V12D07-335_A1,0,1,2,0,0,3
CACCATGATCGCAAAG-1_V12D07-335_A1,2,1,6,0,0,9
GTCGGAAGGATACCAG-1_V12D07-335_A1,2,0,1,0,0,3
GGCCCAGTTATCAGCA-1_V12D07-335_A1,0,4,3,0,0,7
GGGCCTATTTAAGTAT-1_V12D07-335_A1,0,2,6,0,0,8
GTTGTTACATTGCGCT-1_V12D07-335_A1,0,5,2,0,0,7
CAACTCCGTAACTTGC-1_V12D07-335_A1,0,3,2,0,0,5
GATCTTTGCTCAAAGA-1_V12D07-335_A1,0,2,4,0,0,6
TCGCTTAATTACGAAG-1_V12D07-335_A1,1,3,2,0,0,6
CGATCATTAGAGGCAC-1_V12D07-335_A1,0,0,1,0,0,1
TGTTCTCTACTCCCTA-1_V12D07-335_A1,1,1,3,0,0,5
GCTTAGGGAAGCGGTA-1_V12D07-335_A1,0,0,3,0,0,3
CAGGTTTAGTACTACA-1_V12D07-335_A1,0,0,1,0,0,1
AAGCGGAGTGCGCGCA-1_V12D07-335_A1,0,2,3,0,0,5
TCAGATGGAGACGTAG-1_V12D07-335_A1,0,0,5,0,0,5
TCGCACTAACGTTTGT-1_V12D07-335_A1,0,0,0,0,0,0
CACGTCGGGTTCTAGA-1_V12D07-335_A1,0,0,0,0,0,0
GGAGTACACATGAGCT-1_V12D07-335_A1,0,0,0,0,0,0
GTGTGTCGACGTCGCT-1_V12D07-335_A1,0,0,0,0,0,0
GAAGCTCTTTGCTTAG-1_V12D07-335_A1,0,0,0,0,0,0
ACACCGAGCGCTCTTT-1_V12D07-335_A1,0,0,0,0,0,0
CGTAATAATTACGAGT-1_V12D07-335_A1,0,0,0,0,0,0
CATCAACACCTACTAA-1_V12D07-335_A1,0,0,0,0,0,0
CCAAGTTTCTACAGAT-1_V12D07-335_A1,0,5,1,0,0,6
ACGGGTCATGTGACTT-1_V12D07-335_A1,0,5,1,0,0,6
AGTGTGCTAAGATCGC-1_V12D07-335_A1,0,0,0,0,0,0
GGCGGTTTGCCGGTGC-1_V12D07-335_A1,0,2,2,0,0,4
GTATAATCTCCCGGAT-1_V12D07-335_A1,2,3,0,0,0,5
TAGTCCGTATGCATAA-1_V12D07-335_A1,1,1,3,0,0,5
CACTTCGTCTTATCTC-1_V12D07-335_A1,0,1,6,0,0,7
CATCCGCAGGCCCGAA-1_V12D07-335_A1,0,0,0,0,0,0
CCCTGATGTAACTCGT-1_V12D07-335_A1,3,5,1,0,0,9
CCATAGTCAGTAACCC-1_V12D07-335_A1,0,2,2,0,0,4
CGGGCCATAGCCGCAC-1_V12D07-335_A1,0,2,2,0,0,4
CTCCGGCTTGTAGACA-1_V12D07-335_A1,0,2,1,0,0,3
AACTTGCGTTCTCGCG-1_V12D07-335_A1,0,0,0,0,0,0
AATGAGTTCGCATATG-1_V12D07-335_A1,1,0,1,0,0,2
CGAGGCCAGGCATTGG-1_V12D07-335_A1,0,0,0,0,0,0
TCTGCGTCCGGTTTCT-1_V12D07-335_A1,0,0,0,0,0,0
CAATCCTGCCGTGGAG-1_V12D07-335_A1,0,0,1,0,0,1
CTGAGCAAGTAACAAG-1_V12D07-335_A1,1,2,2,0,0,5
GGGTACCCACGGTCCT-1_V12D07-335_A1,0,0,1,1,0,2
ACGGAATTTAGCAAAT-1_V12D07-335_A1,0,0,2,0,0,2
GGGCGGTCCTATTGTC-1_V12D07-335_A1,0,1,3,1,0,5
ATGTTACGAGCAATAC-1_V12D07-335_A1,0,1,3,1,0,5
AACCATGGGATCGCTA-1_V12D07-335_A1,0,0,1,13,0,14
TCGCATCCCTAAGTGT-1_V12D07-335_A1,0,1,2,0,0,3
ACTTAGTACGACAAGA-1_V12D07-335_A1,0,1,1,10,0,12
GAGCTCTCGGACCTAA-1_V12D07-335_A1,0,0,1,12,0,13
TCTATTACGCTGGCGA-1_V12D07-335_A1,0,1,2,1,0,4
AGATACGACTTCATAT-1_V12D07-335_A1,0,1,2,15,0,18
CGCTATACCGCCCACT-1_V12D07-335_A1,0,1,5,0,0,6
CAGTGTCCGCAGAATG-1_V12D07-335_A1,1,0,2,0,0,3
CCATCCATACCAAGTC-1_V12D07-335_A1,2,1,2,0,0,5
AACCCAGAGACGGAGA-1_V12D07-335_A1,0,0,1,1,0,2
GAAGAACGGTGCAGGT-1_V12D07-335_A1,0,0,3,0,0,3
GATAAATCGGTGGATG-1_V12D07-335_A1,0,1,1,1,0,3
CAGCTCGTGCTTGTGT-1_V12D07-335_A1,1,1,0,0,0,2
GAGTACGGGTATACAA-1_V12D07-335_A1,0,0,2,0,0,2
CATCGCCCGCGGCCAA-1_V12D07-335_A1,0,0,1,0,0,1
TCTTACAGAGGTACCG-1_V12D07-335_A1,0,1,0,1,0,2
TGGAAGACGAACACCA-1_V12D07-335_A1,0,0,1,1,0,2
GTTGTCGTGTTAGTTG-1_V12D07-335_A1,0,0,1,0,0,1
CCAAGGAACAGAGAGG-1_V12D07-335_A1,0,0,0,0,0,0
CTGCACCTGGAACCGC-1_V12D07-335_A1,0,1,0,1,0,2
CGCTTTCATACCGGTG-1_V12D07-335_A1,0,0,0,0,0,0
GTTCTTCCCTCGATGT-1_V12D07-335_A1,0,0,2,0,0,2
ATTTAACTCGTATTAC-1_V12D07-335_A1,3,0,1,0,0,4
AACGATAGAAGGGCCG-1_V12D07-335_A1,0,1,2,0,0,3
TATCCTGCATGGGAAT-1_V12D07-335_A1,0,0,3,0,0,3
AGGCCCATTGTACAGG-1_V12D07-335_A1,2,0,1,0,0,3
CCGGCGCATATTGGAT-1_V12D07-335_A1,2,1,4,0,0,7
ATCTGTAATTGTACCC-1_V12D07-335_A1,0,1,1,2,0,4
GAGCGAGGGAGTACCG-1_V12D07-335_A1,1,0,1,0,0,2
TTATTAGGGAAGCATC-1_V12D07-335_A1,0,0,3,0,0,3
CTTCTTACGTCGTATA-1_V12D07-335_A1,0,0,1,0,0,1
GAAGTGCTGGATAGCT-1_V12D07-335_A1,0,0,0,0,0,0
GTGCAACAAATGTGGC-1_V12D07-335_A1,0,1,5,0,0,6
CATGCGTTAGACAGAA-1_V12D07-335_A1,0,1,3,0,0,4
ACACACTTTCTACACG-1_V12D07-335_A1,0,0,2,0,0,2
AGCCCTAAGCGAAGTT-1_V12D07-335_A1,0,1,3,0,0,4
ATTAATTCGGTCACTC-1_V12D07-335_A1,0,0,4,0,0,4
AACAGGAAATCGAATA-1_V12D07-335_A1,0,0,1,0,0,1
ACGTTTAGTTGTGATC-1_V12D07-335_A1,0,0,5,0,0,5
TCCTTCAGTGGTCGAA-1_V12D07-335_A1,0,3,1,0,0,4
CGAACGCCCAGTGCCG-1_V12D07-335_A1,1,3,1,0,0,5
CCTCGAAGTGGACGGG-1_V12D07-335_A1,1,5,4,0,0,10
CTCTGTTTGAGGATTC-1_V12D07-335_A1,0,1,1,0,0,2
TGGGCACGTTCTATGG-1_V12D07-335_A1,1,2,3,0,0,6
ACTATTCGTCCGTGGT-1_V12D07-335_A1,0,3,2,0,0,5
CCTCTGGCCTAGACGG-1_V12D07-335_A1,0,3,4,0,0,7
CCATAAACAACCCGAC-1_V12D07-335_A1,3,3,0,0,0,6
CATAGTACATTGAGAG-1_V12D07-335_A1,1,2,0,0,0,3
ATTTCATTATTTCGCG-1_V12D07-335_A1,1,3,0,0,0,4
CAACTATATCGAATGC-1_V12D07-335_A1,1,0,2,0,0,3
CTAGTATTCGGAATTA-1_V12D07-335_A1,0,5,1,0,0,6
GTGGAACCTACATGCG-1_V12D07-335_A1,0,3,2,0,0,5
CCTAAAGGCTGACGCT-1_V12D07-335_A1,1,0,2,0,0,3
CGTGACATTGGGTCGT-1_V12D07-335_A1,1,0,1,0,0,2
CCAATCGGTAGATCGA-1_V12D07-335_A1,2,2,1,0,0,5
ATTGTCGCAATACCTT-1_V12D07-335_A1,0,4,0,0,0,4
AAATTACACGACTCTG-1_V12D07-335_A1,1,0,1,0,0,2
CACTCCTCTCGGTCGG-1_V12D07-335_A1,1,1,0,0,0,2
AAATAACCATACGGGA-1_V12D07-335_A1,1,1,1,0,0,3
AGTTACTCTATCGTGG-1_V12D07-335_A1,0,1,0,0,0,1
CGTTAGCTCACAACTG-1_V12D07-335_A1,0,1,2,0,0,3
GAATGTATGGCAGGTC-1_V12D07-335_A1,2,1,0,0,0,3
GCAACCACCAGACCGG-1_V12D07-335_A1,2,1,2,0,0,5
TCACTCGTGCAACGGC-1_V12D07-335_A1,0,3,3,0,0,6
AAACAGAGCGACTCCT-1_V12D07-335_A1,0,2,1,0,0,3
CAGCCTCTCCTCAAGA-1_V12D07-335_A1,2,0,4,0,0,6
TTGCGTGAACGCTTAG-1_V12D07-335_A1,3,0,2,0,0,5
CCGCCTGCGAATTGGT-1_V12D07-335_A1,2,0,2,0,0,4
AGATGAGGGTTGCGAT-1_V12D07-335_A1,0,1,0,0,0,1
CGGTGGGCTCCAGCCT-1_V12D07-335_A1,1,0,5,0,0,6
GGCAGCGGTAATCCTA-1_V12D07-335_A1,1,0,4,0,0,5
GCTAGCAGGGAGTGGG-1_V12D07-335_A1,2,0,1,0,0,3
CTCAAGACATTAGCGC-1_V12D07-335_A1,1,0,3,0,0,4
CACGGCGCGCCAAAGG-1_V12D07-335_A1,1,0,0,0,0,1
TGCAATTTGGGCACGG-1_V12D07-335_A1,2,0,3,0,0,5
ATGCCAATCGCTCTGC-1_V12D07-335_A1,2,1,5,0,0,8
GCTGGACCCAAAGTGG-1_V12D07-335_A1,2,1,2,0,0,5
ATTCCTAAGACGTGGA-1_V12D07-335_A1,1,0,3,0,0,4
TCCGGAGGAAGGGCTG-1_V12D07-335_A1,2,1,4,0,0,7
TCGGTGACCGCTCCGG-1_V12D07-335_A1,0,0,1,0,0,1
TCCGAAGTAGTCACCA-1_V12D07-335_A1,1,0,0,0,0,1
CATGTAGGAGCGCCAA-1_V12D07-335_A1,2,0,2,0,0,4
CACAAGAAAGATATTA-1_V12D07-335_A1,2,1,1,0,0,4
AGGGTCAGTAACCCTA-1_V12D07-335_A1,1,1,2,0,0,4
TAAGCCCTTACGACCA-1_V12D07-335_A1,0,1,2,0,0,3
ATACCGTCATCCATAA-1_V12D07-335_A1,2,0,1,0,0,3
GGACGTCCATAGTTGG-1_V12D07-335_A1,0,2,7,0,0,9
CATCAAACTGGCGCCC-1_V12D07-335_A1,2,0,3,0,0,5
AAACGTGTTCGCCCTA-1_V12D07-335_A1,2,2,1,0,0,5
AAATTGGTGAGAAGCA-1_V12D07-335_A1,0,3,1,0,0,4
GGTCATTGTAGTCATA-1_V12D07-335_A1,0,6,2,0,0,8
TGCAGTGAGGCTCGGG-1_V12D07-335_A1,0,3,1,0,0,4
GAACATTAGTATGTTA-1_V12D07-335_A1,0,2,1,0,0,3
GGTTTGCGAACACGTA-1_V12D07-335_A1,0,3,1,0,0,4
ACACAAATATTCCTAG-1_V12D07-335_A1,0,3,1,0,0,4
TTGGGTTTATTCAGCG-1_V12D07-335_A1,0,2,5,0,0,7
ATTCGCAGAGGACACT-1_V12D07-335_A1,0,0,9,3,0,12
GATTTAGTGCGTACTG-1_V12D07-335_A1,0,2,3,0,0,5
TAGAAACACAATAGTG-1_V12D07-335_A1,0,0,0,0,0,0
CAGTAGATGATGTCCG-1_V12D07-335_A1,0,0,0,0,0,0
TCTTAACTCGGATGTA-1_V12D07-335_A1,0,0,0,0,0,0
TACATCTTGTTTCTTG-1_V12D07-335_A1,0,0,0,0,0,0
TTCATAGGGTGTCCAT-1_V12D07-335_A1,0,0,0,0,0,0
TGAAGTAGCTTACGGA-1_V12D07-335_A1,0,0,0,0,0,0
GCACAAGTGGATCATA-1_V12D07-335_A1,0,0,0,0,0,0
GGGCGAATTTCTCCAC-1_V12D07-335_A1,0,0,0,0,0,0
ATGTTCCTGCCCACCT-1_V12D07-335_A1,1,1,0,0,0,2
GCTCAACCTCTTAGAG-1_V12D07-335_A1,0,1,1,0,0,2
ATAGCTGCTCTTGTTA-1_V12D07-335_A1,0,2,4,0,0,6
CGTCAGCTATTTACTC-1_V12D07-335_A1,0,2,2,0,0,4
ATCTGATAGTGTCTTA-1_V12D07-335_A1,0,1,1,0,0,2
TGCACTATGTGAGTGC-1_V12D07-335_A1,0,0,1,1,0,2
CCGACAAACACATGAG-1_V12D07-335_A1,0,1,1,0,0,2
GCCTTGTATATGCAGT-1_V12D07-335_A1,0,0,4,0,0,4
ATAATACCGTTAGCCG-1_V12D07-335_A1,0,1,1,0,0,2
ACACTCCAATGTCACT-1_V12D07-335_A1,1,0,4,0,0,5
AGTTGCTGACTGATAT-1_V12D07-335_A1,0,2,2,0,0,4
GGCGCTCCTCATCAAT-1_V12D07-335_A1,0,1,0,21,0,22
TGCCTGACATCGGTCA-1_V12D07-335_A1,0,3,0,0,0,3
TTGGCCATCTTGCGCT-1_V12D07-335_A1,3,1,3,7,0,14
CAGTGGTTGCACATGA-1_V12D07-335_A1,0,1,1,0,0,2
AGAATTGTTTGACATA-1_V12D07-335_A1,0,1,0,0,0,1
AAATGCTCGTTACGTT-1_V12D07-335_A1,0,2,2,0,0,4
CACCTAATAGAGTCGT-1_V12D07-335_A1,0,5,2,0,0,7
CATTTCTAGCAGACTA-1_V12D07-335_A1,0,1,2,0,0,3
CCGAAAGTGGTGAGCA-1_V12D07-335_A1,0,0,2,0,0,2
AGTCAGCCACCGCCTG-1_V12D07-335_A1,0,0,0,0,0,0
TCATCACTCGAGCTCG-1_V12D07-335_A1,0,0,1,0,0,1
CTCAGGACTCACCTGT-1_V12D07-335_A1,0,0,2,0,0,2
CGGTGTACTTGATCCC-1_V12D07-335_A1,0,0,0,0,0,0
CCTACGGCTCAGTCGA-1_V12D07-335_A1,0,0,1,0,0,1
GTACTTGGGCACTTCT-1_V12D07-335_A1,0,0,1,0,0,1
TGATTTCCTCCTGACG-1_V12D07-335_A1,0,0,0,0,0,0
CCTCACCAATCTTGAC-1_V12D07-335_A1,0,0,0,0,0,0
GGTGAGATGCAGATAA-1_V12D07-335_A1,0,0,0,16,0,16
GCTAGTTTCATTGAGG-1_V12D07-335_A1,0,0,1,7,0,8
AGGACATCGCACGTCG-1_V12D07-335_A1,0,0,3,1,0,4
GTGGACGTGCTGAGAC-1_V12D07-335_A1,1,0,13,5,0,19
TAAGGAACTTGTGGGA-1_V12D07-335_A1,0,1,0,2,0,3
TCGCTGTGCGTAAATC-1_V12D07-335_A1,0,3,0,1,0,4
GCATCCCTAACTTTGA-1_V12D07-335_A1,0,1,0,3,0,4
CACCCACACGTCACCC-1_V12D07-335_A1,0,0,3,0,0,3
CCCTCATTCTGGAATT-1_V12D07-335_A1,0,0,0,0,0,0
AGGGCGTGATCGGCTA-1_V12D07-335_A1,0,0,1,0,0,1
GGTGCGGATAAGTGGC-1_V12D07-335_A1,1,1,0,1,0,3
TAATATTGAAATTCGC-1_V12D07-335_A1,0,0,1,0,0,1
CTTACACTGGGAAATA-1_V12D07-335_A1,0,1,0,0,0,1
ACCAAGAACGCGTGTC-1_V12D07-335_A1,0,0,2,0,0,2
GCCTTCAGCCCTACCG-1_V12D07-335_A1,0,0,2,0,0,2
GATGCTACAAGCGCCT-1_V12D07-335_A1,0,0,2,0,0,2
CCGGGACCCGCAGAGA-1_V12D07-335_A1,1,1,2,0,0,4
GTTCCAGTCTGACCAT-1_V12D07-335_A1,1,1,0,1,0,3
ATGATCGGGAATAGAC-1_V12D07-335_A1,0,0,2,1,0,3
TTGGATTGGGTACCAC-1_V12D07-335_A1,0,0,2,0,0,2
TACCTCACGCTTGTAC-1_V12D07-335_A1,0,0,5,1,0,6
CATGGCAGGAAGATCG-1_V12D07-335_A1,1,0,0,1,0,2
ATGACGCCGGCTCTAA-1_V12D07-335_A1,0,1,1,0,0,2
AGCGACATCCCATTCA-1_V12D07-335_A1,0,0,1,1,0,2
AGTAATGTCTTGCCGC-1_V12D07-335_A1,1,4,1,1,0,7
TTCTTAGTGGCTCAGA-1_V12D07-335_A1,0,1,1,0,0,2
CGTCTGGAAGGGCCCG-1_V12D07-335_A1,0,1,0,0,0,1
ACGTGCGCCTCGTGCA-1_V12D07-335_A1,0,0,1,0,0,1
AGAGCGGGCTAATCAT-1_V12D07-335_A1,0,0,1,0,0,1
GCGTCGAAATGTCGGT-1_V12D07-335_A1,0,1,4,0,0,5
AACTGATATTAGGCCT-1_V12D07-335_A1,0,0,3,0,0,3
CGAGCTGGGCTTTAGG-1_V12D07-335_A1,1,1,3,3,0,8
GGGTGTTTCAGCTATG-1_V12D07-335_A1,0,2,2,0,0,4
TTAATTTCAGACGCGG-1_V12D07-335_A1,0,1,0,0,0,1
ACTGCCGTCGTAACTC-1_V12D07-335_A1,0,1,4,0,0,5
GTGCACGAAAGTGACT-1_V12D07-335_A1,0,0,0,5,0,5
ATCTCCCTGCAATCTA-1_V12D07-335_A1,0,2,3,0,0,5
ACGCCAGATGATTTCT-1_V12D07-335_A1,0,2,1,0,0,3
AGCTATTTAATCCAAC-1_V12D07-335_A1,1,2,2,0,0,5
CCACGAGAAGAGAATC-1_V12D07-335_A1,0,1,3,0,0,4
GATTCCGCGTTTCCGT-1_V12D07-335_A1,1,3,0,0,0,4
GTCGGATGTAGCGCGC-1_V12D07-335_A1,0,4,0,0,0,4
TATTTATACCGAGTAG-1_V12D07-335_A1,0,0,4,0,0,4
GTAGGTGATCCGTGTA-1_V12D07-335_A1,2,0,4,0,0,6
AGTTAAGCGGTCCCGG-1_V12D07-335_A1,2,0,1,0,0,3
CTGGCGACATAAGTCC-1_V12D07-335_A1,0,3,1,0,0,4
TTGGCCTAGAATTTCG-1_V12D07-335_A1,0,1,4,0,0,5
GGCATATCGGTTCTGC-1_V12D07-335_A1,0,3,5,0,0,8
GGGCGTCCACTGGCTC-1_V12D07-335_A1,0,3,2,0,0,5
TTACCCATTGCCGGGT-1_V12D07-335_A1,3,1,4,0,0,8
TTAGACACGATCGTTG-1_V12D07-335_A1,1,0,1,0,0,2
GCGCTGATCCAGACTC-1_V12D07-335_A1,1,1,2,0,0,4
TTCGGCAACCCGCTGA-1_V12D07-335_A1,1,1,2,0,0,4
GATATTTCCTACATGG-1_V12D07-335_A1,1,0,1,0,0,2
CTGCGTTACGATATAA-1_V12D07-335_A1,2,0,2,0,0,4
TAATAAACAAGGAGAT-1_V12D07-335_A1,1,1,2,0,0,4
AACCTTTACGACGTCT-1_V12D07-335_A1,1,0,3,0,0,4
AGTCCCGCCTTTAATT-1_V12D07-335_A1,0,0,2,0,0,2
TGAGATTAGGCCCTAA-1_V12D07-335_A1,0,0,1,0,0,1
AGTGTATTGCGCATTG-1_V12D07-335_A1,3,1,1,0,0,5
GTTGGATTCAGTGGCT-1_V12D07-335_A1,1,0,3,0,0,4
TAAAGCTGCAATAGGG-1_V12D07-335_A1,1,0,0,0,0,1
AGTAGGAAGGAAGTTG-1_V12D07-335_A1,1,0,3,0,0,4
TATCACTTCGAGTAAC-1_V12D07-335_A1,1,0,2,0,0,3
TGATCTACGCTGATCT-1_V12D07-335_A1,2,0,1,0,0,3
GGATCATCCCGTACGC-1_V12D07-335_A1,1,1,2,0,0,4
TGACACTTCTCTTTGC-1_V12D07-335_A1,0,0,1,0,0,1
AGCCCTTCTAATCCGA-1_V12D07-335_A1,1,0,4,0,0,5
CACCGCGTCCACTCTA-1_V12D07-335_A1,1,0,1,0,0,2
TAATTGGAATCGGGAA-1_V12D07-335_A1,2,1,1,0,0,4
TCGTAAGCTCCGAGGA-1_V12D07-335_A1,4,0,2,0,0,6
TATATTACAAATGTCG-1_V12D07-335_A1,0,1,3,0,0,4
CGCGAGAGGGACTTGT-1_V12D07-335_A1,4,0,1,0,0,5
GGACCTACGGTAACGT-1_V12D07-335_A1,0,0,3,0,0,3
GAAATATGCTTGAATG-1_V12D07-335_A1,0,0,1,0,0,1
CCGTATTAGCGCAGTT-1_V12D07-335_A1,1,1,2,0,0,4
AGGCGTCTATGGACGG-1_V12D07-335_A1,0,0,2,0,0,2
AACATCGATACGTCTA-1_V12D07-335_A1,0,0,1,0,0,1
TGAATATGCTATAAAC-1_V12D07-335_A1,2,0,2,0,0,4
ACCAAACACCCAGCGA-1_V12D07-335_A1,0,0,6,0,0,6
TGGCTTGTACAAGCTT-1_V12D07-335_A1,0,1,4,0,0,5
GAATGAAGGTCTTCAG-1_V12D07-335_A1,2,1,2,0,0,5
AGATACCAGCACTTCA-1_V12D07-335_A1,1,5,2,0,0,8
GCGGTCCCGGTGAAGG-1_V12D07-335_A1,0,0,1,0,0,1
GAGGCATTTGCAGCAG-1_V12D07-335_A1,2,0,0,0,0,2
GGCAAGCCAGGGATAG-1_V12D07-335_A1,2,4,0,0,0,6
TCTACGGGCTCAGTTG-1_V12D07-335_A1,1,1,1,0,0,3
TCTGCGAATCGTTCGC-1_V12D07-335_A1,0,7,3,0,0,10
AGCTCGTTGATGGAAA-1_V12D07-335_A1,0,1,2,0,0,3
TGAATGAGATACAGCA-1_V12D07-335_A1,0,4,0,0,0,4
ACCCTTGCCTGGGTCG-1_V12D07-335_A1,0,4,1,0,0,5
GGCGAACCGTTCTGAT-1_V12D07-335_A1,0,2,2,0,0,4
GCGATGTCTGTGCTTG-1_V12D07-335_A1,0,0,0,0,0,0
ATTAACACCTGAGATA-1_V12D07-335_A1,0,0,0,0,0,0
GAAATCTGACCAAGTT-1_V12D07-335_A1,0,0,0,0,0,0
CCTGACAAACTCGCGC-1_V12D07-335_A1,0,0,0,0,0,0
ATGTCATTTCCCATTG-1_V12D07-335_A1,0,0,0,0,0,0
GCGGTGCGGAGCATCG-1_V12D07-335_A1,0,0,0,0,0,0
CGGAAAGCAAATGTGC-1_V12D07-335_A1,0,0,0,0,0,0
GCTGAGCAACGGTTCT-1_V12D07-335_A1,0,0,0,0,0,0
TCACTCTTCGTCTGTC-1_V12D07-335_A1,0,1,1,0,0,2
GATCTTCATTGTCCTC-1_V12D07-335_A1,0,4,1,0,0,5
ACTCGATGTATTTCAT-1_V12D07-335_A1,0,3,1,0,0,4
TGAAGAGCGGTCCTAG-1_V12D07-335_A1,0,1,2,0,0,3
TAAACGTCGTCAATGA-1_V12D07-335_A1,0,1,0,9,0,10
ACGTTATTGGTCACTC-1_V12D07-335_A1,2,0,4,0,0,6
ATAGCCTCAGTACCCA-1_V12D07-335_A1,0,0,2,3,0,5
CGGGAGTATACCGCCG-1_V12D07-335_A1,0,1,0,0,0,1
GTCCTACAGGCGGCTC-1_V12D07-335_A1,1,4,4,0,0,9
CGGATAAGCGGACATG-1_V12D07-335_A1,0,0,0,0,0,0
AACTTCTGCGTCTATC-1_V12D07-335_A1,0,0,2,0,0,2
GGGTTCAGACGAACAA-1_V12D07-335_A1,1,2,1,0,0,4
AGTCTGGACATCCTTG-1_V12D07-335_A1,0,0,0,2,0,2
TTGAACGAATCCTTTG-1_V12D07-335_A1,1,0,0,0,0,1
GAAATACTAAACGTTT-1_V12D07-335_A1,0,0,3,0,0,3
CCCGCGCAATGCACCC-1_V12D07-335_A1,0,0,1,0,0,1
TTCGGCTAGAGATGGT-1_V12D07-335_A1,0,1,3,0,0,4
GACACGAGTTAGAGGA-1_V12D07-335_A1,0,1,1,0,0,2
GAGGTCCCAAAGATCT-1_V12D07-335_A1,0,2,2,0,0,4
TAACTCCATGGAGGCT-1_V12D07-335_A1,0,3,0,0,0,3
CTTGTTTATGTAGCCA-1_V12D07-335_A1,1,3,1,0,0,5
GATGGCGCACACATTA-1_V12D07-335_A1,0,1,0,0,0,1
ATAATAGTGTAGGGAC-1_V12D07-335_A1,0,2,3,0,0,5
CGCTATTCAATGTATG-1_V12D07-335_A1,0,0,0,0,0,0
ATATTGCTGTCAAAGT-1_V12D07-335_A1,0,0,1,0,0,1
GGATTCAGTACGGTGG-1_V12D07-335_A1,1,0,1,0,0,2
TTCTTAGTGAACGGTG-1_V12D07-335_A1,0,0,1,0,0,1
AATGGTTCTCACAAGC-1_V12D07-335_A1,0,1,3,0,0,4
TATACACGCAAAGTAT-1_V12D07-335_A1,0,0,2,0,0,2
CTTCATAGCTCAAGAA-1_V12D07-335_A1,0,0,1,0,0,1
CAACGGTTCTTGATAC-1_V12D07-335_A1,0,1,0,0,0,1
ACACCCGAGAAATCCG-1_V12D07-335_A1,0,0,0,0,0,0
TCTATCATGCAGTTAC-1_V12D07-335_A1,0,0,1,16,0,17
CCCGCCATGCTCCCGT-1_V12D07-335_A1,0,0,2,11,0,13
CGCTTCCACTGAAATC-1_V12D07-335_A1,0,0,3,0,0,3
CACTGTCCAAGTGAGA-1_V12D07-335_A1,0,0,2,0,0,2
ATTACTAGCCTCTTGC-1_V12D07-335_A1,0,0,6,0,0,6
CATAGTAGCATAGTAG-1_V12D07-335_A1,0,0,5,0,0,5
CAACTCCTTGATCCCG-1_V12D07-335_A1,0,1,0,1,0,2
AAGTAGAAGACCGGGT-1_V12D07-335_A1,0,0,2,2,0,4
GCGGGAACCAGGCCCT-1_V12D07-335_A1,0,0,0,1,0,1
ATTAGATTGATAGCGG-1_V12D07-335_A1,0,1,0,0,0,1
CTCGGTCCGTAGCCTG-1_V12D07-335_A1,0,0,1,0,0,1
TGGCTTTGGGTAGACA-1_V12D07-335_A1,0,0,1,0,0,1
TATCCATATCATGCGA-1_V12D07-335_A1,0,0,1,1,0,2
GGAGTGCCGCCCTGGA-1_V12D07-335_A1,0,0,1,0,0,1
TGAGAATGCTTTACCG-1_V12D07-335_A1,0,0,0,0,0,0
TTAACCAACCCTCCCT-1_V12D07-335_A1,1,1,0,0,0,2
TGTTTCGGTACTTCTC-1_V12D07-335_A1,0,0,0,0,0,0
TTGCTGAAGGAACCAC-1_V12D07-335_A1,0,0,1,0,0,1
TATTTAGTCTAGATCG-1_V12D07-335_A1,0,0,2,0,0,2
CTCCGGCCTAATATGC-1_V12D07-335_A1,0,0,3,1,0,4
TTGTGGCCCTGACAGT-1_V12D07-335_A1,2,0,2,0,0,4
TCGCCGGTCGATCCGT-1_V12D07-335_A1,0,0,0,0,0,0
CCATAGGTTGGCGTGG-1_V12D07-335_A1,0,1,3,0,0,4
GAACGACCGAATGATA-1_V12D07-335_A1,0,1,0,0,0,1
TCCGATAATTGCCATA-1_V12D07-335_A1,1,1,4,0,0,6
CATTACGTCGGCCCGT-1_V12D07-335_A1,0,0,1,0,0,1
CAAGCACCAAATGCCT-1_V12D07-335_A1,0,1,2,0,0,3
TGCATGGATCGGATCT-1_V12D07-335_A1,0,0,0,0,0,0
GAAATCGCGCGCAACT-1_V12D07-335_A1,0,0,5,1,0,6
CTGAAAGAGATCCGAC-1_V12D07-335_A1,0,0,1,0,0,1
CACCTCGATGGTGGAC-1_V12D07-335_A1,0,1,1,2,0,4
ATTTGTTCCAGGGCTC-1_V12D07-335_A1,0,0,2,0,0,2
TGGGCCACAAGAGCGC-1_V12D07-335_A1,0,0,2,0,0,2
CCTTCTTGATCCAGTG-1_V12D07-335_A1,0,0,1,0,0,1
CCTCGCCAGCAAATTA-1_V12D07-335_A1,0,4,2,0,0,6
TTCATGGCGCAACAGG-1_V12D07-335_A1,1,4,0,0,0,5
TTAATCAGTACGTCAG-1_V12D07-335_A1,0,1,2,0,0,3
CCTATCTATATCGGAA-1_V12D07-335_A1,0,2,1,0,0,3
ATTATACTTTGCTCGT-1_V12D07-335_A1,0,5,0,0,0,5
ATGGATCCGGCGTCCG-1_V12D07-335_A1,0,5,0,0,0,5
CGCCCGCTTCCGTACA-1_V12D07-335_A1,0,0,3,0,0,3
GGATTCCGCTATACCC-1_V12D07-335_A1,1,0,4,0,0,5
CGGTCTATCAACCCGT-1_V12D07-335_A1,0,1,3,0,0,4
ATGCCGGTTGATGGGA-1_V12D07-335_A1,1,0,2,0,0,3
TCATGCAGGTTCTCAT-1_V12D07-335_A1,0,1,3,0,0,4
TGAGCTTTAATGACGC-1_V12D07-335_A1,0,2,1,0,0,3
TCCCTTAGATTACTCG-1_V12D07-335_A1,1,5,2,0,0,8
ATATCTCCCTCGTTAA-1_V12D07-335_A1,0,0,1,0,0,1
AGCTCTTCCCAGTGCA-1_V12D07-335_A1,2,0,4,0,0,6
TCGCTAAACCGCTATC-1_V12D07-335_A1,2,0,2,0,0,4
CACATTCTTTCGATGG-1_V12D07-335_A1,0,0,2,0,0,2
GATATGCGGTAGCCAA-1_V12D07-335_A1,1,2,3,0,0,6
CGTTTCACTTCGGGCG-1_V12D07-335_A1,3,1,3,0,0,7
CCAATTACGGGTCGAG-1_V12D07-335_A1,2,2,0,0,0,4
GCAGGTAGAGTATGGT-1_V12D07-335_A1,0,2,1,0,0,3
GTCGTATTGGCGTACA-1_V12D07-335_A1,2,3,1,0,0,6
GAAATTAGCACGGATA-1_V12D07-335_A1,1,1,4,0,0,6
AATGCACCAAGCAATG-1_V12D07-335_A1,1,2,3,0,0,6
AGGACGCTCGATGTTG-1_V12D07-335_A1,3,0,1,0,0,4
GGCTAAAGGGCGGGTC-1_V12D07-335_A1,0,1,2,0,0,3
CATCTATCCCGTGTCT-1_V12D07-335_A1,1,0,3,0,0,4
CAGTAACTATTTATTG-1_V12D07-335_A1,1,1,2,0,0,4
CATATACTACTGATAA-1_V12D07-335_A1,4,0,2,0,0,6
GCGTTCGGAGACCGGG-1_V12D07-335_A1,0,1,2,0,0,3
AAGTTCAGTCTGCGTA-1_V12D07-335_A1,3,1,3,0,0,7
CGAAGCTATAAATTCA-1_V12D07-335_A1,2,0,1,0,0,3
CGCGGTCACAAACCAA-1_V12D07-335_A1,0,0,5,0,0,5
GGGAATGAGCCCTCAC-1_V12D07-335_A1,1,0,2,0,0,3
ACGGAGCGCAAATTAC-1_V12D07-335_A1,1,0,0,0,0,1
CGTTCTTCGCACACCT-1_V12D07-335_A1,3,0,1,0,0,4
GAATAGCCCTGCGGTC-1_V12D07-335_A1,1,0,1,0,0,2
AATAGCTACCGCGTGC-1_V12D07-335_A1,0,0,2,0,0,2
CCGAGCTGTGCTTGTC-1_V12D07-335_A1,0,0,1,0,0,1
GATGACGATGATCGCG-1_V12D07-335_A1,0,0,2,0,0,2
GCCTATGCTGGGCCTT-1_V12D07-335_A1,1,0,4,0,0,5
TTACTGTCTAGAGCTC-1_V12D07-335_A1,2,0,3,0,0,5
AGCGGTTGCCGCTCTG-1_V12D07-335_A1,1,0,7,0,0,8
GCTTGCAGCACAATTG-1_V12D07-335_A1,0,0,9,0,0,9
CCGGAGGTCTTATGGT-1_V12D07-335_A1,0,0,1,0,0,1
ACAGTATACCGTGGGA-1_V12D07-335_A1,2,5,6,1,0,14
GGGATCCCAATACAAA-1_V12D07-335_A1,1,3,4,0,0,8
ATTACGACTCCACAGT-1_V12D07-335_A1,0,1,2,0,0,3
CTCACACGCAAGCCTA-1_V12D07-335_A1,1,1,2,0,0,4
CCAGATGTAAATGGGT-1_V12D07-335_A1,1,1,6,0,0,8
GAACTTGTGCACGGGA-1_V12D07-335_A1,2,1,2,0,0,5
AAGCCGCTTTACCTTG-1_V12D07-335_A1,1,2,2,0,0,5
TCCATTCCCACTAGAG-1_V12D07-335_A1,1,2,3,0,0,6
AGAGCGCTTGTAACGG-1_V12D07-335_A1,2,1,1,0,0,4
TGGGTTCCCGGACGGA-1_V12D07-335_A1,0,0,0,0,0,0
GCTGCGCCTCCCACGT-1_V12D07-335_A1,0,0,0,0,0,0
CTGTTGGCTCTTCTGA-1_V12D07-335_A1,0,0,0,0,0,0
TTGTTCTAGATACGCT-1_V12D07-335_A1,0,0,0,0,0,0
CCCTCAAGCTCTTAGT-1_V12D07-335_A1,0,0,0,0,0,0
TGGTCTAGCTTACATG-1_V12D07-335_A1,0,0,0,0,0,0
ATGCACCTTCCTTAAT-1_V12D07-335_A1,0,0,0,0,0,0
GGGATACGGTAATAAT-1_V12D07-335_A1,0,0,0,0,0,0
AGTTCACCGGTTGGAC-1_V12D07-335_A1,0,0,0,0,0,0
GACATACTGTCGCAGA-1_V12D07-335_A1,0,0,1,0,0,1
TGGACACCGTTGCTTG-1_V12D07-335_A1,3,1,1,0,0,5
TGCGATGCTAATGGCT-1_V12D07-335_A1,5,1,3,0,0,9
TTCTGTTTCCTGTCGC-1_V12D07-335_A1,1,3,4,1,0,9
CGTTGTAAACGTCAGG-1_V12D07-335_A1,1,1,1,0,0,3
GATCGGCGATAAGTCG-1_V12D07-335_A1,0,2,0,0,0,2
AGCCTTAAAGCGGAAG-1_V12D07-335_A1,2,2,3,0,0,7
TCCGTAACCACAATCC-1_V12D07-335_A1,0,0,4,0,0,4
GAATGCCGAAATGACC-1_V12D07-335_A1,1,1,1,0,0,3
TATACTCATGCGGCAA-1_V12D07-335_A1,0,0,3,0,0,3
TAGTGTCAGAAACGGC-1_V12D07-335_A1,0,1,2,0,0,3
CGTCATACCATATCCA-1_V12D07-335_A1,0,4,0,0,0,4
TAGTACCTTAGTGGTC-1_V12D07-335_A1,0,2,0,0,0,2
CTGGCGGGAATAAGTA-1_V12D07-335_A1,1,1,2,0,0,4
AGTGTGGTCTATTGTG-1_V12D07-335_A1,0,1,0,0,0,1
GCTATCGCGGCGCAAC-1_V12D07-335_A1,0,3,1,0,0,4
CAGTAATCCCTCCCAG-1_V12D07-335_A1,0,1,1,0,0,2
GTATTAAGGCGTCTAA-1_V12D07-335_A1,0,4,1,0,0,5
CTAATTTCAACAACAC-1_V12D07-335_A1,0,3,2,0,0,5
TTAGCAACATGGATGT-1_V12D07-335_A1,0,1,3,0,0,4
ATGCTCAGTGTTGCAT-1_V12D07-335_A1,0,2,4,0,0,6
GATGTTTGTGCGAGAT-1_V12D07-335_A1,0,1,2,0,0,3
CACTTCGCCACAGGCT-1_V12D07-335_A1,0,3,0,0,0,3
CTGTATGGTGTAGAAA-1_V12D07-335_A1,0,1,4,0,0,5
TACGTGCACTATGCTG-1_V12D07-335_A1,0,0,2,0,0,2
GTATCAGCTTGGGTTC-1_V12D07-335_A1,0,1,0,0,0,1
TAACAAAGGGAGAAGC-1_V12D07-335_A1,0,0,0,0,0,0
TTACATCGTGGCCTGG-1_V12D07-335_A1,0,0,2,0,0,2
TCTGAACCGGTCGGCT-1_V12D07-335_A1,0,0,5,0,0,5
GGCTCGTGCCACCAGC-1_V12D07-335_A1,0,0,0,0,0,0
TATAAGTGAGGATAGC-1_V12D07-335_A1,0,0,2,0,0,2
GCCCGCGCGTTTGACA-1_V12D07-335_A1,0,0,2,0,0,2
TGCTGGTTGGACAATT-1_V12D07-335_A1,0,1,1,0,0,2
GCCTAGCGATCTGACC-1_V12D07-335_A1,0,0,1,15,0,16
CCATGCTCTGCAGGAA-1_V12D07-335_A1,0,0,0,16,0,16
TATAAATCCACAAGCT-1_V12D07-335_A1,1,1,1,0,0,3
CGCTCGACATAATGAT-1_V12D07-335_A1,0,1,1,0,0,2
CCAATTGAATGTTAAT-1_V12D07-335_A1,0,0,0,1,0,1
GCTAATACCGAATGCC-1_V12D07-335_A1,0,0,0,2,0,2
TTCAACGACCCGACCG-1_V12D07-335_A1,1,0,2,0,0,3
TTCCTCGAGGGTGTCT-1_V12D07-335_A1,0,2,2,0,0,4
CAACGACCCGTTTACA-1_V12D07-335_A1,0,0,2,0,0,2
CTTGTACTTGTTGACT-1_V12D07-335_A1,1,0,0,0,0,1
TCTCTAATAGCTGGTA-1_V12D07-335_A1,0,2,2,0,0,4
ATTATGCCATAGGGAG-1_V12D07-335_A1,0,1,1,0,0,2
GACAACGCAGCTTACG-1_V12D07-335_A1,0,0,0,0,0,0
AGATGACTCGCCCACG-1_V12D07-335_A1,0,0,1,1,0,2
GTGCGGGTCTCCAAAT-1_V12D07-335_A1,0,0,1,0,0,1
GTACGAGATTGCGACA-1_V12D07-335_A1,1,1,2,0,0,4
GTATAGGACTCAGTAG-1_V12D07-335_A1,0,0,0,0,0,0
TTGCACGGAGCAGCAC-1_V12D07-335_A1,0,0,0,0,0,0
CACAGCTAGGGAGTGA-1_V12D07-335_A1,0,0,1,0,0,1
ATACTAGCATGACCCT-1_V12D07-335_A1,0,0,0,0,0,0
CCAAGACTTCTGCGAA-1_V12D07-335_A1,0,2,1,2,0,5
ACATAATAAGGCGGTG-1_V12D07-335_A1,0,0,0,0,0,0
TAATACACAGTAGTAT-1_V12D07-335_A1,0,1,0,1,0,2
TCTTGGTAACACCAAA-1_V12D07-335_A1,0,3,3,0,0,6
AACTGGGTCCCGACGT-1_V12D07-335_A1,1,0,1,0,0,2
ATCACTTCATCCTCGC-1_V12D07-335_A1,0,2,1,0,0,3
TGGAAGGATAAAGATG-1_V12D07-335_A1,1,0,1,0,0,2
CATGATGCACAATTCT-1_V12D07-335_A1,0,1,4,0,0,5
TGCCTGATCAAACGAT-1_V12D07-335_A1,0,2,1,0,0,3
ATAGGGATATCCTTGA-1_V12D07-335_A1,0,0,0,0,0,0
CACCTAATCAGTTTAC-1_V12D07-335_A1,0,0,1,0,0,1
TGTGACTACGCCAGTC-1_V12D07-335_A1,0,1,2,0,0,3
CCCGACCATAGTCCGC-1_V12D07-335_A1,0,2,1,0,0,3
CGCGCCCGACTTAATA-1_V12D07-335_A1,0,2,1,0,0,3
TGCCACCTGGCGAAAC-1_V12D07-335_A1,0,1,4,0,0,5
CTGCCAAGGTTGGAAG-1_V12D07-335_A1,2,2,0,0,0,4
TCTCCAACGTAGGTTA-1_V12D07-335_A1,1,1,4,0,0,6
TTCTTGGAGTAATGAG-1_V12D07-335_A1,0,1,0,0,0,1
GTCTCGATCTGCTTTC-1_V12D07-335_A1,0,1,3,0,0,4
TACTCTCCGAACAAAT-1_V12D07-335_A1,1,1,2,0,0,4
ATCACATTAGAATATC-1_V12D07-335_A1,1,2,0,0,0,3
TACGGGATGCTAGCAG-1_V12D07-335_A1,4,2,2,0,0,8
AGCTGAAGTAAACCAA-1_V12D07-335_A1,1,3,0,0,0,4
CATGGGTCGGGTGTGG-1_V12D07-335_A1,0,0,4,0,0,4
CACCCACGAGGCAATT-1_V12D07-335_A1,0,4,1,0,0,5
TGCCATTACTAAAGAA-1_V12D07-335_A1,0,3,0,0,0,3
CCGTTACGTTAGAACA-1_V12D07-335_A1,2,2,2,0,0,6
GCCAGGAGTAACCGAT-1_V12D07-335_A1,1,0,1,0,0,2
GGAAAGTGCCCATGCC-1_V12D07-335_A1,2,2,2,0,0,6
TCTTACCGGAACTCGT-1_V12D07-335_A1,0,4,2,0,0,6
TATGTCAAGACCGACT-1_V12D07-335_A1,1,0,5,0,0,6
CCTAACTAAGGCTCTA-1_V12D07-335_A1,2,1,2,0,0,5
GCGGTGAACTGCGCTC-1_V12D07-335_A1,1,3,0,0,0,4
CCTCGCGCGATATAGG-1_V12D07-335_A1,0,2,0,0,0,2
ATCGGCAAGCAGTCCA-1_V12D07-335_A1,0,3,1,0,0,4
AGATCGTGCATAAGAT-1_V12D07-335_A1,0,1,3,0,0,4
ATTCAGGACCTATTTC-1_V12D07-335_A1,1,2,3,0,0,6
AGCTAGAAGCAGAAGT-1_V12D07-335_A1,1,0,3,0,0,4
TTCGCTATCTGACGTG-1_V12D07-335_A1,3,0,0,0,0,3
TTCCGCAGAGAAATAT-1_V12D07-335_A1,2,1,1,0,0,4
CAGTACATTCTCTAAA-1_V12D07-335_A1,1,0,1,0,0,2
GTGAAGATTTCAAGTG-1_V12D07-335_A1,0,1,0,0,0,1
AACGCATGATCTGGGT-1_V12D07-335_A1,1,0,0,0,0,1
CCCAGAGGAGGGCGTA-1_V12D07-335_A1,0,3,2,0,0,5
GGAAACCTTGTTGAAT-1_V12D07-335_A1,0,1,2,0,0,3
GTGAAGCCGTATAGTC-1_V12D07-335_A1,2,1,0,0,0,3
GAGCTGTCGTCTCGGA-1_V12D07-335_A1,1,0,3,0,0,4
TGTCATTTGTTGGGAA-1_V12D07-335_A1,0,0,0,0,0,0
ACCAACACCACACACT-1_V12D07-335_A1,0,0,6,0,0,6
AAATGATTCGATCAGC-1_V12D07-335_A1,1,2,1,0,0,4
CTGCTTTATGTCCGCG-1_V12D07-335_A1,0,0,2,1,0,3
GCGAGAGGCCATGTAA-1_V12D07-335_A1,3,0,0,0,0,3
ATTGACCGGCGATGAC-1_V12D07-335_A1,2,1,3,0,0,6
ACCCTGGTAACGCCCT-1_V12D07-335_A1,1,0,3,0,0,4
GTTGGACCGCATCAGG-1_V12D07-335_A1,1,1,1,0,0,3
CGTTTACAAGGCAGCT-1_V12D07-335_A1,2,1,0,0,0,3
CGGTCCATGAGACTCC-1_V12D07-335_A1,0,3,2,0,0,5
GTTCGTCTGGGTCCCT-1_V12D07-335_A1,0,2,2,0,0,4
TGTACTACTCTCACGG-1_V12D07-335_A1,0,0,5,0,0,5
AGTGAAGATGGTGTCC-1_V12D07-335_A1,2,2,3,0,0,7
GAGGGCCATAATATTA-1_V12D07-335_A1,0,1,11,0,0,12
ACTCCCGTAGACTAGG-1_V12D07-335_A1,0,2,2,0,0,4
CGTCAAATGGTCGCAG-1_V12D07-335_A1,2,3,1,0,0,6
AAGTCTAGTAGCTGCC-1_V12D07-335_A1,0,0,8,0,0,8
AAGAAATCACCAGATT-1_V12D07-335_A1,0,6,2,0,0,8
GAGTGCACGGACAACA-1_V12D07-335_A1,0,0,5,0,0,5
GTTCAAATCAGATGTC-1_V12D07-335_A1,0,0,0,0,0,0
CATGGCTCCCTATGTC-1_V12D07-335_A1,0,0,0,0,0,0
GGCCACACGAAAGCCT-1_V12D07-335_A1,0,0,0,0,0,0
GAAGCCGGGTAAGCTC-1_V12D07-335_A1,0,0,0,0,0,0
TTGCGCTCTCTCGCTT-1_V12D07-335_A1,0,0,0,0,0,0
TACATGACCTTATCCG-1_V12D07-335_A1,0,0,0,0,0,0
GTCCTTCTACAACCCA-1_V12D07-335_A1,0,0,0,0,0,0
TATATGCTGGGTTGCC-1_V12D07-335_A1,0,0,0,0,0,0
GTTTATGGGATTTAGA-1_V12D07-335_A1,0,4,0,0,0,4
GGAACCCGAACAAGAA-1_V12D07-335_A1,0,5,0,0,0,5
AACGTTATCAGCACCT-1_V12D07-335_A1,0,0,3,0,0,3
CATCGTCCGGTTACTA-1_V12D07-335_A1,0,4,2,0,0,6
AGACAGCTCAGAATCC-1_V12D07-335_A1,0,0,0,0,0,0
GCAGATCCTCGCAAAT-1_V12D07-335_A1,0,0,2,0,0,2
GGGTCATGCGTACCAT-1_V12D07-335_A1,0,4,0,0,0,4
CTGGTCATTCCAATCC-1_V12D07-335_A1,0,0,1,0,0,1
TCAGGGCGCAAACTCG-1_V12D07-335_A1,0,2,0,0,0,2
GATGCCAGCAGAAGGC-1_V12D07-335_A1,0,0,0,0,0,0
GTTATTAACGTGGGAG-1_V12D07-335_A1,1,1,0,0,0,2
AATACAATGTTTCAGG-1_V12D07-335_A1,0,0,1,0,0,1
TTGCTGCACCTATCCA-1_V12D07-335_A1,0,0,3,0,0,3
CCAGAGACAAAGCCGG-1_V12D07-335_A1,0,1,1,1,0,3
CCGAAGTATATTGTTC-1_V12D07-335_A1,0,0,0,0,0,0
GCTAAACCTGAGGTGA-1_V12D07-335_A1,1,0,1,0,0,2
TCATACTTACAGATCC-1_V12D07-335_A1,0,1,3,0,0,4
CGAGCACTTCAAGTTT-1_V12D07-335_A1,0,1,3,0,0,4
TAGCAACCTGTCACAA-1_V12D07-335_A1,0,0,0,0,0,0
TGGGAAATGCCTTTCC-1_V12D07-335_A1,0,1,3,0,0,4
AGACCATGGGATACAA-1_V12D07-335_A1,0,0,2,0,0,2
TAAATGAATCCGTTTC-1_V12D07-335_A1,0,1,2,0,0,3
ACAACGGTCCCTGCGA-1_V12D07-335_A1,0,0,2,0,0,2
GTCACTCTCCAAATCT-1_V12D07-335_A1,0,0,3,0,0,3
TTCTACTTGCGAGGGC-1_V12D07-335_A1,0,1,2,0,0,3
CGCAATTACTTTCGGT-1_V12D07-335_A1,3,0,2,0,0,5
CTGTTCATCTCACGGG-1_V12D07-335_A1,0,1,3,0,0,4
TTCTTGTAACCTAATG-1_V12D07-335_A1,0,0,3,0,0,3
GCTTGATGATAATCAG-1_V12D07-335_A1,0,1,1,0,0,2
TTGGCTCGCATGAGAC-1_V12D07-335_A1,0,1,1,0,0,2
GCCCAGTTGGTATGCC-1_V12D07-335_A1,0,0,1,0,0,1
ATTCCTCCGCCAGTGC-1_V12D07-335_A1,0,0,2,0,0,2
TCGTCCGCTGGCGTCT-1_V12D07-335_A1,0,0,1,0,0,1
GGAGAAGTCATTGGCA-1_V12D07-335_A1,0,0,1,0,0,1
TTGTTAGCAAATTCGA-1_V12D07-335_A1,0,0,0,0,0,0
TCTAGCATCTTCGATG-1_V12D07-335_A1,1,0,0,9,0,10
TTCTAGGCCAATTGTG-1_V12D07-335_A1,0,0,0,26,0,26
TCACGGTCATCGCACA-1_V12D07-335_A1,0,1,4,5,0,10
ATGAAGCCAAGGAGCC-1_V12D07-335_A1,1,0,1,1,0,3
AATGACTGTCAGCCGG-1_V12D07-335_A1,0,1,0,0,0,1
CCAAACAGAACCCTCG-1_V12D07-335_A1,0,0,3,0,0,3
TATCGATGATTAAACG-1_V12D07-335_A1,0,0,0,0,0,0
GAACACACATCAACCA-1_V12D07-335_A1,1,0,0,1,0,2
CCCGTCAGCGTCTGAC-1_V12D07-335_A1,0,0,0,2,0,2
AGCATCGTCGATAATT-1_V12D07-335_A1,0,1,3,2,0,6
GACTAAGATCATGCAC-1_V12D07-335_A1,0,0,0,0,0,0
TAGGGTGTTTCAAGAG-1_V12D07-335_A1,0,0,0,0,0,0
TGGTTCGTAGCAAAGG-1_V12D07-335_A1,0,0,2,0,0,2
CTGTTCACTGCCTGTG-1_V12D07-335_A1,0,0,0,2,0,2
ATGTGCATCCGACGCA-1_V12D07-335_A1,0,1,2,0,0,3
TTGTCGTTCAGTTACC-1_V12D07-335_A1,0,0,2,2,0,4
CGGGATCAATGTAAGA-1_V12D07-335_A1,0,0,4,0,0,4
TTATCTGTATCATAAC-1_V12D07-335_A1,1,0,2,0,0,3
ATCGACTCTTTCCGTT-1_V12D07-335_A1,0,0,0,0,0,0
CTCATTTGATGGGCGG-1_V12D07-335_A1,2,0,0,0,0,2
GTAAGCGGGCAGTCAG-1_V12D07-335_A1,0,1,0,0,0,1
TCTATCGGTCGCAACA-1_V12D07-335_A1,1,0,0,0,0,1
AACGCGGTCTCCAGCC-1_V12D07-335_A1,0,0,1,0,0,1
ATTAATACTACGCGGG-1_V12D07-335_A1,0,0,1,0,0,1
CTTTAACTTTCAAAGG-1_V12D07-335_A1,0,0,1,1,0,2
CGTACCTGATAGGCCT-1_V12D07-335_A1,0,0,3,0,0,3
GAATGTTGGGTAATCT-1_V12D07-335_A1,0,0,1,0,0,1
TGCGGAGTAAAGGTGC-1_V12D07-335_A1,2,0,4,0,0,6
CCTGAATATTTACATA-1_V12D07-335_A1,0,0,1,0,0,1
TTGCTCCCATACCGGA-1_V12D07-335_A1,0,1,1,0,0,2
CCTCTAATCTGCCAAG-1_V12D07-335_A1,0,0,2,0,0,2
AGGTTGAGGCACGCTT-1_V12D07-335_A1,1,0,0,0,0,1
TCCCGTCAGTCCCGCA-1_V12D07-335_A1,1,0,4,0,0,5
TCCGATGACTGAGCTC-1_V12D07-335_A1,0,2,1,0,0,3
CAGCCTCCTGCAGAGG-1_V12D07-335_A1,0,0,2,0,0,2
CTTAGCCTTCCACATG-1_V12D07-335_A1,1,3,2,0,0,6
ATTAATGAACCAGTCG-1_V12D07-335_A1,2,3,2,0,0,7
ACGATACATAGAACTA-1_V12D07-335_A1,1,0,2,0,0,3
AGCCACTCCCGTGCTT-1_V12D07-335_A1,0,1,5,0,0,6
ATACGGGTTTCGATTG-1_V12D07-335_A1,0,3,1,0,0,4
CTGTCAAATGGCTCGG-1_V12D07-335_A1,0,0,1,0,0,1
GCTCGGAATTTAAAGC-1_V12D07-335_A1,0,1,1,0,0,2
TAGGCATGTTACGCCA-1_V12D07-335_A1,1,0,7,0,0,8
TGGCAACTCGCGCGCC-1_V12D07-335_A1,1,7,1,0,0,9
ATCAGTAGGCAGGGAT-1_V12D07-335_A1,0,1,0,0,0,1
TATCGATCTATGCATA-1_V12D07-335_A1,1,1,2,0,0,4
CGACTCAGGATGTTAT-1_V12D07-335_A1,1,1,1,0,0,3
GCCATATTGCACACAG-1_V12D07-335_A1,0,0,3,0,0,3
AATTCATAAGGGATCT-1_V12D07-335_A1,0,1,2,0,0,3
CGGTAGAGGTGCAGGT-1_V12D07-335_A1,0,2,2,0,0,4
AATGATGATACGCTAT-1_V12D07-335_A1,1,2,1,0,0,4
CTTGTGCTCACCGATT-1_V12D07-335_A1,0,3,0,0,0,3
TTCCAATCAGAGCTAG-1_V12D07-335_A1,3,0,2,0,0,5
CGATGGACCCTACGCC-1_V12D07-335_A1,1,3,0,0,0,4
GGTCGGATAAACGGCG-1_V12D07-335_A1,1,1,1,0,0,3
TTAGCTAATACGATCT-1_V12D07-335_A1,0,4,2,0,0,6
CTCGATATTTGCGAGC-1_V12D07-335_A1,1,4,0,0,0,5
ATTACTTACTGGGCAT-1_V12D07-335_A1,0,1,1,0,0,2
CTAGCCGATGTTATGA-1_V12D07-335_A1,2,2,3,0,0,7
TACTGCAATCAATTAC-1_V12D07-335_A1,1,0,1,0,0,2
TAGTCTGTGACGTTGC-1_V12D07-335_A1,1,0,1,0,0,2
CTCGTTTCTAATGTTT-1_V12D07-335_A1,1,1,1,0,0,3
TTCGTTCAACGAAGTT-1_V12D07-335_A1,1,1,2,0,0,4
CTGAATTTATTGCCAG-1_V12D07-335_A1,0,0,6,0,0,6
TGGAATATCCTTGACC-1_V12D07-335_A1,0,1,1,0,0,2
CAGATCATTTAAAGTC-1_V12D07-335_A1,2,1,2,0,0,5
CTCCTTTACGCAAGTC-1_V12D07-335_A1,0,1,1,0,0,2
TCCCAAACAGACAACG-1_V12D07-335_A1,1,1,2,0,0,4
ATCGCTGCGTGCAGCA-1_V12D07-335_A1,1,1,2,0,0,4
TTAGTTCAAGTGTTCG-1_V12D07-335_A1,0,1,2,0,0,3
AAACTCGTGATATAAG-1_V12D07-335_A1,0,2,2,0,0,4
TTAACGAACAAGCAGT-1_V12D07-335_A1,0,0,1,0,0,1
GTTATATCAGGAGCCA-1_V12D07-335_A1,1,1,1,0,0,3
CAAATTGGATTATGCC-1_V12D07-335_A1,1,1,0,0,0,2
CGAGGAGCTTCCATAT-1_V12D07-335_A1,1,2,2,0,0,5
GGAGACCAATGTGCTT-1_V12D07-335_A1,0,3,0,0,0,3
CATTGATGAACACGCC-1_V12D07-335_A1,1,2,2,0,0,5
GTCAATGCTATAATTT-1_V12D07-335_A1,0,1,1,0,0,2
ACCACCCTCTCTTCTA-1_V12D07-335_A1,1,1,1,0,0,3
TGGAGGGAAACACCTC-1_V12D07-335_A1,1,2,3,0,0,6
CACGGACGTGGATGGC-1_V12D07-335_A1,1,2,0,0,0,3
AACTTTCTCGATCATG-1_V12D07-335_A1,2,1,1,0,0,4
CGTATTGTTTCCTAAT-1_V12D07-335_A1,1,5,1,0,0,7
CCTACTGCGGCGGCCA-1_V12D07-335_A1,0,0,4,0,0,4
CTTAGGTCCCAATCGT-1_V12D07-335_A1,0,0,2,0,0,2
CGCAATCGATCATTAG-1_V12D07-335_A1,0,0,0,0,0,0
TGGTTATGCTTGCGGT-1_V12D07-335_A1,0,0,0,0,0,0
GGCTTGGCTCTCACCT-1_V12D07-335_A1,0,0,0,0,0,0
ATTGGTAGGATCCGCT-1_V12D07-335_A1,0,0,0,0,0,0
TCAGGGCGACTTCCTT-1_V12D07-335_A1,0,0,0,0,0,0
TCTGCAGATTCGAGTC-1_V12D07-335_A1,0,0,0,0,0,0
CTCTCGCTGTACTATG-1_V12D07-335_A1,0,0,0,0,0,0
AATAGTCGCGAGTCGG-1_V12D07-335_A1,0,0,0,0,0,0
AGTTACCCTTAAGACT-1_V12D07-335_A1,1,3,1,0,0,5
CTTAAATAAGACCCAT-1_V12D07-335_A1,0,1,4,0,0,5
GGTTGTGCTCTTGTCC-1_V12D07-335_A1,0,2,1,0,0,3
GTGAGTCTAAGACGGA-1_V12D07-335_A1,0,2,1,0,0,3
CGCGACACTGCGCAGC-1_V12D07-335_A1,1,1,1,0,0,3
GCTCGCGGTTCCGCTC-1_V12D07-335_A1,1,0,0,0,0,1
TTAACTCACGCGTGGA-1_V12D07-335_A1,0,2,0,0,0,2
GGAACGGCCTGCAGCC-1_V12D07-335_A1,0,0,2,0,0,2
GTAGAAACGGGTGGAG-1_V12D07-335_A1,0,0,0,0,0,0
TAATGAAAGACCCTTG-1_V12D07-335_A1,0,1,0,0,0,1
AGGCTTGCTAGACACC-1_V12D07-335_A1,0,0,0,0,0,0
TTGCGTAGTTTGAGGA-1_V12D07-335_A1,0,0,0,1,0,1
CGCCCTTGAAGGCTGA-1_V12D07-335_A1,0,0,0,0,0,0
CCCGGTGGAAGAACCT-1_V12D07-335_A1,0,1,0,2,0,3
TTAACACCTCGAACAT-1_V12D07-335_A1,0,0,0,0,0,0
GATTCCTATACGGCGC-1_V12D07-335_A1,1,0,0,0,0,1
TTACCCTAACAGTCCT-1_V12D07-335_A1,0,0,0,0,0,0
ACCCACCTACATGCTC-1_V12D07-335_A1,0,1,1,0,0,2
AAAGGGCAGCTTGAAT-1_V12D07-335_A1,0,1,0,0,0,1
CACACAGGGATAGATT-1_V12D07-335_A1,0,0,2,0,0,2
AGAGCGTACAAGCTCG-1_V12D07-335_A1,0,0,0,0,0,0
TCTTACGGCATCCGAC-1_V12D07-335_A1,0,0,2,0,0,2
GCCTATTCCGATATAG-1_V12D07-335_A1,0,1,1,0,0,2
GAAAGTGACTAACTGC-1_V12D07-335_A1,0,0,2,0,0,2
CCGGAATGGTTTCAGT-1_V12D07-335_A1,0,1,2,0,0,3
AGTATAATACTAGGCA-1_V12D07-335_A1,0,0,1,0,0,1
TAACTATCGAAGGTCC-1_V12D07-335_A1,0,0,3,0,0,3
ATGAGGAGTGTTAATC-1_V12D07-335_A1,0,0,0,0,0,0
TGTGTCGCGAGTTGCA-1_V12D07-335_A1,0,0,1,0,0,1
ATCCAACGCAGTCATA-1_V12D07-335_A1,0,0,1,0,0,1
AAGGCGCGTAAAGCTT-1_V12D07-335_A1,0,0,0,0,0,0
AGTCGGCCCAAACGAC-1_V12D07-335_A1,0,0,0,0,0,0
AACGTCAGACTAGTGG-1_V12D07-335_A1,1,0,2,0,0,3
ACTACCAGCTCTCTGG-1_V12D07-335_A1,0,0,0,0,0,0
GCAAGTGCACAGAGAA-1_V12D07-335_A1,0,0,1,1,0,2
ACACCTTAAGTAGGGC-1_V12D07-335_A1,0,0,3,16,0,19
TTCGACGGGAAGGGCG-1_V12D07-335_A1,0,0,1,21,0,22
TTCGCACTCGCGTGCT-1_V12D07-335_A1,1,0,1,0,0,2
TATTTGTTACCCTTTA-1_V12D07-335_A1,1,0,1,0,0,2
CGCTGTGACGCCGCAC-1_V12D07-335_A1,1,0,0,0,0,1
GTTGCACGGAGTTTCG-1_V12D07-335_A1,0,0,1,0,0,1
GTTTCCTGGAGGGTGA-1_V12D07-335_A1,0,0,0,0,0,0
ACACCCAGCATGCAGC-1_V12D07-335_A1,0,1,0,1,0,2
TCAACCATGTTCGGGC-1_V12D07-335_A1,0,0,1,1,0,2
TTACAACTACGCATCC-1_V12D07-335_A1,0,0,2,0,0,2
TCCGATGGTGCGACAT-1_V12D07-335_A1,0,0,2,0,0,2
GGGCGTACATTTATAT-1_V12D07-335_A1,0,2,2,0,0,4
AGCGACCAACGATATT-1_V12D07-335_A1,0,1,2,1,0,4
ACACAAAGACGGGTGG-1_V12D07-335_A1,0,0,4,0,0,4
ATCGCACGCCGGGAGA-1_V12D07-335_A1,0,1,3,0,0,4
GCTCTAAACCCTGACG-1_V12D07-335_A1,0,0,1,0,0,1
AATGCAACCGGGTACC-1_V12D07-335_A1,0,0,0,1,0,1
TCAAACAACCGCGTCG-1_V12D07-335_A1,0,0,2,0,0,2
TATGCTCCCTACTTAC-1_V12D07-335_A1,0,0,2,0,0,2
AAAGGGATGTAGCAAG-1_V12D07-335_A1,1,1,0,2,0,4
ACGATCATACATAGAG-1_V12D07-335_A1,1,1,1,1,0,4
TTGTTCAGTGTGCTAC-1_V12D07-335_A1,0,0,0,0,0,0
ATGCATGATCCAGGAT-1_V12D07-335_A1,0,0,1,0,0,1
AGTCTTCTCCTCAAAT-1_V12D07-335_A1,0,0,2,0,0,2
GATTCCCTTGTCGCAG-1_V12D07-335_A1,1,0,0,0,0,1
CTCGCACCTATATAGT-1_V12D07-335_A1,1,0,0,1,0,2
ACTCAATAAAGGCACG-1_V12D07-335_A1,0,1,2,0,0,3
AACCGAGCTTGGTCAT-1_V12D07-335_A1,0,1,1,0,0,2
TAAGGCAACATAAGAT-1_V12D07-335_A1,0,0,2,0,0,2
CACGCACAGCGCAGCT-1_V12D07-335_A1,0,0,0,0,0,0
GGTTTACAATCTCAAT-1_V12D07-335_A1,0,0,2,2,0,4
TGCAGGATCGGCAAAG-1_V12D07-335_A1,0,1,1,0,0,2
ATAACGGAGTCCAACG-1_V12D07-335_A1,0,0,3,0,0,3
AACGATATGTCAACTG-1_V12D07-335_A1,1,0,4,0,0,5
GACAACGACCATTGAA-1_V12D07-335_A1,0,3,0,0,0,3
TTGACCATGTTCTCCG-1_V12D07-335_A1,0,0,1,0,0,1
AGTACGGGCACCTGGC-1_V12D07-335_A1,0,0,2,0,0,2
CGCCATCCGATTATGA-1_V12D07-335_A1,0,0,1,0,0,1
AAGGTATCCTAATATA-1_V12D07-335_A1,0,0,0,0,0,0
TGTTGTCAAGAAGTCT-1_V12D07-335_A1,0,2,2,0,0,4
CAGTGAATAAATGACT-1_V12D07-335_A1,0,0,1,0,0,1
CACCTTGCGAAACTCG-1_V12D07-335_A1,1,1,1,0,0,3
CATTTAGCGGACCATG-1_V12D07-335_A1,0,2,0,0,0,2
CCAGTCTAGACGGCGC-1_V12D07-335_A1,0,2,1,0,0,3
TCGCTTTAAACGTTTG-1_V12D07-335_A1,0,1,1,0,0,2
GTGAAACGGCGCCACC-1_V12D07-335_A1,0,2,4,0,0,6
GGGCTCATCGAACCCA-1_V12D07-335_A1,1,1,2,0,0,4
TTGATGTGTAGTCCCG-1_V12D07-335_A1,0,2,2,0,0,4
CAGTAGCCCACGCGGT-1_V12D07-335_A1,0,3,1,0,0,4
AGCGCGGGTGCCAATG-1_V12D07-335_A1,0,2,2,0,0,4
TAATCGATCCGTACGT-1_V12D07-335_A1,0,1,2,0,0,3
AGTGGCGGCAATTTGA-1_V12D07-335_A1,0,0,1,0,0,1
CCTTTCAATGAAGAAA-1_V12D07-335_A1,1,1,0,0,0,2
CTCAGTCACGACAAAT-1_V12D07-335_A1,0,1,0,0,0,1
ATAGGCTAGCTTCGCA-1_V12D07-335_A1,0,3,1,0,0,4
CGGTTCAAGTAGGTGT-1_V12D07-335_A1,1,1,2,0,0,4
CAGTCGAGGATGCAAT-1_V12D07-335_A1,0,2,0,0,0,2
TATCACCCAACCGACC-1_V12D07-335_A1,1,4,1,0,0,6
AATGATGCGACTCCTG-1_V12D07-335_A1,3,1,0,1,0,5
TGGAACCACTGACACA-1_V12D07-335_A1,3,2,1,0,0,6
GCCAATAGGGCATCTC-1_V12D07-335_A1,1,3,2,0,0,6
TTCTTTGGTCGCGACG-1_V12D07-335_A1,0,1,0,0,0,1
ATTAGATTCCTCAGCA-1_V12D07-335_A1,0,3,1,0,0,4
CCGTGGAACGATCCAA-1_V12D07-335_A1,0,2,0,0,0,2
GGGTCGTGGCAAGTGT-1_V12D07-335_A1,2,1,0,0,0,3
TCGCTCGGCACCAGCG-1_V12D07-335_A1,1,2,1,0,0,4
ACGCAATCACTACAGC-1_V12D07-335_A1,0,1,2,0,0,3
CTCTAATGCATTGATC-1_V12D07-335_A1,1,0,0,0,0,1
GTCTCGACTAAGTTTG-1_V12D07-335_A1,0,1,0,0,0,1
TGGTTTAAACGTGGGT-1_V12D07-335_A1,1,3,2,0,0,6
CGCAGATCTTCACCCG-1_V12D07-335_A1,0,2,0,0,0,2
TCCAGATGTACGCCAA-1_V12D07-335_A1,1,0,2,0,0,3
CATTGCGGGTCAATTC-1_V12D07-335_A1,1,1,1,0,0,3
GACGTTCGTAAATACA-1_V12D07-335_A1,2,1,2,0,0,5
TACACCGTCGTTAGTC-1_V12D07-335_A1,1,0,3,0,0,4
ACGGGCGTATGCGACA-1_V12D07-335_A1,0,4,0,0,0,4
GAAGGCTACCATTGTT-1_V12D07-335_A1,2,0,0,0,0,2
TAAATCTTTACACCTC-1_V12D07-335_A1,0,0,4,0,0,4
AGTTTATGTAAAGACA-1_V12D07-335_A1,1,2,2,0,0,5
AGGAGACATCCACAGT-1_V12D07-335_A1,1,2,2,0,0,5
CAACCTGAACCTGCCA-1_V12D07-335_A1,1,0,0,0,0,1
AGTCCCTCGCAGAAAG-1_V12D07-335_A1,3,2,1,0,0,6
TGTATACGGATGATGA-1_V12D07-335_A1,0,0,4,0,0,4
TTGTGGTATAGGTATG-1_V12D07-335_A1,0,1,3,0,0,4
TCTGCACCATTAGTAA-1_V12D07-335_A1,0,2,1,0,0,3
AAATGTATCTTATCCC-1_V12D07-335_A1,0,0,0,0,0,0
ACTCTAAACCTGGGAT-1_V12D07-335_A1,0,0,0,0,0,0
GCTGGCAGGTGCCGTG-1_V12D07-335_A1,0,0,0,0,0,0
CTCATTCGTGAACATC-1_V12D07-335_A1,0,0,0,0,0,0
TCGCCGGATGGGCAAG-1_V12D07-335_A1,0,0,0,0,0,0
GGACTAAGTCAGGAGT-1_V12D07-335_A1,0,0,0,0,0,0
TATCAAAGGTCTGTAA-1_V12D07-335_A1,0,0,0,0,0,0
TTCAGTTTGTGGCAGC-1_V12D07-335_A1,0,0,0,0,0,0
TGTTCATAAATGTGCT-1_V12D07-335_A1,0,1,2,0,0,3
CTTAGCCCGGATAGTG-1_V12D07-335_A1,0,1,4,0,0,5
GATGCGAATGGTATTA-1_V12D07-335_A1,0,6,1,0,0,7
TCTAACTGTATGTAAA-1_V12D07-335_A1,0,2,0,0,0,2
TTAAACCTGGTTCCTT-1_V12D07-335_A1,0,0,0,0,0,0
GCTAAGTAAAGGCGAT-1_V12D07-335_A1,0,0,1,0,0,1
AGTTACCGCACATGGT-1_V12D07-335_A1,0,1,2,0,0,3
GACTGCGGCACGTGTA-1_V12D07-335_A1,0,0,3,1,0,4
TGGTGATCGTATTTGT-1_V12D07-335_A1,0,0,2,0,0,2
TTATCGCCTGCGAAGC-1_V12D07-335_A1,0,0,2,10,0,12
TGGAATTAGACGCTTT-1_V12D07-335_A1,0,0,2,18,0,20
TCGTCACACTGTTAGC-1_V12D07-335_A1,0,0,1,20,0,21
TTATGTTTGCGATAGA-1_V12D07-335_A1,0,0,2,18,0,20
GGTGCTGATCACAAAG-1_V12D07-335_A1,0,0,0,12,0,12
CATAGCCGCCCGGGAT-1_V12D07-335_A1,0,0,1,12,0,13
GGTTAGTTACGGCGCC-1_V12D07-335_A1,1,0,3,13,0,17
ATTCCCACATAAACAA-1_V12D07-335_A1,0,0,0,5,0,5
ATTCAGTAGCAGGGTC-1_V12D07-335_A1,0,1,1,19,0,21
CAGTTCCGCGGGTCGA-1_V12D07-335_A1,0,1,1,0,0,2
AAGAGATGAATCGGTA-1_V12D07-335_A1,0,0,1,1,0,2
CGCAATTCTACAATAA-1_V12D07-335_A1,0,1,1,0,0,2
TAACGCTTTGAGAGCG-1_V12D07-335_A1,0,0,3,0,0,3
AGGCTATGGTTAGCTT-1_V12D07-335_A1,0,0,2,0,0,2
GAGGAATGGAGAGGTT-1_V12D07-335_A1,0,0,0,0,0,0
TCCTCTACGAGATGGC-1_V12D07-335_A1,0,0,2,0,0,2
TTGATTATGCAGATGA-1_V12D07-335_A1,0,0,4,0,0,4
TCAGTACTGACCCGCG-1_V12D07-335_A1,1,0,2,1,0,4
TTATGACAAACTGGAT-1_V12D07-335_A1,0,0,2,0,0,2
GTAAGTAGGGTATACC-1_V12D07-335_A1,0,0,0,0,0,0
CGCAAACACGAGTTAC-1_V12D07-335_A1,0,0,1,0,0,1
TGGCCGTATATTGACC-1_V12D07-335_A1,0,0,2,0,0,2
ACTGTAGCACTTTGGA-1_V12D07-335_A1,0,1,0,0,0,1
GCTCTATGTTACGTGC-1_V12D07-335_A1,1,0,1,1,0,3
TGCGCGATTAACGGAG-1_V12D07-335_A1,0,0,0,19,0,19
GAATCGACATGGTCAC-1_V12D07-335_A1,0,0,2,12,0,14
GACTAAGTAGGCTCAC-1_V12D07-335_A1,0,0,2,6,0,8
ATCTTGACCTGCAACG-1_V12D07-335_A1,1,0,2,4,0,7
ATGCACTACCGCATTG-1_V12D07-335_A1,0,0,3,0,0,3
CAGATACTAACATAGT-1_V12D07-335_A1,0,0,1,0,0,1
GATCGACACTATCTGA-1_V12D07-335_A1,0,0,2,0,0,2
ATAGAGTACTGGGACA-1_V12D07-335_A1,0,0,0,2,0,2
CCTACTGCTTACACTT-1_V12D07-335_A1,0,0,0,0,0,0
CCTGCTATTTGAGAAG-1_V12D07-335_A1,0,0,1,0,0,1
CGCGTTCATGAAATAC-1_V12D07-335_A1,0,0,1,0,0,1
CATTATGCTTGTTGTG-1_V12D07-335_A1,0,0,2,0,0,2
CCAGGGACGTGGCCTC-1_V12D07-335_A1,0,1,1,0,0,2
TATGGATGTGCTACGC-1_V12D07-335_A1,1,0,1,0,0,2
GTACTAAGATTTGGAG-1_V12D07-335_A1,0,0,0,0,0,0
AGACCCGCCCTCCTCG-1_V12D07-335_A1,0,1,2,0,0,3
CGCATTAGCTAATAGG-1_V12D07-335_A1,1,0,0,1,0,2
GCTCTCGGGTACCGAA-1_V12D07-335_A1,1,1,1,0,0,3
CACCGCCAGAAGGTTT-1_V12D07-335_A1,2,0,2,0,0,4
TCCCAAAGACGAAGGA-1_V12D07-335_A1,0,0,0,0,0,0
ATGGATTGACCAAACG-1_V12D07-335_A1,1,0,2,0,0,3
GTCATGGACATGACTA-1_V12D07-335_A1,0,1,1,0,0,2
CTACTGCCACCTGACC-1_V12D07-335_A1,0,0,0,0,0,0
TTATATTTGGCAATCC-1_V12D07-335_A1,0,0,5,0,0,5
AGCACCAGTACTCACG-1_V12D07-335_A1,0,1,1,0,0,2
CATGGTCTAGATACCG-1_V12D07-335_A1,1,1,0,1,0,3
TCTACCGTCCACAAGC-1_V12D07-335_A1,1,0,2,0,0,3
CTAGTTGGGCCCGGTA-1_V12D07-335_A1,1,2,1,0,0,4
TCCCGCGTACTCCTGG-1_V12D07-335_A1,0,0,0,0,0,0
CAGAGCATGAGCTTGC-1_V12D07-335_A1,0,0,0,0,0,0
ACACGGGAACTTAGGG-1_V12D07-335_A1,0,2,1,0,0,3
GGCTCTGCTCCAACGC-1_V12D07-335_A1,0,0,1,0,0,1
AGAACGTGGTACATTC-1_V12D07-335_A1,0,1,2,1,0,4
CAATAAACCTTGGCCC-1_V12D07-335_A1,0,0,1,1,0,2
ACTTCGCCATACGCAC-1_V12D07-335_A1,0,0,0,0,0,0
ATCTGGTTAAGACTGT-1_V12D07-335_A1,1,0,1,0,0,2
TCGTAAGACGACATTG-1_V12D07-335_A1,1,0,0,1,0,2
GTGTACCTTGGCTACG-1_V12D07-335_A1,1,1,3,1,0,6
GCCCGTAATACCTTCT-1_V12D07-335_A1,0,1,0,0,0,1
CGGTCAAGTGGGAACC-1_V12D07-335_A1,0,1,1,0,0,2
TTGTAAGGCCAGTTGG-1_V12D07-335_A1,0,2,0,0,0,2
GGAGCACCAAGAACTA-1_V12D07-335_A1,0,0,3,1,0,4
TAATAGTGACGACCAG-1_V12D07-335_A1,0,0,2,0,0,2
CTAAATCCTATTCCGG-1_V12D07-335_A1,0,0,0,0,0,0
CGAGTTCTGTCCCACC-1_V12D07-335_A1,0,0,0,0,0,0
AGGCAGATGCGTAAAC-1_V12D07-335_A1,0,0,0,0,0,0
AAGGATGAGGGACCTC-1_V12D07-335_A1,0,1,1,0,0,2
AGAGAACCGTCTAGGA-1_V12D07-335_A1,0,0,0,0,0,0
GAGGGCGCAGCTCTGC-1_V12D07-335_A1,0,0,4,0,0,4
AAGATTGGCGGAACGT-1_V12D07-335_A1,0,0,0,0,0,0
CCAGTAGTCTGATCCA-1_V12D07-335_A1,0,0,2,0,0,2
AAGGGACAGATTCTGT-1_V12D07-335_A1,0,1,1,0,0,2
ATAGAGTTATCAACTT-1_V12D07-335_A1,0,0,2,0,0,2
AAATTACCTATCGATG-1_V12D07-335_A1,0,4,1,0,0,5
GATCCTAAATCGGGAC-1_V12D07-335_A1,0,0,1,0,0,1
TTACAGACCTAAATGA-1_V12D07-335_A1,0,1,1,0,0,2
CCTCACCTTAGCATCG-1_V12D07-335_A1,0,0,1,0,0,1
CATGCGACCAGTTTAA-1_V12D07-335_A1,0,0,1,0,0,1
AACATATCAACTGGTG-1_V12D07-335_A1,0,1,2,0,0,3
CTATAAGAGCCAATCG-1_V12D07-335_A1,0,2,4,0,0,6
AATATCGAGGGTTCTC-1_V12D07-335_A1,0,2,3,0,0,5
GTACTCCTGGGTATGC-1_V12D07-335_A1,0,2,1,0,0,3
ATAAGTAGGATTCAGA-1_V12D07-335_A1,0,0,0,0,0,0
AGGTCGCGGAGTTACT-1_V12D07-335_A1,1,1,2,0,0,4
CTAATTCTCAGATATT-1_V12D07-335_A1,0,2,1,0,0,3
GCCAACCATTTCCGGA-1_V12D07-335_A1,0,0,2,0,0,2
TGATCCCAGCATTAGT-1_V12D07-335_A1,2,1,3,0,0,6
CGTTGTAAGATTGATT-1_V12D07-335_A1,1,2,2,0,0,5
GAAACCATGGTGCGCT-1_V12D07-335_A1,0,0,2,0,0,2
AATCTATGCCGGAGCC-1_V12D07-335_A1,1,1,1,0,0,3
GACTCCCAGAATAAGG-1_V12D07-335_A1,1,3,2,0,0,6
TATGATCCGGCACGCC-1_V12D07-335_A1,0,2,3,0,0,5
CCGCTTGCTGACATGG-1_V12D07-335_A1,0,1,1,0,0,2
TGGTTAAGGGCGCTGG-1_V12D07-335_A1,3,1,1,0,0,5
TTGATAGTCAATACAT-1_V12D07-335_A1,0,5,0,0,0,5
GGTTTAATTGAGCAGG-1_V12D07-335_A1,1,1,2,0,0,4
CATTACATAGATTGTG-1_V12D07-335_A1,0,1,1,0,0,2
GGTACACCAGATTTAT-1_V12D07-335_A1,2,2,2,0,0,6
GGCCCGTATACCATGC-1_V12D07-335_A1,0,2,1,0,0,3
ATCTTTCGTATAACCA-1_V12D07-335_A1,0,0,0,0,0,0
GAGATGACAATCCTTA-1_V12D07-335_A1,0,3,2,0,0,5
AAAGCTTGCCTACATA-1_V12D07-335_A1,2,0,3,0,0,5
GAACGATAAGTTAAAG-1_V12D07-335_A1,2,3,1,0,0,6
TAATAGCTAAATGATG-1_V12D07-335_A1,0,0,3,0,0,3
TATGGCTAGGCTAATT-1_V12D07-335_A1,0,2,0,0,0,2
AGGAGAGTCTGGCTAC-1_V12D07-335_A1,0,0,2,0,0,2
TGCTCTGCCGGTTCAC-1_V12D07-335_A1,1,2,0,0,0,3
CCAATAGATTTCATCT-1_V12D07-335_A1,0,0,0,0,0,0
GGGCACGAATTGGCCG-1_V12D07-335_A1,0,0,0,0,0,0
TCGTTGACAGGGTCCC-1_V12D07-335_A1,0,0,0,0,0,0
ATCGTATTCCGAGAAC-1_V12D07-335_A1,0,0,0,0,0,0
GGGAATTCTGTCCAGT-1_V12D07-335_A1,0,0,0,0,0,0
ACGCGTTTCTTAAGAG-1_V12D07-335_A1,0,0,0,8,0,8
GAGAGCGCAGTCCCTG-1_V12D07-335_A1,0,0,0,0,0,0
GTCCTATTGTTGTGGT-1_V12D07-335_A1,0,0,2,0,0,2
CATCTGCAGGATCATT-1_V12D07-335_A1,1,3,3,0,0,7
GAGTCGACAGACCCTC-1_V12D07-335_A1,0,2,0,0,0,2
AAGTGCAAAGGTAGAC-1_V12D07-335_A1,0,0,0,0,0,0
AGGGTGGATAGTGCAT-1_V12D07-335_A1,0,3,0,0,0,3
TGATAGCGGGATTCTA-1_V12D07-335_A1,1,2,3,0,0,6
GTCAGTTTGGTAGTCG-1_V12D07-335_A1,0,0,2,0,0,2
GCATTCGAAATGAACA-1_V12D07-335_A1,0,0,0,0,0,0
AAAGACTGGGCGCTTT-1_V12D07-335_A1,0,0,0,0,0,0
TAACAATATTTGTTGC-1_V12D07-335_A1,2,0,2,0,0,4
CCAGCTTCCGCCCGCA-1_V12D07-335_A1,0,0,4,0,0,4
GATATGGATTACGCGG-1_V12D07-335_A1,1,0,1,21,0,23
AGAGCAGTTATGAGAC-1_V12D07-335_A1,0,0,2,15,0,17
TCACATCTTATCTGAT-1_V12D07-335_A1,1,0,0,10,0,11
TATGAAGACAGGTGCG-1_V12D07-335_A1,1,0,7,11,0,19
TACCTGCTGCACTGTG-1_V12D07-335_A1,2,0,2,2,0,6
TAGGTCCAAGTAAGGA-1_V12D07-335_A1,1,0,2,3,0,6
GAAACTCGTGCGATGC-1_V12D07-335_A1,0,0,3,2,0,5
AACAATTACTCTACGC-1_V12D07-335_A1,0,1,1,0,0,2
CCGCACGTGACCTCGG-1_V12D07-335_A1,0,1,0,18,0,19
AACTTGCCCGTATGCA-1_V12D07-335_A1,0,0,1,2,0,3
GGGTATGTATGCACTT-1_V12D07-335_A1,0,1,1,18,0,20
TTCGTACTCCAGAACG-1_V12D07-335_A1,1,0,2,4,0,7
GAATTTCTCGCTGCAG-1_V12D07-335_A1,0,0,1,19,0,20
AACAGGATGGGCCGCG-1_V12D07-335_A1,0,1,1,18,0,20
GACGTGTAGGGATTAT-1_V12D07-335_A1,0,1,1,3,0,5
TAGGTGAGCCCTACTC-1_V12D07-335_A1,0,0,0,21,0,21
CTAATTCGCACGCGCT-1_V12D07-335_A1,0,0,2,0,0,2
GAAGCTTGCTGACCGC-1_V12D07-335_A1,0,0,0,23,0,23
GGTTAGGCTTGGAGAA-1_V12D07-335_A1,0,0,0,1,0,1
ACAAGGACAAGAGGTT-1_V12D07-335_A1,0,0,3,14,0,17
AGGCCACCCGTTATGA-1_V12D07-335_A1,0,0,1,14,0,15
GTGGGCTTAGACACAC-1_V12D07-335_A1,0,0,2,4,0,6
CGTGTCCCATTCGCGA-1_V12D07-335_A1,1,0,0,23,0,24
TGGAGTGATGCGATGA-1_V12D07-335_A1,0,2,3,0,0,5
AACAACTGGTAGTTGC-1_V12D07-335_A1,0,0,0,1,0,1
CCTGGCTAGACCCGCC-1_V12D07-335_A1,0,1,2,1,0,4
CGCAATTAGGGTAATA-1_V12D07-335_A1,0,2,0,1,0,3
TCGAAATTTAGGACCA-1_V12D07-335_A1,0,1,1,0,0,2
AGACTAGCCTTCCAGA-1_V12D07-335_A1,0,0,1,0,0,1
TTGATCTAACTTTGTC-1_V12D07-335_A1,0,0,0,0,0,0
AAGGAGCGGTTGGTGC-1_V12D07-335_A1,0,0,0,0,0,0
ACTTGGGACCCGGTGG-1_V12D07-335_A1,0,0,3,0,0,3
TGATCTCCGGCGCCAG-1_V12D07-335_A1,0,1,0,1,0,2
CAGTTCAAATTGACAC-1_V12D07-335_A1,0,1,1,0,0,2
GTCCGGCTGAATTGCG-1_V12D07-335_A1,0,0,0,0,0,0
CTGGAAATGGATGCTT-1_V12D07-335_A1,0,0,3,0,0,3
TGATCGGTTTGACCCT-1_V12D07-335_A1,0,1,2,0,0,3
TAGAGTCTAAGCGAAC-1_V12D07-335_A1,0,0,1,0,0,1
GAGACTGATGGGTAGA-1_V12D07-335_A1,0,0,2,0,0,2
TAGCTAAGTCCGGGAG-1_V12D07-335_A1,0,0,2,2,0,4
GGGCGATATGTGTGAA-1_V12D07-335_A1,0,0,0,0,0,0
CTCGAGGTCGAACAGT-1_V12D07-335_A1,0,0,2,2,0,4
GATCCCTTTATACTGC-1_V12D07-335_A1,0,0,1,0,0,1
GTCATGCACCTCCGTT-1_V12D07-335_A1,0,0,3,1,0,4
ACTTTCCTATAGCTTC-1_V12D07-335_A1,0,2,0,0,0,2
TCGCTCGATATATTCC-1_V12D07-335_A1,1,0,4,1,0,6
ATAGGTTGGGCAGATG-1_V12D07-335_A1,0,0,2,0,0,2
CAATTAAGGGTGATGA-1_V12D07-335_A1,0,0,0,0,0,0
ACCGACTGAGTCCCAC-1_V12D07-335_A1,0,0,1,0,0,1
CCTGTCACCCGGGCTC-1_V12D07-335_A1,0,0,2,0,0,2
GATCGGTGGCCATAAC-1_V12D07-335_A1,0,0,1,1,0,2
CCTATGGGTTACCGTC-1_V12D07-335_A1,0,1,1,1,0,3
TTGGGACACTGCCCGC-1_V12D07-335_A1,0,0,0,1,0,1
CGAGGCTAAATATGGC-1_V12D07-335_A1,0,0,2,1,0,3
TCAGGGTGTAACGTAA-1_V12D07-335_A1,0,0,0,0,0,0
CGAGAGATGTGAACCT-1_V12D07-335_A1,0,1,1,1,0,3
TCGCTGGGCGGATTGT-1_V12D07-335_A1,0,2,1,1,0,4
AGATCTCAGGTGTGAT-1_V12D07-335_A1,1,1,0,1,0,3
TGGCCAAACTGAAGTA-1_V12D07-335_A1,0,0,1,1,0,2
GCTTCCGTCCCTAGAC-1_V12D07-335_A1,0,0,2,0,0,2
CAGCAGCCCGTTCCTT-1_V12D07-335_A1,0,1,3,0,0,4
TGTATAACAGATCCTG-1_V12D07-335_A1,0,0,0,0,0,0
CGCGGGAATTAGGCAG-1_V12D07-335_A1,1,0,1,0,0,2
TGCATGTGGTAATCTA-1_V12D07-335_A1,0,0,3,1,0,4
ACAATTTGAGCAGTGG-1_V12D07-335_A1,0,0,1,2,0,3
GAGCTAAGGGCATATC-1_V12D07-335_A1,0,1,0,1,0,2
CCAGATAGTTGAGTGA-1_V12D07-335_A1,1,0,1,0,0,2
CCACAATGTACGTCTT-1_V12D07-335_A1,0,0,1,0,0,1
CAATGGATCTCTACCA-1_V12D07-335_A1,0,1,4,1,0,6
TGTGGCAAAGCGTATG-1_V12D07-335_A1,0,0,2,0,0,2
TAAAGCGTTAGGAGAA-1_V12D07-335_A1,0,6,3,1,0,10
TCCGTTTAGCCTTGAA-1_V12D07-335_A1,0,0,1,0,0,1
CAGCTCGACAAGTTAA-1_V12D07-335_A1,0,1,2,0,0,3
GCCTATAGTGTCAGGG-1_V12D07-335_A1,1,3,0,1,0,5
ATAGACAACGGGACCT-1_V12D07-335_A1,0,0,2,1,0,3
CTACTATCTTTCAGAG-1_V12D07-335_A1,0,0,2,0,0,2
GCGCTGCTTTGCATTT-1_V12D07-335_A1,0,0,1,0,0,1
GCGCATCCAGTCAGCA-1_V12D07-335_A1,0,0,2,0,0,2
GACTCGCGGGAATGAC-1_V12D07-335_A1,0,0,1,0,0,1
CTGGTAACGAGCTCTT-1_V12D07-335_A1,1,2,0,0,0,3
TCCGGCCTAGCGTACA-1_V12D07-335_A1,0,2,3,0,0,5
TCTAGGTGGCGACGCT-1_V12D07-335_A1,1,0,2,0,0,3
ACGCTAGTGATACACT-1_V12D07-335_A1,1,0,2,0,0,3
ATCTGCACCTCTGCGA-1_V12D07-335_A1,1,1,2,0,0,4
CCTCACCTGAGGGAGC-1_V12D07-335_A1,0,1,3,0,0,4
AGTGAGCCTCGCCGCC-1_V12D07-335_A1,0,2,2,0,0,4
ACGAGTACGGATGCCC-1_V12D07-335_A1,0,1,0,0,0,1
GGTACCATTAAGACGG-1_V12D07-335_A1,2,4,1,0,0,7
TTCTGCTAGACTCCAA-1_V12D07-335_A1,2,1,3,0,0,6
TAACTATTACGCCAAA-1_V12D07-335_A1,1,1,1,0,0,3
GCATTCAAGGCAACGC-1_V12D07-335_A1,0,3,1,0,0,4
AGTACATCATTTATCA-1_V12D07-335_A1,0,2,6,0,0,8
GTCGTGTCTGGTCATC-1_V12D07-335_A1,3,2,0,0,0,5
AGTCTAAAGTATACTC-1_V12D07-335_A1,4,1,0,0,0,5
CGGCCCAACCTGTAGT-1_V12D07-335_A1,2,1,2,0,0,5
AGGGAGACATACTTCG-1_V12D07-335_A1,2,0,0,0,1,3
TCCCTAGATCAATAGG-1_V12D07-335_A1,2,3,1,0,0,6
TCCCGTCGCGTCATAG-1_V12D07-335_A1,1,3,1,0,0,5
CGCATCCATCAGCCAG-1_V12D07-335_A1,0,2,1,0,1,4
CTGCACCTAGTCCACA-1_V12D07-335_A1,1,3,0,0,0,4
CGAGGATCGGGAACGA-1_V12D07-335_A1,1,5,2,0,0,8
CAATGAGGTTCGACTA-1_V12D07-335_A1,0,2,0,0,0,2
TCTGACGGGCTAACCC-1_V12D07-335_A1,1,0,0,0,0,1
TTCTATGCCTTTCGCA-1_V12D07-335_A1,2,0,1,0,0,3
AGAGTATAGTGTTACG-1_V12D07-335_A1,0,3,1,0,0,4
CCATTGTTTCCTCCAT-1_V12D07-335_A1,2,3,1,0,0,6
CTCATCACTTAGTGAT-1_V12D07-335_A1,0,3,1,0,0,4
CCGAAGGGCGTACCGC-1_V12D07-335_A1,0,4,1,0,0,5
TCAAGCTGCCTTGAAA-1_V12D07-335_A1,2,4,1,0,0,7
CTCATTAACGTTGCCC-1_V12D07-335_A1,0,2,1,0,0,3
GTCTTCCTCACCTAAG-1_V12D07-335_A1,0,0,0,0,0,0
GGTGATGAAGGAAGTG-1_V12D07-335_A1,0,0,0,0,0,0
TCAATACAATTGCTGC-1_V12D07-335_A1,0,0,0,0,0,0
GCAACCCAAGTTGTTT-1_V12D07-335_A1,0,0,0,0,0,0
ATGAAGTGGACCCAGC-1_V12D07-335_A1,0,0,0,2,0,2
GAGAATCTCACGATCA-1_V12D07-335_A1,0,0,0,0,0,0
TATATCATTGATCAGT-1_V12D07-335_A1,0,0,0,0,0,0
AACTTTACGGGAGCTT-1_V12D07-335_A1,0,0,0,0,0,0
TTCTTGTGTCCATCAG-1_V12D07-335_A1,0,1,1,0,0,2
ACAATTTAGGAGGCTC-1_V12D07-335_A1,0,1,1,0,0,2
ATACTTGTTCTCGAGC-1_V12D07-335_A1,0,2,1,0,0,3
CACGGGATTGAGGGTT-1_V12D07-335_A1,0,3,0,0,0,3
GTTAATGTCTATCTTA-1_V12D07-335_A1,1,2,0,0,0,3
GCGTTATATTTGGAAC-1_V12D07-335_A1,0,3,0,0,1,4
CGTCAAGGCTATAAAT-1_V12D07-335_A1,1,2,1,0,0,4
TTAGCTCTGTAATCCG-1_V12D07-335_A1,1,0,0,0,0,1
AATGGTCCACCGTTCA-1_V12D07-335_A1,1,0,0,0,0,1
GTCATTGCATTGACCC-1_V12D07-335_A1,0,0,3,0,0,3
TGTCCGTGGCGCCTTT-1_V12D07-335_A1,0,0,1,0,0,1
TCAACTAACGTATAAC-1_V12D07-335_A1,0,0,0,0,0,0
TCCTCTCCAGTTGTCC-1_V12D07-335_A1,0,1,1,0,0,2
TGTGTTCGTATCCAAG-1_V12D07-335_A1,0,0,6,0,0,6
CCGCGTAGGTAAGGGC-1_V12D07-335_A1,0,0,1,23,0,24
CTGCGGGTGAAATGTT-1_V12D07-335_A1,0,0,0,18,0,18
TATCTACAGAGGTAAT-1_V12D07-335_A1,0,1,1,3,0,5
CTACTCTAGGCCCGGC-1_V12D07-335_A1,0,0,1,0,0,1
ACAAGCAGTGCCTAGC-1_V12D07-335_A1,1,0,4,0,0,5
TACAAGTCTCGTGCAT-1_V12D07-335_A1,0,0,0,0,0,0
TCGGAATGCGCTCTGA-1_V12D07-335_A1,1,2,2,0,0,5
TCGCGTCCAGAAGGTC-1_V12D07-335_A1,0,0,1,0,0,1
TATGGCCCGGCCTCGC-1_V12D07-335_A1,0,0,2,0,0,2
GCTGGCATATTCACCT-1_V12D07-335_A1,0,1,1,0,0,2
GTCAGAATAGTCTATG-1_V12D07-335_A1,0,0,0,0,0,0
GGCGTCCTATCCGCTG-1_V12D07-335_A1,0,0,0,0,0,0
CGGAGTTTGAGAGACA-1_V12D07-335_A1,1,2,2,1,0,6
AGCACTTAAGGACGCC-1_V12D07-335_A1,0,0,1,2,0,3
TCCACAATGGTTTACG-1_V12D07-335_A1,1,0,1,1,0,3
CCAACGATGCACTGAT-1_V12D07-335_A1,0,0,1,0,0,1
ATTTACAGTTTACTGG-1_V12D07-335_A1,0,0,2,0,0,2
CCCTGAAATGAGTTGA-1_V12D07-335_A1,2,1,2,1,0,6
CAAACGGTCGCACTTT-1_V12D07-335_A1,0,1,1,0,0,2
TGATTCGTCTATCACT-1_V12D07-335_A1,0,0,0,0,0,0
TCAGGTTCTTTGAGAA-1_V12D07-335_A1,0,0,0,0,0,0
CACGCAGCGAGGCTTT-1_V12D07-335_A1,1,1,1,0,0,3
TTAAGCGCCTGACCCA-1_V12D07-335_A1,0,0,2,0,0,2
CTTACACGGTATTCCA-1_V12D07-335_A1,0,0,3,0,0,3
AAGGCTGTGCTCATCG-1_V12D07-335_A1,0,0,0,0,0,0
GACCAGAGCCCTGTAG-1_V12D07-335_A1,0,0,3,0,0,3
TCCCAGGCTTAGCTAA-1_V12D07-335_A1,0,0,5,1,0,6
ATTGAAGATCTTAGTG-1_V12D07-335_A1,0,0,0,0,0,0
AGTTCCTACAGAATTA-1_V12D07-335_A1,1,1,1,0,0,3
GGGCTGGTTAGTCGCG-1_V12D07-335_A1,0,0,2,0,0,2
GAAATGGCGGTGTTAG-1_V12D07-335_A1,0,0,2,0,0,2
TACGAACACGACTTCA-1_V12D07-335_A1,0,0,1,1,0,2
ACCACAAGTTTCTATC-1_V12D07-335_A1,1,1,2,1,0,5
ATATTTAACCCTCAAG-1_V12D07-335_A1,0,1,2,0,0,3
GATCATTCCAAACATT-1_V12D07-335_A1,0,0,2,0,0,2
TCCAGGCGAGTACGGT-1_V12D07-335_A1,0,0,1,2,0,3
GTTTGACCAAATCCTA-1_V12D07-335_A1,0,0,0,2,0,2
CACAGCACCCACGGCA-1_V12D07-335_A1,1,1,0,0,0,2
TGCAAGAATGACGTAA-1_V12D07-335_A1,0,1,1,0,0,2
GCGAAGCCATACCCGT-1_V12D07-335_A1,0,0,2,1,0,3
TCCTTTCTTACGCTTA-1_V12D07-335_A1,0,0,1,0,0,1
GCTGCTCTCCGGACAC-1_V12D07-335_A1,0,0,1,0,0,1
ACTGTCTTCTTTAGAA-1_V12D07-335_A1,0,0,2,0,0,2
TCAAACTTAGATTGTT-1_V12D07-335_A1,0,0,0,0,0,0
CTATGTCACTAGCCCA-1_V12D07-335_A1,0,0,2,0,0,2
TGCGCAAAGCATTTGG-1_V12D07-335_A1,0,0,4,0,0,4
TTAATGTAGACCAGGT-1_V12D07-335_A1,1,0,0,2,0,3
GGCGGTAGGATCATTG-1_V12D07-335_A1,0,0,1,0,0,1
GGCAATAGTCAATGAG-1_V12D07-335_A1,0,0,1,0,0,1
ACACGAGACTCCTTCT-1_V12D07-335_A1,0,0,2,0,0,2
GACACAAGGGAAGAAA-1_V12D07-335_A1,1,0,0,1,0,2
TCAGCAAATGCATCTC-1_V12D07-335_A1,0,0,0,0,0,0
GAGATCTGTCACTCCG-1_V12D07-335_A1,0,0,1,0,0,1
ATGCCGGTCTTGCATA-1_V12D07-335_A1,0,0,2,0,1,3
TTGGGCGGCGGTTGCC-1_V12D07-335_A1,0,0,1,0,0,1
TTGTTGTGTGTCAAGA-1_V12D07-335_A1,0,0,3,2,0,5
ACTGTACGATACACAT-1_V12D07-335_A1,0,0,1,0,0,1
TCCACTTTATCTAGGT-1_V12D07-335_A1,1,0,1,0,0,2
GGTCTGAGAATCTGGA-1_V12D07-335_A1,1,0,1,1,0,3
TAGAAAGGTGGCGCTA-1_V12D07-335_A1,0,1,0,0,0,1
TATGTCTCATTGTGCC-1_V12D07-335_A1,0,0,0,0,0,0
GGATTTCACTTCTATA-1_V12D07-335_A1,1,0,2,2,0,5
TGAGTGGTCCGTGACG-1_V12D07-335_A1,0,1,0,0,0,1
CGCTTTCTTGCATTCG-1_V12D07-335_A1,0,0,1,0,0,1
ACCCAACGCCCGTGGC-1_V12D07-335_A1,1,0,1,3,0,5
GAACGTCTCATGGTCG-1_V12D07-335_A1,0,0,0,1,0,1
AGGGTTCCCTTTGGTT-1_V12D07-335_A1,0,0,0,0,0,0
GTAGCTTCCTCTTGTT-1_V12D07-335_A1,0,1,1,0,0,2
GCATGAGGGACGCGGC-1_V12D07-335_A1,0,0,0,0,0,0
CTACCCTAAGGTCATA-1_V12D07-335_A1,0,0,1,0,0,1
TCACCGCTCGGCACTC-1_V12D07-335_A1,0,0,8,1,0,9
GGCTCGCGTTGAGGTA-1_V12D07-335_A1,1,0,1,1,0,3
CTAACGAAACTTGCTG-1_V12D07-335_A1,0,2,3,0,0,5
TTAAACTCGAATTCAT-1_V12D07-335_A1,0,0,2,1,0,3
TACTTTACTGAGCCGG-1_V12D07-335_A1,0,0,2,0,0,2
GCTTGGATCGATTAGG-1_V12D07-335_A1,0,1,3,0,0,4
CGGTTATCCAACAGTG-1_V12D07-335_A1,0,1,1,0,0,2
CAGACCTGTAAGTGTT-1_V12D07-335_A1,0,0,2,0,0,2
GACGGTCAATAGAAGC-1_V12D07-335_A1,0,0,1,0,0,1
CTGACTGCGCAGCTCG-1_V12D07-335_A1,0,0,0,0,0,0
CCATACCTTTACTTGT-1_V12D07-335_A1,0,0,2,0,0,2
GTAATAAAGGGCTCCC-1_V12D07-335_A1,0,1,0,0,0,1
GTGAACTCCCATTCGA-1_V12D07-335_A1,1,1,1,2,0,5
GTGGTTACTTCTTTCG-1_V12D07-335_A1,0,1,0,0,0,1
TCAGAACCTCCACAGG-1_V12D07-335_A1,1,0,1,0,0,2
TCCCACTCTCTTCCGG-1_V12D07-335_A1,0,1,0,0,0,1
ATCTTGACTTGTCCAA-1_V12D07-335_A1,0,2,0,0,0,2
TCGGGAACGTGCCTAG-1_V12D07-335_A1,1,2,0,0,0,3
GTTAGCCGTAAATCAA-1_V12D07-335_A1,1,1,1,0,0,3
ATTTACTAAGTCCATT-1_V12D07-335_A1,1,0,0,0,0,1
GGGTGCATATGAAAGC-1_V12D07-335_A1,0,3,1,0,1,5
TCCGAATGGTCCTGAG-1_V12D07-335_A1,0,0,0,0,0,0
TGATGGCTGTTTCTGA-1_V12D07-335_A1,1,1,0,0,0,2
AAATAAGGTAGTGCCC-1_V12D07-335_A1,1,2,2,0,0,5
CCACTATCCGGGTCAC-1_V12D07-335_A1,1,1,1,0,0,3
ACACCACATAATTAGC-1_V12D07-335_A1,0,2,1,0,0,3
CGCGGTAAGTCTAGCT-1_V12D07-335_A1,0,1,0,0,0,1
GCGGGCATTACGATGC-1_V12D07-335_A1,2,2,2,0,0,6
AGGATTGCTTACGACA-1_V12D07-335_A1,1,0,1,0,0,2
CTCGGGATAACACCTA-1_V12D07-335_A1,1,4,2,0,0,7
GTCGTCTGGTTGGCTA-1_V12D07-335_A1,1,3,1,0,0,5
GCAATTAGTCGCACCG-1_V12D07-335_A1,1,0,0,0,0,1
GTGACCTAAAGAATAA-1_V12D07-335_A1,1,1,4,0,0,6
CTGAGCGAGACTTATT-1_V12D07-335_A1,0,1,2,0,0,3
CAAGACTCAGAAGCGC-1_V12D07-335_A1,3,3,1,0,0,7
ACTTCGCTAGCGAGTG-1_V12D07-335_A1,1,2,1,0,0,4
CCATACTCGCCTCTCC-1_V12D07-335_A1,0,0,0,0,0,0
ACGATACCTATCCTGA-1_V12D07-335_A1,0,0,0,0,0,0
CTCACCAGTACAAGTG-1_V12D07-335_A1,0,0,0,0,0,0
CGAAGACGGTGAGTGC-1_V12D07-335_A1,0,0,0,0,0,0
AAATTAATAAGCGCGA-1_V12D07-335_A1,0,0,0,0,0,0
GGGCCCTTATCTATAC-1_V12D07-335_A1,0,0,0,0,0,0
CTGCCCACGAAGCGTT-1_V12D07-335_A1,0,0,0,0,0,0
GGACAAGTTGCAGTGA-1_V12D07-335_A1,0,0,0,0,0,0
GTCCGAGAGCAATCAT-1_V12D07-335_A1,0,0,0,0,0,0
ATGGCAGCCGAGAAAC-1_V12D07-335_A1,1,2,0,0,2,5
CCTCGGATGCTACCTG-1_V12D07-335_A1,0,0,0,0,1,1
ATACGGTGAAGATGCA-1_V12D07-335_A1,0,2,0,0,0,2
ACATCAGCTGGGACGC-1_V12D07-335_A1,0,3,0,0,1,4
GGTTGTGTAGCCTGGC-1_V12D07-335_A1,1,1,0,0,0,2
CCTGCGTTCTACGCTT-1_V12D07-335_A1,1,0,0,0,0,1
GAACGTTAGGAAGACG-1_V12D07-335_A1,1,1,4,0,0,6
CTGATAGTGTATCTCA-1_V12D07-335_A1,0,0,0,0,0,0
TTCTGCGAGCGCCCTT-1_V12D07-335_A1,0,0,2,0,0,2
CTTTGGCGCTTTATAC-1_V12D07-335_A1,0,0,0,0,0,0
TCCGAACTTGGCTTAC-1_V12D07-335_A1,0,0,1,0,0,1
TAGATTCCTGGTTATT-1_V12D07-335_A1,0,0,1,0,0,1
CCGACAAAGGGAGTGC-1_V12D07-335_A1,0,0,1,0,0,1
CCATGGCCCTTGTACC-1_V12D07-335_A1,0,0,1,1,0,2
GAAATATCACCATCAG-1_V12D07-335_A1,0,1,0,0,0,1
ACGAAATGGGCGGCAC-1_V12D07-335_A1,0,0,1,16,0,17
GTGAGCGTGCTGCACT-1_V12D07-335_A1,0,0,1,15,0,16
CCGCGGGTACGAAGAA-1_V12D07-335_A1,0,0,8,0,0,8
TCCCTGGCTCGCTGGA-1_V12D07-335_A1,0,1,1,2,0,4
CAGCTTAGTAGGTAGC-1_V12D07-335_A1,0,1,1,0,0,2
CACGAAAGTTAGTCCC-1_V12D07-335_A1,1,0,4,1,0,6
ACCTAATCGACTTCCT-1_V12D07-335_A1,0,3,4,1,0,8
AAGTAGTGACGCGAGG-1_V12D07-335_A1,0,0,1,0,0,1
TCCGATTACATTGCCG-1_V12D07-335_A1,0,1,3,0,0,4
CCTCCGACAATTCAAG-1_V12D07-335_A1,0,1,2,1,0,4
GTTCACAGGAGTCTAG-1_V12D07-335_A1,1,0,0,0,0,1
CGAAGTTGCTCTGTGT-1_V12D07-335_A1,0,0,3,0,0,3
GTCGGATATCTCAGAC-1_V12D07-335_A1,0,1,2,1,0,4
CGCTCTCCGTAGATTA-1_V12D07-335_A1,0,1,0,0,0,1
CAAGCAACGTCGGAGT-1_V12D07-335_A1,0,0,0,0,0,0
CCATTCCCTGCCCACA-1_V12D07-335_A1,1,0,5,0,0,6
CTTTGGCTTTAGTAAA-1_V12D07-335_A1,0,1,0,0,0,1
GGCTATTAAGTTGTAT-1_V12D07-335_A1,0,1,2,0,0,3
CCATTAGCGATAATCC-1_V12D07-335_A1,0,0,1,0,0,1
TGTTCTTCCATTGACT-1_V12D07-335_A1,0,1,2,0,0,3
AGATAACTTCAGGGCC-1_V12D07-335_A1,0,0,2,0,0,2
ATAGACGAAGAGAAAG-1_V12D07-335_A1,0,0,1,0,0,1
GGCGGAGTAATATTAG-1_V12D07-335_A1,1,2,0,0,0,3
TGACCCACGTTAGACA-1_V12D07-335_A1,0,0,1,0,0,1
TCACAGGTTATTGGGC-1_V12D07-335_A1,0,0,6,0,0,6
TCACGCATTGTAGATC-1_V12D07-335_A1,0,0,1,0,0,1
TTGAAGAATTCCCAGG-1_V12D07-335_A1,0,0,1,0,0,1
AAATGGTCAATGTGCC-1_V12D07-335_A1,0,0,0,0,0,0
TAGTGCCCTCCAGAGT-1_V12D07-335_A1,0,1,1,0,0,2
GGTATTGCCGAGTTTA-1_V12D07-335_A1,1,0,3,1,0,5
CGTATTAAGAGATCTA-1_V12D07-335_A1,0,0,3,0,0,3
ACTGTCCAGGATTATA-1_V12D07-335_A1,1,1,2,0,0,4
CGGGCAGCTAAACCGC-1_V12D07-335_A1,0,0,1,1,0,2
TTGCTGATCATGTTCG-1_V12D07-335_A1,1,1,0,0,0,2
TATGGGTACGTATCGT-1_V12D07-335_A1,0,3,0,0,0,3
CAGCTCACTGAGACAT-1_V12D07-335_A1,1,0,1,1,0,3
GGGACTGCATAGATAG-1_V12D07-335_A1,0,0,1,3,0,4
ACGCATTCGTGAGTAC-1_V12D07-335_A1,0,0,3,0,0,3
CTCTGGACGCCTGGTG-1_V12D07-335_A1,0,1,3,0,0,4
AGGGTTTAGTTCGGGA-1_V12D07-335_A1,0,0,0,2,0,2
GGGAGAACTCACAGTA-1_V12D07-335_A1,0,0,0,0,0,0
ATCAATCTGGGCTGCA-1_V12D07-335_A1,1,0,0,0,0,1
TCTTCGATACCAATAA-1_V12D07-335_A1,0,0,2,0,0,2
ACGTAGATTGCTGATG-1_V12D07-335_A1,0,1,1,0,0,2
TCTTGATGCGTAGCGA-1_V12D07-335_A1,1,1,0,0,0,2
GGGCTGCCTAGGGCGA-1_V12D07-335_A1,0,1,2,0,0,3
CTCTCACAATCGATGA-1_V12D07-335_A1,0,0,1,2,0,3
CCAAGCGTAACTCGTA-1_V12D07-335_A1,0,0,3,0,0,3
ACAACAGCATGAGCTA-1_V12D07-335_A1,2,1,2,0,0,5
GTCCCAACGTAAAGTA-1_V12D07-335_A1,0,0,1,0,0,1
TCGGAGTACATGAGTA-1_V12D07-335_A1,0,1,0,0,0,1
GGGAGTTAATGAGGCG-1_V12D07-335_A1,0,0,1,0,0,1
CCGGGCGGTCTCGTCA-1_V12D07-335_A1,1,0,4,0,0,5
CCGTAAGTTGGTCCCA-1_V12D07-335_A1,0,1,2,0,0,3
GGAGGGCTTGGTTGGC-1_V12D07-335_A1,0,1,2,1,0,4
TCGGACGCCCAGCCCA-1_V12D07-335_A1,0,1,1,0,0,2
TCTGTGCCATCATAGT-1_V12D07-335_A1,0,2,2,0,0,4
GTACTGGAGTTAGACC-1_V12D07-335_A1,0,1,0,0,0,1
GGAATGCGCTAGCGTG-1_V12D07-335_A1,0,0,3,0,0,3
GTGTGAATAACTTAGG-1_V12D07-335_A1,0,0,6,0,1,7
GGTCGGCCAGGAGCTT-1_V12D07-335_A1,0,0,0,0,0,0
TAGCCGGCGGTCAGCG-1_V12D07-335_A1,0,0,3,0,0,3
CGGGTGTACCCATTTA-1_V12D07-335_A1,0,1,1,0,0,2
AGTGATTCAAGCAGGA-1_V12D07-335_A1,0,0,0,1,0,1
GTTGGATTGAGAACAC-1_V12D07-335_A1,0,0,0,2,0,2
CACACGCGCTGTCTTA-1_V12D07-335_A1,0,1,0,1,0,2
TAGACGCCCGTACCGG-1_V12D07-335_A1,0,2,0,1,0,3
GGTTTCAATCGGTCAG-1_V12D07-335_A1,0,0,0,0,0,0
AATCTGCGTTGGGACG-1_V12D07-335_A1,1,1,1,3,0,6
TTACGGATGGTTCGAG-1_V12D07-335_A1,0,0,2,0,0,2
CGGCAGGGTCGGGTTG-1_V12D07-335_A1,1,0,1,0,0,2
GCTTTCAGAGGAGGTG-1_V12D07-335_A1,0,0,2,0,0,2
TCTTCCCATGGGCACA-1_V12D07-335_A1,0,3,0,0,0,3
TACCGCGGACTTGCAG-1_V12D07-335_A1,0,1,2,0,0,3
AGAATTATGGATTCGA-1_V12D07-335_A1,0,0,2,0,0,2
ATTGATGAGTCCTAAC-1_V12D07-335_A1,1,0,0,2,0,3
TAGGTCGCCGGAACTG-1_V12D07-335_A1,0,1,1,0,0,2
TAACCTACCGTCCGAG-1_V12D07-335_A1,0,0,0,0,0,0
CTTAGTAGGCCTACAG-1_V12D07-335_A1,1,0,1,0,0,2
CTAGATGTGAGTGTAA-1_V12D07-335_A1,0,1,1,0,0,2
ACTCCCGAATTCGTTT-1_V12D07-335_A1,0,0,0,0,0,0
GTTCATCGTTTGGCTG-1_V12D07-335_A1,0,1,0,0,0,1
ACTTTACCCTCATGAA-1_V12D07-335_A1,0,2,0,0,0,2
GCGAGAGTTGCGTCCA-1_V12D07-335_A1,0,0,0,0,0,0
GTTCGGGCGTACCATT-1_V12D07-335_A1,0,1,2,0,0,3
CGACTTTGTATAGCCT-1_V12D07-335_A1,0,3,1,0,0,4
GCCATCGATGCTGCAT-1_V12D07-335_A1,0,2,1,0,0,3
GCATTTCCAAGGCTCC-1_V12D07-335_A1,0,0,0,0,0,0
ATGTAAGGCTGCTCTT-1_V12D07-335_A1,1,2,0,0,0,3
ACGTTCGCAATCAATT-1_V12D07-335_A1,1,3,0,0,0,4
GTGACGAGGGTGACCC-1_V12D07-335_A1,0,4,0,0,0,4
ATTATAGCTACTTTAC-1_V12D07-335_A1,1,1,0,0,0,2
CGTGTGTTAAACCCTG-1_V12D07-335_A1,0,2,1,0,0,3
TTGGTATGGCTTGTGT-1_V12D07-335_A1,0,2,1,0,0,3
CATTCCCATTCCGTCG-1_V12D07-335_A1,0,1,1,0,0,2
TGCCGAAAGCGTATTC-1_V12D07-335_A1,0,1,0,0,0,1
CAACACATCTCCTGCC-1_V12D07-335_A1,1,2,2,0,0,5
CTGCCTCATATGCAAC-1_V12D07-335_A1,0,0,0,0,0,0
TCCCGCCTATGTGCGT-1_V12D07-335_A1,1,0,1,0,0,2
GGTTACCCGACACTTT-1_V12D07-335_A1,1,4,2,0,0,7
CCAGCGGGATCACCAG-1_V12D07-335_A1,1,2,1,0,0,4
ATGTTTCGGCCCGGAG-1_V12D07-335_A1,1,1,1,0,0,3
GCGTCTAACCTCCTAA-1_V12D07-335_A1,0,0,2,0,0,2
ATCAGGTAGCTGACAG-1_V12D07-335_A1,0,1,5,0,0,6
GGTATGAAAGAACTGA-1_V12D07-335_A1,0,0,0,0,0,0
GTGGCCTAATATCATT-1_V12D07-335_A1,0,0,0,0,0,0
CCTGTGAAACCGTAAC-1_V12D07-335_A1,0,0,0,0,0,0
GGCAGAGAGATCGGGA-1_V12D07-335_A1,0,0,0,0,0,0
TAGCGTCGAATATTGA-1_V12D07-335_A1,0,0,0,0,0,0
CGCCGACTATTCGCTA-1_V12D07-335_A1,0,0,0,0,0,0
TCTGGCGCAAGCCGGG-1_V12D07-335_A1,0,0,0,0,0,0
AGTGGTTGCGTATAGG-1_V12D07-335_A1,0,1,0,0,0,1
ATCGGTTACCTAGTAA-1_V12D07-335_A1,3,1,0,0,6,10
CCTGCCCGTTGTCTAG-1_V12D07-335_A1,2,3,1,0,0,6
GCACACGCCCATGGTC-1_V12D07-335_A1,0,4,0,0,2,6
AGTACGGCCCGTATCG-1_V12D07-335_A1,0,3,1,0,0,4
TATCTAGCCTAAAGGA-1_V12D07-335_A1,0,2,0,0,0,2
CACTCGGTTAGGAGGA-1_V12D07-335_A1,0,1,0,0,0,1
ATGTTCGTCGACCCAC-1_V12D07-335_A1,0,4,3,0,0,7
TTCCTCTGCCCGAATA-1_V12D07-335_A1,0,1,1,0,0,2
TTACTATCGGCTTCTC-1_V12D07-335_A1,0,2,1,0,0,3
GCCGCATTAGTCCGGC-1_V12D07-335_A1,0,1,0,0,0,1
TAAGGGCTGGGAGAGG-1_V12D07-335_A1,1,1,0,0,0,2
TAAGCAGGCGACACGC-1_V12D07-335_A1,0,1,2,0,0,3
AGCACTACCGGCCTGT-1_V12D07-335_A1,0,0,2,0,0,2
GAAAGCCCTTTGGACC-1_V12D07-335_A1,0,0,1,0,0,1
GACCGACTGAAGCGTC-1_V12D07-335_A1,0,0,0,0,0,0
CGGTGAAGACTAAAGT-1_V12D07-335_A1,0,0,1,0,0,1
CCCTGCGCTACGCATA-1_V12D07-335_A1,0,0,1,0,0,1
TACTGGACAGCTCGGC-1_V12D07-335_A1,0,0,1,0,0,1
TTAGTAGGGCGGCGGG-1_V12D07-335_A1,0,0,1,22,0,23
GAGGCTATCAAAGTCG-1_V12D07-335_A1,0,0,0,18,0,18
TTACCATTGATTACCC-1_V12D07-335_A1,0,0,2,1,0,3
ATACCACGGGCAACTT-1_V12D07-335_A1,1,1,0,1,0,3
TGTCCTAAGTCACCGC-1_V12D07-335_A1,1,0,1,0,0,2
AGGTAGGTACAAAGCT-1_V12D07-335_A1,0,1,4,0,0,5
GGCATACAGGTAGCGG-1_V12D07-335_A1,0,0,3,0,0,3
TGTAGTGATCTATAAT-1_V12D07-335_A1,0,0,0,0,0,0
TCCCGGGTGTGCTGCT-1_V12D07-335_A1,0,0,1,0,0,1
TACGATGTTGATCATC-1_V12D07-335_A1,0,0,0,0,0,0
CCTCTCTCCCATCTAG-1_V12D07-335_A1,0,2,4,0,0,6
GCAGGACTATAGAATA-1_V12D07-335_A1,0,0,2,1,0,3
CTAGTGAAGGACAGGA-1_V12D07-335_A1,0,1,1,3,0,5
TACGAGAACTTCACGT-1_V12D07-335_A1,1,1,2,0,0,4
CGTTGTTTCAATTCCC-1_V12D07-335_A1,0,0,1,0,0,1
GCAAATATTACGCTTT-1_V12D07-335_A1,0,0,1,0,0,1
CCAATAGTGCCGTCGA-1_V12D07-335_A1,0,1,2,0,0,3
ATTGCTGCTCCTCCAT-1_V12D07-335_A1,0,1,1,0,0,2
GAGATCTGCTTGGCAT-1_V12D07-335_A1,0,2,0,0,0,2
GCCGAAATTCCTACGT-1_V12D07-335_A1,0,0,3,0,0,3
GGCACTCCACTGGGCA-1_V12D07-335_A1,0,0,0,0,0,0
GGGTCACCGTGACGGT-1_V12D07-335_A1,1,1,3,0,0,5
CACTTAATCAGACGGA-1_V12D07-335_A1,0,1,1,0,0,2
CGTTTCGCTCATTACA-1_V12D07-335_A1,0,2,0,1,0,3
ATAAAGGCTCGGTCGT-1_V12D07-335_A1,1,1,1,0,0,3
CACTAAAGTTGCCTAT-1_V12D07-335_A1,3,0,1,0,0,4
GTGCTCAAGTACTGTC-1_V12D07-335_A1,0,0,0,0,0,0
CCATGCCTGTTTAGTA-1_V12D07-335_A1,1,0,1,1,0,3
TCTAGTTATCAGAAGA-1_V12D07-335_A1,1,0,0,0,0,1
TTGTAATCCGTACTCG-1_V12D07-335_A1,0,0,2,0,0,2
TCCCAGCTTTAGTCTG-1_V12D07-335_A1,0,0,2,0,0,2
CTACGCACGGAGTACC-1_V12D07-335_A1,0,0,0,0,0,0
AAATTAACGGGTAGCT-1_V12D07-335_A1,0,1,1,0,0,2
CGGCCACGCACAAAGT-1_V12D07-335_A1,0,1,3,0,0,4
GAAGCGTGAGGAATTT-1_V12D07-335_A1,1,2,2,1,0,6
ATATCTTAGGGCCTTC-1_V12D07-335_A1,1,0,0,0,0,1
ACGCGGGCCAAGGACA-1_V12D07-335_A1,1,0,1,0,0,2
GCGAGTTCTGCAAAGA-1_V12D07-335_A1,0,0,3,0,0,3
TATTCGTGCCAGAATA-1_V12D07-335_A1,0,0,0,0,0,0
AGGGCTGCAGTTACAG-1_V12D07-335_A1,0,0,1,1,0,2
CTAGCATAGTATAATG-1_V12D07-335_A1,0,0,0,1,0,1
TAGGTTCGAGTTCGTC-1_V12D07-335_A1,0,1,0,0,0,1
GAATTATAGTGAAAGG-1_V12D07-335_A1,2,1,1,0,0,4
CTATCGGGTCTCAACA-1_V12D07-335_A1,2,1,4,0,0,7
GCGCTAATTGAATAGA-1_V12D07-335_A1,0,1,2,1,0,4
ATGCGACAGTCCCATT-1_V12D07-335_A1,0,0,2,1,0,3
GGTAGTGCTCGCACCA-1_V12D07-335_A1,0,1,1,0,0,2
AAGCTCGTGCCAAGTC-1_V12D07-335_A1,0,1,0,1,0,2
TATTCAATTCTAATCC-1_V12D07-335_A1,1,0,0,2,0,3
TTCAAAGTCTCTAGCC-1_V12D07-335_A1,0,0,0,0,0,0
TTGAATATGGACTTTC-1_V12D07-335_A1,0,0,0,0,0,0
AAGAGCTCTTTATCGG-1_V12D07-335_A1,3,0,1,0,0,4
TTACTCCGGCCGGGAA-1_V12D07-335_A1,0,0,2,1,0,3
AAACGAGACGGTTGAT-1_V12D07-335_A1,0,0,1,0,0,1
GCTAAGTAGTTTCTCT-1_V12D07-335_A1,0,0,1,1,0,2
ATAACGCCGGAGGGTC-1_V12D07-335_A1,0,0,2,2,0,4
GGATCCGGAATATACT-1_V12D07-335_A1,0,2,1,0,0,3
TGAAAGGACCTGACTC-1_V12D07-335_A1,0,0,1,0,0,1
TCCGCGGCAGCATCTG-1_V12D07-335_A1,0,1,2,0,0,3
TGCATATGTCTGTCAC-1_V12D07-335_A1,0,0,4,0,0,4
TGTAGGAGAAATTTCC-1_V12D07-335_A1,1,1,0,0,0,2
AGTGAGACTTCCAGTA-1_V12D07-335_A1,0,0,0,0,0,0
CCCAAACATGCTGCTC-1_V12D07-335_A1,2,1,0,0,0,3
GCTTATGAAGCAGGAA-1_V12D07-335_A1,0,0,1,0,0,1
TTCTAACCGAAGCTTA-1_V12D07-335_A1,1,0,0,0,0,1
GGATGTCCTTACCGCA-1_V12D07-335_A1,0,0,1,0,0,1
AGGGTGCTCTCGAGGG-1_V12D07-335_A1,0,0,2,1,0,3
AACTCTCAATAGAGCG-1_V12D07-335_A1,0,0,0,2,0,2
TCTGAATTCCGTACAA-1_V12D07-335_A1,0,0,1,1,0,2
GCGTGGTACTGGGTTA-1_V12D07-335_A1,0,1,1,1,0,3
CGTCGGATAGTGTTGA-1_V12D07-335_A1,0,0,0,0,0,0
ATATGTCTCCCTAGCC-1_V12D07-335_A1,0,0,2,1,0,3
TCTTTAAGACTATGAA-1_V12D07-335_A1,1,2,1,0,0,4
TCATTTAAGTCTCCGA-1_V12D07-335_A1,0,0,2,2,0,4
GATATTGAGATTGGCG-1_V12D07-335_A1,0,0,1,0,0,1
TGACATCGAGCGGACC-1_V12D07-335_A1,2,0,2,1,0,5
GCGTAAATGGCCATAA-1_V12D07-335_A1,0,1,1,1,0,3
ATTGTACAACTCGGCT-1_V12D07-335_A1,0,1,0,0,0,1
TACGCTATAGAAACCT-1_V12D07-335_A1,0,0,0,0,0,0
CACCCAAATCTTATGT-1_V12D07-335_A1,0,1,1,1,0,3
AGATGATGGAGTCTGG-1_V12D07-335_A1,0,0,1,0,0,1
CCACGGTGCCCGGTAG-1_V12D07-335_A1,0,0,2,0,0,2
TCAAGAAATACTAGCT-1_V12D07-335_A1,0,0,1,0,0,1
AGGTATAATTGATAGT-1_V12D07-335_A1,0,1,1,0,0,2
CAAGGTCCTATAGGCT-1_V12D07-335_A1,0,4,1,0,0,5
CCGGCACGACCGTTTC-1_V12D07-335_A1,0,1,1,0,1,3
ACCTCCGTTATTCACC-1_V12D07-335_A1,0,5,0,0,0,5
GCAGCCTATATCACAT-1_V12D07-335_A1,0,2,0,0,0,2
GGTATAGTGACACATA-1_V12D07-335_A1,0,1,1,0,0,2
AAATTCCAGGTCCAAA-1_V12D07-335_A1,1,2,1,0,0,4
TCTTTAGCAGGCGAAC-1_V12D07-335_A1,1,2,0,0,0,3
TATTGACATTTCTGCC-1_V12D07-335_A1,1,2,0,0,0,3
TCTGATCGGGTGCTAG-1_V12D07-335_A1,0,3,0,0,0,3
GGCCCGGAGCATGTCT-1_V12D07-335_A1,0,0,0,0,1,1
GGGCGCAGCGTTACTC-1_V12D07-335_A1,0,1,0,0,0,1
TTGGCGATCCGAATAT-1_V12D07-335_A1,1,1,1,0,0,3
CCACGTAAATTAGACT-1_V12D07-335_A1,1,0,6,0,0,7
TCTGATTGGAAATGGA-1_V12D07-335_A1,1,2,0,0,0,3
ATGGCGGAATAGTCGC-1_V12D07-335_A1,2,3,0,0,0,5
ATCGCTTTACGTCTCA-1_V12D07-335_A1,0,4,0,0,0,4
TACGTGCAAGGTTCCT-1_V12D07-335_A1,0,3,0,0,0,3
CAGGACAGCTGCCCTT-1_V12D07-335_A1,1,2,0,0,0,3
CAAACCAGGTCTGCAT-1_V12D07-335_A1,0,0,0,0,0,0
ACAAGCTATATGGAAG-1_V12D07-335_A1,0,0,0,0,0,0
TCGCCCACTGCGAGAG-1_V12D07-335_A1,0,0,0,0,0,0
AGCCGCAAATTCAAAT-1_V12D07-335_A1,0,0,0,0,0,0
TTAACGTTAAAGCCTG-1_V12D07-335_A1,0,0,0,0,0,0
CAGCGCCAACACGATA-1_V12D07-335_A1,0,0,0,0,0,0
ATCCAATGGTACCGAA-1_V12D07-335_A1,0,0,0,0,0,0
GTGCTGCAGATAAGGA-1_V12D07-335_A1,1,0,0,0,0,1
GGCCTTTGCAACTGGC-1_V12D07-335_A1,0,7,0,0,0,7
GTCGTACCTACGATTG-1_V12D07-335_A1,0,6,0,0,0,6
TAGAAATTCACGTATA-1_V12D07-335_A1,0,0,1,0,0,1
AGAATAAATCTTCAGG-1_V12D07-335_A1,0,3,1,0,0,4
CATTGCGAAATGGGCG-1_V12D07-335_A1,2,4,1,0,0,7
GTCTACTCAATTACAA-1_V12D07-335_A1,0,0,0,0,0,0
TGTAATGACCACAATA-1_V12D07-335_A1,0,3,0,0,0,3
AAAGTCGACCCTCAGT-1_V12D07-335_A1,0,0,1,4,0,5
TACTCGGCACGCCGGG-1_V12D07-335_A1,1,2,1,0,0,4
AGGTGTATCGCCATGA-1_V12D07-335_A1,0,2,4,0,0,6
TGTGCTTTACGTAAGA-1_V12D07-335_A1,0,1,1,0,0,2
AAACCTCATGAAGTTG-1_V12D07-335_A1,0,0,2,0,0,2
TATAGGGTACTCATGA-1_V12D07-335_A1,0,0,0,0,0,0
CCAGCTGATGGTACTT-1_V12D07-335_A1,0,0,0,0,0,0
AATATTGGAGTATTGA-1_V12D07-335_A1,0,0,0,0,0,0
GGCCCTCACCCACTTA-1_V12D07-335_A1,0,1,2,0,0,3
AACCAAGACTTCTCTG-1_V12D07-335_A1,0,0,4,0,0,4
TCGTATTACCCATTGC-1_V12D07-335_A1,0,1,2,0,0,3
ATTCGACGCCGGGCCT-1_V12D07-335_A1,0,0,2,6,0,8
GGCGCAGGACATCTTC-1_V12D07-335_A1,0,1,1,8,0,10
GTACTCCCTTATCGCT-1_V12D07-335_A1,1,1,1,8,0,11
TGGTCTGTTGGGCGTA-1_V12D07-335_A1,0,0,1,2,0,3
AATAACAACGCTCGGC-1_V12D07-335_A1,0,2,4,0,0,6
CATACCCGTACCCAGT-1_V12D07-335_A1,0,3,4,0,0,7
ACAATCCATTTAAACC-1_V12D07-335_A1,0,2,1,0,0,3
GTTACAATTGGTGACG-1_V12D07-335_A1,2,0,1,0,0,3
TTGCCCTGATCACGGG-1_V12D07-335_A1,0,0,2,0,0,2
CTAACCGCGCGCCCGT-1_V12D07-335_A1,0,0,0,0,0,0
CTAAAGAATGCCTACT-1_V12D07-335_A1,0,1,2,1,0,4
ACCCATCTTGAGGGTA-1_V12D07-335_A1,0,1,1,0,0,2
GATCTTTGCAGGGTAT-1_V12D07-335_A1,0,0,0,1,0,1
GGGTACTTCATGAACT-1_V12D07-335_A1,0,0,0,0,0,0
GCCGCTTGTGAGAAAC-1_V12D07-335_A1,0,1,3,0,0,4
CCTGTAAGACATGATA-1_V12D07-335_A1,0,0,1,0,0,1
CGACAGTTCGCGTTAT-1_V12D07-335_A1,0,0,0,1,0,1
ACGATGCATATGTTAT-1_V12D07-335_A1,0,0,4,0,0,4
TGTTCCGCTTCCATGA-1_V12D07-335_A1,0,1,3,0,0,4
GGATGACGCGAGTTTA-1_V12D07-335_A1,0,0,1,0,0,1
GAAGTTTCCACTCAAT-1_V12D07-335_A1,0,0,1,1,0,2
GCGAGGCCCGAGCAGA-1_V12D07-335_A1,0,1,4,0,0,5
CATACTATGTAATTGT-1_V12D07-335_A1,0,0,2,0,0,2
CCAATGTCACAGCAAG-1_V12D07-335_A1,0,2,0,0,0,2
GTTGGATTTGCGTTGG-1_V12D07-335_A1,0,0,0,0,0,0
GGGAGGATGCCCGAAA-1_V12D07-335_A1,0,0,3,0,0,3
GATCGCGGGCTCTCCA-1_V12D07-335_A1,0,0,3,0,0,3
GTTCGCCATAAGTGCC-1_V12D07-335_A1,0,0,2,0,0,2
AGATTATAGGACGTTT-1_V12D07-335_A1,1,0,2,0,0,3
TCGAGACCAACACCGT-1_V12D07-335_A1,1,0,0,1,0,2
TATGGGACCGAGCAGG-1_V12D07-335_A1,0,0,0,1,0,1
GATGCGTCCTGCATTC-1_V12D07-335_A1,0,1,1,1,0,3
TATGGTCTGAGTAACA-1_V12D07-335_A1,1,0,0,1,0,2
GCATAGAGCACTCAGG-1_V12D07-335_A1,0,0,1,0,0,1
CTTCATTGTCAGTGGA-1_V12D07-335_A1,0,0,1,0,0,1
GCAGATTAGGGATATC-1_V12D07-335_A1,0,0,0,1,0,1
CCTGTCGCCCGTAAAT-1_V12D07-335_A1,0,0,0,0,0,0
CAATTTCGTATAAGGG-1_V12D07-335_A1,0,0,0,1,0,1
GTACACTTACCTGAAG-1_V12D07-335_A1,0,1,0,0,0,1
CCAGCCTGGACCAATA-1_V12D07-335_A1,1,0,1,0,0,2
ATGGAGCAGGCCGTGA-1_V12D07-335_A1,0,0,0,0,0,0
GTCATTAGAGCGAACG-1_V12D07-335_A1,0,1,1,1,0,3
AAGACTGCAAGCTACT-1_V12D07-335_A1,0,0,3,0,0,3
CTAGTCACGTCTTAAG-1_V12D07-335_A1,0,1,2,0,0,3
ACTCTTGTATAGTAAC-1_V12D07-335_A1,0,0,1,1,0,2
ATTAGGCGATGCTTTC-1_V12D07-335_A1,0,0,3,1,0,4
TTCGGGACTAATCGCG-1_V12D07-335_A1,1,0,1,0,0,2
TGGACTGTTCGCTCAA-1_V12D07-335_A1,0,0,1,0,0,1
AACGTGCGAAAGTCTC-1_V12D07-335_A1,0,0,1,0,1,2
CCACCCAAGGAAAGTG-1_V12D07-335_A1,0,1,0,2,0,3
CCGCACAAAGACCAAC-1_V12D07-335_A1,1,0,0,0,0,1
GCGATTGTTAACGTTA-1_V12D07-335_A1,1,1,3,1,0,6
ACTCGTCAGTAATCCC-1_V12D07-335_A1,0,1,0,1,0,2
GGTGATAAGGAGCAGT-1_V12D07-335_A1,0,0,3,0,0,3
AAGAGGCATGGATCGC-1_V12D07-335_A1,0,0,0,0,0,0
CACGTTCGTGCTCTAG-1_V12D07-335_A1,0,0,1,0,0,1
CTATTTGGTTACGGAT-1_V12D07-335_A1,0,1,0,0,0,1
GTACAGAGGCAAGGGT-1_V12D07-335_A1,1,2,2,0,0,5
GGGCCGGCCGAAGTAC-1_V12D07-335_A1,0,1,0,0,0,1
CCTGAACGATATATTC-1_V12D07-335_A1,0,0,1,0,0,1
CCGGGCTGCTCCATAC-1_V12D07-335_A1,0,1,3,0,0,4
TACTTGTTAGTAGTCC-1_V12D07-335_A1,0,0,3,0,0,3
CCTAGGCGTAGCGATC-1_V12D07-335_A1,0,0,2,0,0,2
CTGGCGCACAGGTCTG-1_V12D07-335_A1,0,1,5,0,0,6
ACTTATACTTACCCGG-1_V12D07-335_A1,0,1,3,0,0,4
GAAGTCTCCCTAGCGA-1_V12D07-335_A1,0,0,5,0,0,5
ACCGATGGTAGCATCG-1_V12D07-335_A1,0,0,3,0,0,3
CGAGTTTATCGGACTG-1_V12D07-335_A1,0,1,0,1,0,2
CATAACGGACAGTCGT-1_V12D07-335_A1,0,0,0,0,0,0
TGACGATGCACTAGAA-1_V12D07-335_A1,0,0,1,0,0,1
TAGGGAGCTTGGGATG-1_V12D07-335_A1,0,1,1,0,0,2
AGGGTCGATGCGAACT-1_V12D07-335_A1,0,2,1,1,0,4
TATATCCCTGGGAGGA-1_V12D07-335_A1,0,0,3,2,0,5
CATCTTACACCACCTC-1_V12D07-335_A1,1,2,0,1,0,4
GTGCGACAGGGAGTGT-1_V12D07-335_A1,0,0,0,1,0,1
CCGATCTCAACCTTAT-1_V12D07-335_A1,1,0,0,2,0,3
ACGATCATCTTGTAAA-1_V12D07-335_A1,0,1,0,0,0,1
GAAAGAACAGCGTTAT-1_V12D07-335_A1,2,0,0,1,0,3
CTAGGTCTGAAGGAAT-1_V12D07-335_A1,0,1,0,2,0,3
ATATCAACCTACAGAG-1_V12D07-335_A1,0,1,0,0,0,1
AAATAGCTTAGACTTT-1_V12D07-335_A1,0,1,1,0,0,2
GCGACATGTAAACATC-1_V12D07-335_A1,0,2,0,0,0,2
ATAAGTAGGGCGACTC-1_V12D07-335_A1,0,0,3,0,1,4
GCGAGCGCATGCTCCC-1_V12D07-335_A1,0,0,0,1,0,1
AGGGACCGGCTGCGTT-1_V12D07-335_A1,1,0,0,0,1,2
CCTATGAAGTGGTGCC-1_V12D07-335_A1,0,0,0,0,0,0
GCTTACGTAGTTAGTA-1_V12D07-335_A1,0,0,1,0,2,3
CATACTTAGGCAATAC-1_V12D07-335_A1,0,1,1,0,0,2
CCTGTCCCTCACGTTA-1_V12D07-335_A1,0,3,1,0,0,4
CAATGTGCCAACCCTT-1_V12D07-335_A1,1,1,0,0,0,2
GTTAAGTTAGAGTGGG-1_V12D07-335_A1,0,1,1,0,0,2
CTGGGATACGCTACCC-1_V12D07-335_A1,0,0,0,0,0,0
AACCTGTCACGGAATT-1_V12D07-335_A1,0,0,1,0,0,1
ACTGCGGACACACCGT-1_V12D07-335_A1,1,0,1,0,0,2
CCGTGAGGCATTCATG-1_V12D07-335_A1,0,3,0,0,0,3
GCCCAGATGCTGGAGA-1_V12D07-335_A1,0,3,2,0,0,5
TCTGGCCGTTCAAGTT-1_V12D07-335_A1,1,1,1,0,0,3
ATACGAAGGCTTTCCA-1_V12D07-335_A1,0,2,1,0,0,3
GATCCGAATATAAGTG-1_V12D07-335_A1,0,1,0,0,0,1
GTGGAGCATGTCGGCC-1_V12D07-335_A1,1,0,0,0,0,1
ACTCTTCAGCTCCCGC-1_V12D07-335_A1,0,1,1,0,0,2
CCCGATAGCCTCGCCT-1_V12D07-335_A1,2,0,3,0,0,5
ACAGGTGTGTTGTTGC-1_V12D07-335_A1,0,0,0,0,0,0
TGAACTGCTATGACTT-1_V12D07-335_A1,0,0,0,0,0,0
TGACATATATGACGAT-1_V12D07-335_A1,0,0,0,0,0,0
AAGTCTTCTGTGGCCT-1_V12D07-335_A1,0,0,0,0,0,0
ACCAGACCATAACAAC-1_V12D07-335_A1,0,0,0,0,0,0
TGAGACGTACCTCTCA-1_V12D07-335_A1,0,0,0,0,0,0
GACCGTTACATGCGAC-1_V12D07-335_A1,0,0,0,0,0,0
GGTTCGGATTATACTA-1_V12D07-335_A1,1,4,0,1,0,6
CCTCCTGAGCCCACAT-1_V12D07-335_A1,1,3,1,0,0,5
CCGCGATTTGGTAGGT-1_V12D07-335_A1,0,2,1,0,0,3
AATCTCTACTGTGGTT-1_V12D07-335_A1,1,2,2,0,0,5
ACTTTGACTGCATCCT-1_V12D07-335_A1,0,0,1,0,0,1
CCCTGACTAACAAATT-1_V12D07-335_A1,0,1,0,0,0,1
ACGCTGTGAGGCGTAG-1_V12D07-335_A1,0,0,1,0,0,1
GCATACGAGGTCTTTA-1_V12D07-335_A1,0,0,0,0,0,0
TCGGGATTCAAACATA-1_V12D07-335_A1,0,0,0,0,0,0
GGGCCCTACGAAAGGG-1_V12D07-335_A1,0,0,0,0,0,0
CGCCAAGAAGCCGAGT-1_V12D07-335_A1,1,0,1,0,0,2
GGTACATCTGGGACGA-1_V12D07-335_A1,0,1,1,0,0,2
GGATGCTGGCGTTCCT-1_V12D07-335_A1,0,0,2,0,0,2
CCGATTCGAGGGACCC-1_V12D07-335_A1,0,0,0,0,0,0
CCACTGGTGGCTGGTT-1_V12D07-335_A1,1,1,0,0,0,2
GACAGGCACACACTAT-1_V12D07-335_A1,0,0,1,0,0,1
TCAACGCGACCGGCAG-1_V12D07-335_A1,0,0,0,0,0,0
CTACGACTAGCTATAA-1_V12D07-335_A1,0,0,0,0,0,0
CGGTTGACCTGGCATA-1_V12D07-335_A1,1,0,3,0,0,4
ATCCTGAATCGCTGCG-1_V12D07-335_A1,0,0,1,0,0,1
GTTTCATATCGTCGCT-1_V12D07-335_A1,0,0,0,5,0,5
ATAAATATTAGCAGCT-1_V12D07-335_A1,0,0,4,17,0,21
AAGAGGATGTACGCGA-1_V12D07-335_A1,0,4,1,3,0,8
TCCTGCGTTGATACTC-1_V12D07-335_A1,0,2,2,0,0,4
CGTGCATTGTCGACGC-1_V12D07-335_A1,0,0,2,0,0,2
CCGGGTTCGAGGTTAC-1_V12D07-335_A1,0,0,0,0,0,0
CCCAATTTCACAACTT-1_V12D07-335_A1,0,1,0,0,0,1
TGATTTATTAGCTGTG-1_V12D07-335_A1,0,1,0,0,0,1
TGGAAGAAGGGAACGT-1_V12D07-335_A1,0,0,1,0,0,1
GACGCTTGCTTCTAAA-1_V12D07-335_A1,0,0,2,1,0,3
GGGAACGGGAGGTTAG-1_V12D07-335_A1,0,0,1,0,0,1
GCGGCTCTGACGTACC-1_V12D07-335_A1,0,0,1,0,0,1
ACGTTAGATTTGCCCG-1_V12D07-335_A1,0,0,1,1,0,2
GAGAGGGCGCGAGGTT-1_V12D07-335_A1,1,0,0,0,0,1
GCGTCTCTGCATTGGG-1_V12D07-335_A1,0,0,2,0,0,2
GCAGCACACAGCCCAG-1_V12D07-335_A1,0,0,0,0,0,0
CAGGCCGTTTGGGTGT-1_V12D07-335_A1,1,0,1,0,0,2
AACTCAAGTTAATTGC-1_V12D07-335_A1,1,0,0,0,0,1
CTTCGTAGATAGGTGA-1_V12D07-335_A1,0,0,3,1,0,4
TGCAGAGTACCGAGCA-1_V12D07-335_A1,0,0,1,0,0,1
GAAGTGATTTATCGTG-1_V12D07-335_A1,0,0,4,0,0,4
CGCTACGGGACATTTA-1_V12D07-335_A1,0,0,3,0,0,3
CCACACTGAGATATTA-1_V12D07-335_A1,0,0,2,1,0,3
CGATCCGACCCAGTGC-1_V12D07-335_A1,0,1,2,0,0,3
CTGTACTTCTTAGCAT-1_V12D07-335_A1,0,0,1,0,0,1
ACTTATTAGGATCGGT-1_V12D07-335_A1,0,1,1,1,0,3
TAGTCCGCAGAGAATG-1_V12D07-335_A1,0,0,1,1,0,2
TTCACGAAAGGATCAC-1_V12D07-335_A1,0,0,2,0,0,2
TACATTTCTAACGTGC-1_V12D07-335_A1,1,0,2,0,0,3
ACCATATCCGCAATAA-1_V12D07-335_A1,0,1,0,2,0,3
CACTCAAGAGCTATGG-1_V12D07-335_A1,2,2,1,1,0,6
TGTACGAACAAATCCG-1_V12D07-335_A1,1,0,0,1,0,2
ATCATCCAATATTTGT-1_V12D07-335_A1,1,0,1,1,0,3
CGCTATTCTTAGGCTC-1_V12D07-335_A1,0,0,2,1,0,3
TGGCAGCAGTAATAGT-1_V12D07-335_A1,0,0,0,1,0,1
TCACGTGCCCGATTCA-1_V12D07-335_A1,0,0,1,1,0,2
CATACGGCGTCTGGGC-1_V12D07-335_A1,1,1,0,0,0,2
CACATGATTCAGCAAC-1_V12D07-335_A1,0,0,1,2,0,3
GCTAGTAGAGCTTGTA-1_V12D07-335_A1,0,0,2,1,0,3
TGCTGTTGAAGAACTC-1_V12D07-335_A1,1,0,0,2,0,3
CGGAGCATGGCGATCC-1_V12D07-335_A1,0,0,0,3,0,3
TAGCGTTGGGTCTTAC-1_V12D07-335_A1,0,0,1,0,0,1
GTAGCGGCTATACACT-1_V12D07-335_A1,0,0,0,0,0,0
TAACATACAATGTGGG-1_V12D07-335_A1,0,1,0,0,0,1
TCTTCGAATAGACGTT-1_V12D07-335_A1,0,0,1,0,0,1
GATCGTGACTGATATC-1_V12D07-335_A1,0,0,2,1,0,3
GATCCGGGAATTAACA-1_V12D07-335_A1,2,1,1,0,0,4
TTATATACGCTGTCAC-1_V12D07-335_A1,0,0,1,0,0,1
GTCGCGTAACCCGTTG-1_V12D07-335_A1,1,1,2,0,0,4
AGCTCTAGACGTTCCA-1_V12D07-335_A1,0,0,2,1,0,3
GTCAAGCGGACTCGGG-1_V12D07-335_A1,0,0,0,0,0,0
CGAGGGACTGCGGTCG-1_V12D07-335_A1,0,1,1,0,0,2
AATCGCCTCAGCGCCA-1_V12D07-335_A1,0,2,1,0,0,3
CTTGTTGCTGAGTCAA-1_V12D07-335_A1,1,0,1,0,0,2
GATATGAGACACTAAC-1_V12D07-335_A1,0,0,0,0,0,0
TTATGATCTTAACGAA-1_V12D07-335_A1,0,1,1,1,0,3
CGCCGCCCATGCCTGT-1_V12D07-335_A1,0,0,1,0,0,1
CTGGGATAAATAATGG-1_V12D07-335_A1,0,0,1,0,0,1
GTGCCCGTTCGGATTC-1_V12D07-335_A1,0,0,1,0,0,1
TTCAATACTCTGAATC-1_V12D07-335_A1,0,0,1,0,0,1
CGCACATGTCCACTAC-1_V12D07-335_A1,0,2,0,0,0,2
AGAAGAGCGCCGTTCC-1_V12D07-335_A1,0,1,0,0,0,1
GATAACTCGCACTGTG-1_V12D07-335_A1,0,0,1,0,0,1
AGTCGACGGTCTCAAG-1_V12D07-335_A1,0,1,0,0,0,1
GTGACCGCACACTACG-1_V12D07-335_A1,0,0,0,0,0,0
GTATGTGGGTCTAGTT-1_V12D07-335_A1,0,5,0,0,0,5
CTTGAGTTAGGGTAAT-1_V12D07-335_A1,0,0,2,0,0,2
TTAGCTGATTTGCCGT-1_V12D07-335_A1,0,1,0,0,0,1
GCTGTTGCTACCGAAC-1_V12D07-335_A1,0,1,0,0,0,1
TATTACCATCCTGCTT-1_V12D07-335_A1,0,0,1,0,0,1
TTGAATTCACGTGAGG-1_V12D07-335_A1,1,1,0,0,0,2
CCATCTCACCAGTGAA-1_V12D07-335_A1,0,0,1,0,0,1
CGCACGTGCGCTATCA-1_V12D07-335_A1,2,0,0,0,0,2
ACCCGGATGACGCATC-1_V12D07-335_A1,1,1,0,0,0,2
CGCTAGAGACCGCTGC-1_V12D07-335_A1,0,1,0,2,0,3
ATAGTTCCACCCACTC-1_V12D07-335_A1,0,0,1,1,0,2
GCAGACCCAGCACGTA-1_V12D07-335_A1,0,0,1,1,0,2
TAGACTACCTAGCGTT-1_V12D07-335_A1,0,2,1,1,0,4
GGTTCTACTCGTCTGA-1_V12D07-335_A1,0,2,1,0,0,3
GACTCACCCACGTGAG-1_V12D07-335_A1,1,2,0,1,0,4
AGCTCTTCGTAACCTT-1_V12D07-335_A1,2,1,2,0,0,5
ACTATCCAGGGCATGG-1_V12D07-335_A1,1,0,1,0,0,2
AAGGATCGATCGCTTG-1_V12D07-335_A1,0,0,0,0,0,0
ATATCGGTAGGGAGAT-1_V12D07-335_A1,0,0,2,0,0,2
TTCCAGACGAGATTTA-1_V12D07-335_A1,0,3,3,2,0,8
GACCGACGTGAAAGCA-1_V12D07-335_A1,0,0,1,1,0,2
CCTGGAAACGTTCTGC-1_V12D07-335_A1,0,0,3,1,0,4
CCGGTAATGGCTAGTC-1_V12D07-335_A1,0,0,0,0,0,0
GCCGTGGAAGAAATGT-1_V12D07-335_A1,0,0,0,0,0,0
GTCTTGAGGAGCAGTG-1_V12D07-335_A1,2,0,1,0,0,3
TCCCAAAGCCCTAAAT-1_V12D07-335_A1,0,0,1,0,0,1
TTGAGCGCCACGTGAT-1_V12D07-335_A1,0,4,1,1,0,6
TTGAGTCCCGCTGCTG-1_V12D07-335_A1,1,2,1,0,0,4
ATGGAACCTTTGCACA-1_V12D07-335_A1,1,0,1,0,0,2
GCTAGCACCTGGGCCA-1_V12D07-335_A1,0,0,2,0,0,2
CGCCGTCTACCCATCG-1_V12D07-335_A1,1,0,1,0,0,2
GATAGGTGTCCCGGGC-1_V12D07-335_A1,0,2,0,0,0,2
AGGTATGCGGACATTA-1_V12D07-335_A1,1,2,1,0,0,4
TTGGTTCGCTCAAAGG-1_V12D07-335_A1,0,0,0,0,0,0
TCTGGAGCGTAAGAGT-1_V12D07-335_A1,0,3,1,0,0,4
TGCCTAAATTTAATAG-1_V12D07-335_A1,0,2,4,0,0,6
TAATTTCCGTCCAGTA-1_V12D07-335_A1,0,0,0,0,0,0
TCCTTCAATCCCTACG-1_V12D07-335_A1,0,0,0,0,0,0
TACCTATCCCTAGAGG-1_V12D07-335_A1,0,0,0,0,0,0
GCATGGGTACTGACGC-1_V12D07-335_A1,0,0,0,0,0,0
GTCGGGAACATGGTAG-1_V12D07-335_A1,0,0,0,0,0,0
GCAAATGAGGACACTT-1_V12D07-335_A1,0,0,0,0,0,0
GAATGGGCTTATCGAC-1_V12D07-335_A1,0,1,0,0,0,1
TGGTCGTGCAAGGCAA-1_V12D07-335_A1,0,1,0,0,0,1
CACCACGCCACACAGA-1_V12D07-335_A1,1,4,2,0,0,7
GAACCTCGACCTACAC-1_V12D07-335_A1,5,4,0,0,0,9
CAATACGCTCTGAGGC-1_V12D07-335_A1,0,0,1,0,0,1
TGGTAAGCAGGATTGA-1_V12D07-335_A1,3,2,0,0,0,5
AGTGGCTCCGTCGGCC-1_V12D07-335_A1,1,2,0,0,0,3
GATCGGATAGAACCAT-1_V12D07-335_A1,0,0,3,0,0,3
GCTACAGTACGGACCG-1_V12D07-335_A1,1,0,2,0,0,3
TCTATTACTAGAGGAT-1_V12D07-335_A1,0,0,0,0,0,0
TTCAGGCGTCAAAGCC-1_V12D07-335_A1,0,0,1,0,0,1
AGACCGGGAAACCCTG-1_V12D07-335_A1,1,0,0,0,0,1
AGAGATCTCTAAAGCG-1_V12D07-335_A1,0,1,1,0,0,2
CCCTGCCCAATCCGCT-1_V12D07-335_A1,0,0,1,0,0,1
GTGGCGGTCCCAGCGT-1_V12D07-335_A1,1,0,0,0,0,1
GCATTGTAATTCATAT-1_V12D07-335_A1,1,0,0,0,0,1
CCGTTCCGAATCTCGG-1_V12D07-335_A1,0,0,0,0,0,0
AGCTTGATCTTAACTT-1_V12D07-335_A1,0,0,1,0,0,1
CCTGTACTCACGCCCA-1_V12D07-335_A1,0,0,0,0,0,0
AAGTGACGACCGAATT-1_V12D07-335_A1,0,0,0,1,0,1
CTCACTTGGCTGGTAA-1_V12D07-335_A1,1,0,4,1,0,6
CGCCTGGCCTACGTAA-1_V12D07-335_A1,0,0,1,13,0,14
CCCGTAAGTCTAGGCC-1_V12D07-335_A1,0,0,1,23,0,24
TTGGACATGTGGCTTA-1_V12D07-335_A1,1,0,5,0,0,6
ATTACGCGCTGGCAGG-1_V12D07-335_A1,0,0,2,1,0,3
ACGCGCTACACAGGGT-1_V12D07-335_A1,0,1,3,0,0,4
TACGTTTACCGGCAAT-1_V12D07-335_A1,0,0,3,0,0,3
CGAAACGCAATTCATG-1_V12D07-335_A1,0,0,0,1,0,1
TAGTCTAACAACGAGA-1_V12D07-335_A1,0,0,1,0,0,1
TTGCATGCTGATCACG-1_V12D07-335_A1,0,0,0,0,0,0
TCTGGGTAGCGCTCAT-1_V12D07-335_A1,0,0,1,0,0,1
ACATCGGTCAGCCGCG-1_V12D07-335_A1,0,0,1,0,0,1
AGATACCGGTGTTCAC-1_V12D07-335_A1,0,0,3,0,0,3
GATTACTGAATTTGGG-1_V12D07-335_A1,0,0,1,0,0,1
TCCAACTTTAAATTCT-1_V12D07-335_A1,0,0,2,0,0,2
TCCTAGCAAAGAAGCT-1_V12D07-335_A1,0,0,2,0,0,2
GTCTATCTGAGTTTCT-1_V12D07-335_A1,0,1,1,0,0,2
GATGTTCAATCCACGA-1_V12D07-335_A1,0,0,0,0,0,0
AGTTAAACACTTGCGA-1_V12D07-335_A1,0,0,3,0,0,3
AGCTCTTTACTCAGTT-1_V12D07-335_A1,0,0,1,0,0,1
ATCCAGGATTCGTGAA-1_V12D07-335_A1,0,0,0,0,0,0
AGTCAACACCACCATC-1_V12D07-335_A1,0,1,2,1,0,4
CGATACCTCGCGGACA-1_V12D07-335_A1,1,0,2,0,0,3
TACAACGCACAACTCA-1_V12D07-335_A1,0,1,0,1,0,2
AATTAAAGGTCGGCGT-1_V12D07-335_A1,0,0,0,0,0,0
TACGCAGTTCTTTCCT-1_V12D07-335_A1,0,0,2,0,0,2
GACCGTGCTGACGGTG-1_V12D07-335_A1,1,0,0,0,0,1
GGCAAATTACTTTACT-1_V12D07-335_A1,1,0,0,1,0,2
GGTACAAACATGCTAT-1_V12D07-335_A1,2,0,1,0,0,3
CGGGCCTTCTTTGTAA-1_V12D07-335_A1,0,0,1,0,0,1
CGTGAAGTTAATTCAC-1_V12D07-335_A1,0,0,1,1,0,2
ATAGTGAAGCGTTCTC-1_V12D07-335_A1,0,0,1,1,0,2
TACGCCATATTCTAAT-1_V12D07-335_A1,0,0,0,0,0,0
GCCGGGTTAGGGTCGC-1_V12D07-335_A1,0,1,1,0,0,2
TACATAGGCATACACC-1_V12D07-335_A1,0,0,2,0,0,2
GCCGATTGGCCAAGCT-1_V12D07-335_A1,0,0,0,0,0,0
CTGCCATGCATCACAT-1_V12D07-335_A1,0,0,0,0,0,0
TTATGAATGAAAGGGA-1_V12D07-335_A1,0,0,1,0,0,1
GCTGAGGCGTGAGTAT-1_V12D07-335_A1,1,0,1,0,0,2
GCGCCGTTCCACGATA-1_V12D07-335_A1,0,0,2,1,0,3
CGCATGGTGCGATGCT-1_V12D07-335_A1,1,0,5,0,0,6
AGGTTTCACACACCTT-1_V12D07-335_A1,0,2,0,0,0,2
CAAGGATCGCATGTTC-1_V12D07-335_A1,1,1,0,0,0,2
ACGTTAATGTCGAAGA-1_V12D07-335_A1,0,2,1,0,0,3
TCCAGAGCACCGGTTC-1_V12D07-335_A1,0,0,3,1,0,4
GATTCGACGGTTCACG-1_V12D07-335_A1,0,0,1,0,0,1
GTTTCTGCAGTCTCCC-1_V12D07-335_A1,0,1,2,0,0,3
GCTGCACGGTTTCTTA-1_V12D07-335_A1,1,1,3,0,0,5
CGTGCAGACTGGGACA-1_V12D07-335_A1,0,0,1,0,0,1
GTGTTACTATGCGTCC-1_V12D07-335_A1,0,0,0,0,1,1
TCCTCGGGCTGGGCTT-1_V12D07-335_A1,0,0,2,0,0,2
GTGAGGACACTTAAGG-1_V12D07-335_A1,0,0,1,0,0,1
ATACGCCGGCGAAACC-1_V12D07-335_A1,0,0,1,0,0,1
TCTGCCAGAAACTGCA-1_V12D07-335_A1,0,1,1,0,0,2
TTCTGCGGGTTAGCGG-1_V12D07-335_A1,0,1,0,0,0,1
CTCGGTACCACTGCTC-1_V12D07-335_A1,0,1,1,0,0,2
GTAAGTAACAGTCTGG-1_V12D07-335_A1,0,1,0,0,0,1
GTGCGTGTATATGAGC-1_V12D07-335_A1,0,0,0,0,0,0
ATTTGTCTTGGGAGCT-1_V12D07-335_A1,0,0,3,0,0,3
CCTCGGACCGGGATAG-1_V12D07-335_A1,1,0,1,0,0,2
TAGGTGCTCGCCTAGC-1_V12D07-335_A1,0,1,0,0,0,1
CTTTAGGAACACTGTT-1_V12D07-335_A1,1,1,1,0,0,3
TCGGGCCGTCGTGGTA-1_V12D07-335_A1,0,0,1,0,0,1
AGTGCTTGCACGAATA-1_V12D07-335_A1,1,3,1,0,0,5
TGCAGTTTCCTCCCAT-1_V12D07-335_A1,2,2,0,0,0,4
TGAGAGATTTACCACG-1_V12D07-335_A1,0,0,2,0,0,2
GAAACAGATGACCACC-1_V12D07-335_A1,0,2,1,0,0,3
AGCAACATATCTTATT-1_V12D07-335_A1,0,3,3,0,0,6
CAAGTGTGGTTGCAAA-1_V12D07-335_A1,0,1,2,0,0,3
GCCTCATCTGGAAATA-1_V12D07-335_A1,0,0,2,0,0,2
AACCCTACTGTCAATA-1_V12D07-335_A1,1,0,0,0,0,1
ACGTATTACTCCGATC-1_V12D07-335_A1,0,0,1,0,0,1
TCTGGGAACCTTTGAA-1_V12D07-335_A1,0,0,1,0,0,1
GCTCGCTCATGTCCAA-1_V12D07-335_A1,0,4,1,0,0,5
GCGCAAGAGCGCGCTG-1_V12D07-335_A1,0,0,0,0,0,0
TTGACGCTCCATGAGC-1_V12D07-335_A1,1,0,1,0,0,2
TATAGATGGTCGCAGT-1_V12D07-335_A1,0,3,0,0,0,3
TTACATGCCACAACTA-1_V12D07-335_A1,2,1,3,0,0,6
ACATGGCGCCAAAGTA-1_V12D07-335_A1,0,0,2,0,0,2
TATGGTTAGTGGGAGA-1_V12D07-335_A1,0,0,1,0,0,1
CATGACTTCGCTGAAT-1_V12D07-335_A1,3,0,0,2,0,5
ACCACCAATGTAACAA-1_V12D07-335_A1,1,0,0,1,0,2
TCTTAGAGCTCCAATT-1_V12D07-335_A1,0,0,3,1,0,4
CCACGAATTTAACCTC-1_V12D07-335_A1,0,1,2,1,0,4
TTCTTGCTAGCATCTC-1_V12D07-335_A1,2,2,2,1,0,7
ACACCTTACTACTTGC-1_V12D07-335_A1,0,1,1,2,0,4
AGTCGGTTGCGTGAGA-1_V12D07-335_A1,0,0,0,1,0,1
ACCTACAGTATGTGGT-1_V12D07-335_A1,0,4,0,0,0,4
GAGGATAAACAGTGCT-1_V12D07-335_A1,1,2,1,0,0,4
TTCCGGTATCTGTGTC-1_V12D07-335_A1,0,0,2,1,0,3
GGAGGCCGAAGTCGTC-1_V12D07-335_A1,0,1,0,0,0,1
TTCGCTAGGAAGTTGT-1_V12D07-335_A1,0,0,2,0,0,2
TAAAGACAACCCTTTA-1_V12D07-335_A1,0,0,0,0,0,0
GTTGCGCTAACATTAC-1_V12D07-335_A1,0,1,2,0,0,3
GCTGAACTCTCCAGGG-1_V12D07-335_A1,1,0,3,0,0,4
AGCCCTGTCGCACCGT-1_V12D07-335_A1,0,3,2,0,0,5
AGCGCTAGAGCGATGT-1_V12D07-335_A1,0,0,1,0,0,1
TGCGCCGTTAATAACG-1_V12D07-335_A1,0,1,2,0,0,3
TGACAACGCATGTCGC-1_V12D07-335_A1,2,3,0,0,0,5
CGTCTTGAGTGTGACG-1_V12D07-335_A1,1,1,2,0,0,4
GATAGGATTAATTACA-1_V12D07-335_A1,1,2,1,0,0,4
GATACCGTGTCGGAGT-1_V12D07-335_A1,0,1,3,0,0,4
TGTGTCGAAGTCGAGG-1_V12D07-335_A1,0,0,0,0,0,0
GGATCAGAGCCATCAG-1_V12D07-335_A1,0,0,0,0,0,0
GTCCCAATCATCCCGC-1_V12D07-335_A1,0,0,0,0,0,0
TGCCACACTAGAGGAA-1_V12D07-335_A1,0,0,0,0,0,0
TGAATTTCACTTGCCT-1_V12D07-335_A1,0,0,0,0,0,0
CTCAGATTGTGATAAG-1_V12D07-335_A1,0,0,0,0,0,0
CGGACGTTACTTGAAG-1_V12D07-335_A1,0,0,0,0,0,0
CCGCCTTGCGATGTCG-1_V12D07-335_A1,0,1,0,0,0,1
CCAGTCAAATCTCTTA-1_V12D07-335_A1,0,2,1,0,0,3
AAACAGCTTTCAGAAG-1_V12D07-335_A1,0,3,2,0,0,5
TAGCTGATGTGAAGCG-1_V12D07-335_A1,0,1,2,0,0,3
CTTATGCGCTCAGGGC-1_V12D07-335_A1,0,0,1,0,0,1
TGGCTCTTGTCGCGTA-1_V12D07-335_A1,0,0,2,0,0,2
TTGTGAGGCATGACGC-1_V12D07-335_A1,0,0,0,0,0,0
CATAAGCTCTCCGTCT-1_V12D07-335_A1,0,0,1,0,0,1
CCTTCTCAGCGTTCCT-1_V12D07-335_A1,0,0,0,0,0,0
TGCAGCTACGTACTTC-1_V12D07-335_A1,0,0,1,0,0,1
CTCTACACTGGCGATT-1_V12D07-335_A1,0,0,2,0,0,2
TGCAGATCGTCCTAGG-1_V12D07-335_A1,0,0,1,1,0,2
TGCCAAAGTCAGACTT-1_V12D07-335_A1,0,0,2,0,0,2
ACAATAGTCGTACGTT-1_V12D07-335_A1,0,1,0,0,0,1
CATGCCAACTCGCAAA-1_V12D07-335_A1,0,0,1,0,0,1
TGCAGAACTATATCGT-1_V12D07-335_A1,0,0,1,0,0,1
TCGTGTCACGCTGACA-1_V12D07-335_A1,1,0,0,0,0,1
TGATCAGGGAACTGCT-1_V12D07-335_A1,0,0,2,0,0,2
CTTGCAACCGCCTCCT-1_V12D07-335_A1,1,0,2,1,0,4
AGCCCATACATGTAAG-1_V12D07-335_A1,0,1,0,11,0,12
ATCCAATGGAGGGTCC-1_V12D07-335_A1,0,0,1,24,0,25
AAACCGGGTAGGTACC-1_V12D07-335_A1,1,1,1,8,0,11
GCAACCACGGCCGCGT-1_V12D07-335_A1,0,0,1,0,0,1
CGCTTATTCCCGGTCG-1_V12D07-335_A1,1,1,2,0,0,4
TTACTCTGGTACGTAC-1_V12D07-335_A1,0,0,2,0,0,2
GTGGTTTCCGCCTTTC-1_V12D07-335_A1,0,0,3,0,0,3
ATAGGCGGCTATAGAA-1_V12D07-335_A1,0,0,1,0,0,1
GTGCCATCACACGGTG-1_V12D07-335_A1,1,0,1,0,0,2
CCCAACATACGTCGCG-1_V12D07-335_A1,1,1,1,0,0,3
CGGTGCAGATAGAACG-1_V12D07-335_A1,3,2,1,0,0,6
GGGCGGGTTCCCTACG-1_V12D07-335_A1,0,0,2,0,0,2
TGAGCCATACAGTCTC-1_V12D07-335_A1,0,0,2,0,0,2
CTCCGCCCACATGAGG-1_V12D07-335_A1,0,1,1,1,0,3
GTTGAACCGGTTCCAT-1_V12D07-335_A1,0,0,0,0,0,0
TTGACTACCATATGGT-1_V12D07-335_A1,0,0,2,0,0,2
ACCATCGTATATGGTA-1_V12D07-335_A1,0,0,0,0,0,0
TGCGTAAGAACCTGAT-1_V12D07-335_A1,0,0,0,0,0,0
AGAAGGTTGCCGAATT-1_V12D07-335_A1,0,0,0,0,0,0
AGGACGACCCATTAGA-1_V12D07-335_A1,0,1,2,0,0,3
GGTGCTGGTACACATT-1_V12D07-335_A1,0,0,3,0,0,3
GCGCTATGCCGAGGCA-1_V12D07-335_A1,0,0,1,0,0,1
ACCCGGTTACACTTCC-1_V12D07-335_A1,1,3,1,0,0,5
TAACTCATCCGCGCGG-1_V12D07-335_A1,0,0,2,0,0,2
CACAATGAGCTGCTAT-1_V12D07-335_A1,1,0,0,0,0,1
GTTACTTTGGGCCTAG-1_V12D07-335_A1,2,1,1,0,0,4
GGGCCCGTCTTAAACA-1_V12D07-335_A1,0,0,2,0,0,2
GAAATTGTCTCTATAA-1_V12D07-335_A1,0,0,0,1,0,1
GGCGCATGAATTGATG-1_V12D07-335_A1,0,1,2,0,0,3
CATATAGGTACAGTCA-1_V12D07-335_A1,0,0,2,0,0,2
TCAACGAGGAGACAAA-1_V12D07-335_A1,0,0,1,1,0,2
TTGCACAATTCAGAAA-1_V12D07-335_A1,0,1,0,1,0,2
CATCGGACGGGTTAAT-1_V12D07-335_A1,0,1,1,0,0,2
ATTAAACATGCGGACC-1_V12D07-335_A1,0,0,1,0,0,1
TATCTACCACAGCGGG-1_V12D07-335_A1,0,0,0,0,0,0
CGAGACCCTAGAGTGT-1_V12D07-335_A1,0,1,1,1,0,3
ACATCGATCGTTTACC-1_V12D07-335_A1,0,0,0,0,0,0
ATCGACCCAATACAGA-1_V12D07-335_A1,0,0,0,0,0,0
GAATCTGAACATTCTC-1_V12D07-335_A1,0,0,2,2,0,4
AGTTCCTATTTATGTT-1_V12D07-335_A1,0,0,1,0,0,1
CAGTCTGTATACTGGG-1_V12D07-335_A1,1,0,0,0,0,1
GGAGACGACACCTTTG-1_V12D07-335_A1,0,2,3,1,0,6
CCTAAATTAACGGTTC-1_V12D07-335_A1,0,0,1,1,0,2
GCTACGACTTATTGGG-1_V12D07-335_A1,3,0,3,0,0,6
CTGTGCAGGGTAGGTC-1_V12D07-335_A1,0,0,0,1,0,1
ACGCCGCTAGACGACC-1_V12D07-335_A1,0,1,0,1,0,2
ACTTGACTCCCTCTTT-1_V12D07-335_A1,0,0,0,0,0,0
CGCCTCCCTCCTCTAT-1_V12D07-335_A1,0,0,0,1,0,1
CTAGATTTACGACGGC-1_V12D07-335_A1,0,0,2,0,0,2
GATGCTGTATTTCATC-1_V12D07-335_A1,0,0,1,1,0,2
TGCGTTTGTTGACACT-1_V12D07-335_A1,0,0,0,1,1,2
CGTGCCCTCCCGAAGA-1_V12D07-335_A1,0,0,0,0,0,0
ACTCTCTGACTTAGGT-1_V12D07-335_A1,0,1,0,0,0,1
CTGGGTAGGCAGTTAA-1_V12D07-335_A1,1,0,1,0,0,2
GTTTGGCCCAAGTTAT-1_V12D07-335_A1,0,2,2,0,0,4
GAATGTGGTCCGGATT-1_V12D07-335_A1,0,0,0,0,0,0
CCCAGTTAAGGCGCCG-1_V12D07-335_A1,0,2,0,0,0,2
CGGTACTAGAATCAAA-1_V12D07-335_A1,0,2,1,0,0,3
GCTTAATGTAACTAAC-1_V12D07-335_A1,0,1,0,0,0,1
AGGACAGTCGAATCCC-1_V12D07-335_A1,0,2,3,0,0,5
GACAGCCAGACCTGAC-1_V12D07-335_A1,0,1,0,0,0,1
GGCGAAATCTAACTTG-1_V12D07-335_A1,0,0,1,0,0,1
CTGGTAACACATAGAA-1_V12D07-335_A1,2,5,1,0,0,8
TAGCCATTTCAAAGTC-1_V12D07-335_A1,0,0,1,0,0,1
GGGATTTACCGCACCT-1_V12D07-335_A1,0,1,1,0,0,2
ATGCCATTTGCGACCA-1_V12D07-335_A1,0,2,1,1,0,4
GAATAGACGCGACCCA-1_V12D07-335_A1,0,0,1,0,0,1
TGTATGGCGCAGACAG-1_V12D07-335_A1,0,0,0,0,0,0
GGATGAAGATCGCTGA-1_V12D07-335_A1,0,2,1,0,0,3
CGACAATTTGATCTAA-1_V12D07-335_A1,2,3,1,0,0,6
AAAGTTGACTCCCGTA-1_V12D07-335_A1,0,2,1,0,0,3
CGCGGCTCAACTTGAA-1_V12D07-335_A1,0,2,1,1,0,4
CACGCGGAACTGTTGC-1_V12D07-335_A1,0,0,0,0,0,0
TCTTAGAGTGAACTCT-1_V12D07-335_A1,0,0,5,1,0,6
AGTCCATTGGCTGATG-1_V12D07-335_A1,1,0,1,1,0,3
TTAAGATAGGATTGAC-1_V12D07-335_A1,0,0,0,0,0,0
ACATCCTGGTAACTGT-1_V12D07-335_A1,0,0,0,0,0,0
CACCTTGGCGCCTTTG-1_V12D07-335_A1,0,0,1,0,0,1
GCTAGACCGTCTACTG-1_V12D07-335_A1,0,0,0,0,0,0
CGGCCCAGGTATATCC-1_V12D07-335_A1,0,0,2,0,0,2
GTCCATTACTGCTACG-1_V12D07-335_A1,1,0,1,0,0,2
GGGTTTAGGATAGGAT-1_V12D07-335_A1,0,2,0,1,0,3
TAATTAGGACATCCGT-1_V12D07-335_A1,0,0,0,1,0,1
GCTCCCAGTCGGTCCA-1_V12D07-335_A1,0,2,1,0,0,3
ATTCGTGCTATCTCTT-1_V12D07-335_A1,1,2,2,1,0,6
GTTAACTATGTTGTCA-1_V12D07-335_A1,0,0,2,0,0,2
GCTCCGCTCGCTTCAG-1_V12D07-335_A1,0,0,0,0,0,0
GCAACGGCTAGTTATG-1_V12D07-335_A1,0,3,2,1,0,6
AATCGCGCAGAGGACT-1_V12D07-335_A1,0,3,1,0,0,4
AGGTTACACCATGCCG-1_V12D07-335_A1,0,1,0,1,0,2
CGAGATTTCGCTCGGG-1_V12D07-335_A1,1,4,3,0,0,8
CGATAATACTCAGGTT-1_V12D07-335_A1,3,0,2,1,0,6
AAGGCAGGCTGTCTCC-1_V12D07-335_A1,0,1,2,0,0,3
GTAAGTCCACACTCTA-1_V12D07-335_A1,0,1,2,0,0,3
ATGAGGGCAGCGGCTA-1_V12D07-335_A1,1,1,0,0,0,2
GCCGCACTCCGTTTCA-1_V12D07-335_A1,0,0,0,0,0,0
GAGCACGGCGCCTCTT-1_V12D07-335_A1,0,1,0,0,0,1
ACAATTTGGCCATATT-1_V12D07-335_A1,0,0,0,0,0,0
CTGGTTCGCGAGCTAC-1_V12D07-335_A1,0,2,3,0,0,5
GACGGTCCTAGGGTGT-1_V12D07-335_A1,0,0,2,0,0,2
ACTCGCGATCTGACGC-1_V12D07-335_A1,1,0,0,0,0,1
GTGTACGAACCGTTCC-1_V12D07-335_A1,2,2,1,1,0,6
CTTTGACGTCGCTTCT-1_V12D07-335_A1,0,0,0,0,0,0
CGTTATCATACTTCCA-1_V12D07-335_A1,0,0,0,0,0,0
GCTATGCCAGCTTATG-1_V12D07-335_A1,0,0,0,0,0,0
CAGTCGGCCTAGATAT-1_V12D07-335_A1,0,0,0,0,0,0
CCCGTGAGGGCGGTGA-1_V12D07-335_A1,0,0,0,0,0,0
TCTCGTGTTACGAGGA-1_V12D07-335_A1,0,0,0,0,0,0
ACGTCTCGTTCCGGGA-1_V12D07-335_A1,0,0,0,0,0,0
CGAGAGCGCGTAGATA-1_V12D07-335_A1,0,3,4,0,0,7
GACAGATTTCTGGCTC-1_V12D07-335_A1,1,5,2,0,0,8
GGGCCTAAATGGGCTA-1_V12D07-335_A1,0,4,2,0,0,6
ACTTGTAGTCCCTTCA-1_V12D07-335_A1,0,1,1,0,0,2
CCCGAAGTTTCGCGAA-1_V12D07-335_A1,2,6,0,1,0,9
ACCATCCGCCAACTAG-1_V12D07-335_A1,1,1,2,0,0,4
TGCGAATATGGGATTT-1_V12D07-335_A1,0,1,0,0,0,1
TACATCCCTATCCCTG-1_V12D07-335_A1,0,1,0,0,0,1
GTGGGAAGACTGAATC-1_V12D07-335_A1,0,0,2,0,0,2
TCAACATCGACCGAGA-1_V12D07-335_A1,0,0,0,0,0,0
CTATGTGAGTCACGGC-1_V12D07-335_A1,0,0,3,0,0,3
CCGAACACTGGGCCTC-1_V12D07-335_A1,0,1,0,0,0,1
AAACTTGCAAACGTAT-1_V12D07-335_A1,1,0,2,8,0,11
AGGGCGAGCAGCTGAT-1_V12D07-335_A1,0,1,0,3,0,4
AACACGAGACGCGGCC-1_V12D07-335_A1,0,0,0,19,0,19
TGACGAATATTTCCCT-1_V12D07-335_A1,0,0,1,4,0,5
TCGGAGAGTATCGGGA-1_V12D07-335_A1,0,0,0,20,0,20
CAAATCTCTCACAAGG-1_V12D07-335_A1,0,0,0,15,0,15
AGGCCCTAGAACGCCA-1_V12D07-335_A1,0,0,3,13,0,16
TAGAGATCATGCAACT-1_V12D07-335_A1,0,0,1,19,0,20
TTGTTTCCATACAACT-1_V12D07-335_A1,0,0,1,5,0,6
GAGAGGTGCATTCTGG-1_V12D07-335_A1,1,0,0,0,0,1
GTGGACCAACCCGATT-1_V12D07-335_A1,0,1,3,2,0,6
CTGGGCCTGCTATATC-1_V12D07-335_A1,0,1,1,0,0,2
CATAGTCCACAAGAAC-1_V12D07-335_A1,0,0,2,0,0,2
TTGACATGAACGTGGA-1_V12D07-335_A1,0,1,1,0,0,2
GGTTACCACCCTCGGG-1_V12D07-335_A1,0,1,1,0,0,2
TACCGGTCGTTTCCAT-1_V12D07-335_A1,0,1,2,1,0,4
CGAGTACTAAAGAGGA-1_V12D07-335_A1,1,0,2,1,0,4
GCAAGAATTCCTTGGC-1_V12D07-335_A1,0,0,2,0,0,2
TCGCCGAAGTTGCGTC-1_V12D07-335_A1,0,2,2,2,0,6
TTGAGAGTACTGCTAA-1_V12D07-335_A1,0,1,0,1,0,2
GCCACAATTTAAGGAC-1_V12D07-335_A1,0,0,4,0,0,4
ATATTCAGTTAAACCT-1_V12D07-335_A1,0,0,1,0,0,1
TGAGTGCCTCTTAAAT-1_V12D07-335_A1,0,0,1,0,0,1
ATCAGACGGCACGCCG-1_V12D07-335_A1,1,1,1,2,0,5
GTGCGAAATCGAACAC-1_V12D07-335_A1,2,1,0,0,0,3
GTGCCGCTTCAAAGGT-1_V12D07-335_A1,0,2,0,0,0,2
GATACGATGGGAGTCA-1_V12D07-335_A1,0,1,1,0,0,2
GACACTGAGTTCAGTG-1_V12D07-335_A1,1,3,1,1,0,6
ATCCTGCGTGGAATGG-1_V12D07-335_A1,0,0,1,0,0,1
ATCCTACCTAAGCTCT-1_V12D07-335_A1,0,1,0,1,0,2
AGTGATATGAGTAGTT-1_V12D07-335_A1,0,1,2,0,0,3
ATGATGCAATGGTACA-1_V12D07-335_A1,0,1,2,1,0,4
GAAACCGAATTACCTT-1_V12D07-335_A1,2,1,3,1,0,7
AGTGACCTACTTTACG-1_V12D07-335_A1,1,0,0,1,0,2
CAAATGTCCTTCCGTG-1_V12D07-335_A1,0,0,3,1,0,4
TTACTGGGATATTTCA-1_V12D07-335_A1,0,0,0,0,0,0
CTTGCCCAGGCTCTAC-1_V12D07-335_A1,0,2,1,1,0,4
AAATCGTGTACCACAA-1_V12D07-335_A1,0,0,0,0,0,0
GTGATCATAGATCTGC-1_V12D07-335_A1,0,0,0,0,0,0
TGGCAGATTACGATCA-1_V12D07-335_A1,1,0,0,0,0,1
TCACCCTCTTAAGATT-1_V12D07-335_A1,0,0,0,0,0,0
CAGGATATATCGTTGT-1_V12D07-335_A1,0,0,1,0,0,1
CCTGACCACCGATGGT-1_V12D07-335_A1,0,1,2,1,0,4
CTAAAGGGAAATAGGA-1_V12D07-335_A1,1,0,0,0,0,1
CCGCTATCAGCACCAG-1_V12D07-335_A1,0,1,1,4,0,6
CTTTAGTGCTATTATT-1_V12D07-335_A1,1,1,1,1,0,4
CGGGAATTTATGTAAA-1_V12D07-335_A1,0,1,0,2,0,3
TACGACTGCCTCTTAG-1_V12D07-335_A1,1,0,3,0,0,4
AAACTGCTGGCTCCAA-1_V12D07-335_A1,0,0,0,0,0,0
GTACGTTTGCCCGTCA-1_V12D07-335_A1,0,0,1,0,1,2
GGCAAGGCGAAATAGC-1_V12D07-335_A1,0,0,1,0,0,1
GATCTTGGAGGGCATA-1_V12D07-335_A1,0,0,0,1,0,1
AGCGTGGTATTCTACT-1_V12D07-335_A1,0,0,0,0,0,0
CTAAGGGAATGATTGG-1_V12D07-335_A1,0,0,0,0,0,0
CATGGTAAGTAGCGTT-1_V12D07-335_A1,0,2,0,0,0,2
CGTTGAGCGACCGTCG-1_V12D07-335_A1,0,0,0,0,0,0
TGCCCGTACCGTTAAA-1_V12D07-335_A1,0,0,1,0,0,1
ACAAGGGCAGGCTCTG-1_V12D07-335_A1,0,1,0,2,0,3
GAGATCTTCCATGACA-1_V12D07-335_A1,0,2,0,2,0,4
AATGACGTAGGATGTC-1_V12D07-335_A1,0,0,3,0,0,3
GTGGTGGCCAAGTGAA-1_V12D07-335_A1,0,0,2,1,0,3
TCCCGTGTGCAATTTG-1_V12D07-335_A1,0,1,1,0,0,2
ACATCGTATGCAATGG-1_V12D07-335_A1,0,4,2,0,0,6
GCGAAACTTAACTGGA-1_V12D07-335_A1,0,3,0,0,0,3
AATTGAACGCTCTGGT-1_V12D07-335_A1,0,1,3,0,0,4
ACAAATGGTAGTGTTT-1_V12D07-335_A1,0,0,1,0,0,1
ATGGTCGCGTGGTTTC-1_V12D07-335_A1,0,0,0,0,0,0
TGTTATTGTATGTGGC-1_V12D07-335_A1,0,0,0,0,0,0
TTCCGGTTACCCACTT-1_V12D07-335_A1,0,3,0,0,0,3
GAGTGTGCGGTACCCA-1_V12D07-335_A1,0,4,1,0,0,5
CAAGATATTATAACGT-1_V12D07-335_A1,2,1,1,0,0,4
ACACACCAGGACCAGT-1_V12D07-335_A1,0,0,1,0,0,1
ATGGGCCTCGGCCTCT-1_V12D07-335_A1,0,3,1,0,0,4
AAGGTGATAAACCAGC-1_V12D07-335_A1,0,0,0,0,0,0
TCTTACTTATGCCTCT-1_V12D07-335_A1,0,1,1,0,0,2
AAAGTGTGATTTATCT-1_V12D07-335_A1,0,0,3,0,0,3
TGCTCCACAGTTCTTA-1_V12D07-335_A1,0,1,0,0,0,1
CTGGCTGATTCATCCT-1_V12D07-335_A1,0,0,1,0,0,1
TAAGGCTGAATCCCTC-1_V12D07-335_A1,0,2,1,0,0,3
TCTAGTGATATCGTGG-1_V12D07-335_A1,0,3,4,0,0,7
TCGAAGAACCGAGCAC-1_V12D07-335_A1,0,2,2,0,0,4
GACAAACATATGCAGG-1_V12D07-335_A1,0,0,1,0,0,1
AAGTCAATTGTCGTCA-1_V12D07-335_A1,2,2,0,0,0,4
AGTGAACAAACTTCTC-1_V12D07-335_A1,0,0,0,0,0,0
CATGATGGAAGTTAGC-1_V12D07-335_A1,0,0,2,0,0,2
AAGTGCCTTGACTGTA-1_V12D07-335_A1,0,0,1,0,0,1
ATCGCCAGTCAACATT-1_V12D07-335_A1,0,0,0,0,0,0
ACCGCGGTGGAAGTCG-1_V12D07-335_A1,0,0,1,0,0,1
TCTTCTATAACCCGCC-1_V12D07-335_A1,0,0,2,0,0,2
CACATTTCTTGTCAGA-1_V12D07-335_A1,0,1,0,0,0,1
TAGCGTCCCTCGATTG-1_V12D07-335_A1,1,6,2,0,0,9
GTTCGGATCGGGAACA-1_V12D07-335_A1,0,0,1,1,0,2
CAAACTCGCGACGCCG-1_V12D07-335_A1,0,2,0,0,0,2
GTCTTGTAGCTATTCA-1_V12D07-335_A1,3,1,1,1,0,6
TCTCGACGTATCGCCG-1_V12D07-335_A1,1,0,0,0,0,1
TTGCCAAGCAGAACCC-1_V12D07-335_A1,0,1,2,1,0,4
AAACCCGAACGAAATC-1_V12D07-335_A1,0,0,1,1,0,2
TTGAGCAGCCCACGGT-1_V12D07-335_A1,0,1,1,2,0,4
CGCCTTTAGCATGCTC-1_V12D07-335_A1,2,0,2,0,0,4
TGTGGCTCCCACCAAC-1_V12D07-335_A1,0,1,2,2,0,5
CCGCCGTTGAGGATAA-1_V12D07-335_A1,0,1,1,2,0,4
CAATACGAGAGTCTGA-1_V12D07-335_A1,0,2,1,1,0,4
CATCTAGTGAAGGGAA-1_V12D07-335_A1,0,2,0,1,0,3
GGTGGAGGTTGATACG-1_V12D07-335_A1,0,1,3,0,0,4
CCGCACACGAACGTGT-1_V12D07-335_A1,0,3,1,0,0,4
AGAACCCAGCGTGACA-1_V12D07-335_A1,0,0,2,0,0,2
GCGCTCGATCACCTGT-1_V12D07-335_A1,0,0,2,0,0,2
ATCATGGACTACCGAC-1_V12D07-335_A1,0,1,2,0,0,3
TACGCCGCCTCAGAAG-1_V12D07-335_A1,0,1,1,0,0,2
CGACCTACTAGACAAT-1_V12D07-335_A1,0,0,0,0,0,0
GAGTCTTGTAAAGGAC-1_V12D07-335_A1,0,0,0,0,0,0
AATATCCTAGCAAACT-1_V12D07-335_A1,0,0,0,0,0,0
CCCTAGGCAACAAGAG-1_V12D07-335_A1,0,0,0,0,0,0
ACAAAGAAGGTAGGCC-1_V12D07-335_A1,0,0,0,0,0,0
CCCTGGCTGTTCCTTC-1_V12D07-335_A1,0,0,0,0,0,0
TCGCCGCACCGCGTGA-1_V12D07-335_A1,0,0,0,0,0,0
TATAGCGCACGTTATC-1_V12D07-335_A1,0,4,0,0,0,4
TTATCTGACATTAGGA-1_V12D07-335_A1,1,5,1,0,0,7
AGTGGTGTTACCCGTG-1_V12D07-335_A1,0,2,3,0,0,5
GCCAAGAATACTTCTG-1_V12D07-335_A1,0,3,1,0,0,4
CCGGCGTGAGACTCTG-1_V12D07-335_A1,2,3,0,0,0,5
TTCCCGGCGCCAATAG-1_V12D07-335_A1,1,0,4,0,0,5
AAACAGGGTCTATATT-1_V12D07-335_A1,1,2,2,0,0,5
ACAGTAATACAACTTG-1_V12D07-335_A1,1,0,2,0,0,3
CGAACGGCCGGACAAC-1_V12D07-335_A1,0,0,1,0,0,1
GCAACACACTAGAACT-1_V12D07-335_A1,0,0,0,0,0,0
ACTCCCATTCCTAAAG-1_V12D07-335_A1,0,0,2,0,0,2
ACCTGCGTGTCATGTT-1_V12D07-335_A1,0,0,2,7,0,9
TACTTTCCGCACGCCA-1_V12D07-335_A1,0,0,1,17,0,18
AGGTCAGGTGAGAGTG-1_V12D07-335_A1,0,0,1,23,0,24
TCCTCCTAAGACATTC-1_V12D07-335_A1,0,1,0,20,0,21
ATGTGAAAGCCTAATG-1_V12D07-335_A1,0,0,1,19,0,20
AGTCGGCTCAACTTTA-1_V12D07-335_A1,0,1,3,10,0,14
CGATCTGTTGGAGGAC-1_V12D07-335_A1,1,0,1,10,0,12
ACGGGAGTGTCGGCCC-1_V12D07-335_A1,0,0,0,4,0,4
TTAACTTCAGGTAGGA-1_V12D07-335_A1,1,0,3,1,0,5
CCACGGAGCCATAAGA-1_V12D07-335_A1,0,0,4,1,0,5
CTTCTATGTTGAAGTA-1_V12D07-335_A1,1,1,3,0,0,5
CACCGTTGCGCGATAT-1_V12D07-335_A1,0,1,0,0,0,1
TCTAGCAATCTCCGCC-1_V12D07-335_A1,0,2,3,0,0,5
AGTTTGGCCAGACCTA-1_V12D07-335_A1,0,1,3,0,0,4
TTGTAAGGACCTAAGT-1_V12D07-335_A1,1,0,1,1,0,3
AAATTTGCGGGTGTGG-1_V12D07-335_A1,2,2,0,1,0,5
AAGTTCGGCCAACAGG-1_V12D07-335_A1,2,1,2,1,0,6
CCGCTTACCTCACTCT-1_V12D07-335_A1,1,2,1,0,0,4
ATCACGTGCTAATTAA-1_V12D07-335_A1,0,1,1,0,0,2
GGTGAAGTACAGGGAT-1_V12D07-335_A1,0,2,1,0,0,3
GCTGTATTACTGGCCC-1_V12D07-335_A1,1,0,1,0,0,2
AACGGCCATCTCCGGT-1_V12D07-335_A1,0,0,2,0,0,2
TAAGTAACATCTTGAC-1_V12D07-335_A1,0,1,0,1,0,2
TTCTTGAGCCGCGCTA-1_V12D07-335_A1,1,0,1,0,0,2
AGTGCGTAGCTCGTAA-1_V12D07-335_A1,0,2,0,1,0,3
GGGATGGTCGTAACCG-1_V12D07-335_A1,0,1,2,1,0,4
GTCTGGGCGGTCGAGA-1_V12D07-335_A1,2,0,2,0,0,4
CGGAACGTAAACATAG-1_V12D07-335_A1,0,1,2,0,0,3
TGCGACACCCTAGTGC-1_V12D07-335_A1,1,0,3,0,0,4
CAAACGAGTATCGCAG-1_V12D07-335_A1,0,1,2,0,0,3
TCAGTAGGGACTATAA-1_V12D07-335_A1,0,0,2,0,0,2
GCGGTTCCCTATCATG-1_V12D07-335_A1,0,2,1,2,0,5
GTGACTTCAGTAGTGC-1_V12D07-335_A1,0,0,2,1,0,3
CGTCACGTCCATTGGT-1_V12D07-335_A1,0,2,1,1,0,4
ATAAGTTACCGCGACG-1_V12D07-335_A1,0,0,1,0,0,1
CTGAATCCGAGACCTC-1_V12D07-335_A1,0,0,2,0,0,2
TACGACGCTTGCTGCG-1_V12D07-335_A1,0,0,0,1,0,1
GAATTCACCCGGGTGT-1_V12D07-335_A1,0,0,0,0,0,0
GGGTGACACCTTAACT-1_V12D07-335_A1,0,0,1,0,0,1
TGAGTAAATTAGCGTA-1_V12D07-335_A1,0,0,1,1,0,2
GAGTCCGCTTACCGGA-1_V12D07-335_A1,0,0,1,0,0,1
GGCGCGTTCGAGTTTA-1_V12D07-335_A1,0,1,0,0,0,1
ATTCATATACTGTCCA-1_V12D07-335_A1,1,0,1,0,0,2
ATAAACGGACCCGTAA-1_V12D07-335_A1,0,0,1,0,0,1
GTCGTACCATCTCGGG-1_V12D07-335_A1,0,0,4,0,0,4
ATAATAGCTGTTGAAT-1_V12D07-335_A1,0,0,0,0,0,0
TTCCGCGTGAGGCGAT-1_V12D07-335_A1,0,0,2,0,0,2
TACCGGCTCACTGCCC-1_V12D07-335_A1,0,0,2,0,0,2
GTATCTTTCATAACCA-1_V12D07-335_A1,2,0,1,0,0,3
GTTACCTACAACTTGC-1_V12D07-335_A1,0,0,0,1,0,1
TGACTATAATCCTTTC-1_V12D07-335_A1,0,1,2,0,0,3
AAATACCTATAAGCAT-1_V12D07-335_A1,0,1,1,0,0,2
TTATTAGAGCGTGTTC-1_V12D07-335_A1,0,0,1,0,0,1
ATGTGGACATCTTGAT-1_V12D07-335_A1,0,1,0,0,0,1
GTACGCTTCATTGCAC-1_V12D07-335_A1,0,0,1,0,0,1
CACATATTAGCAGGAT-1_V12D07-335_A1,0,2,1,0,0,3
CAAGAGGGCGGAGTAC-1_V12D07-335_A1,0,0,0,0,0,0
TCGCAAAGATGCATTT-1_V12D07-335_A1,0,0,4,0,0,4
GTCGTTATTCGCTTAT-1_V12D07-335_A1,0,3,1,0,0,4
TCGTGTACTATGGATG-1_V12D07-335_A1,2,0,1,0,0,3
GCGGAGAGGGAGAACG-1_V12D07-335_A1,1,4,1,1,0,7
TCACAGGGAATCGCAA-1_V12D07-335_A1,0,0,3,0,0,3
GACTGCACCAGCCCAG-1_V12D07-335_A1,0,0,1,0,0,1
TCCGCTGTCATCCCGG-1_V12D07-335_A1,0,0,2,0,1,3
AGATACTCAAGATCGA-1_V12D07-335_A1,0,1,5,0,1,7
ACTGAATGGCGAAAGT-1_V12D07-335_A1,2,2,1,0,1,6
TCCTACATCCACGGCC-1_V12D07-335_A1,0,2,1,0,0,3
TTCAGCCCTGGTCCAC-1_V12D07-335_A1,0,3,1,0,0,4
TTAGAGTTTAGAAGGA-1_V12D07-335_A1,0,1,0,0,0,1
GGTTAGCTATATGTCT-1_V12D07-335_A1,0,4,2,0,1,7
CTGGTTTCGAGCAAGA-1_V12D07-335_A1,0,3,4,0,0,7
TGGGCCCATACTAATT-1_V12D07-335_A1,0,1,0,0,0,1
ACTTATTTATGTGCCA-1_V12D07-335_A1,0,2,0,0,0,2
TTAGTTATTCGTGGCA-1_V12D07-335_A1,0,2,1,0,0,3
AACCGCTAAGGGATGC-1_V12D07-335_A1,0,1,2,0,0,3
ATACGTCCACTCCTGT-1_V12D07-335_A1,0,0,0,0,0,0
CGACACGCTCCGACAG-1_V12D07-335_A1,0,3,1,0,0,4
TCTGAACTCGTACCCG-1_V12D07-335_A1,0,3,2,0,0,5
AGGATATAGGGATTTA-1_V12D07-335_A1,0,0,0,0,0,0
GTGATCACTAACGCCT-1_V12D07-335_A1,0,4,1,0,1,6
ACCGGGCCTTTGTTGA-1_V12D07-335_A1,0,1,7,0,0,8
TTGACAGGAGCTCCCG-1_V12D07-335_A1,0,1,1,0,0,2
CTCTTCTATTGACTGG-1_V12D07-335_A1,0,2,1,0,0,3
CGTGGCCGAATATCTA-1_V12D07-335_A1,0,1,2,0,0,3
GGTTTAGCCTTTCTTG-1_V12D07-335_A1,0,1,2,0,0,3
TCAAGGTTACTACACC-1_V12D07-335_A1,0,0,0,0,0,0
TTGACTATTGTCCGGC-1_V12D07-335_A1,0,1,1,0,0,2
CGGGAATATAGTATAC-1_V12D07-335_A1,0,1,0,0,0,1
GCAACAGCAGTATGCG-1_V12D07-335_A1,0,0,1,0,0,1
ATCAAACACTGTTCCA-1_V12D07-335_A1,0,3,1,0,0,4
TGGGCAATAGTTGGGT-1_V12D07-335_A1,0,0,1,1,0,2
TGAATGTCAGCCGGCC-1_V12D07-335_A1,0,0,2,0,0,2
CGGCTCTAAAGCTGCA-1_V12D07-335_A1,0,0,1,0,0,1
GGACACAAGTTTACAC-1_V12D07-335_A1,0,0,0,0,0,0
CCGAGAAGTCGCATAA-1_V12D07-335_A1,0,1,0,0,0,1
AACTACCCGTTTGTCA-1_V12D07-335_A1,0,1,1,0,0,2
GCACAAACGAGGCGTG-1_V12D07-335_A1,0,0,2,0,0,2
CACACAGCTTGCGCTC-1_V12D07-335_A1,0,0,1,0,0,1
GTGCTTACATCAGCGC-1_V12D07-335_A1,1,1,2,1,0,5
GCAAACGTCGCCAGGT-1_V12D07-335_A1,0,0,1,0,0,1
GAATAGCATTTAGGGT-1_V12D07-335_A1,0,0,2,1,0,3
TACTGTTTCTCTGGTA-1_V12D07-335_A1,2,0,2,2,0,6
TCCTATCATAGGTAAC-1_V12D07-335_A1,0,0,0,1,0,1
TTCGGTGGAGACGCCC-1_V12D07-335_A1,0,0,2,0,0,2
TGTTGCCGTCGTCCCA-1_V12D07-335_A1,0,0,1,0,0,1
CCAACTTGATAGATCC-1_V12D07-335_A1,1,2,2,0,0,5
CAAAGGTCATCTGAAA-1_V12D07-335_A1,1,2,1,0,0,4
CTAGCTTAATGGTCCC-1_V12D07-335_A1,0,3,1,0,0,4
AGGCCACATTGGTTAC-1_V12D07-335_A1,0,1,0,0,0,1
TTAGGATGGGAGGGTA-1_V12D07-335_A1,0,2,2,0,1,5
TATGACCTTGCGCTGG-1_V12D07-335_A1,0,0,0,0,0,0
ATATACATGTATGGTA-1_V12D07-335_A1,0,0,0,0,0,0
TGTGTGACCATGAATC-1_V12D07-335_A1,0,0,0,0,0,0
CCCACTCCACGGTATC-1_V12D07-335_A1,0,0,0,0,0,0
GGGCAGACGTCACTGC-1_V12D07-335_A1,0,0,0,0,0,0
TCAAAGAGCTATCTGT-1_V12D07-335_A1,0,0,0,0,0,0
AGATGCATCCTGTGTC-1_V12D07-335_A1,0,1,0,0,0,1
GTGAAGTCACGACTCG-1_V12D07-335_A1,0,3,0,0,0,3
TGATTCAGGTCCCGCG-1_V12D07-335_A1,1,1,1,0,0,3
CGCCACAGGTCGCGAT-1_V12D07-335_A1,1,2,1,1,0,5
TTGAATCGTTGTATAA-1_V12D07-335_A1,1,2,1,0,0,4
TGGCCAATTTGGTACT-1_V12D07-335_A1,0,2,0,0,0,2
CGACCCTTAACGCCGG-1_V12D07-335_A1,0,0,1,0,0,1
TCGGCGTACTGCACAA-1_V12D07-335_A1,0,3,2,0,0,5
GAGTAAGGCCACGGGA-1_V12D07-335_A1,0,1,2,0,0,3
ATCAGCTCGTCCACTA-1_V12D07-335_A1,0,0,0,0,0,0
AGGATCACGCGATCTG-1_V12D07-335_A1,0,0,0,0,0,0
AAATGGCCCGTGCCCT-1_V12D07-335_A1,1,0,0,0,0,1
CAGTACCAGTTTACGT-1_V12D07-335_A1,0,0,0,10,0,10
GGTCGTAAGCTCGCAC-1_V12D07-335_A1,0,0,0,14,0,14
CGTTCATGGTGCGCGT-1_V12D07-335_A1,0,0,1,22,0,23
GACTACAAAGCGGTGG-1_V12D07-335_A1,0,0,1,15,0,16
CAGCTGGCGTAACCGT-1_V12D07-335_A1,0,0,5,5,0,10
ACTCGTAACCCGTCCT-1_V12D07-335_A1,0,0,2,1,0,3
CATATGTCAGGCTACG-1_V12D07-335_A1,0,1,1,2,0,4
GCCCGACTTCTTCCCG-1_V12D07-335_A1,0,1,1,0,0,2
CTGGCATCCGAATGAG-1_V12D07-335_A1,0,1,1,0,0,2
AAGTGCGTTAGAATCT-1_V12D07-335_A1,1,4,1,0,0,6
AGAAGTGATTCGTGAT-1_V12D07-335_A1,0,1,0,0,0,1
TACCTTAAGATTTCCC-1_V12D07-335_A1,1,1,2,0,0,4
AATGACAGCAATGTCT-1_V12D07-335_A1,0,3,1,0,0,4
TCAACGCAGGAAATAA-1_V12D07-335_A1,1,1,2,0,0,4
TATTCCTCCGCCCACT-1_V12D07-335_A1,0,0,1,0,0,1
ATCAAACGAAGGTTTG-1_V12D07-335_A1,0,0,1,1,0,2
TTGATTAGCTGTTTCT-1_V12D07-335_A1,0,2,0,1,0,3
CTGCTGAGGCCACGAA-1_V12D07-335_A1,0,0,1,0,0,1
CCGTGTTAAATTCCAT-1_V12D07-335_A1,1,2,2,0,0,5
CACGTCGGCAACCTCT-1_V12D07-335_A1,0,0,2,0,0,2
GTATTCTGAGAAACGA-1_V12D07-335_A1,1,1,0,0,0,2
CGGTGCGCGTTGGTCC-1_V12D07-335_A1,2,1,1,0,0,4
GTGATTCGCCGCTCAA-1_V12D07-335_A1,0,0,3,0,0,3
GCCCGCGCGTAAACGG-1_V12D07-335_A1,0,0,0,0,0,0
AACGTACTGTGGGTAC-1_V12D07-335_A1,0,0,2,0,0,2
GAGTATGCCCGCCTTG-1_V12D07-335_A1,0,1,0,0,0,1
TGATTCTGTCGCCGGT-1_V12D07-335_A1,0,1,0,0,0,1
GGGCGGCAAATGAATT-1_V12D07-335_A1,0,1,0,0,0,1
TTCCAATCTGGCTATC-1_V12D07-335_A1,1,0,2,1,0,4
GGAACCGTGTAAATTG-1_V12D07-335_A1,0,0,4,1,0,5
TTGGTCACACTCGTAA-1_V12D07-335_A1,0,1,2,0,0,3
CGAACCCGCATGCGTC-1_V12D07-335_A1,2,0,1,0,0,3
GGGCGTCACCACGTAA-1_V12D07-335_A1,0,1,5,0,0,6
TACCAGAAGTAGGTTC-1_V12D07-335_A1,2,1,2,0,0,5
TTGGATATCGTCTACG-1_V12D07-335_A1,0,0,3,0,0,3
TAGATATGGACTGGAA-1_V12D07-335_A1,0,0,1,0,0,1
GCGACGATAGTTGTAC-1_V12D07-335_A1,0,0,2,0,0,2
CTGGATTTACACTTGA-1_V12D07-335_A1,1,0,2,0,0,3
GTTATATTATCTCCCT-1_V12D07-335_A1,0,0,3,0,0,3
TATTCCACTCAGCTCG-1_V12D07-335_A1,0,3,1,0,0,4
CTGTTACCCAATCTAG-1_V12D07-335_A1,0,0,1,1,0,2
ACGCGAAGTCAGACGA-1_V12D07-335_A1,0,0,2,0,0,2
GATAGGTAACGTTGAC-1_V12D07-335_A1,0,0,1,0,0,1
TGTTCGTATTGCGGTG-1_V12D07-335_A1,1,0,0,1,0,2
GGTCAGTGGGTCCCAC-1_V12D07-335_A1,0,0,1,1,0,2
AATTCTAGAGTTAGGC-1_V12D07-335_A1,0,0,0,0,0,0
GTTTACGTTCCATCTG-1_V12D07-335_A1,0,1,2,0,0,3
AGACCCACCGCTGATC-1_V12D07-335_A1,2,0,1,0,0,3
TCTAGCATGCCCAGAA-1_V12D07-335_A1,0,0,2,0,0,2
CCCGCAGCGCGAACTA-1_V12D07-335_A1,0,0,1,1,0,2
CTCTATTTGGCTGCAG-1_V12D07-335_A1,1,1,2,0,0,4
TTCTGCCGCGCCTAGA-1_V12D07-335_A1,0,0,2,0,0,2
ACTCCCTAGAATAGTA-1_V12D07-335_A1,0,0,3,0,0,3
CCGAACCTTCCCGGCC-1_V12D07-335_A1,0,1,1,0,0,2
TCAGACGCTATAGAAG-1_V12D07-335_A1,0,0,1,0,0,1
CAGGCGCCATGCTAGG-1_V12D07-335_A1,0,0,0,0,0,0
CACTCGAGCTGAACAA-1_V12D07-335_A1,1,1,2,0,0,4
ACAAGGAAATCCGCCC-1_V12D07-335_A1,0,2,2,0,0,4
ACCACGTGCAGCTATA-1_V12D07-335_A1,0,0,0,0,0,0
ACGGCGACGATGGGAA-1_V12D07-335_A1,0,4,4,0,0,8
TTACTAAAGGACTTTA-1_V12D07-335_A1,0,2,1,0,0,3
GGCTGAAATAGCAAAG-1_V12D07-335_A1,0,0,1,0,0,1
TTAGACGAGTCACCTC-1_V12D07-335_A1,0,3,2,0,0,5
GTAGTCGCGGGAATCA-1_V12D07-335_A1,0,3,1,0,0,4
GCAAACCCTACATTAT-1_V12D07-335_A1,0,4,3,0,0,7
GTTAAAGTAGGACTGG-1_V12D07-335_A1,1,4,1,0,0,6
ACCCTCCCTTGCTATT-1_V12D07-335_A1,0,3,1,0,2,6
CATGTCTCATTTATGG-1_V12D07-335_A1,0,0,1,0,0,1
AATAGAATCTGTTTCA-1_V12D07-335_A1,0,4,1,0,0,5
TCTCATGAGATAGGGT-1_V12D07-335_A1,2,1,0,0,0,3
ATGACTATGCGACATT-1_V12D07-335_A1,0,2,2,0,0,4
CCTAACCCAAACAAGT-1_V12D07-335_A1,0,3,1,0,0,4
AGTCAAGATGACACTT-1_V12D07-335_A1,1,0,1,0,0,2
CGGGAGCTTCAGTGTA-1_V12D07-335_A1,0,2,0,0,0,2
CCACAGTACCCATCCT-1_V12D07-335_A1,0,3,0,0,0,3
GAGCGCGCACGAGTAG-1_V12D07-335_A1,0,3,3,0,0,6
ACCAGTGCGGGAGACG-1_V12D07-335_A1,0,1,2,0,0,3
TCCTTACGACGGTCCG-1_V12D07-335_A1,0,0,1,0,0,1
TAGTCGATCACGGGTT-1_V12D07-335_A1,0,3,1,0,0,4
AGACGAAGTGCCGGTC-1_V12D07-335_A1,2,2,1,1,0,6
CGCTGGTGACTACCCT-1_V12D07-335_A1,1,5,2,0,0,8
AGGCATTGTCGTAGGG-1_V12D07-335_A1,0,0,3,0,0,3
TGGTAGAATATATGGG-1_V12D07-335_A1,0,1,0,0,0,1
TTCTTATCCGCTGGGT-1_V12D07-335_A1,0,7,0,0,0,7
AGTTTGGCACGGGTTG-1_V12D07-335_A1,0,1,2,0,0,3
GCATCGGCCGTGTAGG-1_V12D07-335_A1,0,5,1,0,0,6
ATGCGAGTCCCACCAC-1_V12D07-335_A1,2,2,0,0,0,4
TCGGCGAACCCAAACC-1_V12D07-335_A1,0,5,2,0,0,7
AGAGTAAACTTCACTA-1_V12D07-335_A1,0,1,1,0,0,2
AAGCCGAAGCGGTTTA-1_V12D07-335_A1,0,3,1,0,0,4
CCCGAGTTTCTCCGTA-1_V12D07-335_A1,0,2,0,0,0,2
AATATCGAATCAATGC-1_V12D07-335_A1,0,0,1,0,0,1
GCGCCTCCCACTCCGA-1_V12D07-335_A1,0,3,1,0,0,4
CGTTAAACTAGTTAGG-1_V12D07-335_A1,0,2,2,0,0,4
TGAGTTAAAGACATTC-1_V12D07-335_A1,0,1,1,0,0,2
AACAGGTAGTATGGAT-1_V12D07-335_A1,1,1,1,0,0,3
GAACGCGGGTCACACG-1_V12D07-335_A1,0,0,4,0,0,4
TGTTTGAGATCGTCAG-1_V12D07-335_A1,0,2,0,0,0,2
ATCTCGTGAGCGAAAC-1_V12D07-335_A1,1,0,1,1,0,3
CTGAGAAAGTTCGGCG-1_V12D07-335_A1,0,0,1,0,0,1
ATTACCACACTGCCTG-1_V12D07-335_A1,0,1,2,1,0,4
CTGCTGTCTAACGAGC-1_V12D07-335_A1,0,0,2,0,0,2
CGTGGAAGCCTCGTAC-1_V12D07-335_A1,0,1,1,1,0,3
GGACTCACAAATTAGG-1_V12D07-335_A1,0,2,6,0,0,8
CTTTGCTGTCATGGAT-1_V12D07-335_A1,0,0,0,0,0,0
GGTGTTGGGCGTCTTA-1_V12D07-335_A1,0,1,1,1,0,3
TACCATGTATTGATTT-1_V12D07-335_A1,0,0,1,1,0,2
GGTCTCCAAGTAGTGC-1_V12D07-335_A1,0,1,2,1,0,4
ATCCTTCTGAAAGAAC-1_V12D07-335_A1,1,1,0,1,0,3
CCGGAAGTTATCAGTC-1_V12D07-335_A1,0,0,0,0,0,0
TTAGAGGGATATACAG-1_V12D07-335_A1,0,0,0,0,0,0
TTGTACACCTCGAACA-1_V12D07-335_A1,0,0,0,0,0,0
GTGGGTACTGAGCGTA-1_V12D07-335_A1,0,0,0,0,0,0
CTTAAGCAGCGAGCCG-1_V12D07-335_A1,0,0,0,0,0,0
GCATTGACTTGCGGAA-1_V12D07-335_A1,0,0,0,0,0,0
CCATAACCTGTGCAGT-1_V12D07-335_A1,0,0,0,0,0,0
GGGCTACTATTTCGTG-1_V12D07-335_A1,0,1,1,0,0,2
GGCGAGCGAAACGGCA-1_V12D07-335_A1,1,1,1,0,0,3
GGAGACCATCTACATA-1_V12D07-335_A1,1,2,0,0,0,3
AGACCAAACCACACCT-1_V12D07-335_A1,0,1,1,0,0,2
CGACGCATCCGTACCT-1_V12D07-335_A1,0,1,1,0,0,2
CCTAGGTAAAGGTAGC-1_V12D07-335_A1,0,8,2,0,0,10
AGCGGCGGTTAGCGGT-1_V12D07-335_A1,1,5,0,0,0,6
CTGGACGCAGTCCGGC-1_V12D07-335_A1,0,5,0,0,0,5
AGCCTAATACCCACGT-1_V12D07-335_A1,0,4,1,0,0,5
AATCTGGCTTTCTAGT-1_V12D07-335_A1,1,3,1,0,0,5
CACCCTTGGTGAGACC-1_V12D07-335_A1,0,1,1,0,0,2
GGATCTTGACTCAACC-1_V12D07-335_A1,0,0,1,0,0,1
ACGAGGATACCACTCT-1_V12D07-335_A1,0,0,2,0,0,2
GAGTTGATGGCAATTT-1_V12D07-335_A1,0,0,2,0,0,2
GTGGCAAACAGCGGCA-1_V12D07-335_A1,0,0,1,11,0,12
GATGTAACGAACCACC-1_V12D07-335_A1,0,0,1,8,0,9
AGCCGTGGCTAAATGT-1_V12D07-335_A1,0,0,0,16,0,16
CTCCCTCCTTTCGATC-1_V12D07-335_A1,0,0,2,17,0,19
TTGGAAGAATACAGTC-1_V12D07-335_A1,1,0,1,2,0,4
AGTTAAGTCAACCGCT-1_V12D07-335_A1,0,0,2,6,0,8
CTCATGGTAATTTGCG-1_V12D07-335_A1,2,0,1,0,0,3
AAAGTAGCATTGCTCA-1_V12D07-335_A1,1,1,3,1,0,6
TTGTGGTAGGAGGGAT-1_V12D07-335_A1,0,1,0,0,0,1
AGTCGTGGGCATTACG-1_V12D07-335_A1,1,1,2,1,0,5
ACCTAAGTACCTTTCA-1_V12D07-335_A1,0,0,2,0,0,2
GTAGAGGGAGACAAGT-1_V12D07-335_A1,0,0,4,0,0,4
GATCCTCGACACTGGC-1_V12D07-335_A1,0,0,2,0,0,2
CCTACATTCACAGACG-1_V12D07-335_A1,0,1,0,0,0,1
TTGACCGTGTTAATGA-1_V12D07-335_A1,0,1,1,0,0,2
TCTGTTACCCAGCATA-1_V12D07-335_A1,0,0,2,1,0,3
CTAACTGGTCCGGTTC-1_V12D07-335_A1,0,1,0,0,0,1
AGCGACAGGAACGGTC-1_V12D07-335_A1,0,0,1,1,0,2
TAATAGAACAGAGTTA-1_V12D07-335_A1,0,1,1,0,0,2
ACAGGTGGAGGTGAGG-1_V12D07-335_A1,0,3,2,0,0,5
TGCGAGAATATTACCC-1_V12D07-335_A1,0,0,0,0,0,0
TTGCGTCGGCCAACCG-1_V12D07-335_A1,1,1,2,0,0,4
AGGCTTCCCGAAGAAG-1_V12D07-335_A1,1,0,3,0,0,4
GCGGACCGCGTTGTGG-1_V12D07-335_A1,0,0,3,0,0,3
GTAATCTGATTCTTCG-1_V12D07-335_A1,0,0,1,1,0,2
CCGCGGAATGCGTCAC-1_V12D07-335_A1,0,0,1,0,0,1
TTCCACACAGATTTGA-1_V12D07-335_A1,0,0,2,0,0,2
CTTCTATTAATGCTAG-1_V12D07-335_A1,0,0,1,0,0,1
CATTTGAGTGGTACGT-1_V12D07-335_A1,0,0,1,0,0,1
TCACAGCAAACTCGAA-1_V12D07-335_A1,0,0,0,0,0,0
CAGACGAACCTGATAC-1_V12D07-335_A1,0,0,2,0,0,2
TAGCTAGAAGGCATGA-1_V12D07-335_A1,0,0,4,1,0,5
ATCCAGAGCAACAACC-1_V12D07-335_A1,1,0,0,0,0,1
TCCGGTTCGTCCGGTC-1_V12D07-335_A1,1,1,3,0,0,5
CGCGCATGTTTGATTG-1_V12D07-335_A1,0,0,0,1,0,1
TGGCGATCAAGTTATG-1_V12D07-335_A1,0,0,2,0,0,2
CCCTTTGACAGGTCTT-1_V12D07-335_A1,0,0,1,0,0,1
CAGAGACGGTCACCCA-1_V12D07-335_A1,1,0,4,0,0,5
TAGCTCGCCTGATAAC-1_V12D07-335_A1,2,1,0,1,0,4
TTGTGTTTCCCGAAAG-1_V12D07-335_A1,0,0,2,0,0,2
TATACACAGACGCCTT-1_V12D07-335_A1,0,0,1,0,0,1
ACATTAGTTTATATCC-1_V12D07-335_A1,1,0,1,0,0,2
CCATCGCAGTTAAACT-1_V12D07-335_A1,0,0,2,0,0,2
AATTAGCGCTGCAGCG-1_V12D07-335_A1,0,1,1,0,0,2
TCCGCTTATCCCATTA-1_V12D07-335_A1,0,0,1,0,0,1
GTTTGGGCTTGTGAGC-1_V12D07-335_A1,1,1,1,2,0,5
CTTGTCAACATTCGAG-1_V12D07-335_A1,0,1,0,1,0,2
GGACCAACAGGATAAC-1_V12D07-335_A1,0,0,1,0,0,1
AAGCTAGATCGAGTAA-1_V12D07-335_A1,1,0,5,0,0,6
TACCGTGCCTCGGACC-1_V12D07-335_A1,1,0,1,0,0,2
GTAGCCAAACATGGGA-1_V12D07-335_A1,0,0,1,0,0,1
TGCCAGTACGTGGAGA-1_V12D07-335_A1,0,0,3,0,0,3
ATAAGGTGGAGAACAT-1_V12D07-335_A1,0,0,0,0,0,0
CTTTAATATTGGTCGA-1_V12D07-335_A1,0,0,1,0,0,1
TGGTTCAACGGGTAAT-1_V12D07-335_A1,0,1,0,0,0,1
GCTGCTACTGCGTAGC-1_V12D07-335_A1,0,1,3,0,0,4
CTGCACAACTACATAT-1_V12D07-335_A1,0,1,2,0,0,3
ATATTCCACATAGTGA-1_V12D07-335_A1,0,0,2,0,0,2
TGGCAAACTAAATTAC-1_V12D07-335_A1,0,3,0,1,0,4
ACCGCAATAACTGCCT-1_V12D07-335_A1,0,0,1,0,0,1
TCGCACCAGGAGGCAG-1_V12D07-335_A1,0,0,2,0,0,2
ACTTCAGGCTGATCCC-1_V12D07-335_A1,1,1,0,0,0,2
ACAAATCGCACCGAAT-1_V12D07-335_A1,0,0,0,0,0,0
TCTGATGTATTCTGTC-1_V12D07-335_A1,0,0,1,0,0,1
CTTTACCGAATAGTAG-1_V12D07-335_A1,0,2,2,0,0,4
GCAGATCCATAAGACT-1_V12D07-335_A1,0,3,3,0,0,6
TTCCTCGGACTAACCA-1_V12D07-335_A1,0,1,2,0,0,3
TTATCCGGGATCTATA-1_V12D07-335_A1,0,0,3,0,0,3
CTGGAAGACACGGTGG-1_V12D07-335_A1,0,3,2,0,0,5
GTTCGTCTAAAGAACT-1_V12D07-335_A1,0,1,2,0,0,3
GTCTATTGGTTCCGGT-1_V12D07-335_A1,0,0,1,0,0,1
CTAGGCGCCCTATCAG-1_V12D07-335_A1,0,4,0,0,0,4
AACGGACGTACGTATA-1_V12D07-335_A1,1,2,1,1,0,5
AACACACGCTCGCCGC-1_V12D07-335_A1,0,6,0,0,0,6
GCTACTATAGTAGAGT-1_V12D07-335_A1,0,2,3,0,0,5
AGCATATCAATATGCT-1_V12D07-335_A1,0,1,2,0,0,3
CGAACAGTATGGGCGT-1_V12D07-335_A1,0,1,2,0,0,3
ACAATTGTGTCTCTTT-1_V12D07-335_A1,0,1,1,0,0,2
GATCGCTACCCGATTT-1_V12D07-335_A1,0,0,0,0,0,0
ATTGCGATCAGTAACT-1_V12D07-335_A1,1,1,1,0,0,3
CAGCAGTCCAGACTAT-1_V12D07-335_A1,0,3,1,0,0,4
AGAGGCTTCGGAAACC-1_V12D07-335_A1,0,0,1,0,0,1
AAACAAGTATCTCCCA-1_V12D07-335_A1,0,1,1,0,0,2
GGCAGCAAACCTATGC-1_V12D07-335_A1,0,2,0,0,0,2
ACTAGTTGCGATCGTC-1_V12D07-335_A1,0,1,0,0,0,1
TTGGACCATCTGGCAA-1_V12D07-335_A1,1,0,3,0,0,4
CCCTCCTCGCTCGTAT-1_V12D07-335_A1,0,0,1,0,0,1
GAGCGCAAATACTCCG-1_V12D07-335_A1,0,1,0,0,0,1
ATTACATGTCAGTCTT-1_V12D07-335_A1,0,1,2,0,0,3
TTGGGACGTAAGAGTT-1_V12D07-335_A1,0,1,0,0,0,1
CTTCGGCCAATTGTTT-1_V12D07-335_A1,0,3,2,0,0,5
AGACCGCTCCGCGGTT-1_V12D07-335_A1,0,0,1,0,0,1
GACCGCGTCTGACGTG-1_V12D07-335_A1,0,0,1,0,0,1
CCAAATAACAAGATTC-1_V12D07-335_A1,0,3,1,0,1,5
TCTTTAGAGTCTAACA-1_V12D07-335_A1,3,1,0,1,0,5
CTCCCAATGAGTCGCG-1_V12D07-335_A1,0,1,2,0,0,3
TAGTCTTTCCGAATTG-1_V12D07-335_A1,0,1,0,0,0,1
GAGTAAACCGGAAAGT-1_V12D07-335_A1,0,1,5,0,0,6
GATCTCGACGCTGTGG-1_V12D07-335_A1,0,1,1,0,0,2
CTGACATAGAAATAGA-1_V12D07-335_A1,0,0,4,1,0,5
TATACCGAGTGCCACA-1_V12D07-335_A1,0,1,0,0,0,1
TCCGAACGTTGCCGCT-1_V12D07-335_A1,0,0,1,0,0,1
GCAGAAGGTAATCTCC-1_V12D07-335_A1,1,1,2,0,0,4
GGTACTAAGTGCTTTG-1_V12D07-335_A1,0,1,0,1,0,2
CAGAATATTCGTTATC-1_V12D07-335_A1,0,0,1,1,0,2
TAATCAACCAAATGGG-1_V12D07-335_A1,1,0,1,0,0,2
TCTGCTTAGAACAAGC-1_V12D07-335_A1,0,2,0,1,0,3
AACTGAGTTATACTGA-1_V12D07-335_A1,1,2,1,0,0,4
CCTCAACGATCGCTGT-1_V12D07-335_A1,0,0,0,0,0,0
CGGTACGGCAAACCCA-1_V12D07-335_A1,0,0,0,0,0,0
CAGATGTTTGTCCCAA-1_V12D07-335_A1,0,0,0,0,0,0
GTTTGTTAGCCAAGTA-1_V12D07-335_A1,0,0,0,0,0,0
ACGTGACAAAGTAAGT-1_V12D07-335_A1,0,0,0,0,0,0
TTGTCACCGCGGTATC-1_V12D07-335_A1,0,0,0,0,0,0
GATCTAACCGTATTCA-1_V12D07-335_A1,1,2,0,0,0,3
ATGGAAATTTAAGGAG-1_V12D07-335_A1,0,1,0,0,0,1
ATTGATCACCACATTT-1_V12D07-335_A1,0,6,0,0,0,6
ACTGCTCGGAAGGATG-1_V12D07-335_A1,1,3,1,0,0,5
TCTAAAGAACAGTCTC-1_V12D07-335_A1,1,2,1,0,0,4
CTGGGTTGAGTTAAAG-1_V12D07-335_A1,5,5,1,0,0,11
CCCAGTAAACTTGGGA-1_V12D07-335_A1,0,2,1,0,0,3
AGATTCACAACCGATA-1_V12D07-335_A1,1,4,1,1,0,7
AGAAGGTACACTTCAC-1_V12D07-335_A1,0,0,0,0,0,0
GCAGGAACTTAGATCT-1_V12D07-335_A1,0,2,0,0,0,2
AATCTAGGTTTACTTG-1_V12D07-335_A1,0,1,1,0,0,2
CCCGGTGTATCGGAAT-1_V12D07-335_A1,0,2,1,0,0,3
TTATCCTCAAGGAATA-1_V12D07-335_A1,0,0,2,0,0,2
AGCATCATTTCGAAAG-1_V12D07-335_A1,0,0,1,0,0,1
CGCGAGTCTGCCGGGT-1_V12D07-335_A1,0,0,1,0,0,1
TGCGTCATGACTGAGC-1_V12D07-335_A1,0,0,0,0,0,0
GTATGAAATTTCACTC-1_V12D07-335_A1,0,0,5,0,0,5
TTGGTTGCGGTGCGCG-1_V12D07-335_A1,1,0,1,0,0,2
ACAGAACTGAGAACAA-1_V12D07-335_A1,2,0,1,15,0,18
CTACTATCATAGGTTT-1_V12D07-335_A1,0,0,0,12,0,12
CCTCTATCGATTAGCA-1_V12D07-335_A1,0,1,1,12,0,14
CCGTATCTCGTCGTAG-1_V12D07-335_A1,0,0,5,17,0,22
TCACGATGTCCGTGGA-1_V12D07-335_A1,1,2,1,1,0,5
TCAACAAAGATAATTC-1_V12D07-335_A1,0,0,2,2,0,4
ATGACGCGTTCTATCC-1_V12D07-335_A1,2,0,1,0,0,3
ATTTGCGCGAGTAGCT-1_V12D07-335_A1,1,3,0,0,0,4
TTCTTGGACGATCTGC-1_V12D07-335_A1,1,1,2,0,0,4
AGACGACGATGCCGCT-1_V12D07-335_A1,1,0,2,0,0,3
GGTCTCTGAATGGACT-1_V12D07-335_A1,0,1,2,0,0,3
GCTCAATCCGTTTATT-1_V12D07-335_A1,1,2,0,1,0,4
CCAGAAAGCAACTCAT-1_V12D07-335_A1,1,1,2,0,0,4
CACCGTTAGGGATCAC-1_V12D07-335_A1,0,1,2,0,0,3
AATAACACTAGAACAA-1_V12D07-335_A1,0,3,1,2,0,6
CACCCGGTTTGTGACT-1_V12D07-335_A1,1,0,4,0,0,5
CCACCAACTTTACTGT-1_V12D07-335_A1,0,0,2,0,0,2
AACTCTCAGTGTGCTC-1_V12D07-335_A1,1,0,4,0,0,5
AAACCGTTCGTCCAGG-1_V12D07-335_A1,0,1,0,0,0,1
CAGCGATTCCCTTCAA-1_V12D07-335_A1,0,1,0,0,0,1
GCTAGCTTGAATAGCT-1_V12D07-335_A1,0,0,1,0,0,1
TTGCGGCATCAGAAAG-1_V12D07-335_A1,0,0,3,0,0,3
AATAGAACAGAGTGGC-1_V12D07-335_A1,0,2,0,0,0,2
GCCATCGAGCTGCGTG-1_V12D07-335_A1,0,1,2,0,0,3
ACACTGATCAAGGTGT-1_V12D07-335_A1,0,1,1,0,0,2
ACCAACGCTTATTTAT-1_V12D07-335_A1,1,1,1,1,0,4
GACATCGATTTATAAC-1_V12D07-335_A1,0,2,0,0,0,2
CAGACACCGATCGCTG-1_V12D07-335_A1,0,2,1,0,0,3
CCAAGAAAGTGGGCGA-1_V12D07-335_A1,0,0,4,0,0,4
GGTAGACCGTTGGGCG-1_V12D07-335_A1,1,1,0,0,0,2
TCGTTAGGAGTCCCTA-1_V12D07-335_A1,0,0,1,0,0,1
ACGGCCAACATGGACT-1_V12D07-335_A1,0,0,0,1,0,1
GTGAGTGGTACAACGC-1_V12D07-335_A1,0,0,2,0,0,2
GAGACTTCGCGACCGA-1_V12D07-335_A1,0,0,2,0,0,2
GAAGTCAGTTGCACTA-1_V12D07-335_A1,0,0,0,0,0,0
GTTTGGTAGGGTCAAC-1_V12D07-335_A1,0,1,1,0,0,2
ACGGCACTTGCTTGGG-1_V12D07-335_A1,0,1,1,0,0,2
CCTCTGTACTATTCTA-1_V12D07-335_A1,0,0,1,0,0,1
CTATTCATGTGTCCCA-1_V12D07-335_A1,0,1,1,0,0,2
GCCCGATCTGTGGTCG-1_V12D07-335_A1,2,0,1,1,0,4
TTAGAAGAACATGACT-1_V12D07-335_A1,0,0,1,0,0,1
AGGATAAAGTCGGGAT-1_V12D07-335_A1,0,0,1,0,0,1
CGGCAAACATCGTGCG-1_V12D07-335_A1,0,0,2,0,0,2
CTAGTTACAACCCGGT-1_V12D07-335_A1,0,1,1,0,0,2
TTCGACAGAGCCCGTG-1_V12D07-335_A1,1,2,1,0,0,4
AAGCATACTCTCCTGA-1_V12D07-335_A1,4,1,2,0,0,7
GACGACGATCCGCGTT-1_V12D07-335_A1,0,0,0,0,0,0
GGTAGAAGACCGCCTG-1_V12D07-335_A1,0,2,5,0,0,7
GAGATGGGAGTCGACA-1_V12D07-335_A1,0,0,1,1,0,2
AACGATAATGCCGTAG-1_V12D07-335_A1,0,1,1,0,0,2
TGGTCCCACGCTACGG-1_V12D07-335_A1,0,0,1,2,0,3
CTGCTTGGCGATAGCT-1_V12D07-335_A1,0,0,1,23,0,24
ATCGGAGACAGACGGC-1_V12D07-335_A1,1,0,1,10,0,12
TAGCGTCCGGTGTGGT-1_V12D07-335_A1,0,0,4,12,0,16
GTTGAGTCCCGCCGGT-1_V12D07-335_A1,0,2,1,0,0,3
AAATAGGGTGCTATTG-1_V12D07-335_A1,0,1,1,0,0,2
AAGTGTTTGGAGACGG-1_V12D07-335_A1,0,0,1,0,0,1
AGCACTACCTCACCAG-1_V12D07-335_A1,1,0,0,1,0,2
TGCCTTGGCCAGGCAA-1_V12D07-335_A1,0,0,1,0,0,1
TCGTCTTAGGCGTTAA-1_V12D07-335_A1,1,0,1,0,0,2
TTCTGACCGGGCTCAA-1_V12D07-335_A1,0,1,2,0,1,4
CAGAACTTAGCCCTCT-1_V12D07-335_A1,1,0,0,0,0,1
AGCTCCTTCGCACATC-1_V12D07-335_A1,0,2,2,0,0,4
ACAGGCTTGCCCGACT-1_V12D07-335_A1,0,1,0,0,0,1
GCTATACGTCTCGGAC-1_V12D07-335_A1,0,1,1,0,0,2
GAGCCAGCTACCTGTG-1_V12D07-335_A1,0,2,2,0,0,4
TGCTAAGTGTCTATTT-1_V12D07-335_A1,0,2,1,0,0,3
GTCCTACGAATAGTCT-1_V12D07-335_A1,0,1,0,0,0,1
CAGTGTCGGCTGGCCC-1_V12D07-335_A1,0,1,0,0,0,1
CTATCGACGAAATACA-1_V12D07-335_A1,0,1,1,0,0,2
CATCATTACCCTGAGG-1_V12D07-335_A1,0,3,0,0,0,3
TAAGTTGCGACGTAGG-1_V12D07-335_A1,0,0,1,0,0,1
AGTGCACGCTTAAGAA-1_V12D07-335_A1,1,2,0,0,0,3
TGTGCCGGTGCCGGAA-1_V12D07-335_A1,1,0,0,0,0,1
AGGAGGCCTTCGCGCG-1_V12D07-335_A1,4,6,2,0,0,12
TCCGCGGCCCAATGAA-1_V12D07-335_A1,0,2,2,0,0,4
TCCGTTAAGCTAATAT-1_V12D07-335_A1,0,1,0,0,0,1
AAATCTAGCCCTGCTA-1_V12D07-335_A1,0,2,1,0,0,3
CGCAGGCGATCCAAAC-1_V12D07-335_A1,0,3,0,0,0,3
CCATATGGAAACTATA-1_V12D07-335_A1,0,0,2,0,0,2
CACCGTATCCCATCCG-1_V12D07-335_A1,1,2,2,0,0,5
GGTCAAGACTACTTCG-1_V12D07-335_A1,2,1,3,0,0,6
CCCGTTTCGCAGATGT-1_V12D07-335_A1,0,2,2,0,0,4
GTTATAATACGGTGAA-1_V12D07-335_A1,2,1,3,0,0,6
ACTTGTGGATGGAACG-1_V12D07-335_A1,0,3,1,0,0,4
GTTCGCTGAGACGTCT-1_V12D07-335_A1,0,2,0,0,1,3
GACACTGGAACCCGAT-1_V12D07-335_A1,0,0,0,0,0,0
CCCAGGTCTGAAGGCT-1_V12D07-335_A1,0,0,0,0,0,0
TCTCGAGGAGGTTCGC-1_V12D07-335_A1,0,0,0,0,0,0
ACTATCTGCCCGCGTA-1_V12D07-335_A1,0,1,2,0,0,3
CCTAAATTGTATCCTA-1_V12D07-335_A1,0,1,2,0,0,3
AGAAATTATGACTCGC-1_V12D07-335_A1,0,0,0,0,0,0
TCCAGCGCTATAAGCG-1_V12D07-335_A1,0,0,1,0,0,1
TCGTGTATTGGTCACG-1_V12D07-335_A1,0,0,0,0,0,0
CCACATACTGCACCCA-1_V12D07-335_A1,0,1,1,1,0,3
GTTGCGGACGGTCAGG-1_V12D07-335_A1,0,1,0,0,0,1
GTATTTAATGGCATAA-1_V12D07-335_A1,0,1,3,0,0,4
GTCGATAGGTGACTTT-1_V12D07-335_A1,1,0,2,2,0,5
AATAATCTTCGTATCG-1_V12D07-335_A1,1,1,2,0,0,4
ATTGTTCAACGATCCG-1_V12D07-335_A1,0,1,1,1,0,3
GTGCAGCGTAGAGTAG-1_V12D07-335_A1,0,0,1,2,0,3
TGTGGTAGGGTGCCTT-1_V12D07-335_A1,0,0,1,0,0,1
TGTGGACTATCTACGT-1_V12D07-335_A1,0,0,1,0,1,2
GGCGGGCTCTAAGAGT-1_V12D07-335_A1,0,2,0,0,0,2
TGTGCCAGAGGCAAAG-1_V12D07-335_A1,0,0,0,0,0,0
TGGCTTATGTATAATG-1_V12D07-335_A1,0,0,0,0,0,0
GCAAGCTGGAAACCGC-1_V12D07-335_A1,0,0,0,0,0,0
GATATCAAGCAGGAGC-1_V12D07-335_A1,0,0,0,0,0,0
CACCAATCATCCGTCT-1_V12D07-335_A1,0,0,0,0,0,0
CCACATGGCTCTTTAT-1_V12D07-335_A1,0,0,0,0,0,0
GTCCTACTCTACGGGC-1_V12D07-335_A1,2,2,0,0,0,4
CTCGAGACATACGATA-1_V12D07-335_A1,0,1,1,0,0,2
TATCAGTGGCGTAGTC-1_V12D07-335_A1,0,2,2,0,0,4
TGACAGGACAAGTCCA-1_V12D07-335_A1,0,1,0,0,0,1
TATTAACACCAAAGCA-1_V12D07-335_A1,1,6,0,0,0,7
TAGGCGATGAGGTCTC-1_V12D07-335_A1,0,3,0,0,0,3
CCGCCGGAACTTCTCG-1_V12D07-335_A1,1,2,3,0,0,6
GCCATTAGCCTCAAAC-1_V12D07-335_A1,1,4,2,0,0,7
GTTAGGCTACCCGTTT-1_V12D07-335_A1,0,1,2,0,0,3
GGGTATTCTAGCAAAC-1_V12D07-335_A1,1,4,2,0,0,7
GCCCTAGCCGTCGCGA-1_V12D07-335_A1,0,2,1,0,0,3
CAGATCCTGGTTTGAA-1_V12D07-335_A1,0,0,1,0,0,1
CTTCAGTGGTCGCCTA-1_V12D07-335_A1,0,2,2,0,0,4
GGGCAACCGCACGTGC-1_V12D07-335_A1,0,1,0,0,0,1
GACCCAATTATGATAC-1_V12D07-335_A1,0,0,1,0,0,1
GAAGCTCGGACCCGTC-1_V12D07-335_A1,0,0,2,0,0,2
CGTCGGGTCTAAGCGC-1_V12D07-335_A1,0,0,2,0,0,2
GAGGCCCGACTCCGCA-1_V12D07-335_A1,0,0,2,0,0,2
TTGCCATAGCCCGCTC-1_V12D07-335_A1,0,0,0,0,0,0
TAACATACACGCGATC-1_V12D07-335_A1,0,0,1,0,0,1
CCGACGGGCATGAGGT-1_V12D07-335_A1,0,1,0,6,0,7
AATGTGCCCGAGGTGT-1_V12D07-335_A1,0,0,2,0,0,2
AGCTGTAACCTCAATC-1_V12D07-335_A1,0,0,0,26,0,26
CGAGTGAAGGTACCAG-1_V12D07-335_A1,0,0,1,18,0,19
AGTCTCACAAGACTAC-1_V12D07-335_A1,0,0,1,2,0,3
AAATTGATAGTCCTTT-1_V12D07-335_A1,1,2,3,4,0,10
TAAGTCGCCGAGTATC-1_V12D07-335_A1,1,0,1,0,0,2
GCGGAGAAACTTCGCA-1_V12D07-335_A1,0,1,2,0,0,3
GGCAAAGGCGCCAATA-1_V12D07-335_A1,0,0,3,0,0,3
ATTTCCGGGTTCTGCG-1_V12D07-335_A1,0,1,1,0,0,2
TAAACCCAGGAGGGCA-1_V12D07-335_A1,0,0,3,0,0,3
TTCGGGCGCTAGTCTT-1_V12D07-335_A1,1,0,3,0,0,4
GTGGAGTCGGCGGTTG-1_V12D07-335_A1,0,0,2,0,0,2
GCACGCCTACTTAGAT-1_V12D07-335_A1,1,2,4,0,0,7
CAATATTCTTGACCTA-1_V12D07-335_A1,0,2,1,1,0,4
CGTTTGTGTAGAGGGT-1_V12D07-335_A1,0,0,2,0,0,2
CATAGCGTTGCCCACC-1_V12D07-335_A1,2,1,0,0,0,3
TGATACATTTAGCCGT-1_V12D07-335_A1,0,0,1,0,0,1
TTCCGGCCTTGAGGCT-1_V12D07-335_A1,0,0,1,1,0,2
CCTATACCGTCCTGTC-1_V12D07-335_A1,0,0,2,1,0,3
TCGTTGCTATCCGGTC-1_V12D07-335_A1,0,1,1,3,0,5
TGGCGACTGCTCCAAA-1_V12D07-335_A1,0,1,5,1,0,7
CAGAGGCGATGCATGA-1_V12D07-335_A1,0,1,0,1,0,2
TCACAGGAGAATAAGA-1_V12D07-335_A1,0,0,2,0,0,2
GGGTTAACATTTGAGT-1_V12D07-335_A1,0,0,2,0,0,2
GCGGGCGAGCCTTACC-1_V12D07-335_A1,0,0,0,0,0,0
TGCCAATGGGTACTCT-1_V12D07-335_A1,0,1,0,0,0,1
AGGGACTCTACGCGAC-1_V12D07-335_A1,0,1,0,0,0,1
GACGCCGTAAAGGCTA-1_V12D07-335_A1,0,0,1,0,0,1
AAAGGCTCTCGCGCCG-1_V12D07-335_A1,0,0,1,0,0,1
CTGGCTGGTTGTCAGT-1_V12D07-335_A1,0,2,2,0,0,4
ACATCCCGGCCATACG-1_V12D07-335_A1,2,1,1,0,0,4
CTCTTGTCCCGCTTGG-1_V12D07-335_A1,0,1,0,0,0,1
TACGCCTCCATTCCGA-1_V12D07-335_A1,0,2,1,1,0,4
CGGAGCAATTTAATCG-1_V12D07-335_A1,0,0,2,1,0,3
AACTAGGCTTGGGTGT-1_V12D07-335_A1,2,0,4,0,0,6
GCGTCGCCAGGGTGAT-1_V12D07-335_A1,0,1,1,0,0,2
GTTGGTCATGCTATCC-1_V12D07-335_A1,2,1,3,0,0,6
GCTGGCGGCGCATGCT-1_V12D07-335_A1,0,1,0,1,0,2
TGAGCGGAAAGTGTTC-1_V12D07-335_A1,0,0,0,1,0,1
CTTTCTGTGCGGGCTT-1_V12D07-335_A1,0,1,4,0,0,5
ATCTAATATCCTACGG-1_V12D07-335_A1,0,0,0,0,0,0
AACCTTTAAATACGGT-1_V12D07-335_A1,0,1,2,0,0,3
TTCACTCGAGCACCTA-1_V12D07-335_A1,0,0,3,0,0,3
CTGCACTCCAGTACAG-1_V12D07-335_A1,0,1,3,0,0,4
CCATTTCTACCTATTA-1_V12D07-335_A1,0,0,4,0,0,4
CAAGCGGCACATAATT-1_V12D07-335_A1,0,1,0,0,0,1
GTTAACATCACTTAAA-1_V12D07-335_A1,2,0,0,0,0,2
ATATAAATGTAGCTGC-1_V12D07-335_A1,0,1,2,0,0,3
GCCTCTATACATAGCA-1_V12D07-335_A1,2,1,1,0,0,4
GTGTCGTATAGCGTTC-1_V12D07-335_A1,0,0,2,9,0,11
ATACGTACTTAGCCAC-1_V12D07-335_A1,1,0,0,10,0,11
GCTATCATACTCATGG-1_V12D07-335_A1,0,0,0,6,0,6
TATCCAATTGGTTATC-1_V12D07-335_A1,0,1,4,8,0,13
TCTCCCTGGGCAGCGT-1_V12D07-335_A1,0,0,4,2,0,6
CCTATAATGAGTGCCC-1_V12D07-335_A1,0,0,3,0,0,3
CAATGCGAGAAGTATC-1_V12D07-335_A1,1,0,0,0,0,1
TACCAATAAAGTACCA-1_V12D07-335_A1,0,0,0,0,0,0
GCTAGGCACCACGGAG-1_V12D07-335_A1,1,0,1,0,0,2
GGTGGACTGCTCTGGC-1_V12D07-335_A1,0,0,0,0,0,0
TATTCCGAGCTGTTAT-1_V12D07-335_A1,0,1,3,0,0,4
TTGAGAAGTTTAGCAT-1_V12D07-335_A1,3,2,5,0,0,10
GTCCGGACCTGAAATT-1_V12D07-335_A1,0,1,3,0,0,4
CTGTGGTCGGGAGATA-1_V12D07-335_A1,0,0,1,0,0,1
CATGTAAGAGACATTT-1_V12D07-335_A1,0,0,1,0,0,1
CACGTTTCGTACACAC-1_V12D07-335_A1,0,1,0,0,0,1
CATCCTCTCAAAGATC-1_V12D07-335_A1,2,4,0,0,0,6
GATTAACCGAAAGCCC-1_V12D07-335_A1,1,0,1,0,0,2
AACGCTGTTGCTGAAA-1_V12D07-335_A1,2,2,1,0,0,5
TTCAGCTGGCGTGCCC-1_V12D07-335_A1,1,0,0,0,0,1
TAGAGGTTCTACTTGT-1_V12D07-335_A1,0,3,1,0,0,4
GTATCAAACGTTAGCT-1_V12D07-335_A1,0,3,0,0,0,3
AATCATGTAAAGACTC-1_V12D07-335_A1,0,1,1,0,0,2
AGTCACTAGCTCTCGA-1_V12D07-335_A1,1,2,3,0,0,6
GCGAAACGATCGGGAG-1_V12D07-335_A1,0,2,0,0,0,2
CATGGATTGTCTTCCG-1_V12D07-335_A1,1,0,0,0,0,1
ATTGGATTACAGCGTA-1_V12D07-335_A1,0,2,1,0,0,3
CACACACGCTAACGAG-1_V12D07-335_A1,0,3,0,0,0,3
CTATGGGAAGCGGAAT-1_V12D07-335_A1,1,0,0,0,0,1
TGCCTAATTGAAGATT-1_V12D07-335_A1,1,7,2,0,0,10
TGGCAATGGGACGGCG-1_V12D07-335_A1,0,1,0,0,1,2
ACCTCCGCCCTCGCTG-1_V12D07-335_A1,1,6,1,0,0,8
CGGCAATAAGATCGCC-1_V12D07-335_A1,0,0,0,0,0,0
CCTTGACCACTTTATT-1_V12D07-335_A1,2,1,0,0,0,3
TCATTTAGAAGTGTGA-1_V12D07-335_A1,0,4,0,0,0,4
CAGAATAACACACGGA-1_V12D07-335_A1,0,6,1,0,0,7
TCTGAGCAATTGACTG-1_V12D07-335_A1,0,2,3,0,0,5
CAACGTGGTGGAGTCT-1_V12D07-335_A1,0,0,1,0,1,2
CACAGTTCGCTTCCCA-1_V12D07-335_A1,0,1,0,0,0,1
TCTCTCGCCGCACATA-1_V12D07-335_A1,0,0,0,0,0,0
TGGGCAGGCCACCGCA-1_V12D07-335_A1,0,0,2,0,0,2
CTCCTGTTCAAGGCAG-1_V12D07-335_A1,0,0,1,0,0,1
TATTTGATTTGCACAG-1_V12D07-335_A1,0,0,2,0,0,2
GCCACTCCTTACGGTA-1_V12D07-335_A1,0,1,2,0,0,3
ACCGATATTTAATCAT-1_V12D07-335_A1,1,0,0,0,0,1
TTATTATCTGGAAGGC-1_V12D07-335_A1,0,2,4,0,2,8
TACATGCCGGAATTGT-1_V12D07-335_A1,1,0,1,1,0,3
GGCACTCAGCCGACCC-1_V12D07-335_A1,0,0,2,1,0,3
AAACCGGAAATGTTAA-1_V12D07-335_A1,1,0,0,0,0,1
AGACAGGCATCTCAGC-1_V12D07-335_A1,0,0,0,0,0,0
GTGGTGATGGTTTGTG-1_V12D07-335_A1,4,0,0,0,0,4
CCGATATGACGTAAGG-1_V12D07-335_A1,0,1,0,1,0,2
CATACACAAAGTCAGC-1_V12D07-335_A1,0,0,0,0,0,0
TGCCGTTCTTAATCGG-1_V12D07-335_A1,0,0,0,0,0,0
TCGAGTCTACGATTCG-1_V12D07-335_A1,0,0,0,0,0,0
ACTTCCAGTGGAAGCT-1_V12D07-335_A1,0,0,0,0,0,0
CAATTGGGCCGCACTC-1_V12D07-335_A1,0,0,0,0,0,0
AAATCGCGGAAGGAGT-1_V12D07-335_A1,0,0,0,0,0,0
ATATCAATTCCAGCCT-1_V12D07-335_A1,0,7,1,0,0,8
CTTTGTCGAATGCTCC-1_V12D07-335_A1,0,1,1,0,0,2
TGAGGCATGTACTGTG-1_V12D07-335_A1,2,2,1,0,0,5
TTCGCCGCTCGCGCTA-1_V12D07-335_A1,3,5,1,0,0,9
GACTCCTTCCAATTGA-1_V12D07-335_A1,1,4,0,0,0,5
ACCGAAGAGTCTGGTT-1_V12D07-335_A1,0,2,1,0,0,3
TGGCATGAAGTTTGGG-1_V12D07-335_A1,3,4,1,0,0,8
ACGAGGTTTACAACGT-1_V12D07-335_A1,2,0,4,0,0,6
AACCCATCCCATGATC-1_V12D07-335_A1,0,3,1,0,0,4
TCGACAACTGAACCCG-1_V12D07-335_A1,0,3,0,0,0,3
TATCTTGCAATACAAC-1_V12D07-335_A1,1,3,1,0,0,5
TATTATGTTTGCCTGC-1_V12D07-335_A1,0,5,3,0,0,8
GTCAAAGAAGTGGTGT-1_V12D07-335_A1,0,4,0,0,0,4
GGGACAGAGTTACTCC-1_V12D07-335_A1,0,3,1,0,0,4
AGCAACCGAAAGTAAT-1_V12D07-335_A1,0,0,0,0,0,0
CTCTCTAACTGCCTAG-1_V12D07-335_A1,2,3,0,0,0,5
ATACGGAACGTCGTTT-1_V12D07-335_A1,0,1,1,0,0,2
TCGGTCCCGACAATAG-1_V12D07-335_A1,1,1,2,0,0,4
CGCGCAAATGTCCAGA-1_V12D07-335_A1,0,0,2,0,0,2
TCTAATACTGCCTCAG-1_V12D07-335_A1,0,2,2,0,0,4
CTCGGTTGTCGGCCCT-1_V12D07-335_A1,0,0,3,0,0,3
GGTAACCGGGAGGATA-1_V12D07-335_A1,0,1,5,0,0,6
CAGGCGCACGGTGGTC-1_V12D07-335_A1,1,1,0,1,0,3
TCATCGATGGTCCCAA-1_V12D07-335_A1,0,0,1,0,0,1
CAAAGATTATTGGGCC-1_V12D07-335_A1,0,0,2,7,0,9
ACAATGAATACGGAGA-1_V12D07-335_A1,0,1,2,2,0,5
GCTCCTGACATACTGG-1_V12D07-335_A1,0,0,2,11,0,13
GATGACAAGTAGGGCA-1_V12D07-335_A1,0,0,0,18,0,18
TACGCCGAGGGTACCC-1_V12D07-335_A1,0,3,0,2,0,5
AAGCGTCCCTCATCGA-1_V12D07-335_A1,1,0,0,3,0,4
CACTCCTATGTAAGAT-1_V12D07-335_A1,0,0,5,1,0,6
TCGAGCCAGGCAGGCC-1_V12D07-335_A1,1,0,1,1,0,3
TCGTCAAGTACGCGCA-1_V12D07-335_A1,0,0,1,0,0,1
CCCGTAGCTGGGAAGA-1_V12D07-335_A1,1,0,3,1,0,5
ACCCTATGCCATATCG-1_V12D07-335_A1,1,0,1,0,0,2
GTGGTATAGTCTGCCG-1_V12D07-335_A1,0,0,2,0,0,2
CCGGTTTGTAATTGTG-1_V12D07-335_A1,0,1,0,0,0,1
GTCGCCGTTGTGTGTT-1_V12D07-335_A1,0,0,8,0,0,8
TACTGAACAGATTTAG-1_V12D07-335_A1,0,1,0,0,0,1
TATTAACCTGACCGCG-1_V12D07-335_A1,0,2,1,1,0,4
CTGTAGCCATCTCACT-1_V12D07-335_A1,0,0,3,0,0,3
TACTATGGTTCCTCAG-1_V12D07-335_A1,1,4,6,0,0,11
GAGTCAGACCAGAATC-1_V12D07-335_A1,0,0,1,1,0,2
TAAGGCATAACATCAA-1_V12D07-335_A1,0,0,1,1,0,2
CTTCCGCTCCGTGAAG-1_V12D07-335_A1,0,1,1,0,0,2
GGGCTATGATCGATGG-1_V12D07-335_A1,0,1,2,0,0,3
GGTCGGTCGTCCACAG-1_V12D07-335_A1,0,1,0,1,0,2
GGGACCCGTATATCTT-1_V12D07-335_A1,0,1,1,0,0,2
GAAAGCAGTGCACTTT-1_V12D07-335_A1,0,3,0,0,0,3
AGCGCATAATGAATCG-1_V12D07-335_A1,1,4,0,0,0,5
GCTGCTAAGTAGTCGA-1_V12D07-335_A1,2,0,3,0,0,5
AATAGTCCGTCCCGAC-1_V12D07-335_A1,0,2,2,1,0,5
AGCAGCCAGATGAATA-1_V12D07-335_A1,0,2,2,0,0,4
CCTCGCGCTGTGCGAT-1_V12D07-335_A1,0,0,0,0,0,0
TTGTGTATGCCACCAA-1_V12D07-335_A1,1,0,0,0,0,1
TGCTCGGCGAAACCCA-1_V12D07-335_A1,0,0,0,0,0,0
CGATTAAATATCTCCT-1_V12D07-335_A1,0,2,1,0,0,3
TGCCGTGGATCGTCCT-1_V12D07-335_A1,0,0,3,0,0,3
GTGGACGCATTTGTCC-1_V12D07-335_A1,0,1,3,2,0,6
ACCCGGAAACTCCCAG-1_V12D07-335_A1,0,1,2,0,0,3
CCGCATGTGGTACGAT-1_V12D07-335_A1,0,0,2,0,0,2
GCAAACCTTGGCCATA-1_V12D07-335_A1,0,0,2,0,0,2
ATTCACTGATGTTGGA-1_V12D07-335_A1,0,1,3,0,0,4
ACTCCCTAATGCTAAA-1_V12D07-335_A1,0,1,0,0,0,1
TCCTAAATTGGGAAGC-1_V12D07-335_A1,0,0,0,1,0,1
GAACAGATTACTAAAT-1_V12D07-335_A1,0,1,0,1,0,2
ATACAGGCCCTCCAAT-1_V12D07-335_A1,0,1,5,0,0,6
CGATTCGCCTGGCTGC-1_V12D07-335_A1,0,2,2,0,0,4
TCCGCCTGTCTACAAG-1_V12D07-335_A1,1,0,2,0,0,3
CACATCTCACCGACGA-1_V12D07-335_A1,1,2,1,2,0,6
CGTCGTCCTTCGCGAA-1_V12D07-335_A1,1,0,3,2,0,6
CGTTGAATACCGCGCT-1_V12D07-335_A1,0,0,1,23,0,24
ACCAATATGCAAGTTA-1_V12D07-335_A1,0,1,0,20,0,21
ACGGATGGTGCGGATA-1_V12D07-335_A1,0,0,4,3,0,7
CACCCTAACAAGATCT-1_V12D07-335_A1,0,0,1,0,0,1
AAGCTCTTTCATGGTG-1_V12D07-335_A1,0,0,4,0,0,4
CATGGGTATGCCTTAT-1_V12D07-335_A1,0,1,1,0,0,2
GCGCGTCATTGGTACA-1_V12D07-335_A1,0,0,0,0,0,0
TCTGAAGCACGTGGTC-1_V12D07-335_A1,0,1,0,0,0,1
AAGTTCACTCCAAGCT-1_V12D07-335_A1,0,1,2,0,0,3
TTGGACCTATAACAGT-1_V12D07-335_A1,0,0,2,0,0,2
ATCAGCCTCATGCTGC-1_V12D07-335_A1,0,1,2,0,0,3
AGTACTCTTATGCCCA-1_V12D07-335_A1,0,1,3,0,0,4
GCGCTTAAATAATTGG-1_V12D07-335_A1,1,1,1,0,0,3
TTGTGAACCTAATCCG-1_V12D07-335_A1,0,4,2,0,0,6
AGTCGTCGACCACCAA-1_V12D07-335_A1,0,4,1,0,0,5
TCCTTTAAATCCGCTT-1_V12D07-335_A1,1,2,3,0,0,6
ACTGAAACGCCGTTAG-1_V12D07-335_A1,1,0,4,0,0,5
GCACACACTGGTAGCC-1_V12D07-335_A1,3,7,1,0,0,11
TAAGGGCCTGTCCGAT-1_V12D07-335_A1,0,2,1,0,0,3
GCTAGAGTAGAGATGT-1_V12D07-335_A1,0,1,1,0,0,2
CACAGGGCCATATAGT-1_V12D07-335_A1,0,0,2,0,0,2
CCATGCCCTAGATTTC-1_V12D07-335_A1,1,2,1,0,0,4
TCGCGTAGCAGTGTCC-1_V12D07-335_A1,0,2,4,0,0,6
GACGAGGCTAATAAAC-1_V12D07-335_A1,0,1,2,0,0,3
CTACACTCGCAGATGG-1_V12D07-335_A1,0,4,0,0,0,4
ACGCATACGTTTACTA-1_V12D07-335_A1,0,4,2,1,0,7
GGAGCAACATTTCAAG-1_V12D07-335_A1,3,3,0,0,0,6
CGAGAGGGTAGCCGCG-1_V12D07-335_A1,1,0,1,0,0,2
TCGTGTTCGACCACAA-1_V12D07-335_A1,0,1,0,0,0,1
TCTACCCAATAGAGAG-1_V12D07-335_A1,0,1,2,0,0,3
ATAAACGTTGCACCAC-1_V12D07-335_A1,0,1,2,0,0,3
TCAACTGCAGAGTCAG-1_V12D07-335_A1,1,2,0,0,0,3
AGCTCCATATATGTTC-1_V12D07-335_A1,0,2,0,0,0,2
GTAACATCTAAGATAA-1_V12D07-335_A1,0,4,1,0,0,5
CCGACAATAGGCCGCC-1_V12D07-335_A1,0,0,1,0,0,1
ATGCTTAGGAGTTGAT-1_V12D07-335_A1,0,1,2,0,0,3
AACCCGAGCAGAATCG-1_V12D07-335_A1,0,3,1,0,0,4
CGGGTTTGTTAGGGCT-1_V12D07-335_A1,0,2,2,0,0,4
AGGCACGTGACTGTCC-1_V12D07-335_A1,0,3,0,0,0,3
GACAAGAGATGAGATT-1_V12D07-335_A1,0,0,0,0,0,0
AGCCCTTGGACATCCC-1_V12D07-335_A1,0,1,0,0,0,1
GCAGTTCGATCCGAGC-1_V12D07-335_A1,0,0,1,0,0,1
TCGAGGGCAACAGACG-1_V12D07-335_A1,0,0,1,0,1,2
ACTTTGTCGACGCACT-1_V12D07-335_A1,0,0,1,0,0,1
GAGTATCAAAGTTACA-1_V12D07-335_A1,0,0,0,0,0,0
CCAGGCTGGCGTCTGA-1_V12D07-335_A1,0,0,1,0,0,1
GGACTCTTCCGGTTGA-1_V12D07-335_A1,0,0,2,0,1,3
TCCCAGCACACGACAT-1_V12D07-335_A1,0,0,3,0,1,4
GCTCCATGAGTGCAGA-1_V12D07-335_A1,0,0,3,0,2,5
GCAGTGCGGGCGGATG-1_V12D07-335_A1,1,0,0,0,0,1
GCGTTCTGACTAAGCG-1_V12D07-335_A1,0,0,1,0,0,1
ATTTGGAGATTGCGGT-1_V12D07-335_A1,0,0,0,0,0,0
AAGGGTTTGATTTCAG-1_V12D07-335_A1,0,0,0,0,0,0
CCGGCCGCGAGCATAT-1_V12D07-335_A1,0,0,0,0,0,0
GAGTTCTGTGGGTGCT-1_V12D07-335_A1,0,0,0,0,0,0
AAACGAAGATGGAGTA-1_V12D07-335_A1,0,0,0,0,0,0
AATTACGAGACCCATC-1_V12D07-335_A1,1,4,1,1,0,7
CCTTTGAATTATGGCT-1_V12D07-335_A1,1,5,0,0,0,6
CATGGTATTAGTTTGT-1_V12D07-335_A1,0,8,1,0,0,9
AACGAAAGTCGTCCCA-1_V12D07-335_A1,1,3,0,0,0,4
ACATAAGTCGTGGTGA-1_V12D07-335_A1,0,3,1,0,0,4
GCACAACCTCGGGCGT-1_V12D07-335_A1,1,4,0,0,0,5
ATGCACGCGCTGTTCA-1_V12D07-335_A1,1,3,0,0,0,4
CGATGTTGTTATCTAC-1_V12D07-335_A1,0,1,1,0,0,2
GTCTCCTGCCAGTATG-1_V12D07-335_A1,0,0,0,0,0,0
GATGCCTTCTGCGGCA-1_V12D07-335_A1,2,4,2,0,0,8
ACCGGTCAGGTACACC-1_V12D07-335_A1,0,0,1,2,0,3
GTGGAGCGTTTACCGA-1_V12D07-335_A1,1,1,0,0,0,2
AGGCGGTTTGTCCCGC-1_V12D07-335_A1,1,0,3,4,0,8
TCCCTGGCGTATTAAC-1_V12D07-335_A1,1,1,1,0,0,3
AAACACCAATAACTGC-1_V12D07-335_A1,3,3,0,1,0,7
TGGACGCAATCCAGCC-1_V12D07-335_A1,0,2,0,0,0,2
GGAACCTTGACTCTGC-1_V12D07-335_A1,1,4,0,0,0,5
GTATCTCAGTCTTGAC-1_V12D07-335_A1,0,2,0,0,0,2
GCTGAATCTTCCAATC-1_V12D07-335_A1,0,1,0,0,0,1
AGATGCAAGACGTGCA-1_V12D07-335_A1,1,0,3,0,0,4
TTAAGGCCCGTACTTT-1_V12D07-335_A1,0,2,2,0,0,4
AGTATGCTGGAGACCA-1_V12D07-335_A1,0,0,1,0,0,1
GCGGCAAAGTATTGCC-1_V12D07-335_A1,0,1,1,0,0,2
GCGCAAATATATTCAA-1_V12D07-335_A1,0,1,1,0,0,2
GAAGAAACGATATTGT-1_V12D07-335_A1,0,0,1,0,0,1
GGACCTCTAGGCCGCC-1_V12D07-335_A1,0,0,0,0,0,0
AACAGCTGTGTGGCAA-1_V12D07-335_A1,0,0,3,0,0,3
TCGAATATCCCGCAGG-1_V12D07-335_A1,0,0,0,0,0,0
GCGACCCAACCATCTG-1_V12D07-335_A1,0,0,4,0,0,4
AGAGAAGGAGTACAAT-1_V12D07-335_A1,2,0,4,5,0,11
GGCTCCTCCACCTGTT-1_V12D07-335_A1,0,0,0,1,0,1
TCAGTGTATACGTCAT-1_V12D07-335_A1,1,1,2,9,0,13
ATTATTATGTCCGTCA-1_V12D07-335_A1,0,0,0,20,0,20
TTAGGTCATAACCGAC-1_V12D07-335_A1,0,2,1,1,0,4
AAGATGGCACCGGACC-1_V12D07-335_A1,0,0,3,3,0,6
CTACAAGAAATAACCC-1_V12D07-335_A1,0,1,1,0,0,2
ACTATTTCCGGGCCCA-1_V12D07-335_A1,0,1,1,0,0,2
TTGTTTCACATCCAGG-1_V12D07-335_A1,0,0,3,1,0,4
CGCTGTGTGGATGTTG-1_V12D07-335_A1,0,1,1,1,0,3
TCAACATAGCGCCCTA-1_V12D07-335_A1,0,2,2,0,0,4
GGCCGTTTGGGTTTCA-1_V12D07-335_A1,0,0,1,0,0,1
TACTCTTTCGTCTTCA-1_V12D07-335_A1,0,0,4,0,0,4
TTCGCGCGCCATACGA-1_V12D07-335_A1,0,1,2,0,0,3
CGGAAAGAATCAAACG-1_V12D07-335_A1,0,0,1,0,0,1
AGGCAGGGAGCGTACT-1_V12D07-335_A1,1,0,2,0,0,3
CCTTTAAGGGAGCACT-1_V12D07-335_A1,0,1,2,1,0,4
CGCCCAGCACGCCTAG-1_V12D07-335_A1,1,0,0,0,0,1
AGTATTTGGCACGACC-1_V12D07-335_A1,0,0,2,1,0,3
TATCCGCACCGTCGGG-1_V12D07-335_A1,0,0,2,0,0,2
ACCCGTGTCATCAGTA-1_V12D07-335_A1,0,0,1,0,0,1
CAACTGCTCATCCGAT-1_V12D07-335_A1,0,0,1,0,0,1
CCGGAGCGTACTTTCT-1_V12D07-335_A1,0,1,0,1,0,2
TACCGTAGGTTAACTA-1_V12D07-335_A1,0,0,2,1,0,3
TGAGGAGTGCCAGCTT-1_V12D07-335_A1,0,2,2,0,0,4
CCAGTCTTGTCATAGA-1_V12D07-335_A1,0,0,1,0,0,1
GGGCAGAGCAATCGTT-1_V12D07-335_A1,0,0,1,0,0,1
TACCAAATAGCCCAGA-1_V12D07-335_A1,0,0,0,1,0,1
TACCTACTCCCAGTAT-1_V12D07-335_A1,0,0,1,0,0,1
TGTGAGACTAGCCCAA-1_V12D07-335_A1,1,1,0,0,0,2
ATACCTAACCAAGAAA-1_V12D07-335_A1,0,1,1,0,0,2
GTCGGGAAGCAGAAAC-1_V12D07-335_A1,0,1,2,0,0,3
AATTAACGGATTTCCA-1_V12D07-335_A1,1,0,1,0,0,2
GAACCCTCTGTGTTCT-1_V12D07-335_A1,0,0,2,0,0,2
ATATAAAGCGCTCGTG-1_V12D07-335_A1,0,0,1,0,0,1
CCTGGTCGAATGTGGG-1_V12D07-335_A1,0,1,2,3,0,6
CTAGGTTCGGACGTGA-1_V12D07-335_A1,0,0,1,0,0,1
TCGGGAGACAGCGTAC-1_V12D07-335_A1,0,0,5,1,0,6
CATAAGAAGCTTGGCT-1_V12D07-335_A1,1,0,2,2,0,5
AAGCACCCTGCGTATC-1_V12D07-335_A1,0,0,1,0,0,1
AGTTTGCACCTGCCTC-1_V12D07-335_A1,0,0,3,0,0,3
GACTGCAAATCGAGCT-1_V12D07-335_A1,0,0,7,3,0,10
GTGTATATCAGCGGGC-1_V12D07-335_A1,0,0,2,14,0,16
CTTCAACTCCACTTGG-1_V12D07-335_A1,0,0,0,18,0,18
ACTTACGCATCCACGC-1_V12D07-335_A1,0,0,1,13,0,14
CATGAGATGCACTCTC-1_V12D07-335_A1,0,0,0,0,0,0
GAGCACCTGTGTCCAG-1_V12D07-335_A1,1,1,4,0,0,6
CGCGACCGCGACAGAT-1_V12D07-335_A1,0,1,1,0,0,2
GTCCCGCGACGTTATG-1_V12D07-335_A1,0,0,1,0,0,1
GCAGTGTGGCTATAGG-1_V12D07-335_A1,0,0,1,0,0,1
ATACTGCCTTACACCG-1_V12D07-335_A1,1,1,1,0,0,3
TACAGAAACGGTGGGC-1_V12D07-335_A1,0,0,0,0,0,0
GGCGCGGAGATCTTTC-1_V12D07-335_A1,0,0,2,0,0,2
CGTTAATGTCCCGACG-1_V12D07-335_A1,1,0,1,0,0,2
GCTAACTGAAGTCTGA-1_V12D07-335_A1,0,2,2,1,0,5
AGTGATAACCTGCGCG-1_V12D07-335_A1,1,0,1,0,0,2
TATGATCTTCTCTTTA-1_V12D07-335_A1,2,3,2,0,0,7
TGTACCTACACGAGGG-1_V12D07-335_A1,1,2,1,0,0,4
ATATCGTTCCTCGAAC-1_V12D07-335_A1,0,2,1,0,0,3
CGGCGCCATCAATCCC-1_V12D07-335_A1,1,4,2,0,0,7
CCTGTTTGAAGACACG-1_V12D07-335_A1,0,1,0,0,0,1
GCCACTCAGAGCGCGA-1_V12D07-335_A1,1,2,1,0,0,4
TCGGCTTGTATCGACG-1_V12D07-335_A1,0,7,2,0,0,9
TAGATGGTTCCTTACT-1_V12D07-335_A1,0,1,1,0,0,2
ATCGTTAGCTAGCGGA-1_V12D07-335_A1,1,4,2,0,0,7
ACAGCGACATTCTCAT-1_V12D07-335_A1,0,0,1,0,0,1
ATTCAACCATTTAAGG-1_V12D07-335_A1,1,4,1,0,0,6
CACTCTTCTGCTAGCC-1_V12D07-335_A1,0,1,1,0,0,2
CTAACTGATAATCGCC-1_V12D07-335_A1,1,1,2,0,0,4
TGATGTCAATTAAGTG-1_V12D07-335_A1,0,1,1,0,0,2
CGCCGTTCAGCATAGT-1_V12D07-335_A1,0,0,1,0,0,1
ATACTACCCGTACCAC-1_V12D07-335_A1,0,3,0,0,0,3
CCACTGTTTGGATTAA-1_V12D07-335_A1,0,2,2,0,0,4
CACTACGGGAGCTGCC-1_V12D07-335_A1,0,7,0,0,0,7
GACCAAACGTTGACTG-1_V12D07-335_A1,0,4,2,0,0,6
AAGAGGCCCTTTGGAA-1_V12D07-335_A1,0,2,0,0,0,2
ACACGTAGGCCACAAG-1_V12D07-335_A1,0,3,0,0,0,3
TACTCTTACTTTACTG-1_V12D07-335_A1,2,7,0,0,0,9
AGAGCCGCCGAGATTT-1_V12D07-335_A1,0,0,2,0,0,2
GGCCTGCTTCTCCCGA-1_V12D07-335_A1,0,0,1,0,0,1
TCAAGCGCGGACGGTA-1_V12D07-335_A1,0,2,0,0,0,2
ACACTGGGACAGTCGT-1_V12D07-335_A1,0,2,1,0,0,3
TGTGTAGTAGCACGTG-1_V12D07-335_A1,0,3,0,0,0,3
CTAGCCACAGGCGAGC-1_V12D07-335_A1,0,0,1,0,0,1
CTATCGCGTAGAGAAC-1_V12D07-335_A1,0,3,0,0,0,3
GTTCCCGTAAACATAT-1_V12D07-335_A1,0,1,1,0,0,2
TCTTTCCTTCGAGATA-1_V12D07-335_A1,0,0,0,0,0,0
ATATTGGAGAGGCCTT-1_V12D07-335_A1,1,0,1,0,0,2
AGGCGATAACTGGCGT-1_V12D07-335_A1,0,0,1,0,0,1
ACCCGGAGCACCACAA-1_V12D07-335_A1,0,1,0,0,0,1
TGAGCTCAACTGTATA-1_V12D07-335_A1,1,0,1,0,2,4
ACGACCCATGAGTTGC-1_V12D07-335_A1,0,0,5,2,1,8
CGGTCAGTCCATATTT-1_V12D07-335_A1,0,0,0,0,3,3
TCCGGCTGTCGGGTCG-1_V12D07-335_A1,0,0,0,0,1,1
ATTCCCGAAGGTACAG-1_V12D07-335_A1,0,0,0,0,0,0
CTAACAGCACAATAAC-1_V12D07-335_A1,0,0,0,0,0,0
TTGTGCGGAAGCGGAT-1_V12D07-335_A1,0,0,0,0,0,0
GGGCACTATTGACCAT-1_V12D07-335_A1,0,0,0,0,0,0
CCATAGAGGCTGCCAG-1_V12D07-335_A1,0,0,0,0,0,0
CCGAAGCATTGACCAA-1_V12D07-335_A1,0,1,1,1,0,3
TACTGAGGGAAGAAAG-1_V12D07-335_A1,1,4,1,0,0,6
TATGTAGAAACCCGGC-1_V12D07-335_A1,1,2,0,0,0,3
TGGTTAACTTACATTT-1_V12D07-335_A1,0,3,1,0,0,4
AGAACCCTCAATTGGG-1_V12D07-335_A1,1,3,2,0,0,6
CCTATATCGTGTCACG-1_V12D07-335_A1,0,3,1,0,0,4
ACGGCTGGATGTAGAA-1_V12D07-335_A1,0,4,0,0,0,4
CTCGCATTGCATAGCC-1_V12D07-335_A1,0,4,1,0,0,5
ACTTTGGTCGTGCTCC-1_V12D07-335_A1,2,2,1,0,0,5
GCTGGTTTAGGCCATA-1_V12D07-335_A1,0,0,1,11,0,12
TGTCGTTATCACATAT-1_V12D07-335_A1,0,0,0,0,0,0
ACACATGATCAAATCT-1_V12D07-335_A1,0,0,0,0,0,0
TATCCATCTCGGTTAG-1_V12D07-335_A1,0,0,0,0,0,0
CTCGTCGAGGGCTCAT-1_V12D07-335_A1,2,0,0,7,0,9
ATCAATGCCGTGGCTG-1_V12D07-335_A1,0,0,2,3,0,5
GAAACATAGGAAACAG-1_V12D07-335_A1,1,2,1,0,0,4
TAATAGGTCACCAGAA-1_V12D07-335_A1,1,4,4,0,0,9
CACCAGTCAGCATGCA-1_V12D07-335_A1,1,6,1,0,0,8
GAGCGCTGTTAGGTAA-1_V12D07-335_A1,0,4,2,0,0,6
CCCTATGTAGAGCAGA-1_V12D07-335_A1,2,5,1,0,0,8
GATCGCTATATCTCAG-1_V12D07-335_A1,1,0,1,0,0,2
AAGGGACTATGCATTC-1_V12D07-335_A1,0,1,2,0,0,3
CTCGGGTTCTCTGGCC-1_V12D07-335_A1,0,2,1,0,0,3
TATATATCGAGAAATG-1_V12D07-335_A1,0,2,0,0,0,2
ACCCGAGCGAAATTAC-1_V12D07-335_A1,1,2,1,0,0,4
TTGTTTCATTAGTCTA-1_V12D07-335_A1,0,0,1,0,0,1
ATGGGACCTGCTGAAC-1_V12D07-335_A1,0,2,2,0,0,4
TGCGACGGCCGAACGT-1_V12D07-335_A1,0,0,0,0,0,0
AGCTAACAAGCAATGT-1_V12D07-335_A1,0,0,1,0,0,1
CGTGTCTCGTTACGAC-1_V12D07-335_A1,1,1,1,0,0,3
CTAAATCCGGTGTACA-1_V12D07-335_A1,1,2,4,0,0,7
GAATAGTGCTCGATTA-1_V12D07-335_A1,0,1,0,0,0,1
AACAATACATTGTCGA-1_V12D07-335_A1,0,2,0,0,0,2
CACATCGTGCACGCGC-1_V12D07-335_A1,0,0,2,9,0,11
ACCGTGACCACGTGGG-1_V12D07-335_A1,0,0,3,1,0,4
CCCAATGAGATTTGCA-1_V12D07-335_A1,1,0,0,14,0,15
TCAGCAGTAGGCCCTG-1_V12D07-335_A1,0,0,3,13,0,16
CTACTCAAGGTATAGT-1_V12D07-335_A1,0,0,5,0,0,5
TAGTAGCTTATACCAG-1_V12D07-335_A1,0,2,3,11,0,16
ACGTTCGTTCAGGAAA-1_V12D07-335_A1,0,1,2,0,0,3
TTAGAATAAGGGTCGG-1_V12D07-335_A1,0,2,3,1,0,6
TTCTAGAAAGTCTTAT-1_V12D07-335_A1,0,0,1,0,0,1
CCTTCAGTTAAAGTGA-1_V12D07-335_A1,0,1,3,1,0,5
TAGCTAGTGATGATGG-1_V12D07-335_A1,0,0,0,1,1,2
AGCCCGGTAGCCTGTA-1_V12D07-335_A1,0,0,3,0,0,3
TACCTCAGTTGTCTGT-1_V12D07-335_A1,0,0,3,0,0,3
GACGGGTTGGCCCGTA-1_V12D07-335_A1,0,2,3,0,0,5
GAAACCTATACAAATG-1_V12D07-335_A1,1,0,2,0,0,3
TCCACCTCTAGCCTTT-1_V12D07-335_A1,1,0,1,0,0,2
AAGACCCAACTGAACA-1_V12D07-335_A1,0,0,1,0,0,1
CATACACGGTTCCCAC-1_V12D07-335_A1,0,0,1,0,0,1
ACTACGCGTTAGAATT-1_V12D07-335_A1,0,2,0,1,0,3
CTTGGCCAAGCTGGGA-1_V12D07-335_A1,0,0,2,0,0,2
TTACCCTAGGGATTGG-1_V12D07-335_A1,0,0,1,1,0,2
TTCGCACTGTACGACA-1_V12D07-335_A1,0,3,2,0,0,5
TAGGTGTTCCACAGAT-1_V12D07-335_A1,0,0,1,1,0,2
GAAGCCTGCACATTCC-1_V12D07-335_A1,0,0,4,0,0,4
GGCTTTCAATAAGGGT-1_V12D07-335_A1,0,0,0,0,0,0
TCCAGGGTATATACGA-1_V12D07-335_A1,0,0,3,0,0,3
CTCGCCGAATGTAGGG-1_V12D07-335_A1,0,1,0,0,0,1
AGGAAGCTGTCCGCCG-1_V12D07-335_A1,0,0,1,0,0,1
GTCTCAAGGCCCGGCT-1_V12D07-335_A1,0,1,1,1,0,3
ACCGACACATCTCCCA-1_V12D07-335_A1,0,0,1,0,0,1
TATACGCGTCATCACT-1_V12D07-335_A1,0,1,1,2,0,4
ATCTGGGCTGTTCTTG-1_V12D07-335_A1,0,0,2,1,0,3
TCAAATTTGAGACTCA-1_V12D07-335_A1,1,0,1,0,0,2
GTTAAGGGTGCGATGT-1_V12D07-335_A1,0,0,2,0,0,2
AGCAAAGGCCGCTAGT-1_V12D07-335_A1,1,1,3,0,0,5
TTATAGGTAATTGTCT-1_V12D07-335_A1,0,1,1,1,0,3
TTGTGCAGCCACGTCA-1_V12D07-335_A1,5,0,2,0,0,7
ACGGACTCTCAAAGCG-1_V12D07-335_A1,0,0,0,20,0,20
ATGCTCTGGCGCGGTA-1_V12D07-335_A1,0,0,0,18,0,18
ATAATCTTGGAGAACC-1_V12D07-335_A1,0,1,1,4,0,6
CTCATTGCTCTAACAA-1_V12D07-335_A1,0,0,2,6,0,8
TAGGTGACGATAACCT-1_V12D07-335_A1,0,1,0,0,0,1
CGGATCCTCAAGGACT-1_V12D07-335_A1,0,0,0,0,0,0
GGGCGTGGTTTCCCAG-1_V12D07-335_A1,0,0,0,1,0,1
TGGCTATGTGACATAC-1_V12D07-335_A1,0,0,1,0,0,1
CTTAGTGTAGTAGCAT-1_V12D07-335_A1,0,0,1,0,0,1
GGATTGCTGTGACTCC-1_V12D07-335_A1,0,0,1,0,0,1
ACTTCCATGCGGGACA-1_V12D07-335_A1,0,0,0,1,0,1
ACTCAAGTGCAAGGCT-1_V12D07-335_A1,0,4,2,0,0,6
ACAAGGATGCTTTAGG-1_V12D07-335_A1,0,0,3,0,0,3
TTGAACGACGTGCTGA-1_V12D07-335_A1,0,0,1,0,0,1
ATTCATCGTTGAGGCA-1_V12D07-335_A1,0,1,1,0,0,2
TGCAACCCATCTGCGG-1_V12D07-335_A1,1,0,3,0,0,4
AGTGCTAAACACAGCA-1_V12D07-335_A1,0,3,2,0,0,5
AACTCCAGAGCGTGTT-1_V12D07-335_A1,2,2,2,0,0,6
TCTCCACAAGTTGAAT-1_V12D07-335_A1,1,1,5,0,0,7
CTTTGCATCGCTCTTG-1_V12D07-335_A1,0,0,0,0,0,0
TCACAAACCGAGGTAC-1_V12D07-335_A1,1,4,0,0,0,5
CCGTAGGAAATCCCTG-1_V12D07-335_A1,0,2,0,0,0,2
AAACATTTCCCGGATT-1_V12D07-335_A1,1,3,1,0,0,5
GCCTCCGACAATTCAC-1_V12D07-335_A1,1,2,1,0,0,4
TCTGCATACCTTGCTT-1_V12D07-335_A1,3,4,0,0,0,7
ACCCATTTGTCCCTCT-1_V12D07-335_A1,0,5,1,0,0,6
CTGCAGAGAATCAGAG-1_V12D07-335_A1,0,5,1,0,0,6
GGAAACTAAATGGGCC-1_V12D07-335_A1,0,1,1,0,0,2
CAACCTACCGAGCAGT-1_V12D07-335_A1,1,1,2,0,0,4
CCGTAGGGTTGTTTAC-1_V12D07-335_A1,2,2,1,0,1,6
GGTTTGTGACCTGAGG-1_V12D07-335_A1,0,0,0,0,0,0
TAACCTAGGGAGTCCA-1_V12D07-335_A1,0,1,1,0,0,2
TTCCATCGACAGCGTG-1_V12D07-335_A1,0,4,0,0,0,4
ATCTCCCACGGAATAT-1_V12D07-335_A1,0,1,2,0,0,3
GTTTCAAACGAGTTGT-1_V12D07-335_A1,0,2,1,0,0,3
GGAACTTTGGCGATTA-1_V12D07-335_A1,0,1,0,0,0,1
CTGCAAGCACGTTCCG-1_V12D07-335_A1,0,3,0,0,0,3
CACAGTCCCGCTTCGC-1_V12D07-335_A1,0,1,2,0,0,3
TACGCTCGGTATTGGA-1_V12D07-335_A1,0,4,1,0,0,5
CTGGTAAAGTGTGGGC-1_V12D07-335_A1,0,1,1,0,0,2
CAACCAGTGGCCTACC-1_V12D07-335_A1,2,1,4,0,0,7
TCTTCGCGGTGAGAGG-1_V12D07-335_A1,0,0,1,0,0,1
TTCGGGTTGCCACGGG-1_V12D07-335_A1,0,1,1,0,0,2
ACCGATAGGCATAACC-1_V12D07-335_A1,0,0,1,0,0,1
CTTATAGATGGCTGTT-1_V12D07-335_A1,0,0,0,0,0,0
AGACGCCCACTTCGCC-1_V12D07-335_A1,0,2,1,0,0,3
AGGTCGCCTCCCAACA-1_V12D07-335_A1,0,2,0,0,0,2
CCTCACGTCAGCTAAT-1_V12D07-335_A1,0,0,0,0,0,0
CCACCTGTATGGAATA-1_V12D07-335_A1,0,1,1,0,0,2
GGACTCGAAGCTTTCA-1_V12D07-335_A1,0,0,0,0,1,1
AAGCCGGAGAGCAGGA-1_V12D07-335_A1,0,0,2,0,0,2
GCCTATCAGGTAAGAT-1_V12D07-335_A1,0,0,0,0,1,1
TCAGAGTGTGAGCATG-1_V12D07-335_A1,0,2,1,0,0,3
AAACATGGTGAGAGGA-1_V12D07-335_A1,0,0,0,0,0,0
ATCATTGTACCGCATT-1_V12D07-335_A1,0,0,0,0,0,0
TCAGCTTGAGCTTTCG-1_V12D07-335_A1,0,0,0,0,0,0
CCGCGCAAGATACCCA-1_V12D07-335_A1,0,0,0,0,0,0
CTATACTTAAAGCGAG-1_V12D07-335_A1,0,0,0,0,0,0
ACCGTCCACTGGGCCC-1_V12D07-335_A1,2,2,0,0,0,4
AAGACCAAATAACTCA-1_V12D07-335_A1,1,5,0,0,0,6
TGTTTCTGAAGCGTGC-1_V12D07-335_A1,1,5,0,0,0,6
TTCTCTTACAGGTGAT-1_V12D07-335_A1,0,4,2,0,0,6
AATTCATTGTCATGCA-1_V12D07-335_A1,1,4,0,0,0,5
GCCCGAGAGTCTAAAT-1_V12D07-335_A1,2,8,0,0,0,10
ATATAGAGTATTGGTC-1_V12D07-335_A1,0,5,2,0,0,7
TTGAAGGATGGGCGCC-1_V12D07-335_A1,1,0,3,0,0,4
TAGTACCACAACTTTC-1_V12D07-335_A1,1,3,2,0,0,6
ATCCCATCCACAGCGC-1_V12D07-335_A1,1,2,3,1,0,7
CTTAGGTATAGACCAG-1_V12D07-335_A1,0,2,2,0,0,4
TGACTCCGAATCATAC-1_V12D07-335_A1,0,0,0,3,0,3
ACTACATCCCGACAAG-1_V12D07-335_A1,0,0,3,2,0,5
TTGCCGCAGACCTACA-1_V12D07-335_A1,1,0,1,7,0,9
TAAGAGGGACAGGGAC-1_V12D07-335_A1,0,0,2,0,0,2
CGAATGAAGTCATTGC-1_V12D07-335_A1,2,1,0,0,0,3
AAGGGAACGACTGGCT-1_V12D07-335_A1,0,3,5,0,0,8
CGAATCTGCTCGACGC-1_V12D07-335_A1,1,7,1,0,0,9
ATCGTGGAAAGTCTGG-1_V12D07-335_A1,0,1,2,0,0,3
CCTATGGCTCCTAGTG-1_V12D07-335_A1,0,3,1,0,0,4
CGTCGCTTGGTTATAC-1_V12D07-335_A1,0,2,0,0,0,2
TGCTTAGAGAGAATGC-1_V12D07-335_A1,0,3,0,0,0,3
GATTGCTCCAGTTGCA-1_V12D07-335_A1,0,1,0,0,0,1
CGTGCTTCTACCTAAA-1_V12D07-335_A1,0,4,3,0,0,7
ACTCCAATATCATCAT-1_V12D07-335_A1,0,5,0,0,0,5
GCCGACCCACGACTGC-1_V12D07-335_A1,0,2,2,0,0,4
GAGGGTAGTAACAAAG-1_V12D07-335_A1,0,1,3,0,0,4
GGCCGAGACTCTGGTG-1_V12D07-335_A1,0,2,1,0,0,3
TATATAGGGCTTTACG-1_V12D07-335_A1,0,0,0,0,0,0
TGCCGGATGTACGAGC-1_V12D07-335_A1,0,0,0,0,0,0
AGGTAGATCGAGATAT-1_V12D07-335_A1,0,0,3,0,0,3
GATCAACATAAAGGGA-1_V12D07-335_A1,1,0,2,0,0,3
TAACAGCGTTTGTGCT-1_V12D07-335_A1,0,1,1,0,0,2
CTATAGGCGTTGATGT-1_V12D07-335_A1,0,1,2,0,0,3
GGTTTAATTACCATCG-1_V12D07-335_A1,0,0,0,0,0,0
CTCTTCTGGAAGTTAG-1_V12D07-335_A1,0,0,0,0,0,0
ATCTGACATGGAAGGA-1_V12D07-335_A1,0,1,2,0,0,3
TACGTACTAGTGCTGA-1_V12D07-335_A1,0,0,2,1,0,3
ATGACTATCAGCTGTG-1_V12D07-335_A1,0,1,1,0,0,2
CTTTGGGATTGTTGCA-1_V12D07-335_A1,0,0,1,15,0,16
AGACTGTTACCGGGTC-1_V12D07-335_A1,0,1,1,6,0,8
TCCTAACCGTCGGGCA-1_V12D07-335_A1,0,0,4,1,0,5
ACGCAAACTAATAGAT-1_V12D07-335_A1,0,0,1,13,0,14
AAGTGAGTCGGGTTTA-1_V12D07-335_A1,0,1,2,0,0,3
TAAAGCGGTATTTCCA-1_V12D07-335_A1,0,1,5,0,0,6
CTCCTCCAGCTCACAC-1_V12D07-335_A1,0,0,2,0,0,2
CGGTCCGTCGCAAGCC-1_V12D07-335_A1,0,1,2,0,0,3
CCTATATTTGTCCTGG-1_V12D07-335_A1,0,0,2,0,0,2
TCCAATAAAGGCTACC-1_V12D07-335_A1,1,0,3,0,0,4
AAAGGCTACGGACCAT-1_V12D07-335_A1,0,0,2,0,0,2
CGTGACCAGTCCTCTG-1_V12D07-335_A1,0,0,2,0,0,2
GATCTGCTATCTAAGG-1_V12D07-335_A1,0,0,0,0,0,0
CGAATGACGCATAATG-1_V12D07-335_A1,1,0,3,1,0,5
GCTCAATGTAATACCG-1_V12D07-335_A1,0,1,5,0,0,6
CTATGCCCGAATGCAA-1_V12D07-335_A1,0,0,3,0,0,3
CACAGGGCCGTTGTCA-1_V12D07-335_A1,0,0,1,0,0,1
TCAATACGCCGTCATG-1_V12D07-335_A1,0,0,2,0,0,2
AGCGGACACTTCGTAG-1_V12D07-335_A1,0,1,3,0,0,4
ATACGTTATGCACGGA-1_V12D07-335_A1,0,1,1,0,0,2
GAGTAGATACTAGTTG-1_V12D07-335_A1,0,1,0,0,0,1
CCAGCTCGAACGCATT-1_V12D07-335_A1,0,0,2,0,0,2
TGCTTCCCAAGCAGTA-1_V12D07-335_A1,1,0,1,0,0,2
GTAGACACGCCTGACT-1_V12D07-335_A1,1,0,2,1,0,4
CTCACATTTACTAAAT-1_V12D07-335_A1,0,1,0,0,0,1
GAATGCGAATCGGTTC-1_V12D07-335_A1,0,1,2,0,0,3
TAAGGCCCGTCACCCT-1_V12D07-335_A1,1,1,0,0,0,2
GAGTATGCGCGTGCAT-1_V12D07-335_A1,0,0,2,0,0,2
ATCCACATCGACAGAA-1_V12D07-335_A1,1,0,2,3,0,6
TAGACGAAACGCCAAT-1_V12D07-335_A1,0,2,3,7,0,12
CAGCAGTCTGTGCTGC-1_V12D07-335_A1,1,1,1,13,0,16
CTCACTGTGATACTTA-1_V12D07-335_A1,0,1,0,8,0,9
TTAATTGCTTTGGGTG-1_V12D07-335_A1,0,1,1,5,0,7
GTAGTCTACGATATTG-1_V12D07-335_A1,1,0,4,0,0,5
TTGCCGCTTTCTAGTA-1_V12D07-335_A1,1,0,4,0,0,5
GAACCTTTAACGATCC-1_V12D07-335_A1,1,1,0,0,0,2
TGGACCAATCTAAGAT-1_V12D07-335_A1,0,0,0,0,0,0
CTAGTAGAAAGGGATT-1_V12D07-335_A1,0,0,2,0,0,2
AACCTCGCTTTAGCCC-1_V12D07-335_A1,0,0,2,0,0,2
GAGTGTCAACCAGAAA-1_V12D07-335_A1,0,0,1,0,0,1
GTGATCCTTGTCATGA-1_V12D07-335_A1,0,0,3,0,0,3
CTCAACTAACCCGGAT-1_V12D07-335_A1,0,0,1,0,0,1
AGTGGCGTCTGAAGGT-1_V12D07-335_A1,0,2,4,0,0,6
GGGAAGGGCTTTCTCA-1_V12D07-335_A1,0,1,5,0,0,6
AGGCCTGAGAATCTCG-1_V12D07-335_A1,0,0,1,0,0,1
AGCCACAGGTTACCCG-1_V12D07-335_A1,1,0,1,0,0,2
TGCAATCTAACACGGT-1_V12D07-335_A1,0,3,1,1,0,5
GTTTGGGTTTCGCCCG-1_V12D07-335_A1,0,6,1,0,0,7
CCTATGTCCACTCCAC-1_V12D07-335_A1,1,4,1,0,0,6
CTGCCTTTCTAGTAAA-1_V12D07-335_A1,0,3,1,0,0,4
TTAGTAAACCTGCTCT-1_V12D07-335_A1,1,3,0,0,0,4
TTGTGGTGGTACTAAG-1_V12D07-335_A1,1,6,1,0,0,8
CCTCCTGTTGTGTCGT-1_V12D07-335_A1,1,0,3,0,0,4
ACAAAGCATGACCTAG-1_V12D07-335_A1,0,2,0,0,0,2
ATAGCAACTAGGGAAG-1_V12D07-335_A1,0,1,0,0,0,1
CCGCTCTTCCGAACTA-1_V12D07-335_A1,1,5,2,0,0,8
TAGAATAGCCGATGAA-1_V12D07-335_A1,0,2,5,0,0,7
GGTCTCCGTCCAGGTT-1_V12D07-335_A1,0,2,2,0,0,4
TAATTACGTCAGTAGA-1_V12D07-335_A1,0,2,2,0,0,4
TACGTAAAGCGGAGTG-1_V12D07-335_A1,0,1,1,0,0,2
GCTACAATCGAGGATA-1_V12D07-335_A1,0,3,0,0,0,3
TCAGCCAATCCGTAAA-1_V12D07-335_A1,0,1,1,0,0,2
ATCATAGCCCTATGTA-1_V12D07-335_A1,0,5,1,0,0,6
GAGGCCTGTTGATACA-1_V12D07-335_A1,0,3,2,0,0,5
ATATACGCTCGTGACG-1_V12D07-335_A1,0,2,1,0,0,3
CCCTTTAATGGAGTTC-1_V12D07-335_A1,0,1,2,0,0,3
TTACACGATCTGCGAC-1_V12D07-335_A1,0,8,1,0,0,9
TCGCATAAAGGGCGCA-1_V12D07-335_A1,0,1,0,0,0,1
TGTAGCCATCCCATTC-1_V12D07-335_A1,0,0,1,0,0,1
GGGTCTATCGCTTTCC-1_V12D07-335_A1,0,5,5,0,0,10
GGAGGGTCAAGTAAGA-1_V12D07-335_A1,0,2,1,0,0,3
TACGGCATGGACGCTA-1_V12D07-335_A1,0,2,1,0,0,3
CACGTCAATCAATGGA-1_V12D07-335_A1,0,3,0,0,0,3
CGCTTGGACGGATAGA-1_V12D07-335_A1,0,3,2,0,0,5
CGCGGTACGGTATACA-1_V12D07-335_A1,0,7,0,0,0,7
CCTACTCAACACGATT-1_V12D07-335_A1,0,1,2,0,0,3
CGTTTGGTGTTGTGGG-1_V12D07-335_A1,0,0,2,0,0,2
GTTGTTGCAAGATGGC-1_V12D07-335_A1,0,5,2,0,0,7
CATTCGTCGTAGCGGT-1_V12D07-335_A1,0,0,1,0,0,1
CAGCCTCGATAGCGGT-1_V12D07-335_A1,0,0,0,0,0,0
TCATAAGTCCAAGAAG-1_V12D07-335_A1,0,1,2,0,1,4
AAAGTGCCATCAATTA-1_V12D07-335_A1,0,1,0,0,0,1
GTTGCAGTCGACAACA-1_V12D07-335_A1,3,0,2,0,1,6
TAAATGGGCTACTGAG-1_V12D07-335_A1,0,0,2,0,0,2
GGACAAGCCATGATCG-1_V12D07-335_A1,0,0,0,0,0,0
TCCAATGCGTCGCCGC-1_V12D07-335_A1,0,0,0,0,0,0
AAAGAATGACCTTAGA-1_V12D07-335_A1,0,0,0,0,0,0
CCTATTATTCCGGCCG-1_V12D07-335_A1,0,0,0,0,0,0
CAGTAAGGGACGTCTC-1_V12D07-335_A1,1,0,0,0,0,1
GGGATGGACCCGCGTC-1_V12D07-335_A1,1,8,0,0,0,9
GACGCATACCCGTCGG-1_V12D07-335_A1,0,2,1,0,0,3
GGGCAGGATTTCTGTG-1_V12D07-335_A1,0,0,0,0,0,0
TATCTGAGCCGATATT-1_V12D07-335_A1,0,4,2,0,0,6
AATGTATGGCACTGTA-1_V12D07-335_A1,0,4,2,0,0,6
GCCTTTGTCAGTGGAC-1_V12D07-335_A1,1,1,2,0,0,4
AACCATAGGGTTGAAC-1_V12D07-335_A1,0,2,2,0,0,4
AAACTTAATTGCACGC-1_V12D07-335_A1,1,5,4,0,0,10
TAGGCGGCTGCAAAGA-1_V12D07-335_A1,2,2,0,0,0,4
TCCATCAATACTAATC-1_V12D07-335_A1,0,2,2,0,0,4
ACCTCGAACTTATGCT-1_V12D07-335_A1,0,5,2,1,0,8
ACAAACCATGCGTCCT-1_V12D07-335_A1,0,1,3,0,0,4
ACACCGGTCTGACCGC-1_V12D07-335_A1,0,0,4,0,0,4
ATGGCAGCATTACGAT-1_V12D07-335_A1,1,2,3,0,0,6
CTGGTGAATGGGCCTA-1_V12D07-335_A1,0,1,3,0,0,4
CACAGAGACGAGGACG-1_V12D07-335_A1,0,0,2,0,0,2
GCACAAACCCTAGATG-1_V12D07-335_A1,1,1,7,0,0,9
ACTATGTCCAGCTGCC-1_V12D07-335_A1,1,3,3,0,0,7
AAGCCGCCGTGAAATC-1_V12D07-335_A1,0,4,2,0,0,6
ATGGGTGTATACCTCC-1_V12D07-335_A1,0,3,1,0,0,4
TAAGCGCGAATCAAAT-1_V12D07-335_A1,0,3,2,0,0,5
AGCCCGGCATTAGAGG-1_V12D07-335_A1,0,7,1,0,0,8
GTGATCAAGCGTGCAC-1_V12D07-335_A1,0,1,1,0,0,2
CTGCCTTTAATACCTT-1_V12D07-335_A1,0,5,1,0,0,6
TACCTCCACACCAATG-1_V12D07-335_A1,1,0,2,0,0,3
GAGCATCAACAACTTG-1_V12D07-335_A1,0,4,2,0,0,6
CATACGAACTAGCTGG-1_V12D07-335_A1,0,0,0,0,0,0
GGGAACGGTTTCAGAT-1_V12D07-335_A1,0,0,0,0,0,0
AGGGTGCCGTTCTTTA-1_V12D07-335_A1,0,0,2,0,0,2
ACGACTGGTCATACTC-1_V12D07-335_A1,0,1,1,0,0,2
GGATCTTACTGCCCTT-1_V12D07-335_A1,0,1,2,0,0,3
TACTCCTCTAGTTGAC-1_V12D07-335_A1,0,0,2,0,0,2
GTAGCTCCGGGAGGCT-1_V12D07-335_A1,0,0,1,0,0,1
GGACTCGTGAGTGGTC-1_V12D07-335_A1,0,0,2,0,0,2
GTAGTTCGAAGGCGAA-1_V12D07-335_A1,0,0,0,0,0,0
CTCAAACCACTGCCCG-1_V12D07-335_A1,0,0,0,0,0,0
GAGGGAGTCAGATCGC-1_V12D07-335_A1,0,0,2,0,0,2
GCGTCCCTAAGACATA-1_V12D07-335_A1,0,1,4,0,0,5
TCTCTTACCGCGAACC-1_V12D07-335_A1,1,0,2,0,0,3
GGCTACTATACACTCC-1_V12D07-335_A1,0,0,0,0,0,0
CGTTGCCCGCGTGGGA-1_V12D07-335_A1,0,0,1,0,0,1
TATAGAGTCGCTTGAA-1_V12D07-335_A1,0,0,3,2,0,5
ATGTTGTAGTCTGTTT-1_V12D07-335_A1,0,0,1,0,0,1
AGTATACACAGCGACA-1_V12D07-335_A1,0,0,3,17,0,20
TGTGGTTGCTAAAGCT-1_V12D07-335_A1,0,1,1,5,0,7
TGATTCCCGGTTACCT-1_V12D07-335_A1,0,1,3,4,0,8
CACTGACGATTGTGGA-1_V12D07-335_A1,0,0,0,13,0,13
AACATTGTGACTCGAG-1_V12D07-335_A1,0,1,1,0,0,2
GTCCAATATTTAGCCT-1_V12D07-335_A1,2,0,2,3,0,7
GCTCTTTCCGCTAGTG-1_V12D07-335_A1,0,0,1,0,0,1
GGGTCAGGAGCTAGAT-1_V12D07-335_A1,0,1,3,0,0,4
AGGTGGTGACCTTCGC-1_V12D07-335_A1,0,0,4,0,0,4
CCCGGGTCGTTCAGGG-1_V12D07-335_A1,0,0,5,0,0,5
AGCCAAGCTTTGTGTC-1_V12D07-335_A1,0,0,3,0,0,3
TGTGGCGGGCTTCTGG-1_V12D07-335_A1,0,2,1,0,0,3
CGAGGGTATCCAGGTG-1_V12D07-335_A1,0,0,1,0,0,1
CGTTCAGACCCGCGAA-1_V12D07-335_A1,0,1,1,0,0,2
TCATATGAGCTTTGTT-1_V12D07-335_A1,0,1,1,0,0,2
AGTTGACGGTCCTTGC-1_V12D07-335_A1,0,0,1,0,0,1
ATAATTAGCTAAGTAG-1_V12D07-335_A1,0,1,3,0,0,4
GGTCTTGAGCGCTCTT-1_V12D07-335_A1,0,0,2,0,0,2
CGTTGTCGGCAATTGA-1_V12D07-335_A1,1,1,1,0,0,3
TCTTGCTCCCGATACT-1_V12D07-335_A1,0,1,0,1,0,2
AGCAGAAGGAGAAAGA-1_V12D07-335_A1,0,4,1,1,0,6
GAAGCCACTGATTATG-1_V12D07-335_A1,0,0,1,0,0,1
TGCTCTTGAGAGTTTG-1_V12D07-335_A1,0,0,1,1,0,2
GACATCCGTCGAACTG-1_V12D07-335_A1,3,3,4,2,0,12
AGATATAATACGACTA-1_V12D07-335_A1,0,1,1,4,0,6
TCGCTACTGGCTTTGA-1_V12D07-335_A1,1,0,1,12,0,14
GTGACAGCTTCCCACT-1_V12D07-335_A1,0,0,2,14,0,16
GTGACGCAGGTTTCAT-1_V12D07-335_A1,0,0,1,1,0,2
GGGAAGACGGTCTGTC-1_V12D07-335_A1,0,0,1,0,0,1
CGTCGCATGTGAGCCA-1_V12D07-335_A1,1,0,3,0,0,4
AGAAGGTTGTAGGTCG-1_V12D07-335_A1,0,0,0,0,0,0
GGCCGGCGTCTGCTAT-1_V12D07-335_A1,0,0,0,0,0,0
TTGACCAGGAACAACT-1_V12D07-335_A1,0,0,1,0,0,1
AGTCGTATAAAGCAGA-1_V12D07-335_A1,0,0,3,0,0,3
GGCGTAGGGAAAGCTG-1_V12D07-335_A1,0,0,2,0,0,2
AAACCTAAGCAGCCGG-1_V12D07-335_A1,0,2,1,0,0,3
ATTGCCTTTATGTTTG-1_V12D07-335_A1,0,1,0,1,0,2
CAGGCAGTCTTACCAG-1_V12D07-335_A1,0,1,3,0,0,4
AGCTAAGTACGCAGGC-1_V12D07-335_A1,0,1,1,0,0,2
AAATCCGATACACGCC-1_V12D07-335_A1,0,0,2,0,0,2
CGAGAGCTTTCACTAC-1_V12D07-335_A1,0,3,1,0,0,4
CGCCCAGCGTTTCACG-1_V12D07-335_A1,0,2,2,1,0,5
TTAAGTATTGTTATCC-1_V12D07-335_A1,0,0,3,0,0,3
AAACGGGCGTACGGGT-1_V12D07-335_A1,0,2,1,0,0,3
GTATCCTTTGGTAACC-1_V12D07-335_A1,0,1,0,0,0,1
CATAGTCAAATACATA-1_V12D07-335_A1,0,1,5,1,0,7
TCTATGCTATAACGAC-1_V12D07-335_A1,3,3,0,1,0,7
ACGTTCTGTACAAGTC-1_V12D07-335_A1,0,4,3,0,0,7
CGCGAAGTGGCATACT-1_V12D07-335_A1,1,3,2,0,0,6
ACCAACCGCACTCCAC-1_V12D07-335_A1,0,3,0,0,0,3
GTCATGCGCGAGGGCT-1_V12D07-335_A1,0,2,4,0,0,6
TAGGCTAAAGTGGCAC-1_V12D07-335_A1,0,3,3,0,0,6
TGGCTACACTCTACCT-1_V12D07-335_A1,0,2,1,0,0,3
TGTCCACGGCTCAACT-1_V12D07-335_A1,0,1,0,0,0,1
AATTGCAGCAATCGAC-1_V12D07-335_A1,2,0,2,0,0,4
GTCAACCAGGCCTATA-1_V12D07-335_A1,0,0,2,0,0,2
ATCTTATCGCACACCC-1_V12D07-335_A1,0,3,3,0,0,6
GTCTATTGCATGCTCG-1_V12D07-335_A1,0,0,1,0,0,1
GCACGTGGTTTACTTA-1_V12D07-335_A1,0,4,1,0,0,5
ATTCGCGCCTTGAGAG-1_V12D07-335_A1,0,1,4,0,0,5
AGCGATGCGCCTAATA-1_V12D07-335_A1,0,1,2,0,0,3
TCTATAGGTGGGTAAT-1_V12D07-335_A1,0,0,0,0,0,0
AGATACCAATAGAACC-1_V12D07-335_A1,0,4,1,0,0,5
CGTGTATGGGAGCTGA-1_V12D07-335_A1,1,1,0,0,0,2
ATGTACATGCGGTGAG-1_V12D07-335_A1,0,6,0,0,0,6
TTGGCTCAATATGTGT-1_V12D07-335_A1,0,4,0,0,0,4
GTTCGGAGCACTCAAC-1_V12D07-335_A1,0,4,0,0,0,4
TCCCTCTTCTCAAGGG-1_V12D07-335_A1,0,2,2,0,0,4
TTACGTATCTATGACA-1_V12D07-335_A1,0,1,0,0,1,2
CCCATATAGGTCGATT-1_V12D07-335_A1,0,0,0,0,0,0
GTCCACGTCGCATTCG-1_V12D07-335_A1,0,1,4,0,0,5
AATTGTGGTTGCCAAA-1_V12D07-335_A1,1,3,3,0,0,7
AGGAACGAACGACTTC-1_V12D07-335_A1,0,0,0,0,0,0
TAATTCCAATGCTTCA-1_V12D07-335_A1,0,0,0,0,0,0
AGGGCCCTAATGTTCT-1_V12D07-335_A1,0,0,5,0,0,5
AGGTGTTGCCGACCAC-1_V12D07-335_A1,0,1,0,0,0,1
CTGAGAGTAGAAATAC-1_V12D07-335_A1,0,2,4,0,0,6
TAGAAGAAGGGTTACA-1_V12D07-335_A1,0,2,3,0,0,5
GGTGACTGATAGAGAG-1_V12D07-335_A1,0,0,3,1,0,4
TACCCTCGGTAACCCT-1_V12D07-335_A1,0,0,1,0,2,3
TGTAAGACTGATAAGA-1_V12D07-335_A1,0,0,0,0,0,0
GTCACTCATGAGCGAT-1_V12D07-335_A1,0,0,0,0,0,0
CGGTTTACTGAACATT-1_V12D07-335_A1,0,0,0,0,0,0
GAGATCGATCTTACTC-1_V12D07-335_A1,0,0,0,0,0,0
TCTTTCATCCGTCCTT-1_V12D07-335_A1,0,4,1,0,0,5
TCGGATCTGGATGACC-1_V12D07-335_A1,0,7,2,0,0,9
GTCCTAGGATACCTTA-1_V12D07-335_A1,2,2,1,0,0,5
TGTACCCGACCCTAAT-1_V12D07-335_A1,4,2,0,0,0,6
AGGTTCTCCTTTCCGG-1_V12D07-335_A1,0,7,3,0,0,10
AATTGCGTGGATTACA-1_V12D07-335_A1,6,2,3,0,0,11
CGATAGCGATACAGTG-1_V12D07-335_A1,3,4,0,0,0,7
CGCCCTAATTGTTCAA-1_V12D07-335_A1,0,4,0,0,0,4
ATTATGAGACCCAATT-1_V12D07-335_A1,0,3,1,0,0,4
CCTCCTAGCTAGAGTC-1_V12D07-335_A1,1,6,1,0,0,8
CGAAGGGTTTCAGATT-1_V12D07-335_A1,8,5,0,0,0,13
CACAAGCTAAGAAAGG-1_V12D07-335_A1,0,5,2,0,0,7
CACCGGTAGAGACATT-1_V12D07-335_A1,2,3,1,0,0,6
ACTCATGGCAGCCTTC-1_V12D07-335_A1,1,9,1,0,0,11
CATCCAATATAGTTTG-1_V12D07-335_A1,0,0,3,0,0,3
CAGATATGAAGATGAC-1_V12D07-335_A1,0,1,0,0,0,1
GCAAAGGGCGTTAGCC-1_V12D07-335_A1,1,3,2,0,0,6
CTGTTGTTCAGTCGTA-1_V12D07-335_A1,1,0,3,0,0,4
AAAGGCCCTATAATAC-1_V12D07-335_A1,0,5,8,0,0,13
AACATTGAAGTTGATC-1_V12D07-335_A1,0,1,4,0,0,5
GCTAGCGATAGGTCTT-1_V12D07-335_A1,1,1,2,0,0,4
ATTGCCTATTAGACCG-1_V12D07-335_A1,0,3,3,0,0,6
GGGCGTTTACATTCAT-1_V12D07-335_A1,0,4,1,0,0,5
CCTCTACAAGGATTGG-1_V12D07-335_A1,1,1,1,0,0,3
AGTGACTGTGACACAA-1_V12D07-335_A1,0,1,1,0,0,2
AGCCCTCCCTGGTGGC-1_V12D07-335_A1,0,3,0,0,0,3
CGGTTGAGTATCCTTC-1_V12D07-335_A1,0,1,1,0,0,2
CATTATCCCATTAACG-1_V12D07-335_A1,0,0,1,0,0,1
AATGTGCTAATCTGAG-1_V12D07-335_A1,0,0,2,0,0,2
CTTAGTTGAGGAATCG-1_V12D07-335_A1,1,4,5,0,0,10
CTTCTGGGCGTACCTA-1_V12D07-335_A1,0,1,1,0,0,2
AGTCAAATGATGTGAT-1_V12D07-335_A1,0,2,1,0,0,3
TGAACAAGCAGGGACT-1_V12D07-335_A1,0,0,0,0,0,0
AATACCGGAGGGCTGT-1_V12D07-335_A1,0,0,1,0,0,1
GTTTGGTGATCGGTGC-1_V12D07-335_A1,1,0,2,0,0,3
GACTGCTGGTGAGAAA-1_V12D07-335_A1,0,1,0,0,0,1
CGATCCTCGCAACATA-1_V12D07-335_A1,0,0,0,0,0,0
CCAACCTTATGTAACT-1_V12D07-335_A1,0,0,0,0,0,0
CGTGGTACCCAAAGGC-1_V12D07-335_A1,1,1,2,0,0,4
AACCCGACAACCCGTG-1_V12D07-335_A1,0,1,3,0,0,4
TATGTAAAGTGCTTAA-1_V12D07-335_A1,0,0,1,0,0,1
GCAAGTGTAAAGCATG-1_V12D07-335_A1,0,1,6,0,0,7
GTAACTGCCCAAGGAG-1_V12D07-335_A1,0,0,3,0,0,3
GGTGCATAAATGATTA-1_V12D07-335_A1,0,1,0,0,0,1
TAGTCCCGGAGACCAC-1_V12D07-335_A1,0,0,1,0,0,1
CGGCCAGAGCGACCAT-1_V12D07-335_A1,0,0,1,0,0,1
TGAATGAGTGTTTCCC-1_V12D07-335_A1,0,0,0,0,0,0
TTCACTTCCTAGAACG-1_V12D07-335_A1,0,0,1,2,0,3
CGCTTAGTATTGATAC-1_V12D07-335_A1,0,0,2,18,0,20
AACGCGACCTTGGGCG-1_V12D07-335_A1,1,1,3,13,0,18
GTGCACCAGCTTCAAC-1_V12D07-335_A1,0,0,2,14,0,16
TTCTATTAAACGCAGC-1_V12D07-335_A1,0,0,2,12,0,14
TGGCAAGCACAAGTCG-1_V12D07-335_A1,0,0,1,2,0,3
ATCTGCTGTTATCGCC-1_V12D07-335_A1,0,0,3,7,0,10
AATTCCAAGCATGTAC-1_V12D07-335_A1,3,0,0,1,0,4
AAACGGTTGCGAACTG-1_V12D07-335_A1,0,2,4,2,0,8
GAAGGAGTCGAGTGCG-1_V12D07-335_A1,0,0,3,1,0,4
GGCAAGCCCATAGTGG-1_V12D07-335_A1,0,1,1,0,0,2
TGACCAAATCTTAAAC-1_V12D07-335_A1,0,2,1,0,0,3
TTCGGTACTGTAGAGG-1_V12D07-335_A1,0,0,4,0,0,4
ATGTACGATGACGTCG-1_V12D07-335_A1,1,1,0,0,0,2
ATCTAGCTTGTGAGGG-1_V12D07-335_A1,0,1,4,0,0,5
AGCGGGTCTGACACTC-1_V12D07-335_A1,0,0,3,0,0,3
GAGGTACGCGTGTCCC-1_V12D07-335_A1,1,1,2,1,0,5
GCACTGCCTACCTTTA-1_V12D07-335_A1,0,2,0,0,0,2
GGAGCGAGGCCTACTT-1_V12D07-335_A1,0,1,1,1,0,3
AAACTCGGTTCGCAAT-1_V12D07-335_A1,1,1,5,0,0,7
GGCGCTTCATTCCCTG-1_V12D07-335_A1,1,0,4,1,0,6
TGCTCGGTGGGTCACC-1_V12D07-335_A1,0,0,1,8,0,9
AAGCGCAGGGCTTTGA-1_V12D07-335_A1,0,0,2,13,0,15
GACCTTCCACGTCTAC-1_V12D07-335_A1,0,0,2,18,0,20
GTTAGCCCATGACATC-1_V12D07-335_A1,0,1,0,3,0,4
AATTCGATTCGAGGAT-1_V12D07-335_A1,0,1,4,0,0,5
AGTCTTTAAAGTGTCC-1_V12D07-335_A1,0,0,2,0,0,2
GACTAGGCCGTTAGGT-1_V12D07-335_A1,0,0,2,0,0,2
TCCAAGCCTAGACACA-1_V12D07-335_A1,0,0,0,0,0,0
GATTGGGAAAGGTTGT-1_V12D07-335_A1,0,0,0,0,0,0
GATGAGGAACCTTCGG-1_V12D07-335_A1,0,0,1,0,0,1
TGAATACCGACGCGTA-1_V12D07-335_A1,0,2,1,0,0,3
AATCGTGAGCCGAGCA-1_V12D07-335_A1,0,1,0,0,0,1
GCGAAGAATCTGACGG-1_V12D07-335_A1,0,2,0,0,0,2
GAACAACTGGGATGAA-1_V12D07-335_A1,0,1,5,0,1,7
TCGCCGACATATTCGC-1_V12D07-335_A1,0,1,2,0,0,3
CGTAGAGAGTAATTAT-1_V12D07-335_A1,0,0,5,0,0,5
CGATAGTCGTACTGCA-1_V12D07-335_A1,0,1,2,0,0,3
CGCATGCCGAATGCGT-1_V12D07-335_A1,1,3,3,1,0,8
CTCTAGCCCTCGGAAA-1_V12D07-335_A1,0,4,3,0,1,8
TCCAACTCAGCTATCT-1_V12D07-335_A1,1,2,0,0,0,3
GTCTAGTGAGCCGCTT-1_V12D07-335_A1,0,2,1,0,0,3
TACCGAATAATTGTAA-1_V12D07-335_A1,0,1,1,0,0,2
ATATAACACGGGCGCA-1_V12D07-335_A1,0,3,2,1,0,6
GCATGCTAATAACGAT-1_V12D07-335_A1,1,4,0,0,0,5
TCCGGGCTTGACGGGA-1_V12D07-335_A1,2,2,2,0,0,6
ATTATTCAGAGTCACT-1_V12D07-335_A1,0,3,2,0,1,6
TAGCAGTATGACTAAA-1_V12D07-335_A1,0,2,0,0,0,2
TATGAAGAATTAAGGT-1_V12D07-335_A1,1,3,2,0,0,6
CAAGGCCAGTGGTGCA-1_V12D07-335_A1,0,2,0,0,0,2
TGCGTACGGCTAATTG-1_V12D07-335_A1,0,1,2,0,0,3
CAGATAATGGGCGGGT-1_V12D07-335_A1,0,1,4,0,0,5
GAGAACGGTTCTGACT-1_V12D07-335_A1,1,1,0,0,0,2
CGCTTCGGTCTAAGAC-1_V12D07-335_A1,0,0,1,0,0,1
AGCATTACGAGGCAAG-1_V12D07-335_A1,0,0,4,0,0,4
AAGTTGTGATGTTATA-1_V12D07-335_A1,0,0,0,0,0,0
TTGCTCATAGTACGTG-1_V12D07-335_A1,0,1,5,0,0,6
TACTTAAACATGTACA-1_V12D07-335_A1,0,0,1,0,0,1
AGTGAGTCGAATTAAC-1_V12D07-335_A1,0,2,1,0,0,3
TAGGCCTATATAGTCT-1_V12D07-335_A1,0,1,2,0,0,3
ACTCGCCGTTCGATAA-1_V12D07-335_A1,0,0,2,0,0,2
GGTACGTTGCGGCCGG-1_V12D07-335_A1,0,5,0,0,0,5
TATTGCCGGGCTTGTA-1_V12D07-335_A1,0,3,0,0,1,4
GGTAAACTCTGCGCTG-1_V12D07-335_A1,0,0,0,0,0,0
TCCCTTGTCTGAAACT-1_V12D07-335_A1,0,1,0,0,0,1
CATGATCGCTTTGAGA-1_V12D07-335_A1,0,1,2,0,0,3
GGACGGGCGACCAACC-1_V12D07-335_A1,0,3,2,0,0,5
GAGAGGCCTATGTGTA-1_V12D07-335_A1,0,0,1,0,0,1
TCGTAACTCCCAAGAC-1_V12D07-335_A1,0,0,0,0,0,0
CGTATCTAGAACTAAG-1_V12D07-335_A1,0,0,0,0,0,0
GCACCTTCCCGAAGGT-1_V12D07-335_A1,0,1,0,0,0,1
TACCTCTTTACCATCC-1_V12D07-335_A1,0,0,0,0,0,0
TGACTCTAACTGGTAA-1_V12D07-335_A1,0,1,0,0,0,1
GAGAAACTGGATCCCA-1_V12D07-335_A1,1,1,2,0,0,4
ATCCGGACCAGCCTGA-1_V12D07-335_A1,0,0,1,0,0,1
TTATTTAGGTTCCTTA-1_V12D07-335_A1,0,0,0,0,0,0
CGAATTCCCGGTTCAA-1_V12D07-335_A1,0,0,2,0,0,2
TAGTTTGATCGGTCGC-1_V12D07-335_A1,0,0,0,0,0,0
AGTCGAAACGATTCAG-1_V12D07-335_A1,0,0,0,0,0,0
ACGTCGGGCAACTCGG-1_V12D07-335_A1,0,0,0,0,0,0
ACTTGCTCTATCTACC-1_V12D07-335_A1,2,0,0,0,0,2
ATTACGGGCTACGGTT-1_V12D07-335_A1,0,2,0,1,0,3
GCAAACGTAAGCGACC-1_V12D07-335_A1,1,1,1,0,0,3
TTCGGACTGGGCATGG-1_V12D07-335_A1,0,1,2,0,0,3
GGGCCATTCGTGCTGG-1_V12D07-335_A1,3,6,1,0,0,10
GAGTTGTCACCAGTCT-1_V12D07-335_A1,2,5,2,0,0,9
AGTAATTTGCAAGCGT-1_V12D07-335_A1,2,6,0,0,0,8
GTGGCCGGTTTCTCGG-1_V12D07-335_A1,1,2,1,0,0,4
ATCTTAGGGCATTAAT-1_V12D07-335_A1,2,3,1,0,0,6
CTACATATCGCGGGAC-1_V12D07-335_A1,1,3,0,0,0,4
ATGGTATTTACTGATT-1_V12D07-335_A1,1,3,1,0,0,5
CCGTCAACCTCTGGCG-1_V12D07-335_A1,0,1,1,0,0,2
GCTTCGACGTTCAATC-1_V12D07-335_A1,0,6,1,0,0,7
GACCGATTAAATATGT-1_V12D07-335_A1,4,2,4,0,0,10
GTCGAATTTGGGCGCT-1_V12D07-335_A1,2,2,4,0,0,8
TCACGGCCCAAGAGAG-1_V12D07-335_A1,3,5,1,0,0,9
CTACGATCCTATCCTA-1_V12D07-335_A1,2,5,1,1,0,9
TGCAGTGGTAGGGAAC-1_V12D07-335_A1,1,1,0,0,0,2
TTGCCTAATCCAAAGT-1_V12D07-335_A1,0,3,5,0,0,8
AGCGAGACGTGAAGGC-1_V12D07-335_A1,1,2,2,0,0,5
TTCTACCTCAATCGGT-1_V12D07-335_A1,0,5,0,1,0,6
TACGCTGCTGTGTTAA-1_V12D07-335_A1,0,2,2,0,0,4
TAGTCCTGCACTAAGC-1_V12D07-335_A1,0,2,3,0,0,5
AGCACACGTTTAGACT-1_V12D07-335_A1,0,2,6,0,0,8
GTTCGACAATTGTATA-1_V12D07-335_A1,0,1,3,0,0,4
CCATGTTCATCTATAT-1_V12D07-335_A1,0,5,1,0,0,6
CCCTCGATAATACACA-1_V12D07-335_A1,0,2,0,0,0,2
ACTGCCCGCCATTCTC-1_V12D07-335_A1,0,4,1,0,0,5
CTATATCCAGCCTGGC-1_V12D07-335_A1,0,5,2,0,0,7
CGCACGTCTGTTTATG-1_V12D07-335_A1,0,6,1,0,0,7
AATCAGGTTTCATTTA-1_V12D07-335_A1,0,3,0,0,0,3
AGAGAAACACCAGAAA-1_V12D07-335_A1,0,2,2,0,0,4
ACCCGATTGGTTCCGA-1_V12D07-335_A1,0,0,2,0,0,2
TACCAGGAATCCCGTC-1_V12D07-335_A1,0,2,1,1,0,4
AAGTGCTTCTCTATTG-1_V12D07-335_A1,0,1,0,0,0,1
TGCATGTGACCCATAG-1_V12D07-335_A1,0,1,4,0,0,5
TAGATTCAAAGTGCGG-1_V12D07-335_A1,0,2,1,0,0,3
AGGGTCAGAGCACTCG-1_V12D07-335_A1,0,1,0,0,0,1
GTGAGATAACCTTATA-1_V12D07-335_A1,0,0,1,0,0,1
GTGTCAGTGTACGTGG-1_V12D07-335_A1,0,2,1,0,0,3
CTGTAGTGAGGATCGA-1_V12D07-335_A1,0,0,0,0,0,0
GATAGTGCGAGTAAGT-1_V12D07-335_A1,0,0,3,0,0,3
AGGGTTCAGACGGTCC-1_V12D07-335_A1,0,0,0,0,0,0
GGACTCGACAGCGCAT-1_V12D07-335_A1,0,0,2,0,0,2
CACTCTCAAGCATCGA-1_V12D07-335_A1,0,0,3,0,0,3
GAGCGGAATGCGGTGT-1_V12D07-335_A1,0,1,2,0,0,3
CAGTTCGAGGACCCGA-1_V12D07-335_A1,0,0,1,0,0,1
CGTAACTTCGACACTT-1_V12D07-335_A1,0,0,1,0,0,1
TGATCACCACACTGAC-1_V12D07-335_A1,0,0,1,0,0,1
CATACTTCTTTCTCCG-1_V12D07-335_A1,0,1,0,0,0,1
CAAGTAAGTGATAGAC-1_V12D07-335_A1,0,0,2,1,0,3
AGCCCGCAACAAGCAG-1_V12D07-335_A1,0,1,1,15,0,17
GCTCCATGCAAAGCAA-1_V12D07-335_A1,0,0,3,3,0,6
TCGTACCGACGTCAAG-1_V12D07-335_A1,0,0,0,14,0,14
ATTATCGGAATGTACG-1_V12D07-335_A1,0,0,2,14,0,16
ACCTACTATAAATCTA-1_V12D07-335_A1,1,0,3,13,0,17
TATCCTATCAACTGGT-1_V12D07-335_A1,1,0,2,10,0,13
GCGCGGTCTAGTAACT-1_V12D07-335_A1,2,0,3,10,0,15
CCTTCGTATAGAATCC-1_V12D07-335_A1,1,0,2,8,0,11
TGGGCGATACAATAAG-1_V12D07-335_A1,0,1,2,1,0,4
TGACATGTAACGTGAC-1_V12D07-335_A1,1,0,4,2,0,7
TTGGGAAGACGAGCCG-1_V12D07-335_A1,0,1,2,1,0,4
GGTGTAAATCGATTGT-1_V12D07-335_A1,0,0,0,1,0,1
GAACTGTGGAGAGACA-1_V12D07-335_A1,0,1,2,0,0,3
TCCACATCGTATATTG-1_V12D07-335_A1,0,1,2,2,0,5
CCTATGGTCAAAGCTG-1_V12D07-335_A1,2,1,2,2,0,7
TCCTTGTCCTTTAATT-1_V12D07-335_A1,0,0,2,5,0,7
AAGTTTATGGGCCCAA-1_V12D07-335_A1,0,0,3,1,0,4
GTCCGGGTTCACATTA-1_V12D07-335_A1,0,0,1,5,0,6
ATGTAGCGCGCGTAGG-1_V12D07-335_A1,0,2,3,6,0,11
TACGGAAGCCAAACCA-1_V12D07-335_A1,0,0,5,10,0,15
GCCCTGAGGATGGGCT-1_V12D07-335_A1,1,0,4,12,0,17
CGGGCGATGGATCACG-1_V12D07-335_A1,0,1,2,1,0,4
TGCGGACTTGACTCCG-1_V12D07-335_A1,0,0,2,0,0,2
TAATACTAGAACAGAC-1_V12D07-335_A1,0,0,2,0,0,2
TCAAATTGTTGTGCCG-1_V12D07-335_A1,0,0,0,0,0,0
GGGCAGTCAACGCCAA-1_V12D07-335_A1,0,0,3,0,0,3
TCGCTGCCAATGCTGT-1_V12D07-335_A1,0,1,0,0,0,1
TACGTGGGCCCAGGGC-1_V12D07-335_A1,0,0,0,0,0,0
GCCTACGTTCTGTGCA-1_V12D07-335_A1,0,1,2,1,0,4
TTGCGTGTGTAGGCAT-1_V12D07-335_A1,0,0,2,0,0,2
TCCTAAAGATTCAGAC-1_V12D07-335_A1,0,0,9,0,0,9
TGGGTGCACAAGCCAT-1_V12D07-335_A1,0,1,5,0,0,6
GGGAGCGACCGTAGTG-1_V12D07-335_A1,0,2,1,0,0,3
CATAGAGGAGATACTA-1_V12D07-335_A1,0,1,3,0,0,4
CTTCGATTGCGCAAGC-1_V12D07-335_A1,3,3,3,0,0,9
GTGCCTGAGACCAAAC-1_V12D07-335_A1,0,1,1,0,0,2
TCATCCTCAGCTGCTT-1_V12D07-335_A1,0,5,3,0,0,8
TGCAACTACTGGTTGA-1_V12D07-335_A1,0,4,1,0,0,5
ATGTTGATTAGAGACT-1_V12D07-335_A1,6,3,1,0,0,10
GTTTCTAGAGGCGCGG-1_V12D07-335_A1,4,4,3,0,0,11
TACAAGGGCTTCTTTA-1_V12D07-335_A1,0,3,0,0,0,3
ACAGGCACGGATCCTT-1_V12D07-335_A1,0,1,0,0,0,1
CCCAAGTCATTACACT-1_V12D07-335_A1,0,0,1,0,0,1
ACTCTGACCTAATAGA-1_V12D07-335_A1,0,1,0,0,1,2
GGATGGCTTGAAGTAT-1_V12D07-335_A1,0,2,2,0,0,4
ACCCTCCCGTCAGGGC-1_V12D07-335_A1,0,1,16,0,0,17
AGCTTCTTCTCGAGCA-1_V12D07-335_A1,0,1,0,0,0,1
TTGCGCTTGATCAATA-1_V12D07-335_A1,1,1,8,0,0,10
TGGGTGTAATAGATTT-1_V12D07-335_A1,0,1,1,0,0,2
CATGGTTTATTAATCA-1_V12D07-335_A1,0,3,1,0,0,4
TTGCCTTCTCGCCGGG-1_V12D07-335_A1,0,1,1,0,0,2
TTAAAGTAAGTCGCCA-1_V12D07-335_A1,0,2,2,0,0,4
AGTTGGCAAGGCTAGA-1_V12D07-335_A1,1,3,0,0,0,4
CCGCACTTGCAATGAC-1_V12D07-335_A1,0,3,0,0,0,3
AATGTTGTCGTGAGAC-1_V12D07-335_A1,0,2,0,0,0,2
CCAAGGTTGCCCTTTC-1_V12D07-335_A1,0,2,2,0,0,4
TGTGACTAGAGTTTGC-1_V12D07-335_A1,0,1,0,0,0,1
TTGTGATCTGTTCAGT-1_V12D07-335_A1,0,2,2,0,0,4
GGAGTTGATTCTGTGT-1_V12D07-335_A1,0,0,3,0,0,3
GTAGTGAGCAACCTCA-1_V12D07-335_A1,0,2,1,0,0,3
AAGACATACGTGGTTT-1_V12D07-335_A1,0,3,1,0,0,4
CATCCCGAGATTCATA-1_V12D07-335_A1,0,0,2,0,0,2
GGCCGCAGGAACCGCA-1_V12D07-335_A1,0,1,2,0,0,3
CCAGAAACTGATGCGA-1_V12D07-335_A1,0,3,4,0,0,7
ACCCGTAGTCTAGTTG-1_V12D07-335_A1,0,0,1,0,0,1
AGGGTCTGGACGCAGT-1_V12D07-335_A1,0,0,3,0,0,3
TTGAAACCCTCATTCC-1_V12D07-335_A1,0,0,0,0,0,0
TCAATCCCGCGCCAAA-1_V12D07-335_A1,0,0,0,0,0,0
AGGACATCGGCACACT-1_V12D07-335_A1,0,0,0,0,0,0
GACAAGACGCCCGTGC-1_V12D07-335_A1,0,0,0,0,0,0
GAGTAAATTAAGAACC-1_V12D07-335_A1,0,0,2,0,0,2
TAAGTCGGTGAGCTAG-1_V12D07-335_A1,0,1,3,0,0,4
CTTACTGACTCCTCTG-1_V12D07-335_A1,0,0,2,0,0,2
TTAACTGATCGTTTGG-1_V12D07-335_A1,0,0,1,0,0,1
GGGCGATCCATAGGCC-1_V12D07-335_A1,0,0,0,0,0,0
CGTATTGTTTGGCGCC-1_V12D07-335_A1,0,0,0,0,0,0
CGCGTGGGCCTGTGTT-1_V12D07-335_A1,0,0,0,0,0,0
AAATCTGCCCGCGTCC-1_V12D07-335_A1,0,0,0,0,0,0
GCTGAAGGGTTCTTGG-1_V12D07-335_A1,4,3,1,0,0,8
TAATTGCGCTGATTAC-1_V12D07-335_A1,1,3,0,1,0,5
TCGCGCGTTTACATGA-1_V12D07-335_A1,3,2,2,0,0,7
TAACTGAAATACGCCT-1_V12D07-335_A1,1,5,1,0,0,7
CCTGTCGTGTATGAAG-1_V12D07-335_A1,2,4,0,0,0,6
CGGGAACGCCCTGCAT-1_V12D07-335_A1,0,1,2,0,0,3
AGTTGCGGTCCTCAAC-1_V12D07-335_A1,4,2,4,0,0,10
GGGTCCTTGGAAGAAG-1_V12D07-335_A1,0,3,2,0,0,5
CGGGAAGTACCGTGGC-1_V12D07-335_A1,2,2,3,0,0,7
ACGGTCACCGAGAACA-1_V12D07-335_A1,2,2,1,0,0,5
TAGACTCAGTTGGCCT-1_V12D07-335_A1,0,1,4,0,0,5
CCTTCCGCAACGCTGC-1_V12D07-335_A1,1,1,3,0,0,5
CAGTGTTAATCTCTCA-1_V12D07-335_A1,1,0,3,0,0,4
CAGGCCAGTACCACCT-1_V12D07-335_A1,0,7,0,1,0,8
GATCGCTGTGGTGCGT-1_V12D07-335_A1,2,6,0,0,0,8
GTATCTCGGGCGCTTT-1_V12D07-335_A1,0,6,5,0,0,11
CCGGGCTAAGAATTTC-1_V12D07-335_A1,1,3,5,0,0,9
CTTCACGCCCTGGTAC-1_V12D07-335_A1,0,3,3,0,0,6
CGGATGAATGCTGTGA-1_V12D07-335_A1,0,3,2,0,0,5
CTCTGCAGGCATTCTT-1_V12D07-335_A1,0,6,2,0,0,8
TCAAAGTCACGGCGTC-1_V12D07-335_A1,0,5,0,0,0,5
TGGGTTTCGGGCGTAC-1_V12D07-335_A1,0,4,1,0,0,5
TGCTATGGCAAAGGGA-1_V12D07-335_A1,0,3,4,0,0,7
TTCACGGTCGTCACGT-1_V12D07-335_A1,0,0,3,0,0,3
CGTAAAGCAAGAAATC-1_V12D07-335_A1,0,7,0,0,0,7
CTGATCCCTTTATGCA-1_V12D07-335_A1,0,4,0,0,0,4
GAGTATACCCTAATCA-1_V12D07-335_A1,1,0,3,0,0,4
CCACGGCAGGTGTAGG-1_V12D07-335_A1,0,3,1,0,0,4
ACGTACTTTGGCACGG-1_V12D07-335_A1,0,2,2,0,0,4
CCTGAGAATAAATGCA-1_V12D07-335_A1,0,4,1,0,0,5
TTGATGCCGCTCGTCG-1_V12D07-335_A1,0,0,1,0,0,1
GCCAGGAAAGAACACT-1_V12D07-335_A1,0,4,1,0,0,5
TCCGACCGCTAATCAA-1_V12D07-335_A1,0,1,0,0,0,1
TATATCAAAGTGATCT-1_V12D07-335_A1,0,4,2,0,0,6
CCTCGGTTTCCTTGCC-1_V12D07-335_A1,0,1,2,0,0,3
TAAATTTAGTAACACC-1_V12D07-335_A1,0,0,1,0,0,1
CTCGTTACGGCTACCA-1_V12D07-335_A1,0,2,1,0,0,3
GCCGTCGGTTTCGGGC-1_V12D07-335_A1,0,2,0,0,0,2
GTTCCGTCCGCCTGCA-1_V12D07-335_A1,0,2,3,0,0,5
CTAGGGATAGGGACAA-1_V12D07-335_A1,0,1,0,0,0,1
GTCCAGGCACGTGTGC-1_V12D07-335_A1,0,2,1,0,0,3
GAGGAATATCTCTTTG-1_V12D07-335_A1,0,1,5,0,0,6
CGTTCAAGGAAACGGA-1_V12D07-335_A1,1,1,0,0,0,2
GTGGGAACAAACCGGG-1_V12D07-335_A1,0,2,0,0,0,2
GGGCACGTAGTACTGT-1_V12D07-335_A1,0,2,1,0,0,3
ACTACAAAGAGAGGTG-1_V12D07-335_A1,0,0,2,0,0,2
GGTGTAGGTAAGTAAA-1_V12D07-335_A1,0,0,1,0,0,1
CCTGTTCAACCTCGGG-1_V12D07-335_A1,1,2,3,0,0,6
TGAGGTGTGTGGCGGA-1_V12D07-335_A1,0,0,1,0,0,1
ATTGTCTGTTTCATGT-1_V12D07-335_A1,0,0,1,0,0,1
GCCGGTCGTATCTCTC-1_V12D07-335_A1,0,0,1,0,0,1
ATATGGGATAGCAACT-1_V12D07-335_A1,0,0,0,0,0,0
GATAGAACCCGCTAGG-1_V12D07-335_A1,1,1,3,2,0,7
ATCCCATTTCCGTGGG-1_V12D07-335_A1,0,0,2,0,0,2
GATGCTACCTTCGATG-1_V12D07-335_A1,0,0,0,16,0,16
TGCAAAGTTCGTCTGT-1_V12D07-335_A1,0,0,3,0,0,3
GTTCAGTCGCCAAATG-1_V12D07-335_A1,0,0,1,21,0,22
GTCTCCGCCTCAATAC-1_V12D07-335_A1,0,0,3,14,0,17
AGTAGAAGGCGCCTCA-1_V12D07-335_A1,0,0,3,9,0,12
GTTGTAGATTTATGAG-1_V12D07-335_A1,0,0,2,16,0,18
CTATTTGCTTGGAGGA-1_V12D07-335_A1,0,0,2,9,0,11
AGCCATATAGTATGTG-1_V12D07-335_A1,0,0,2,15,0,17
TGTTCCGGCCTGAGCT-1_V12D07-335_A1,0,1,3,2,0,6
TGCCGTGGGACCCAAT-1_V12D07-335_A1,0,0,2,5,0,7
TTGCAAGAAGACTCCT-1_V12D07-335_A1,0,0,3,1,0,4
CCGCTCCAGGGCGATC-1_V12D07-335_A1,0,0,2,5,0,7
CAAACCCTCCGGCGGG-1_V12D07-335_A1,1,2,1,2,0,6
CGGACCTTTACGTCCC-1_V12D07-335_A1,0,1,7,4,0,12
ACGTAGGAGAGTCGCT-1_V12D07-335_A1,0,0,5,7,0,12
CTGCGACCTCGCCGAA-1_V12D07-335_A1,0,0,3,10,0,13
GGCCCAGCTGGTTTGC-1_V12D07-335_A1,1,1,1,6,0,9
GGATTAATCATGGACC-1_V12D07-335_A1,0,0,2,8,0,10
GAGATGGCTTTAATCA-1_V12D07-335_A1,0,0,0,0,0,0
AGTACAGAAGCTTATA-1_V12D07-335_A1,0,1,2,0,0,3
GCGGCTTTAGCAAGTT-1_V12D07-335_A1,0,0,0,0,0,0
ACCGAGTCTCCTTATT-1_V12D07-335_A1,1,0,1,0,0,2
GACCACACTTCCCTTT-1_V12D07-335_A1,0,1,1,0,0,2
TGTAGCCAATTCCGTT-1_V12D07-335_A1,0,1,1,0,0,2
CTCGTCTGTGCCTTCG-1_V12D07-335_A1,0,0,2,0,0,2
GGACTCTTTGACTAAG-1_V12D07-335_A1,0,1,2,0,0,3
TCATCGACGACCGTCG-1_V12D07-335_A1,0,0,3,0,0,3
TACTACGTGCAATGCG-1_V12D07-335_A1,1,0,5,0,0,6
CCCTACTTGAACAATG-1_V12D07-335_A1,0,1,3,0,2,6
GCAGCTGTCAACGCAT-1_V12D07-335_A1,0,6,1,0,0,7
ATCTACCATCTGCTCC-1_V12D07-335_A1,1,1,2,1,0,5
TCTCAAATCAATCGGG-1_V12D07-335_A1,0,1,1,0,1,3
ACTCCGGCCGACCACT-1_V12D07-335_A1,0,4,1,0,0,5
TACACCTCTTCGAATC-1_V12D07-335_A1,0,0,3,0,0,3
GTGGCTGTTTCTGTTC-1_V12D07-335_A1,0,5,1,0,1,7
ACGACTCTAGGGCCGA-1_V12D07-335_A1,0,5,4,0,0,9
TCGTTTACGCGACCCT-1_V12D07-335_A1,0,4,1,1,1,7
AGGATATCCGACTGCA-1_V12D07-335_A1,0,2,0,0,0,2
GACACTTCCAATTACC-1_V12D07-335_A1,0,4,3,0,0,7
ACGGTACAGTTCAATG-1_V12D07-335_A1,0,2,2,0,0,4
CTTGATGACCATCCAG-1_V12D07-335_A1,1,4,2,0,0,7
CTGGTAAAGACTTACA-1_V12D07-335_A1,0,2,0,0,0,2
CTTGCCCACCCACGCA-1_V12D07-335_A1,0,5,1,0,0,6
CATTACGCAGGAAGGG-1_V12D07-335_A1,0,3,1,0,0,4
GGACAACCATGAAGCC-1_V12D07-335_A1,0,2,1,0,0,3
GTTATCAAGCTATCGA-1_V12D07-335_A1,0,2,0,0,0,2
AGGTGCACGTCCACAT-1_V12D07-335_A1,0,1,0,0,0,1
AAAGAATGTGGACTAA-1_V12D07-335_A1,0,0,1,0,0,1
ACCAAGTCATCGGCAG-1_V12D07-335_A1,0,2,1,0,0,3
AGTAACTATAGCAGCC-1_V12D07-335_A1,0,3,0,0,0,3
GGGAAAGAATGCCAAC-1_V12D07-335_A1,0,1,0,0,0,1
AATCGGTATAGCCCTC-1_V12D07-335_A1,0,1,2,0,0,3
GGCACTGCGGTGGTTT-1_V12D07-335_A1,0,9,2,0,0,11
CGTCCTCATCGCGTGC-1_V12D07-335_A1,0,3,0,0,0,3
CTTAACTTACAGTATA-1_V12D07-335_A1,0,0,4,0,0,4
GTGAGTCGACTAATAG-1_V12D07-335_A1,0,0,1,0,0,1
TGTACTTCCGGGCATG-1_V12D07-335_A1,0,1,1,0,0,2
CACAAACCGCAGAACT-1_V12D07-335_A1,0,1,0,0,0,1
GCTTTACACAACTGGG-1_V12D07-335_A1,0,0,0,0,0,0
CACCGATGATGGGTAC-1_V12D07-335_A1,0,0,0,0,0,0
TCAATATACAGGAGGC-1_V12D07-335_A1,0,1,0,0,0,1
AACGACCTCCTAGCCG-1_V12D07-335_A1,0,1,0,0,0,1
GTTACCAAGGCGTACG-1_V12D07-335_A1,1,1,1,0,0,3
TAGCTCACTGTGTTTG-1_V12D07-335_A1,0,0,0,0,0,0
TCGGCAGGGTTAAGGG-1_V12D07-335_A1,0,0,0,0,0,0
TGTTAACAAAGTGACT-1_V12D07-335_A1,0,1,0,0,0,1
CAGAGCGATGGATGCT-1_V12D07-335_A1,0,0,0,0,0,0
CATAGTGGGCACGCCT-1_V12D07-335_A1,0,2,0,0,1,3
AAACGCTGGGCACGAC-1_V12D07-335_A1,2,0,0,0,0,2
TGTTCTCATACTATAG-1_V12D07-335_A1,0,0,0,0,0,0
TCCGCTGGGTCGATCG-1_V12D07-335_A1,0,0,0,0,0,0
TTAGCATCCCTCACGT-1_V12D07-335_A1,0,0,0,0,0,0
AGCCTTGTCACTGATA-1_V12D07-335_A1,0,0,0,0,0,0
GTTTCTTGTTAGAGCT-1_V12D07-335_A1,1,1,0,0,0,2
TCGGAGTCCTGGTTGC-1_V12D07-335_A1,0,3,1,0,0,4
ACGGGTTGTGACCTGT-1_V12D07-335_A1,8,8,0,0,0,16
TGACAGAAATCTTGCT-1_V12D07-335_A1,1,2,4,1,1,9
TAGCCATGATTGCCTA-1_V12D07-335_A1,0,5,1,1,0,7
CGAAGCCACAGCATGG-1_V12D07-335_A1,0,6,1,0,0,7
ACCCGTAGCAGAGAAT-1_V12D07-335_A1,2,5,1,0,0,8
AGCTTGATCAGGGTAG-1_V12D07-335_A1,0,0,4,7,0,11
CTATAAGTAGGGTTTG-1_V12D07-335_A1,2,0,1,2,0,5
TATAGTTAGGTGTACT-1_V12D07-335_A1,1,1,2,0,0,4
TACGCTGATAGTTGTA-1_V12D07-335_A1,0,1,2,0,0,3
TTCTCAATTGCTACAA-1_V12D07-335_A1,2,4,1,0,0,7
GTTGCCCTAACGGGTG-1_V12D07-335_A1,1,1,1,0,0,3
GACATTTCGCCCAGCC-1_V12D07-335_A1,1,3,1,0,0,5
GTAACTACGTAGACCT-1_V12D07-335_A1,0,2,1,0,0,3
CCAGTGTACAGACCGA-1_V12D07-335_A1,0,7,7,0,0,14
GCCCGATGCCCAGTTC-1_V12D07-335_A1,0,3,5,0,0,8
CGAACCTCTTTCCTAG-1_V12D07-335_A1,0,6,7,0,0,13
CATGCACATGAGAGGC-1_V12D07-335_A1,0,5,1,0,0,6
CCAAATCAAAGGGCAA-1_V12D07-335_A1,1,2,7,0,0,10
GTAGTTTAAGCACACG-1_V12D07-335_A1,0,1,1,0,0,2
TAAGTGAATAGTCTAC-1_V12D07-335_A1,1,8,2,0,0,11
GGTCCACGTCTATTTG-1_V12D07-335_A1,0,4,4,0,0,8
CCCTCAGATCGAGAAC-1_V12D07-335_A1,0,5,3,0,0,8
ACATTCGCGCGGAATA-1_V12D07-335_A1,2,1,3,0,0,6
CTATGAACACCTTGCC-1_V12D07-335_A1,0,1,1,1,0,3
CGAATGGTAGGTCGTC-1_V12D07-335_A1,0,1,1,0,0,2
TCGACATAGCGTAGCG-1_V12D07-335_A1,3,4,4,0,0,11
GACGTTGCTCGGCGGC-1_V12D07-335_A1,1,1,3,0,0,5
CTCGAGGCAAGTTTCA-1_V12D07-335_A1,0,0,2,0,0,2
GCTGGGAGCGCGTCAA-1_V12D07-335_A1,0,2,1,0,0,3
GACGATATCACTGGGT-1_V12D07-335_A1,0,7,2,0,0,9
CAGCTCTGGGCTCACT-1_V12D07-335_A1,1,5,2,0,0,8
TAGTCTGCGGCACATT-1_V12D07-335_A1,1,3,1,0,0,5
TGGTCGATATACCTCT-1_V12D07-335_A1,0,1,3,0,0,4
TTCAGTTCAAGAGGAG-1_V12D07-335_A1,0,3,0,0,0,3
GTCTGTAGGTTGAACA-1_V12D07-335_A1,0,2,6,0,0,8
GAGAGTCTCGGGAGAG-1_V12D07-335_A1,2,2,3,0,0,7
TTGTTTGTATTACACG-1_V12D07-335_A1,2,4,3,1,0,10
GCACAGCACGGGCCGA-1_V12D07-335_A1,0,1,7,0,0,8
AAACAGTGTTCCTGGG-1_V12D07-335_A1,0,3,4,0,0,7
TGGAGAATAATCGTCC-1_V12D07-335_A1,1,1,9,0,0,11
CGCCGCGTTCTGAACG-1_V12D07-335_A1,0,3,3,0,0,6
CATGCGTTGAGAGGAG-1_V12D07-335_A1,1,3,0,0,0,4
TACGCTCCTAGAACTG-1_V12D07-335_A1,3,0,3,0,0,6
CCTTGTGAACGTGGTT-1_V12D07-335_A1,0,1,3,0,0,4
TTAAAGGCGATGCTCG-1_V12D07-335_A1,0,0,2,0,0,2
TAAAGTGCACGTCTCG-1_V12D07-335_A1,0,0,1,0,0,1
TGTCCGCAAACAATTC-1_V12D07-335_A1,0,1,1,0,0,2
AGGCCTATCATACCAA-1_V12D07-335_A1,0,0,2,0,0,2
ACTGGGATGCCAGTGC-1_V12D07-335_A1,0,0,0,0,0,0
CGATCCACCATTGTTG-1_V12D07-335_A1,0,1,0,0,0,1
GGGCATGCATGTCGAG-1_V12D07-335_A1,0,1,2,0,0,3
TCCAGGCAGGACGATC-1_V12D07-335_A1,0,0,1,0,0,1
CAATGACCCTTAATTT-1_V12D07-335_A1,0,0,3,0,0,3
ATCAAGATCCCAGGAC-1_V12D07-335_A1,0,0,3,0,0,3
CTCAGAGCTAATGTCG-1_V12D07-335_A1,0,0,2,0,0,2
CTGCGATTTCGAGATT-1_V12D07-335_A1,0,0,2,0,0,2
ATGGTATTGGGAACCG-1_V12D07-335_A1,0,0,2,0,0,2
TAGGTTCTGCTGAGAA-1_V12D07-335_A1,0,0,3,3,0,6
GCCTGTCCCGGTGCAT-1_V12D07-335_A1,0,0,0,0,0,0
GGCCTGCTCTGATGTT-1_V12D07-335_A1,0,1,1,14,0,16
TAGAGGGAGTTTATCT-1_V12D07-335_A1,0,0,3,0,0,3
CTCTACATCCTGCGTG-1_V12D07-335_A1,0,1,4,12,0,17
ACACATTTCCGTAGAC-1_V12D07-335_A1,0,0,3,2,0,5
TGGGTGTTAAGTAGAA-1_V12D07-335_A1,0,0,1,17,0,18
GAGCTCAACATGAGCG-1_V12D07-335_A1,0,1,2,10,0,13
GCACACAGCTATTACC-1_V12D07-335_A1,0,0,0,19,0,19
GCGACGGTAGTCTCCT-1_V12D07-335_A1,0,0,4,18,0,22
GTATCAAGGTACTTCC-1_V12D07-335_A1,0,0,0,7,0,7
GGAAAGGGAATTGAGC-1_V12D07-335_A1,0,0,4,11,0,15
TACACAGCCGTGGTGC-1_V12D07-335_A1,0,0,1,17,0,18
CGGTTGGGCAGGGTCC-1_V12D07-335_A1,0,0,1,1,0,2
GCACGCCGATTCCCGC-1_V12D07-335_A1,1,0,0,0,0,1
CGCTTTCCGCCAAGGT-1_V12D07-335_A1,0,0,0,0,0,0
TGCCCGATAGTTAGAA-1_V12D07-335_A1,0,1,1,0,0,2
TCAGAACGGCGGTAAT-1_V12D07-335_A1,0,2,2,0,0,4
CCACTCAGATCCGCAA-1_V12D07-335_A1,0,0,0,0,0,0
GAAGGGTCATTAAGAC-1_V12D07-335_A1,0,1,0,0,0,1
GCGGTCTTGCTTTCAC-1_V12D07-335_A1,0,0,0,0,0,0
GGAAGGACACCGTATA-1_V12D07-335_A1,0,1,2,0,0,3
CGCGGGAATTCCTTTC-1_V12D07-335_A1,0,0,0,0,0,0
TCTATCCGATTGCACA-1_V12D07-335_A1,0,1,2,1,0,4
TACTCGTTTGAATCAA-1_V12D07-335_A1,1,0,3,0,0,4
GTCTGCCGACTCGACG-1_V12D07-335_A1,0,3,4,0,0,7
TACGGGTAATAACATA-1_V12D07-335_A1,0,3,1,0,0,4
CCAGTTCGGTAACTCA-1_V12D07-335_A1,0,4,2,0,0,6
CGTGCACACCACTGTA-1_V12D07-335_A1,0,4,0,0,0,4
CTTCAGTTGGACAACG-1_V12D07-335_A1,0,3,1,0,0,4
TGATCTATCACACTCT-1_V12D07-335_A1,0,4,1,0,0,5
TAGCAGATACTTAGGG-1_V12D07-335_A1,0,4,2,0,0,6
CACCGGGCATCACAAG-1_V12D07-335_A1,0,0,3,0,0,3
AGTGGCCCGCAAATGG-1_V12D07-335_A1,0,7,0,0,1,8
CTCGCTAGGTAAGCGA-1_V12D07-335_A1,0,4,1,0,0,5
GATAGATAGTACAGTC-1_V12D07-335_A1,1,2,1,0,4,8
CGAGACTACTGCTGCT-1_V12D07-335_A1,0,1,1,0,0,2
ACATTTGAAACCTAAC-1_V12D07-335_A1,0,6,0,0,0,6
GACACAGCCGGGACTG-1_V12D07-335_A1,0,2,4,0,0,6
ACGGAACACGAGTGCC-1_V12D07-335_A1,0,5,2,0,0,7
ACGCCAGTGCGTTTGC-1_V12D07-335_A1,0,2,1,0,0,3
GCACCTAGGCGAGTCC-1_V12D07-335_A1,0,5,0,0,0,5
TCACTATCCCTTCGGT-1_V12D07-335_A1,0,0,1,0,0,1
TGAGTGTAACAACGGG-1_V12D07-335_A1,0,1,0,0,0,1
ATTGGTTGTGCATTAC-1_V12D07-335_A1,1,2,3,0,0,6
CTGGCGATTTACATGT-1_V12D07-335_A1,1,0,2,0,1,4
TCCACCAAGACATAGG-1_V12D07-335_A1,0,2,1,0,0,3
AACGTCGCTGCACTTC-1_V12D07-335_A1,0,0,3,0,1,4
GTCTCCCGAGTCCCGT-1_V12D07-335_A1,0,4,1,0,0,5
AGCCCGCACTACAATG-1_V12D07-335_A1,0,1,1,0,0,2
GGCACGCTGCTACAGT-1_V12D07-335_A1,0,3,0,0,0,3
GCTTGAGTGACCTCTG-1_V12D07-335_A1,0,8,0,0,0,8
ATAGCCATAACAGTCA-1_V12D07-335_A1,0,1,0,0,0,1
TAGGAGGCTCGAGAAC-1_V12D07-335_A1,0,3,1,0,0,4
GTCGGGTGAAGTACCG-1_V12D07-335_A1,0,1,0,0,0,1
CACCCGCGTTTGACAC-1_V12D07-335_A1,0,2,0,0,0,2
TCTCAGGCTACTCGCT-1_V12D07-335_A1,1,2,0,0,0,3
TAGATTCTCTAGCAAA-1_V12D07-335_A1,0,1,0,0,0,1
CCCATTATTGTATCCT-1_V12D07-335_A1,0,2,1,0,0,3
GTTAATAGCGTCATTA-1_V12D07-335_A1,0,1,0,0,0,1
TACTCATTGACGCATC-1_V12D07-335_A1,0,2,1,0,0,3
TAGTGACAAGCTCTAC-1_V12D07-335_A1,0,0,0,0,0,0
ATCGCCGTGGTTCATG-1_V12D07-335_A1,0,1,3,0,0,4
CTGCTCTCAACACACC-1_V12D07-335_A1,0,1,0,0,0,1
GCATGACACAAAGGAA-1_V12D07-335_A1,0,0,0,0,4,4
CAACGATCGATCCAAT-1_V12D07-335_A1,0,1,0,0,0,1
ATACAGCGTCCACTGA-1_V12D07-335_A1,0,0,0,0,0,0
TCACGATTAATACGTT-1_V12D07-335_A1,0,0,0,0,0,0
CGTGAACTGACCCGAT-1_V12D07-335_A1,0,0,0,0,0,0
TCGATGTTACGGCCGT-1_V12D07-335_A1,0,1,2,0,0,3
GACCGGTGATACTCTC-1_V12D07-335_A1,0,4,1,2,0,7
TCTGTTTAGATTGTTC-1_V12D07-335_A1,0,6,1,0,0,7
GCTACTCGGACGCAGA-1_V12D07-335_A1,1,6,1,0,0,8
AAGAAAGTTTGATGGG-1_V12D07-335_A1,0,4,0,0,0,4
CGCCAGTAGTACCTTG-1_V12D07-335_A1,1,2,2,0,0,5
CTCCCTTGTATCAAGG-1_V12D07-335_A1,1,1,1,0,2,5
ACTTTATACACCACTT-1_V12D07-335_A1,0,4,1,0,0,5
AGATCTGGAGAGGATA-1_V12D07-335_A1,1,3,4,0,0,8
TCATCCATCTGATCAC-1_V12D07-335_A1,0,3,4,0,0,7
AGAACACGGCGATGGT-1_V12D07-335_A1,1,8,4,0,0,13
CCGCTCCGGATAAGCT-1_V12D07-335_A1,0,5,0,0,0,5
TGGTCGGGTACAGGGC-1_V12D07-335_A1,0,1,1,0,0,2
ACGGACGCAGCGACAA-1_V12D07-335_A1,1,5,0,0,0,6
ACATGCTTACGGCAGC-1_V12D07-335_A1,0,1,1,0,0,2
CAGGGAGATAGGCCAG-1_V12D07-335_A1,1,7,4,0,0,12
TCGCCACCCGGATTAC-1_V12D07-335_A1,0,3,1,0,0,4
TCTTGGTCAATGATAC-1_V12D07-335_A1,2,4,2,0,0,8
CATAGGGACACTTGTG-1_V12D07-335_A1,0,0,3,1,0,4
CACGAGCAAACCAGAC-1_V12D07-335_A1,0,0,2,0,0,2
GGGATATTGATCGCCA-1_V12D07-335_A1,1,3,1,0,0,5
TAATGTCGGTTCATGG-1_V12D07-335_A1,1,4,3,0,0,8
CGATTTGTCATTAATG-1_V12D07-335_A1,0,2,2,0,0,4
TTAAGATACCCAGAGA-1_V12D07-335_A1,1,2,2,0,0,5
CGACCGTTGGTATTCG-1_V12D07-335_A1,0,1,3,0,0,4
ACTACCATCCGAGGGC-1_V12D07-335_A1,0,3,1,0,0,4
TCTACGCACGATCTCC-1_V12D07-335_A1,0,2,1,1,0,4
AAGCCACTTGCAGGTA-1_V12D07-335_A1,0,3,2,0,0,5
ACGTTGTCGTTGAAAG-1_V12D07-335_A1,1,4,4,0,0,9
ACCGCTAGTCATTGGT-1_V12D07-335_A1,0,0,3,0,0,3
CATGAGTCCATCACGG-1_V12D07-335_A1,0,4,2,0,0,6
ATGTCTTGTTTGACTC-1_V12D07-335_A1,1,1,1,0,0,3
TCCCAAACATCCTCTA-1_V12D07-335_A1,1,3,2,0,0,6
CAACGCGATGAGCCAA-1_V12D07-335_A1,0,3,2,1,0,6
GACACCCAAAGACGCG-1_V12D07-335_A1,0,3,2,0,0,5
ACGTTCACTATGCCGC-1_V12D07-335_A1,0,1,4,0,0,5
ATGGACTGCTTAGTTG-1_V12D07-335_A1,0,5,2,0,0,7
CCATGGCAAACGCTCA-1_V12D07-335_A1,1,7,2,0,0,10
TTGTCTCGGCAAGATG-1_V12D07-335_A1,0,7,1,0,0,8
TTCGAACGAAACATGC-1_V12D07-335_A1,0,8,3,0,0,11
GGAAAGTCTTGATTGT-1_V12D07-335_A1,0,5,2,1,0,8
ATCATAGATCGACGAG-1_V12D07-335_A1,0,5,3,0,0,8
GATTAGAAACAAGCGT-1_V12D07-335_A1,0,4,2,0,0,6
GCTGCGAAGAATTATT-1_V12D07-335_A1,0,2,1,0,0,3
TTCCAGTGGGTTTCGT-1_V12D07-335_A1,0,4,3,1,0,8
GCTCATTGATCATATC-1_V12D07-335_A1,0,2,4,0,0,6
ATACGAGGTTTGTAAG-1_V12D07-335_A1,2,2,3,0,0,7
GTCTATACACGCATGG-1_V12D07-335_A1,1,5,1,0,0,7
GATTTGCGCTAACACC-1_V12D07-335_A1,1,1,3,0,0,5
TGGTGCCCTGCCTTAC-1_V12D07-335_A1,0,3,1,0,0,4
TCGAATCGCAGGGTAG-1_V12D07-335_A1,2,1,3,0,0,6
GGTAGGCCAATATCAC-1_V12D07-335_A1,0,2,2,0,0,4
CGTAAATAACAAAGGG-1_V12D07-335_A1,1,3,1,0,0,5
GACTCTAGAGTTCCAA-1_V12D07-335_A1,0,1,1,0,0,2
ACTTGTTACCGGATCA-1_V12D07-335_A1,0,1,1,0,0,2
GGCATTGAACATCTCA-1_V12D07-335_A1,0,1,1,0,0,2
AACCCGCTGTATTCCA-1_V12D07-335_A1,0,1,5,0,0,6
TAACAGGTTCCCTTAG-1_V12D07-335_A1,0,1,0,0,0,1
GTTCTTGTAACTCAAT-1_V12D07-335_A1,0,1,2,0,0,3
GATTCTGTTAATGAGT-1_V12D07-335_A1,0,1,0,0,0,1
GGACACCTCGGTGTTG-1_V12D07-335_A1,0,2,3,0,0,5
CGATCGAGAAGCACCA-1_V12D07-335_A1,0,0,1,0,0,1
CTGCTCTGACGGCAAA-1_V12D07-335_A1,0,1,4,0,0,5
CCCAGGAAGAATTCGA-1_V12D07-335_A1,0,0,1,0,0,1
TGTCGTGGGTATAGGC-1_V12D07-335_A1,0,1,0,0,0,1
ATATGTCTAGAGCGTG-1_V12D07-335_A1,0,0,3,0,0,3
GCGGGCAGACGGGTGA-1_V12D07-335_A1,0,1,0,0,0,1
CGAAGATCAGTTTCAT-1_V12D07-335_A1,0,0,5,0,0,5
ACGCCACTCGAAACAG-1_V12D07-335_A1,0,0,0,0,0,0
CTTAGATGTTTCATCC-1_V12D07-335_A1,0,0,2,0,0,2
GCGAATGGACTAGCGA-1_V12D07-335_A1,1,0,1,0,0,2
TAAATTGTGGGTAAAG-1_V12D07-335_A1,1,0,2,0,0,3
ATTTATACTGGTAAAG-1_V12D07-335_A1,0,1,0,0,0,1
GCGTCGTAACATGGTC-1_V12D07-335_A1,0,0,3,0,0,3
CGGTATGGGCACTCTG-1_V12D07-335_A1,0,0,2,0,0,2
CTATCACAACGCTGGA-1_V12D07-335_A1,0,0,1,0,0,1
ACCACACGGTTGATGG-1_V12D07-335_A1,0,3,4,0,0,7
TCAGCGCACGCCGTTT-1_V12D07-335_A1,0,3,0,0,0,3
AATGTTAAGACCCTGA-1_V12D07-335_A1,1,4,0,0,0,5
CTTACATAGATTTCTT-1_V12D07-335_A1,0,1,1,0,0,2
AACATAGCGTGTATCG-1_V12D07-335_A1,0,3,4,1,0,8
AGCAGTCGAAGCATGC-1_V12D07-335_A1,0,1,5,0,1,7
GTACTACGGCCTCGTT-1_V12D07-335_A1,2,3,1,1,0,7
TTGGCCAAATTGTATC-1_V12D07-335_A1,1,3,0,0,0,4
TCAGAGGACGCGTTAG-1_V12D07-335_A1,0,0,1,0,0,1
AGTAATCTAAGGGTGG-1_V12D07-335_A1,1,3,3,0,0,7
AATTATACCCAGCAAG-1_V12D07-335_A1,3,7,2,0,0,12
CCCTACCCACACCCAG-1_V12D07-335_A1,1,4,2,0,0,7
CTCTGTCCATGCACCA-1_V12D07-335_A1,1,4,1,0,0,6
TCGCCTCCTTCGGCTC-1_V12D07-335_A1,0,0,3,0,0,3
CCTGATTCGCGAAGAA-1_V12D07-335_A1,0,5,0,0,0,5
GACTTCAACGCATCAA-1_V12D07-335_A1,0,4,1,0,0,5
GCTTCCCGTAAGCTCC-1_V12D07-335_A1,0,4,1,0,0,5
AGAACTGTACTTTGTA-1_V12D07-335_A1,0,1,0,0,2,3
CCTTAAGTACGCAATT-1_V12D07-335_A1,0,5,0,0,0,5
GGCCAATTGTATAGAC-1_V12D07-335_A1,0,5,3,0,0,8
AGAATACAGGCTATCC-1_V12D07-335_A1,0,5,2,0,1,8
AATACCTGATGTGAAC-1_V12D07-335_A1,2,0,2,0,0,4
TAGAGTGTTCCGGGTA-1_V12D07-335_A1,0,1,2,0,0,3
GCTTCCATGTAACCGC-1_V12D07-335_A1,0,4,0,0,0,4
GGTTCGCATTTGCCGT-1_V12D07-335_A1,0,4,5,0,0,9
TCAATCCGGGAAGTTT-1_V12D07-335_A1,0,1,0,0,0,1
CCGGAAGTGCAATATG-1_V12D07-335_A1,0,1,1,0,0,2
CTCATAAATGTGTATA-1_V12D07-335_A1,0,2,0,0,0,2
GACGGGCATCGAATTT-1_V12D07-335_A1,1,0,0,0,0,1
GCTAAGCCCAGTATGC-1_V12D07-335_A1,0,0,0,0,0,0
GCTATAAGGGCCAGGA-1_V12D07-335_A1,0,0,1,0,0,1
GCGGATTACTTGTTCT-1_V12D07-335_A1,0,2,0,0,0,2
TACAACAGCGCATACA-1_V12D07-335_A1,0,0,0,0,0,0
TCTAACCTAGCCTGCG-1_V12D07-335_A1,0,1,0,0,0,1
TCTACCCGCATCATTT-1_V12D07-335_A1,0,2,0,0,0,2
GTCTTACCACGCCAAG-1_V12D07-335_A1,1,2,0,0,0,3
AATAACGTCGCGCCCA-1_V12D07-335_A1,0,3,1,0,0,4
CGTTTCGGTTATATGC-1_V12D07-335_A1,0,0,1,0,0,1
TACGCTGCACGGTCGT-1_V12D07-335_A1,0,2,1,0,0,3
CGTTAAATACGACCAG-1_V12D07-335_A1,0,1,1,0,0,2
TCGACTGACGATGGCT-1_V12D07-335_A1,0,0,1,0,0,1
ACGCTACTGAATGGGC-1_V12D07-335_A1,0,0,0,0,0,0
AAGGGTTAGCCATGCG-1_V12D07-335_A1,0,1,1,0,0,2
ACGTTTCGGTGCACTT-1_V12D07-335_A1,0,1,0,0,0,1
TTAACCCGAGGCGTGT-1_V12D07-335_A1,0,0,0,0,0,0
GCCCGTCAAGCCCAAT-1_V12D07-335_A1,1,0,0,0,4,5
ATTCGTCCCGAGGTTA-1_V12D07-335_A1,0,1,2,1,1,5
TCAAATTATGTTCGAC-1_V12D07-335_A1,0,0,0,0,1,1
AACGTTCTACCATTGT-1_V12D07-335_A1,0,0,0,2,2,4
CTGTCCTGCGCACTAC-1_V12D07-335_A1,0,0,0,0,0,0
GCCCAGCGACACAAAG-1_V12D07-335_A1,0,0,0,0,0,0
TATAGCTATTATCTCT-1_V12D07-335_A1,0,0,0,0,0,0
AAGCTATGGATTGACC-1_V12D07-335_A1,0,2,1,0,0,3
CCGAAACACGACCTCT-1_V12D07-335_A1,0,4,2,0,0,6
ATCAGAAGCTGGTTGC-1_V12D07-335_A1,4,5,2,0,0,11
TGAACCTGAATGTGAG-1_V12D07-335_A1,0,5,1,0,0,6
TCAGAGCATGTCAACG-1_V12D07-335_A1,1,4,1,0,0,6
ATACCCTCCCGGCCAA-1_V12D07-335_A1,2,0,0,0,4,6
GCCACCTTATTCGCGA-1_V12D07-335_A1,2,1,2,0,0,5
CAACGAGCTTATTATG-1_V12D07-335_A1,0,4,2,0,0,6
GATCCAACCTTTAAAC-1_V12D07-335_A1,0,2,0,0,0,2
TTGTGGAGACAGCCGG-1_V12D07-335_A1,1,4,2,0,0,7
AGATAATCACACCTAT-1_V12D07-335_A1,0,0,1,0,0,1
GGTTAGGGATGCTAAT-1_V12D07-335_A1,1,3,1,0,0,5
TCATGAAGCGCTGCAT-1_V12D07-335_A1,0,6,3,0,0,9
CCAGGCGAGATGGTCT-1_V12D07-335_A1,0,1,0,0,0,1
CGACTTGCCGGGAAAT-1_V12D07-335_A1,0,1,1,0,0,2
GTGCCAAACGTTTCGA-1_V12D07-335_A1,1,1,6,0,0,8
TGCTCAAAGGATGCAC-1_V12D07-335_A1,0,0,4,0,0,4
GCCTCAGGTACCGGTC-1_V12D07-335_A1,0,4,3,0,0,7
ACAAGTAATTGTAAGG-1_V12D07-335_A1,0,0,1,0,0,1
TTAGAGTATTGTCGAG-1_V12D07-335_A1,0,4,2,0,0,6
GTCATCCCAAACTCAC-1_V12D07-335_A1,0,3,0,0,0,3
CTCCTAGTAATCGTGA-1_V12D07-335_A1,0,2,1,1,0,4
CCCTCATCACAGAGTA-1_V12D07-335_A1,0,1,1,1,0,3
GGAAACAGAGCTTGGG-1_V12D07-335_A1,0,2,0,0,0,2
ACATCGCAATATTCGG-1_V12D07-335_A1,0,3,1,0,0,4
TTAGCCATAGGGCTCG-1_V12D07-335_A1,0,1,1,2,0,4
CGGATTCTGCCTTATG-1_V12D07-335_A1,1,0,0,0,0,1
TTGTTGGCAATGACTG-1_V12D07-335_A1,0,0,0,0,1,1
GGATCTACCGTTCGTC-1_V12D07-335_A1,0,0,1,0,0,1
GGTGGGATTAGGTCCC-1_V12D07-335_A1,0,1,2,0,0,3
AATAGGCACGACCCTT-1_V12D07-335_A1,0,0,4,1,0,5
GAGGTCCGTTCGCTGT-1_V12D07-335_A1,2,1,2,0,0,5
TGACAACTTAAAGGTG-1_V12D07-335_A1,0,1,3,0,0,4
AGCTAAGCTCCGTCCG-1_V12D07-335_A1,0,0,0,0,0,0
CTAGCCCGGGAGACGA-1_V12D07-335_A1,0,2,2,0,0,4
CCCAGATTCCCGTGAC-1_V12D07-335_A1,0,2,1,0,0,3
GCCCGTTCACACAATT-1_V12D07-335_A1,0,4,2,0,0,6
ACAAACTCCATCAGAG-1_V12D07-335_A1,0,1,4,0,0,5
GGTTCCGTACGACTAA-1_V12D07-335_A1,0,1,3,0,0,4
TTGCGGAAAGCTGCCC-1_V12D07-335_A1,0,1,1,0,0,2
GGAACTCGTGAATACG-1_V12D07-335_A1,0,2,5,0,0,7
GGTTACCGCTCCCTAC-1_V12D07-335_A1,0,3,1,0,0,4
AGCGACTTTGAAGACA-1_V12D07-335_A1,1,2,2,1,0,6
CCGTTTCCTTTCCGTG-1_V12D07-335_A1,0,2,1,1,0,4
TGGATGGCATCTTGGA-1_V12D07-335_A1,0,3,1,0,0,4
CAAGTCGTTGAAATCT-1_V12D07-335_A1,2,3,0,1,0,6
TGCAAACGTACTAGTT-1_V12D07-335_A1,0,3,1,0,0,4
GGCTGTCCTACTGCGG-1_V12D07-335_A1,0,3,1,0,0,4
TACTGCATGATTAAAT-1_V12D07-335_A1,0,3,0,0,1,4
CGGACCTCTGTAGTTA-1_V12D07-335_A1,0,3,4,0,0,7
CCCTAGCTCTAAGGTC-1_V12D07-335_A1,0,5,4,0,0,9
GTAACAGGTTAACGGC-1_V12D07-335_A1,1,4,1,1,0,7
CCCGCAAATAATCATC-1_V12D07-335_A1,1,0,4,0,0,5
AATCCCGCTCAGAGCC-1_V12D07-335_A1,0,4,4,1,0,9
AACGTCATCCGGCTTG-1_V12D07-335_A1,0,3,3,0,0,6
CTCGTGGCACTGAAAG-1_V12D07-335_A1,0,0,5,0,0,5
CTTTATCCGACGCATG-1_V12D07-335_A1,2,0,6,0,0,8
AAATGACTGATCAAAC-1_V12D07-335_A1,0,0,2,0,0,2
TTCGTGCATGTTATAG-1_V12D07-335_A1,0,2,1,0,0,3
ATCAAAGAGCCGTGGT-1_V12D07-335_A1,0,2,4,1,0,7
ATGTCATAATAAACGA-1_V12D07-335_A1,0,2,3,1,0,6
CTTAATCGACTTAGTA-1_V12D07-335_A1,1,0,1,0,0,2
CTAAAGGATGAGATAC-1_V12D07-335_A1,0,2,3,0,0,5
GTGCTATCCAGCTGGA-1_V12D07-335_A1,0,1,0,0,0,1
GACAGAGGTCTTCAGT-1_V12D07-335_A1,0,1,2,0,0,3
TCGATTTACGAAACGA-1_V12D07-335_A1,0,0,1,0,0,1
AGGCTTAAGTTGCACA-1_V12D07-335_A1,0,0,2,0,0,2
TAGGATCTTAACCGCA-1_V12D07-335_A1,0,1,0,0,0,1
GACTTTCGAGCGGTTC-1_V12D07-335_A1,0,2,1,0,0,3
CCCTGGGAGGGATCCT-1_V12D07-335_A1,0,0,4,0,0,4
TAGTAGTTGCCGGACA-1_V12D07-335_A1,0,1,1,0,0,2
GCCCTAAGTGCAGGAT-1_V12D07-335_A1,0,2,0,0,0,2
ACTTGGGCTTTCGCCA-1_V12D07-335_A1,0,3,2,0,0,5
CATGATACGGTGAAAC-1_V12D07-335_A1,0,0,1,0,0,1
TCCTGCAGCCGCCAAT-1_V12D07-335_A1,0,4,1,1,0,6
GTCCGTTAGAGGGCCT-1_V12D07-335_A1,0,1,1,0,0,2
GCTTTATTAAGTTACC-1_V12D07-335_A1,2,1,3,0,0,6
AATCGAGGTCTCAAGG-1_V12D07-335_A1,0,5,1,0,0,6
GTGCTGTTAGAACATA-1_V12D07-335_A1,2,6,2,0,0,10
GGCTTCTCGTGGGTGG-1_V12D07-335_A1,0,3,2,0,0,5
CCTACAGTTGAGGGAG-1_V12D07-335_A1,0,4,3,0,0,7
TATCCCTCGATCTGCA-1_V12D07-335_A1,0,3,2,0,0,5
CCGGTATCTGGCGACT-1_V12D07-335_A1,1,3,1,0,0,5
CTCTAACACCGGCAGC-1_V12D07-335_A1,0,3,2,0,0,5
CTTCATCACCAGGGCT-1_V12D07-335_A1,1,3,0,0,0,4
GGCTGGCAATCCCACG-1_V12D07-335_A1,1,4,3,0,0,8
CAAACCATAAGCGTAT-1_V12D07-335_A1,0,5,1,1,0,7
CATGTGGGCTCATCAC-1_V12D07-335_A1,0,2,2,0,0,4
CCCGTGACAGTGCCTT-1_V12D07-335_A1,0,7,3,0,0,10
GATTATCTTGCATTAT-1_V12D07-335_A1,0,3,0,0,0,3
GAGTCCACCAGGTTTA-1_V12D07-335_A1,0,5,0,1,0,6
TGTACTATCGCTCGTT-1_V12D07-335_A1,1,7,3,0,0,11
TTAGCGAATAGATAGG-1_V12D07-335_A1,0,3,1,0,0,4
ACATACAATCAAGCGG-1_V12D07-335_A1,0,4,3,0,0,7
ATTCGTGTACCCATTC-1_V12D07-335_A1,0,6,1,1,0,8
GCTAGCAACGCACCTA-1_V12D07-335_A1,0,1,1,0,0,2
ACCTCAGCGAGGCGCA-1_V12D07-335_A1,0,1,2,0,0,3
TCCGGGCCACTAACGG-1_V12D07-335_A1,0,1,2,0,0,3
TCCCAATATCGACGAC-1_V12D07-335_A1,0,3,2,0,0,5
GGATTGAAGTAGCCTC-1_V12D07-335_A1,0,2,0,0,0,2
GGCGCACAGTTTACCT-1_V12D07-335_A1,0,1,4,0,0,5
CCCGGCACGTGTCAGG-1_V12D07-335_A1,0,2,1,0,0,3
AGTAAGGGACAGAATC-1_V12D07-335_A1,0,0,2,0,1,3
TTGCGCACAACCACGT-1_V12D07-335_A1,0,2,0,0,0,2
CCTGCTACAACCATAC-1_V12D07-335_A1,0,2,0,0,0,2
CTGGGCTACTGGAGAG-1_V12D07-335_A1,0,2,2,0,1,5
AGCTACGAATGGTGGT-1_V12D07-335_A1,1,5,4,0,0,10
ATTCGTTTATCGTATT-1_V12D07-335_A1,0,2,0,0,0,2
GGCATTCCCTCCCTCG-1_V12D07-335_A1,1,1,1,0,0,3
AGTTATTCAGACTGTG-1_V12D07-335_A1,0,1,0,0,0,1
CCACTTTCCTTCTAGG-1_V12D07-335_A1,3,5,1,0,0,9
CGCAGTTCTATCTTTC-1_V12D07-335_A1,1,1,1,0,0,3
AGGAGCGTTTATTATC-1_V12D07-335_A1,0,3,0,0,0,3
GACAGGTAATCCGTGT-1_V12D07-335_A1,1,1,0,0,0,2
TTCCCAAAGTACTGAT-1_V12D07-335_A1,0,2,4,0,0,6
CTGCAGGGTGACGCTC-1_V12D07-335_A1,0,0,0,0,0,0
TCATGGAGGCCTTTGT-1_V12D07-335_A1,0,0,2,0,0,2
ATGGCCCGAAAGGTTA-1_V12D07-335_A1,0,0,0,0,0,0
CGTAATATGGCCCTTG-1_V12D07-335_A1,0,1,1,0,0,2
AGAGTCTTAATGAAAG-1_V12D07-335_A1,0,0,1,0,0,1
GAACGTTTGTATCCAC-1_V12D07-335_A1,0,0,0,0,0,0
ATTGAATTCCCTGTAG-1_V12D07-335_A1,0,1,3,0,0,4
TACCTCACCAATTGTA-1_V12D07-335_A1,0,0,2,0,0,2
AGTCGAATTAGCGTAA-1_V12D07-335_A1,0,1,0,0,2,3
TTGAAGTGCATCTACA-1_V12D07-335_A1,0,2,0,0,3,5
