key,oligo,other,astrocyte,neuron,microglia,n_cells
ACGCCTGACACGCGCT-1_V12D07-332_B1,6,1,0,0,2,9
TACCGATCCAACACTT-1_V12D07-332_B1,3,4,0,0,4,11
ATTAAAGCGGACGAGC-1_V12D07-332_B1,3,3,0,0,1,7
GATAAGGGACGATTAG-1_V12D07-332_B1,4,3,0,0,1,8
GTGCAAATCACCAATA-1_V12D07-332_B1,3,2,0,0,1,6
TGTTGGCTGGCGGAAG-1_V12D07-332_B1,6,2,0,1,3,12
GCATCCTCTCCTATTA-1_V12D07-332_B1,0,8,0,3,0,11
GCGAGGGACTGCTAGA-1_V12D07-332_B1,0,4,0,1,0,5
TGGTACCGGCACAGCC-1_V12D07-332_B1,1,0,0,0,1,2
GCGCGTTTAAATCGTA-1_V12D07-332_B1,0,1,1,0,0,2
TGCCTTGCCCTTACGG-1_V12D07-332_B1,0,0,0,0,0,0
GACGACTTTCCAAGAA-1_V12D07-332_B1,0,2,0,0,1,3
CCAGTGAGCTCCTTGT-1_V12D07-332_B1,0,0,0,0,0,0
ATACCCTGGCTCAAAT-1_V12D07-332_B1,0,2,0,0,0,2
GGGTTTCCGGCTTCCA-1_V12D07-332_B1,0,3,0,4,1,8
TAACCGTCCAGTTCAT-1_V12D07-332_B1,0,2,0,13,0,15
AAACAACGAATAGTTC-1_V12D07-332_B1,1,0,0,0,0,1
CAAGGGAGTGTATTTG-1_V12D07-332_B1,0,1,0,0,0,1
CCAAGCTTGATCTCCT-1_V12D07-332_B1,1,2,0,1,0,4
TTATTTCATCCCAAAC-1_V12D07-332_B1,0,1,0,0,0,1
GAGCGCTATGTCAGGC-1_V12D07-332_B1,0,1,0,0,0,1
TATGGCAGACTTTCGA-1_V12D07-332_B1,0,0,0,0,0,0
CTTCGTGCCCGCATCG-1_V12D07-332_B1,0,1,0,0,2,3
AAACGGGTTGGTATCC-1_V12D07-332_B1,0,0,0,1,0,1
TGCAAACCCACATCAA-1_V12D07-332_B1,1,1,0,9,0,11
GACGGGATGTCTTATG-1_V12D07-332_B1,0,0,0,5,0,5
GGCGAGCATCGAGGAC-1_V12D07-332_B1,0,0,0,0,0,0
CGCGTGCTATCAACGA-1_V12D07-332_B1,0,0,0,1,1,2
TGAAACCTCAACTCAC-1_V12D07-332_B1,0,0,0,0,0,0
CACATAAGGCGACCGT-1_V12D07-332_B1,0,0,0,0,0,0
TGACCCAACTCACATT-1_V12D07-332_B1,0,1,0,0,0,1
ATACGCCGATCTACCG-1_V12D07-332_B1,0,0,0,0,0,0
ACTTATCTGATCTATA-1_V12D07-332_B1,0,0,0,0,0,0
GTGTGAGCCGAGGTGC-1_V12D07-332_B1,0,0,1,0,0,1
GATGATTTGAAACTGG-1_V12D07-332_B1,0,0,0,0,0,0
GGGAACCACCTGTTTC-1_V12D07-332_B1,0,0,0,0,0,0
GTTCGTTGCGGACCAG-1_V12D07-332_B1,1,2,0,0,0,3
TGAGGTTGATCCCAAG-1_V12D07-332_B1,1,2,1,0,0,4
GATGCCACACTACAGC-1_V12D07-332_B1,1,3,0,0,0,4
AGGCAAAGAGGAATCA-1_V12D07-332_B1,0,2,0,0,0,2
AAGTAAGCTTCCAAAC-1_V12D07-332_B1,1,1,1,0,0,3
AACGTAGTCTACCCAT-1_V12D07-332_B1,1,1,0,0,1,3
GTTTGAGCGGTTATGT-1_V12D07-332_B1,0,1,0,0,0,1
GAAGCAAGGCAATGTT-1_V12D07-332_B1,0,1,0,1,1,3
TCACTCAGCGCATTAG-1_V12D07-332_B1,0,0,0,5,0,5
TACAATGAAACCAGCA-1_V12D07-332_B1,0,0,0,15,0,15
GTGCGCTTACAAATGA-1_V12D07-332_B1,0,0,0,5,1,6
GCACTCCCACAGTCCC-1_V12D07-332_B1,1,1,0,5,0,7
CGAAGACTGCCCGGGA-1_V12D07-332_B1,1,0,1,0,1,3
CAGGATCCGCCCGACC-1_V12D07-332_B1,1,0,0,1,0,2
CACGATTGGTCGTTAA-1_V12D07-332_B1,1,0,1,0,0,2
GGTTGTATCGTGAAAT-1_V12D07-332_B1,0,0,0,5,2,7
TCTTATGGGTAGTACC-1_V12D07-332_B1,0,3,0,11,0,14
TACAAGCTGTTCACTG-1_V12D07-332_B1,0,0,0,8,0,8
GTATCTTGTTGCTCAC-1_V12D07-332_B1,0,0,0,0,0,0
ATACCAGGTGAGCGAT-1_V12D07-332_B1,0,2,0,0,0,2
CCTAAACAGGGTCCGT-1_V12D07-332_B1,0,0,0,0,0,0
ATGGTGCTCAAAGCCA-1_V12D07-332_B1,0,2,0,0,0,2
CAAATGCGGAGTGTTC-1_V12D07-332_B1,0,1,0,0,0,1
CGTGCCCGACATTTGT-1_V12D07-332_B1,0,1,0,0,0,1
GTATCTCCCTAACTGT-1_V12D07-332_B1,1,0,0,0,0,1
ATTTGCCTAGTTACGA-1_V12D07-332_B1,1,0,0,0,1,2
ACGTCCTAAACGAGAT-1_V12D07-332_B1,0,6,0,10,2,18
CTGGGATCGCCCAGAT-1_V12D07-332_B1,0,8,2,2,0,12
CTGCAAATGGGCTCCA-1_V12D07-332_B1,0,0,0,3,3,6
CATTATAACAGGGTCC-1_V12D07-332_B1,0,0,0,0,0,0
ACCTTTCCTTTAGAAG-1_V12D07-332_B1,0,1,1,0,0,2
ATAGATTTGCAGTCGG-1_V12D07-332_B1,0,0,1,0,0,1
CTCGGGCATCGTCGGG-1_V12D07-332_B1,1,0,2,0,1,4
GTGGCGGGCCGTAGCT-1_V12D07-332_B1,4,2,0,0,1,7
CAACAGTGCCAAACGG-1_V12D07-332_B1,0,1,0,0,1,2
TGCGGGTATTGGGATC-1_V12D07-332_B1,0,0,0,0,0,0
GTCTCGCCAACACGCC-1_V12D07-332_B1,3,0,0,0,1,4
CTGGGCGGCCAAATGT-1_V12D07-332_B1,0,0,0,0,1,1
TAAAGGAGAAACTAGT-1_V12D07-332_B1,1,1,0,0,0,2
TCCCACGGAGGGAGCT-1_V12D07-332_B1,0,0,0,0,0,0
AGCTTCAATACTTTGA-1_V12D07-332_B1,1,2,0,0,0,3
TTCCACATTTCTCGTC-1_V12D07-332_B1,1,0,0,0,0,1
ACAAACCGACAAGGCG-1_V12D07-332_B1,2,0,0,0,0,2
AGACGGGATTGGTATA-1_V12D07-332_B1,0,2,0,0,0,2
AACCTAAAGCCGTCCG-1_V12D07-332_B1,3,0,0,0,0,3
TACAAATTGCGGAGGT-1_V12D07-332_B1,1,1,0,0,1,3
CCCGCTAGAGGGTTAA-1_V12D07-332_B1,1,5,0,0,1,7
CATTGCAAAGCATAAT-1_V12D07-332_B1,3,0,0,0,0,3
TGTACGCTATCAGCTT-1_V12D07-332_B1,4,0,0,0,0,4
TTCTTCGCAATAGAGC-1_V12D07-332_B1,2,1,0,0,0,3
TGTGATTCCAGCGCTT-1_V12D07-332_B1,3,1,0,0,1,5
ATTCAGGATCGCCTCT-1_V12D07-332_B1,2,5,0,0,0,7
GCCCATGGGTGCAATG-1_V12D07-332_B1,4,0,0,0,1,5
TTCCCGACGCTTCACT-1_V12D07-332_B1,1,1,0,0,1,3
AGCGGTTGAGATGTAC-1_V12D07-332_B1,7,1,0,1,1,10
GCTGTCTGTGATCGAC-1_V12D07-332_B1,4,1,0,1,1,7
AAAGACATGAAGTTTA-1_V12D07-332_B1,3,0,0,0,1,4
CAACAGAATAACGCTA-1_V12D07-332_B1,4,1,0,0,0,5
TGCGGTCTACGAGTAA-1_V12D07-332_B1,3,1,0,0,0,4
AAGACTCACGCCCACT-1_V12D07-332_B1,3,1,0,1,0,5
CTTTGAAACATATTCC-1_V12D07-332_B1,0,0,0,1,0,1
CTGGGCACTAGTCGGA-1_V12D07-332_B1,1,0,0,0,0,1
CGCCCTTACATCCACC-1_V12D07-332_B1,4,1,0,0,0,5
CACGACCACAGACTTT-1_V12D07-332_B1,1,3,0,0,0,4
CAATCCATTATCCGTT-1_V12D07-332_B1,2,2,0,0,1,5
GTGGCGTGCACCAGAG-1_V12D07-332_B1,0,1,0,1,0,2
CGGAGTCCTAACCTGG-1_V12D07-332_B1,2,0,0,1,0,3
GGTCCCATAACATAGA-1_V12D07-332_B1,2,2,1,0,1,6
ATCTCATAAACCTACC-1_V12D07-332_B1,5,1,0,0,0,6
TGCATGGCAGTCTTGC-1_V12D07-332_B1,2,1,0,0,0,3
TTGCAGGTCATGAAGT-1_V12D07-332_B1,0,1,0,0,1,2
AGCTGCATTTGAGGTG-1_V12D07-332_B1,1,1,0,0,0,2
TAATCAGGAATGCTGC-1_V12D07-332_B1,0,0,0,0,0,0
CCATCATAAGAACAGG-1_V12D07-332_B1,2,2,0,0,0,4
TCGTATCACCAAGCTA-1_V12D07-332_B1,0,1,0,0,0,1
ATTCAGATGAATCCCT-1_V12D07-332_B1,0,1,0,0,0,1
AAAGGTCAACGACATG-1_V12D07-332_B1,0,0,0,0,1,1
AGCTGCTGTGCCGAAT-1_V12D07-332_B1,1,5,0,0,0,6
CTAGCGCCAATCCTAC-1_V12D07-332_B1,0,0,0,0,0,0
GCTCGACCGAACTGAA-1_V12D07-332_B1,0,0,0,0,1,1
ACAGTGCAGCGCATTT-1_V12D07-332_B1,0,0,0,0,0,0
CGGCTGAAGGTTACGC-1_V12D07-332_B1,0,0,0,0,0,0
CACCTCTACGAGTGTG-1_V12D07-332_B1,0,2,0,0,0,2
ATACGACAGATGGGTA-1_V12D07-332_B1,0,0,0,0,1,1
ACTTCCTGTCGTGCGA-1_V12D07-332_B1,0,2,0,0,0,2
CGTAACGGAACGATCA-1_V12D07-332_B1,0,2,0,0,0,2
AAATCACTCCTAAACG-1_V12D07-332_B1,0,1,0,0,0,1
CTCCGAGTAAATCCGC-1_V12D07-332_B1,1,1,0,0,2,4
ACGCTAGTATCAGTGC-1_V12D07-332_B1,0,1,0,0,1,2
AGAGTGAACAGACACC-1_V12D07-332_B1,0,1,0,0,0,1
ACACCCGTAAATCTGT-1_V12D07-332_B1,0,1,0,0,0,1
GCTTTGCTGCCGGGTA-1_V12D07-332_B1,0,1,0,0,0,1
ACAGGAGGCGCAGCCG-1_V12D07-332_B1,1,2,0,0,4,7
AGGCAATACGGAGGAC-1_V12D07-332_B1,6,0,0,0,2,8
TGGTGTGACAGACGAT-1_V12D07-332_B1,4,0,0,0,5,9
ATCTATCGATGATCAA-1_V12D07-332_B1,3,3,0,0,0,6
CGGTAACAAGATACAT-1_V12D07-332_B1,2,2,0,0,4,8
TCGCCGGAGAGTCTTA-1_V12D07-332_B1,3,1,0,2,3,9
GGAGGAGTGTGTTTAT-1_V12D07-332_B1,7,4,0,0,1,12
TTAGGTGTGACTGGTC-1_V12D07-332_B1,8,3,0,0,1,12
CAGGGCTAACGAAACC-1_V12D07-332_B1,0,2,0,3,0,5
CCCGTGGGTTAATTGA-1_V12D07-332_B1,0,6,0,1,0,7
GACCGACCGCTAATAT-1_V12D07-332_B1,0,0,0,0,0,0
GGTATCAAGCATAGAA-1_V12D07-332_B1,0,0,0,0,0,0
TGCATGAGTAGATTCG-1_V12D07-332_B1,0,0,0,0,0,0
AATTCCAACTTGGTGA-1_V12D07-332_B1,0,0,0,0,0,0
TGCCGATGTCATCAAT-1_V12D07-332_B1,1,0,0,1,0,2
GCTGGGTCCGCTGTTA-1_V12D07-332_B1,0,0,0,0,0,0
TGAACACCCGAAGCAG-1_V12D07-332_B1,0,1,0,10,0,11
AACATTGGTCAGCCGT-1_V12D07-332_B1,0,0,0,4,0,4
GTGGGTCTTCTTTGCG-1_V12D07-332_B1,0,4,0,0,0,4
CATCGAATGGATCTCT-1_V12D07-332_B1,0,0,0,0,0,0
GCTACACTGTCCGAAC-1_V12D07-332_B1,0,0,0,0,0,0
CGGGTTGTAGCTTTGG-1_V12D07-332_B1,0,2,0,0,0,2
CCTAAGTGTCTAACCG-1_V12D07-332_B1,0,0,0,2,1,3
TCTGTGACTGACCGTT-1_V12D07-332_B1,0,0,0,0,0,0
TTATCATACTCGCAAA-1_V12D07-332_B1,1,2,0,0,0,3
AGCGTAGCGCTAGACC-1_V12D07-332_B1,0,2,0,0,0,2
TCCCTCCGAAATCGTT-1_V12D07-332_B1,0,1,0,0,0,1
AGGTCGCCACTTCGGT-1_V12D07-332_B1,0,0,0,0,1,1
CTAGCAACTAATTTAC-1_V12D07-332_B1,0,2,0,10,0,12
TTGCTAGCTACCAATC-1_V12D07-332_B1,0,1,0,3,0,4
GCCGGTTTGGGCGGAT-1_V12D07-332_B1,0,2,0,0,0,2
TGTAACTTGTCAACCT-1_V12D07-332_B1,0,0,1,9,1,11
CGAGATGTTGCCTATA-1_V12D07-332_B1,1,0,0,0,0,1
GTTACGAAATCCACGC-1_V12D07-332_B1,1,1,0,0,1,3
CTTGTCGTACGTGTCA-1_V12D07-332_B1,0,1,0,0,0,1
GCGTCCAGCTCGTGGC-1_V12D07-332_B1,0,1,0,0,0,1
CCCTTCTCGTACGCGA-1_V12D07-332_B1,0,0,0,0,0,0
CCAAAGTCCCGCTAAC-1_V12D07-332_B1,0,0,0,0,0,0
CCGCTTCGCGGTTAAC-1_V12D07-332_B1,0,0,0,0,0,0
GTTACGGCCCGACTGC-1_V12D07-332_B1,0,1,0,0,0,1
CCCGCTTGCCCTCGTC-1_V12D07-332_B1,0,2,1,0,1,4
TAGTGAGAAGTGGTTG-1_V12D07-332_B1,0,0,0,0,0,0
CGCTACCGCCCTATGA-1_V12D07-332_B1,1,0,0,0,0,1
AAACAATCTACTAGCA-1_V12D07-332_B1,0,1,0,0,0,1
GCGCGATGGGTCAAGT-1_V12D07-332_B1,0,2,0,1,0,3
ATAAACCATTGGACGG-1_V12D07-332_B1,0,3,0,12,1,16
TCGGGCACTTCTGGAT-1_V12D07-332_B1,0,0,1,13,1,15
TCTGTGGCTACATTTC-1_V12D07-332_B1,0,2,0,4,0,6
CTCTGTGCCTGCTATG-1_V12D07-332_B1,0,0,0,1,0,1
CACGACTAAAGTTCTG-1_V12D07-332_B1,0,0,0,0,0,0
GAGGAGTAATTCCTAC-1_V12D07-332_B1,0,0,0,0,0,0
AGAGGTATCTCGGTCC-1_V12D07-332_B1,1,0,0,0,1,2
GGCGTACCCTATATAA-1_V12D07-332_B1,0,2,0,2,0,4
GCCGGAAACACATCTT-1_V12D07-332_B1,0,2,0,4,1,7
AAATGTGGGTGCTCCT-1_V12D07-332_B1,1,3,1,4,0,9
ACCAGGAGTGTGATCT-1_V12D07-332_B1,0,1,0,8,1,10
TGTGGAGGAAGCTTAA-1_V12D07-332_B1,0,2,0,0,0,2
AAGGAGAACTTATAAG-1_V12D07-332_B1,0,0,0,0,0,0
CCCTCGGGAGCCTTGT-1_V12D07-332_B1,2,0,0,0,0,2
ACTGTTTAGTGTAGGC-1_V12D07-332_B1,0,5,0,0,0,5
CGTCAGTTTATCGTCT-1_V12D07-332_B1,0,0,0,0,1,1
GCGTGTATGTCGTATT-1_V12D07-332_B1,0,0,0,0,0,0
ACAATCGATCTTTATA-1_V12D07-332_B1,2,0,0,0,0,2
CAGCCCTCACAGGCAG-1_V12D07-332_B1,1,1,0,0,0,2
CGCGTCATATTAAACC-1_V12D07-332_B1,0,5,0,11,0,16
GAAGACTTCAATGCCG-1_V12D07-332_B1,0,3,1,1,0,5
TTGCGGCGACTCATGC-1_V12D07-332_B1,0,0,0,0,0,0
ACCAAACTAGAAATCC-1_V12D07-332_B1,1,2,0,1,0,4
TTACTGTTTCTCTACG-1_V12D07-332_B1,2,2,0,0,0,4
GACCAGGTCATTCATA-1_V12D07-332_B1,2,0,0,0,1,3
TTCTTCCCTTTGATAT-1_V12D07-332_B1,0,1,0,0,0,1
ACGCCCAGCTGTCGAT-1_V12D07-332_B1,1,1,0,0,0,2
AGTAGCGTGAACGAAC-1_V12D07-332_B1,0,2,0,0,0,2
CCTCGACCCACTGCCT-1_V12D07-332_B1,0,0,0,0,0,0
AGTTATTGAAAGGTAA-1_V12D07-332_B1,1,1,0,0,0,2
TCAGTTACGGAATGAT-1_V12D07-332_B1,1,1,0,0,0,2
GAATCTATACTCGGAC-1_V12D07-332_B1,1,1,0,0,0,2
TCGGCTAACTTCCCTT-1_V12D07-332_B1,2,2,0,0,0,4
ACGTGGTCGAATGTGC-1_V12D07-332_B1,0,0,0,0,1,1
ATATCGTGCCAGACCC-1_V12D07-332_B1,3,1,0,0,0,4
GTAGCTAGTAAGCGCG-1_V12D07-332_B1,0,0,0,0,0,0
ACGCTTAGTGTCTCTC-1_V12D07-332_B1,1,3,0,0,0,4
TCCGGCCTGCATCGAT-1_V12D07-332_B1,3,0,0,0,0,3
TAGTGGAACTCATACA-1_V12D07-332_B1,1,0,0,0,0,1
ATCATCTGCCCAGTGT-1_V12D07-332_B1,2,2,0,0,0,4
GTTATTAAATACGACC-1_V12D07-332_B1,1,0,0,0,0,1
GCGCTAAGTATGCATG-1_V12D07-332_B1,2,4,0,0,0,6
CCTGACGCAACCTTTA-1_V12D07-332_B1,1,1,0,0,0,2
CCCAAGAATGCACGGT-1_V12D07-332_B1,6,2,0,0,0,8
AACTGGGTTCGAGCCG-1_V12D07-332_B1,2,1,0,0,0,3
GGTTCCACCCGCTTCT-1_V12D07-332_B1,6,1,0,0,0,7
CATGCACGTGTTACTG-1_V12D07-332_B1,3,3,0,0,0,6
AGCGTTCCGATTTAAA-1_V12D07-332_B1,3,1,0,0,1,5
CCTACGCGACCTTACA-1_V12D07-332_B1,2,0,0,0,3,5
CGAATTACATGGTGTT-1_V12D07-332_B1,1,3,0,0,1,5
GAGGTCTTAGTGGGTC-1_V12D07-332_B1,4,2,0,0,0,6
GCCGCTAGATACGCAG-1_V12D07-332_B1,2,4,0,0,0,6
GTCACCTGTCTATGTC-1_V12D07-332_B1,2,0,0,0,0,2
CCGATTGGTCAATGAA-1_V12D07-332_B1,0,1,0,0,0,1
CCTGTGCGGATTGTAA-1_V12D07-332_B1,3,2,0,0,0,5
TTACGTAGCGCGTGCT-1_V12D07-332_B1,4,0,0,1,0,5
GGAGGCGAAGAACCGC-1_V12D07-332_B1,2,2,0,0,0,4
GGGTCACGTGCTTATG-1_V12D07-332_B1,4,3,0,0,1,8
GCTCCGGACGTTGATA-1_V12D07-332_B1,1,0,0,1,0,2
ATGTTTGTAAGATCAT-1_V12D07-332_B1,2,1,0,0,0,3
TGACCCAGCATTCCCG-1_V12D07-332_B1,1,1,0,0,0,2
TGGTCGTTTGATAGAT-1_V12D07-332_B1,1,1,0,0,0,2
TGTAATGCCTTCGGAC-1_V12D07-332_B1,0,1,0,0,0,1
TGCTCACACAACAACC-1_V12D07-332_B1,3,1,0,1,0,5
TACGATCCAAGCCACT-1_V12D07-332_B1,2,1,0,0,0,3
TTGTAACTTCATAGCG-1_V12D07-332_B1,0,2,0,1,0,3
AGATTCAAGCGGGTCG-1_V12D07-332_B1,0,0,0,0,1,1
CTCAGCAGACTGCCGA-1_V12D07-332_B1,0,0,0,0,0,0
GTAACATCAGCTCATC-1_V12D07-332_B1,0,1,0,0,0,1
ATGGAACAGAATAAAC-1_V12D07-332_B1,1,1,0,0,2,4
GGGCCTATACAACCGG-1_V12D07-332_B1,0,1,0,0,0,1
TCAAACAATTAGGACA-1_V12D07-332_B1,0,0,0,0,0,0
AAACCACTACACAGAT-1_V12D07-332_B1,0,0,0,0,0,0
AAACGACAGTCTTGCC-1_V12D07-332_B1,0,1,0,0,0,1
TTGAGGGTCGAACGCG-1_V12D07-332_B1,0,0,0,0,0,0
TGTTGATCACTGTTTA-1_V12D07-332_B1,0,0,0,0,0,0
AGGGTGTGCTACACGC-1_V12D07-332_B1,0,0,0,0,1,1
GTAGTTAGACAATATA-1_V12D07-332_B1,0,0,0,0,0,0
AATGGCCGCCAATGCG-1_V12D07-332_B1,0,2,0,0,1,3
TCGGCGGTATTAGATT-1_V12D07-332_B1,0,2,0,1,0,3
GGGTCACTGAGTAGTG-1_V12D07-332_B1,0,2,0,0,0,2
GAATTATGCAACCTAC-1_V12D07-332_B1,0,0,0,0,0,0
GATCTTAGTGAACGTG-1_V12D07-332_B1,1,5,0,0,1,7
CTAATGCGCCCAACAA-1_V12D07-332_B1,6,0,0,0,2,8
GCCACCCATTCCACTT-1_V12D07-332_B1,2,0,0,0,2,4
TACTCACAACGTAGTA-1_V12D07-332_B1,9,3,0,0,2,14
GTTCGGTGTGGATTTA-1_V12D07-332_B1,4,0,0,0,4,8
TCTTTCGGCGGGACAC-1_V12D07-332_B1,7,5,0,0,2,14
GGAGACATTCACGGGC-1_V12D07-332_B1,3,2,0,0,0,5
GGGATTATCTCACAAC-1_V12D07-332_B1,1,1,0,0,0,2
TAGAACGCCAGTAACG-1_V12D07-332_B1,3,7,0,0,0,10
ACGAGTCGCCGGCGTT-1_V12D07-332_B1,3,3,1,0,1,8
TGATGGGACTAAGTCA-1_V12D07-332_B1,2,4,0,0,1,7
TGCGAGAAACGTTACG-1_V12D07-332_B1,0,7,0,1,0,8
TCGCCTCGACCTGTTG-1_V12D07-332_B1,1,11,0,5,1,18
AACTCGATAAACACGT-1_V12D07-332_B1,0,2,0,0,0,2
AGGAAAGCCTCTGATG-1_V12D07-332_B1,0,2,0,0,0,2
GAAGGACTAAATTGAA-1_V12D07-332_B1,0,1,0,0,0,1
GTATCGGGACGAGCTG-1_V12D07-332_B1,0,1,0,0,0,1
CCTGTGCATAGGAGAC-1_V12D07-332_B1,0,1,1,10,0,12
CATACGGGTGCATGAT-1_V12D07-332_B1,0,0,0,7,0,7
CCACTAAACTGAATCG-1_V12D07-332_B1,0,0,0,0,1,1
AAATTGCGGCGGTTCT-1_V12D07-332_B1,1,3,1,0,0,5
AGTCCAGCGGGTACGT-1_V12D07-332_B1,0,0,0,0,0,0
CATTCAGGTCAGTGCG-1_V12D07-332_B1,1,2,0,0,0,3
CTAAAGTCCGAAGCTA-1_V12D07-332_B1,1,1,0,0,0,2
AATCAGACTGCAGGAC-1_V12D07-332_B1,1,0,0,0,0,1
AGTATCCATAATAACG-1_V12D07-332_B1,1,2,0,0,0,3
CTGGCTGCTAACGTAA-1_V12D07-332_B1,0,2,0,1,0,3
GTTCCAAGACAGCGAC-1_V12D07-332_B1,1,2,0,0,1,4
AAGACTAACCCGTTGT-1_V12D07-332_B1,0,3,0,0,0,3
GATTAATCCTGGCTCA-1_V12D07-332_B1,0,2,0,1,1,4
CGCGCAAGGAACTACA-1_V12D07-332_B1,0,3,0,0,0,3
CAGTAGCGAGGTAGTA-1_V12D07-332_B1,0,2,0,0,3,5
ACGGCGGGTTGCCCTG-1_V12D07-332_B1,1,0,0,0,0,1
CTAGGCGGCAGAGAAT-1_V12D07-332_B1,0,3,0,8,0,11
GTGCGCAGCTTGCTCC-1_V12D07-332_B1,0,1,1,0,0,2
TCACTATCGTGCAATC-1_V12D07-332_B1,0,1,0,12,0,13
TATGATTCTGCTTGGT-1_V12D07-332_B1,0,1,0,2,0,3
TAAGATTTAGCGGGAG-1_V12D07-332_B1,0,1,0,1,0,2
TTACGGTGTCACCGAG-1_V12D07-332_B1,1,0,0,3,0,4
CTACACTAGCTTGTTC-1_V12D07-332_B1,0,1,1,0,0,2
TGAGCAGTCGTGAAGT-1_V12D07-332_B1,0,1,0,12,0,13
CGCTGAGGACGTCCAA-1_V12D07-332_B1,0,2,0,0,0,2
GTGTATGACTTTAAAG-1_V12D07-332_B1,0,0,0,6,0,6
CTAAACGGGTGTAATC-1_V12D07-332_B1,0,0,0,4,0,4
TGTACTGTGCCAAAGT-1_V12D07-332_B1,0,0,1,4,0,5
GGCCACAAGCGATGGC-1_V12D07-332_B1,0,1,0,17,1,19
GTCAATTGTACTGAAG-1_V12D07-332_B1,0,1,0,3,0,4
AGGGACAGCACGGCGG-1_V12D07-332_B1,0,3,0,12,0,15
AGCTTATAGAGACCTG-1_V12D07-332_B1,0,0,0,1,2,3
AACTAGCGTATCGCAC-1_V12D07-332_B1,0,1,0,0,0,1
AACTTTAGCTGCTGAG-1_V12D07-332_B1,2,0,0,0,0,2
CCCAAGACAGAGTATG-1_V12D07-332_B1,1,1,0,0,0,2
GGCATCAACGAGCACG-1_V12D07-332_B1,0,1,0,0,1,2
ATGCATTCCGTGATGG-1_V12D07-332_B1,1,1,0,1,0,3
TTATAGATGCACATTA-1_V12D07-332_B1,0,0,0,0,0,0
GAACCATCTGGGAGAC-1_V12D07-332_B1,1,2,0,5,0,8
TGCTATACAAACGGAC-1_V12D07-332_B1,1,2,0,3,1,7
ACTTGCCATATTGTAC-1_V12D07-332_B1,0,1,0,20,0,21
TATTCCGGCAGTCCTA-1_V12D07-332_B1,1,1,0,6,0,8
GACGGACCGCGTTCCT-1_V12D07-332_B1,0,0,0,0,0,0
ATGTGTAGTTTAGTCA-1_V12D07-332_B1,0,2,0,1,0,3
ATACCAGCAAATTGCT-1_V12D07-332_B1,1,2,0,0,0,3
AAGTTTACTAATGGCA-1_V12D07-332_B1,1,4,0,0,0,5
CTCTCGATGTGCGCCT-1_V12D07-332_B1,0,3,0,0,0,3
GATTGACACTCTGCTC-1_V12D07-332_B1,0,1,0,0,0,1
TATCACAGCACGGGCA-1_V12D07-332_B1,2,0,0,0,0,2
ACCGTTCCCGCTCTGA-1_V12D07-332_B1,2,1,0,0,0,3
CCGCCACCACAATCCA-1_V12D07-332_B1,1,0,0,0,1,2
CATTCACTGACAGCTA-1_V12D07-332_B1,4,3,0,0,0,7
CGGCTGCAAGATTAAG-1_V12D07-332_B1,2,0,0,0,0,2
CATGAACCTCTTATCA-1_V12D07-332_B1,1,1,0,0,0,2
TTAATGCGAGGTAACT-1_V12D07-332_B1,0,0,0,0,2,2
AATAAGTCCTCGAGAC-1_V12D07-332_B1,3,1,0,0,0,4
ACCAGCCCGGTCTTTG-1_V12D07-332_B1,1,4,1,0,0,6
CTACGAACTAGGTCGA-1_V12D07-332_B1,0,3,0,0,0,3
ACATCTCAACGCGTAA-1_V12D07-332_B1,1,0,0,0,0,1
CACTACTCAGTTCTGT-1_V12D07-332_B1,1,0,0,0,0,1
CCGACTCGCATAGTCT-1_V12D07-332_B1,1,1,0,0,1,3
CATTTATCGTTCAAGA-1_V12D07-332_B1,1,1,0,0,0,2
CAAACGTGGTCTTGCG-1_V12D07-332_B1,2,0,0,0,0,2
TAGAAACCACTAAGTA-1_V12D07-332_B1,0,1,0,0,0,1
ACTGATTTAGTGATTC-1_V12D07-332_B1,0,1,0,0,0,1
TCGTATTTCGTCCGGA-1_V12D07-332_B1,1,1,0,0,0,2
CGGAAATTTCACATCC-1_V12D07-332_B1,0,1,0,0,0,1
ATCCACGCTAAATGTT-1_V12D07-332_B1,0,2,1,0,0,3
GTTCAATCTATGTCAA-1_V12D07-332_B1,1,0,0,0,0,1
ATAAAGGTCAAGTACG-1_V12D07-332_B1,4,2,0,0,0,6
CAACTCCAACGTTTAG-1_V12D07-332_B1,4,2,0,0,0,6
TAGGAACAGCCTCCAG-1_V12D07-332_B1,0,0,0,0,1,1
ATGGGAACGGAAGCGG-1_V12D07-332_B1,3,1,0,0,0,4
CACACGTTTCAATGGG-1_V12D07-332_B1,1,3,0,0,0,4
GGTGTTCTGTTTCTAC-1_V12D07-332_B1,4,0,0,0,0,4
AGTAACGTTCATCCTG-1_V12D07-332_B1,2,0,0,0,0,2
GTATAGTGGCCCATGT-1_V12D07-332_B1,5,0,0,0,0,5
TCTACACGTTCATGCA-1_V12D07-332_B1,2,1,0,0,0,3
AATCTGGGTAGACCCT-1_V12D07-332_B1,1,0,0,0,0,1
TCGGTTAGCCATGTAG-1_V12D07-332_B1,1,1,0,0,0,2
TGCCATGGCTTATAAG-1_V12D07-332_B1,3,3,0,0,0,6
TAAGTAAATGTGCCGC-1_V12D07-332_B1,4,1,0,0,0,5
GTGTCCGATAAGGCAT-1_V12D07-332_B1,3,0,0,0,1,4
TGGCACGAGCTCGAGT-1_V12D07-332_B1,2,2,0,0,2,6
ACCGGTCTGAGTACGG-1_V12D07-332_B1,2,2,0,1,0,5
GAACTTAGCGCCCGGT-1_V12D07-332_B1,3,0,0,1,0,4
AGTAGCTAGACGCCGA-1_V12D07-332_B1,2,0,0,0,0,2
ATAGGAATCTAAGCTT-1_V12D07-332_B1,1,2,0,0,0,3
CTTCCTGCATATTTAC-1_V12D07-332_B1,3,1,0,0,0,4
CAATATGTAGATTTAC-1_V12D07-332_B1,2,1,0,0,0,3
ACAAGGCCTACCAGCC-1_V12D07-332_B1,1,0,0,0,0,1
TTATAGTCCAAGGTGC-1_V12D07-332_B1,1,1,0,0,1,3
AAACGCCCGAGATCGG-1_V12D07-332_B1,2,2,0,0,0,4
CCTCGTTACGCCTGTT-1_V12D07-332_B1,0,0,0,0,0,0
GAACGGTGTAAAGCAG-1_V12D07-332_B1,0,0,0,0,0,0
ACGCATAAATGACATG-1_V12D07-332_B1,0,1,0,0,0,1
GGTTCGATGCTGAGTT-1_V12D07-332_B1,0,0,0,0,0,0
CTTTGGCAGACAGAGT-1_V12D07-332_B1,1,1,0,0,0,2
TTCGTGGGCTGGAAGC-1_V12D07-332_B1,0,0,0,0,0,0
CAAAGGTTAAATTCAG-1_V12D07-332_B1,0,1,0,0,1,2
GTTTGGCGTCAGGCAC-1_V12D07-332_B1,0,0,0,0,1,1
GCTTTCTATCTCAACT-1_V12D07-332_B1,0,1,0,0,0,1
TGCATCTCCGGATCTT-1_V12D07-332_B1,0,0,0,0,0,0
CTGAAACGGCCCTCAG-1_V12D07-332_B1,0,2,0,0,0,2
TAGCAGTAAATACGCG-1_V12D07-332_B1,0,1,0,1,1,3
CGGGCTACTTAAATTG-1_V12D07-332_B1,0,1,0,1,0,2
ATTATGCTCAGTATTG-1_V12D07-332_B1,0,1,0,0,1,2
TGATGCTCACGTAGTC-1_V12D07-332_B1,0,2,0,0,0,2
GTCTAAGATGCCCAGC-1_V12D07-332_B1,0,0,0,0,0,0
AACCCGATAGGGCTTC-1_V12D07-332_B1,0,0,0,0,0,0
CGCTATCGTGGCTTTA-1_V12D07-332_B1,0,5,0,0,0,5
CGTCTCTCGCCGAGGC-1_V12D07-332_B1,0,3,0,0,0,3
AGTGGGAGTATACACG-1_V12D07-332_B1,5,0,0,0,4,9
GGTCTTGGTGTTAACT-1_V12D07-332_B1,6,0,0,0,2,8
GGCTGGCAGCTTTATG-1_V12D07-332_B1,7,5,0,0,3,15
CGCCAATTATTGCGTT-1_V12D07-332_B1,10,3,0,0,1,14
GGTAACCGGCAAAGGT-1_V12D07-332_B1,7,2,0,0,0,9
TGGGACCATTGGGAGT-1_V12D07-332_B1,4,2,0,0,0,6
CTGCAGGTGCTCGGCC-1_V12D07-332_B1,3,0,0,0,0,3
CCGGTGCGAGTGATAG-1_V12D07-332_B1,3,1,0,0,0,4
GGGTACACTCTGGAGG-1_V12D07-332_B1,1,4,0,0,0,5
TAGCCAGAGGGTCCGG-1_V12D07-332_B1,1,1,0,0,0,2
CTTGTGAGGACAGCGG-1_V12D07-332_B1,1,3,0,0,0,4
GAAGGGCATAACCATG-1_V12D07-332_B1,1,5,0,0,0,6
CAACATGGCCTGATAA-1_V12D07-332_B1,0,8,0,4,0,12
CAATTTGACCGGGAAG-1_V12D07-332_B1,0,2,0,0,0,2
TCTGACTGTAATGGTT-1_V12D07-332_B1,0,2,0,0,0,2
TTCATAGCCTTGTAAC-1_V12D07-332_B1,0,0,0,0,0,0
TGGAAACGGAGTGAAC-1_V12D07-332_B1,0,2,0,0,0,2
ATCGCACGATTGTTCA-1_V12D07-332_B1,0,2,0,0,0,2
CGCCACCCGCATTAAC-1_V12D07-332_B1,0,2,0,15,1,18
TGGACCACGGCGTTGA-1_V12D07-332_B1,0,2,0,4,1,7
GTATATGTTACGGCGG-1_V12D07-332_B1,0,0,0,0,0,0
GTATTCTTACCGTGCT-1_V12D07-332_B1,0,3,0,0,0,3
TTCAGAGTAACCTGAC-1_V12D07-332_B1,0,0,0,0,0,0
GCGGTAACCCAAATGA-1_V12D07-332_B1,0,1,0,0,0,1
CTACGTGTTGCCACCA-1_V12D07-332_B1,0,1,0,0,1,2
CTAGATAAACTCCTCG-1_V12D07-332_B1,1,2,0,0,0,3
TCCATTAGTTGGATAG-1_V12D07-332_B1,1,0,0,0,0,1
CTGGCTCCTGCGGGAT-1_V12D07-332_B1,0,1,0,0,0,1
CAGTCTCTCGGCTAAT-1_V12D07-332_B1,0,2,0,0,0,2
GTATGACGTGGGAAAC-1_V12D07-332_B1,0,1,0,0,0,1
AGTCACTCCGCCTCAT-1_V12D07-332_B1,1,0,0,0,0,1
GCAGCGGTGGGCATTA-1_V12D07-332_B1,1,2,0,0,2,5
TATGGAGTTTCTCGTT-1_V12D07-332_B1,0,3,0,0,0,3
ACTCAACGAATGTATT-1_V12D07-332_B1,0,2,0,0,0,2
AACACGCGGCCGCGAA-1_V12D07-332_B1,2,2,0,0,2,6
CGATATTAGCCGCAGG-1_V12D07-332_B1,0,1,0,0,1,2
AGCGTCTGAACCCGCA-1_V12D07-332_B1,1,2,0,0,1,4
GATGTCCGGATCACAT-1_V12D07-332_B1,0,0,0,0,0,0
GGTCACGTTAGATTCA-1_V12D07-332_B1,0,0,0,1,0,1
TTAAGGATACGGAGGT-1_V12D07-332_B1,0,1,0,0,0,1
GTGCGGGACCATCGGC-1_V12D07-332_B1,0,0,1,0,1,2
CCATCTTGTTCACAAT-1_V12D07-332_B1,0,1,0,0,0,1
TCCGAGAAGGCTAAGC-1_V12D07-332_B1,1,2,0,1,0,4
TGGCGGTGTGCGATTG-1_V12D07-332_B1,0,1,0,0,0,1
ATCCTGCTGCAGATAG-1_V12D07-332_B1,0,0,0,1,0,1
TTATGCGTCCCGGTCC-1_V12D07-332_B1,0,2,0,0,0,2
CATAATGAGCGGGCGA-1_V12D07-332_B1,1,0,0,0,0,1
AGACATAGATCCTTCC-1_V12D07-332_B1,3,0,0,2,1,6
GGTGAAACCGGGAATG-1_V12D07-332_B1,1,2,0,0,1,4
AACTGGTGTGGGCCTT-1_V12D07-332_B1,1,1,0,2,1,5
GTAGCGCTGTTGTAGT-1_V12D07-332_B1,0,1,0,0,0,1
TTGTTTGTGTAAATTC-1_V12D07-332_B1,1,2,0,1,2,6
GGATCAAAGGACGAGG-1_V12D07-332_B1,0,2,0,0,1,3
CGTAGCGCCGACGTTG-1_V12D07-332_B1,1,2,0,0,1,4
CAAGTGAACTTTGGTT-1_V12D07-332_B1,1,3,0,0,1,5
GTAGACAACCGATGAA-1_V12D07-332_B1,1,3,0,0,2,6
CAATGGTCGGCCTGGG-1_V12D07-332_B1,0,0,0,5,0,5
ACAGATTAGGTTAGTG-1_V12D07-332_B1,1,1,0,1,0,3
GTTATCACCTTCTGAA-1_V12D07-332_B1,1,0,0,12,0,13
TGGTATCGGTCTGTAT-1_V12D07-332_B1,0,1,0,7,0,8
GGAATAACCTCAAGAA-1_V12D07-332_B1,1,1,0,2,0,4
ATTATCTCGACAGATC-1_V12D07-332_B1,0,0,0,3,1,4
CCGAGGGATGTTAGGC-1_V12D07-332_B1,0,3,1,0,0,4
TGAGATCAAATACTCA-1_V12D07-332_B1,0,0,0,0,0,0
AAACGAAGAACATACC-1_V12D07-332_B1,1,0,0,0,0,1
CTGGTCCTAACTTGGC-1_V12D07-332_B1,1,3,0,0,0,4
TGCACGAGTCGGCAGC-1_V12D07-332_B1,1,0,1,0,0,2
ATAGTCTTTGACGTGC-1_V12D07-332_B1,0,0,0,0,0,0
TGGAGCTAAAGTTCCC-1_V12D07-332_B1,1,0,0,0,0,1
GGGTGGTCCAGCCTGT-1_V12D07-332_B1,1,0,0,0,0,1
CATGCATGGAGACCCT-1_V12D07-332_B1,0,0,0,0,0,0
ACACGGCACTATGCAT-1_V12D07-332_B1,1,1,0,0,0,2
CCCTGGTATGGGCGGC-1_V12D07-332_B1,0,0,0,0,0,0
GGAGGATTGAAAGGAG-1_V12D07-332_B1,2,1,1,0,0,4
CCGCTGGTGCCATTCA-1_V12D07-332_B1,0,1,0,0,0,1
GTTAGAGTGTGCCGCT-1_V12D07-332_B1,0,1,0,0,0,1
TCGGAATGACCATCAA-1_V12D07-332_B1,0,0,0,0,1,1
TTCAATTAGCCATAAT-1_V12D07-332_B1,1,0,0,0,0,1
GATGTGTTGTCACAAG-1_V12D07-332_B1,0,0,0,0,0,0
TCTTTCTCTTAAGGAG-1_V12D07-332_B1,1,1,0,0,1,3
ACCCTTTAGTTCTCCA-1_V12D07-332_B1,0,0,0,0,0,0
ACCACAACTCAGAACA-1_V12D07-332_B1,1,0,0,0,0,1
TATGATAAATCTAACG-1_V12D07-332_B1,0,2,0,0,0,2
GATCCTCTTGCGCTTA-1_V12D07-332_B1,0,1,0,1,1,3
TTCTACCTTTATGTTG-1_V12D07-332_B1,0,1,0,0,0,1
GAAATACCTGCTGGCT-1_V12D07-332_B1,0,2,0,0,0,2
ATTCTGAGTATGAACT-1_V12D07-332_B1,1,2,0,1,1,5
GGATTAAGCTAAGGTC-1_V12D07-332_B1,1,1,0,0,0,2
AGTACGTGGCCTGTCT-1_V12D07-332_B1,0,0,0,0,1,1
TCAGGGTGCACGAAAC-1_V12D07-332_B1,1,1,0,0,0,2
AAATTTACCGAAATCC-1_V12D07-332_B1,0,1,0,0,1,2
TTGAGGCATTTAACTC-1_V12D07-332_B1,1,0,0,0,0,1
AACCAGTATCACTCTT-1_V12D07-332_B1,0,1,0,0,0,1
CACCGGAGATATCTCC-1_V12D07-332_B1,3,1,0,0,0,4
GACTGGGCGCCGCAAC-1_V12D07-332_B1,4,0,0,0,0,4
CACGTCTATGATGTGG-1_V12D07-332_B1,2,3,0,0,0,5
TTAAGACGAACGAACC-1_V12D07-332_B1,3,1,0,0,0,4
TGACCAGCTTCAAAGT-1_V12D07-332_B1,3,2,0,1,0,6
AGAGTTAGAGACCGAT-1_V12D07-332_B1,8,2,0,0,0,10
TTCGGACTGATGCCTT-1_V12D07-332_B1,5,1,0,0,0,6
CTCGAATGGAACGTAT-1_V12D07-332_B1,6,2,0,0,0,8
GGACGGCTTGCGCAAC-1_V12D07-332_B1,4,2,0,1,0,7
CTAAGTACAGGGCTAC-1_V12D07-332_B1,0,1,0,0,0,1
ACAAATTCAGATCTGA-1_V12D07-332_B1,3,1,0,1,0,5
CATGGAAATGGGACCA-1_V12D07-332_B1,0,1,0,1,0,2
GGTGGACCACGTGTTA-1_V12D07-332_B1,0,0,0,0,0,0
CACGACGTAATAGTAA-1_V12D07-332_B1,1,1,0,0,1,3
CGGGTTCGGCACGTAT-1_V12D07-332_B1,1,0,0,0,1,2
CTGGGCTATCCTTTGG-1_V12D07-332_B1,2,0,0,0,0,2
GTATTAGGGTTCGCGT-1_V12D07-332_B1,2,0,0,0,0,2
TCATTCGTATAATTTG-1_V12D07-332_B1,2,0,0,0,0,2
AATAGCAAGCCTCCTG-1_V12D07-332_B1,0,2,0,0,0,2
CATCTACCCGAGAACG-1_V12D07-332_B1,1,0,0,0,0,1
GCTTCAGTGGGATTAC-1_V12D07-332_B1,0,0,0,0,0,0
TCTGTGATGGAGGTTG-1_V12D07-332_B1,0,2,0,0,0,2
ATCCACTTTCAGACTA-1_V12D07-332_B1,0,3,0,0,1,4
ATGGTTACGAAACATG-1_V12D07-332_B1,0,0,0,0,1,1
GGCCCAATCTAGAGGG-1_V12D07-332_B1,0,0,0,0,0,0
GATGGTGAAATAACCC-1_V12D07-332_B1,0,0,0,0,0,0
AGAGGGACAATTGTCC-1_V12D07-332_B1,0,1,0,0,0,1
CGCGTACATTCTGGAA-1_V12D07-332_B1,0,2,0,0,0,2
CAAGAAACCCTAAACT-1_V12D07-332_B1,0,0,0,0,0,0
TTGGTGCGGTGTTGAA-1_V12D07-332_B1,0,1,0,1,0,2
GGTTCCCTAGTGTCTC-1_V12D07-332_B1,0,1,0,0,0,1
CGATAACCAATTTGAG-1_V12D07-332_B1,0,0,0,0,0,0
GCCCACTGGTCCACAA-1_V12D07-332_B1,0,0,0,1,0,1
GAGGGCCGGCAGAGTC-1_V12D07-332_B1,0,2,0,2,0,4
CGACACGGATGCCCAC-1_V12D07-332_B1,0,3,0,1,0,4
CTGTCTGTGGCTGGCT-1_V12D07-332_B1,3,1,0,0,1,5
ATATTATCCCGTATTT-1_V12D07-332_B1,3,4,0,0,2,9
GCGCTGGCGGAAAGTC-1_V12D07-332_B1,8,2,0,0,6,16
ATCTAACGTCCCTATG-1_V12D07-332_B1,4,1,0,0,1,6
GTCAGACAGCGTTGGA-1_V12D07-332_B1,3,1,0,0,0,4
GCCAGGCTTAGTGGTA-1_V12D07-332_B1,3,1,0,0,0,4
ATTCAAAGTACCTGTT-1_V12D07-332_B1,3,1,0,0,1,5
TGGACGTAGGCGAATC-1_V12D07-332_B1,4,1,0,0,0,5
ACACATTGACGCAACA-1_V12D07-332_B1,3,0,0,0,1,4
GATATCAGTATGTATC-1_V12D07-332_B1,5,5,0,0,0,10
TGGGCCTTGCCTGCAT-1_V12D07-332_B1,4,0,0,0,1,5
CAAAGTCAGGTTAGCT-1_V12D07-332_B1,3,3,0,0,1,7
GGATCCCTACCAGCTA-1_V12D07-332_B1,1,3,0,1,1,6
ATCGTCCAATCGAGTC-1_V12D07-332_B1,0,0,0,1,1,2
ACATGGCTCAATTTAG-1_V12D07-332_B1,0,2,0,0,0,2
AGGCCCAGTGACTGGT-1_V12D07-332_B1,0,4,0,0,0,4
GCTTCCAGCTTAGATT-1_V12D07-332_B1,0,3,0,0,0,3
TGCTTGAAACCATGCA-1_V12D07-332_B1,0,3,0,0,0,3
CAATATTGGACTAGTG-1_V12D07-332_B1,0,1,0,7,0,8
CGTGCTGGCCTAGTCG-1_V12D07-332_B1,0,3,0,10,1,14
CCTGCGATAGAACTGT-1_V12D07-332_B1,0,2,0,0,0,2
GGGTAATGCTGTGTTT-1_V12D07-332_B1,1,1,0,0,0,2
AACGCGAACGGCAACA-1_V12D07-332_B1,0,0,0,1,0,1
TGTCGGCATGGTGGAA-1_V12D07-332_B1,0,1,0,0,0,1
AGCGTACGAGAGCTAG-1_V12D07-332_B1,0,3,0,0,0,3
ATACTCTCGCCACTCT-1_V12D07-332_B1,0,1,0,1,0,2
AATCCATGCAAGGGTG-1_V12D07-332_B1,0,1,0,0,0,1
TTAAACAGAGTCCCGC-1_V12D07-332_B1,0,0,0,0,0,0
CCACAGCTGAAATCAT-1_V12D07-332_B1,0,1,0,0,0,1
CGGTTCCGGCTTCTTG-1_V12D07-332_B1,0,1,0,0,0,1
GACGTGAGACTCCATG-1_V12D07-332_B1,0,0,0,0,0,0
TCGTTGGCTCGTCAAT-1_V12D07-332_B1,2,0,0,0,0,2
GGTGAACGGGCTAGCC-1_V12D07-332_B1,1,0,0,0,0,1
GCACTGTGCAAATGTA-1_V12D07-332_B1,0,0,0,0,1,1
ACGAGAACCCATCACG-1_V12D07-332_B1,0,1,0,0,1,2
CCAGCTACGCCTCATA-1_V12D07-332_B1,0,0,0,1,0,1
TCCCGGTCAGGAATTT-1_V12D07-332_B1,0,0,0,2,0,2
TCGCATTCAATGACTT-1_V12D07-332_B1,1,0,0,1,0,2
CTGGTTCAACGCATCA-1_V12D07-332_B1,0,3,0,0,0,3
GGTGATTTCATCTTGT-1_V12D07-332_B1,0,1,0,0,0,1
CACCCTTTCCTCGCTC-1_V12D07-332_B1,0,1,0,0,0,1
CAACTTGTAGTGGGCA-1_V12D07-332_B1,1,1,0,0,0,2
AATATCAAGGTCGGAT-1_V12D07-332_B1,0,3,0,0,1,4
ACTCAGACCTGCTTCT-1_V12D07-332_B1,1,0,0,1,0,2
TTGGAGTCTCCCTTCT-1_V12D07-332_B1,0,0,0,0,2,2
GGATACTCATGAATTG-1_V12D07-332_B1,0,0,0,0,0,0
TGGGCACAAACAGAAC-1_V12D07-332_B1,0,1,0,0,0,1
GAGCCACGGTAGTAGG-1_V12D07-332_B1,0,2,0,0,0,2
TCGATAGGCTAGTCGC-1_V12D07-332_B1,0,0,0,0,0,0
TAACCGCCCGCAGTGC-1_V12D07-332_B1,1,1,0,0,1,3
GCCTATTTGCTACACA-1_V12D07-332_B1,0,0,0,0,0,0
TTGACGATTCAGCACG-1_V12D07-332_B1,0,1,0,1,0,2
TTAAACCGGTAGCGAC-1_V12D07-332_B1,0,1,0,0,0,1
ACCGAAAGGGCCCTGC-1_V12D07-332_B1,1,3,0,1,0,5
ACGTTCCGCGCTCCGT-1_V12D07-332_B1,0,2,0,0,0,2
ATACCAGGCTAATAGA-1_V12D07-332_B1,0,3,0,0,0,3
CGGCTTTGTATGATAA-1_V12D07-332_B1,1,3,0,0,0,4
CTTGACCCGAAAGATA-1_V12D07-332_B1,0,0,0,0,0,0
CGCAGAAACATTTGCG-1_V12D07-332_B1,0,1,0,0,1,2
GACCCGTCGCCGGCTA-1_V12D07-332_B1,0,0,0,0,0,0
AATCGGGACACTACGA-1_V12D07-332_B1,0,1,0,1,0,2
TATATTCGCGTCGATA-1_V12D07-332_B1,0,2,0,11,2,15
CCTCCCGACAATCCCT-1_V12D07-332_B1,0,1,0,15,0,16
CGACATGCGATCTTCT-1_V12D07-332_B1,1,1,0,2,1,5
AACACGACTGTACTGA-1_V12D07-332_B1,0,1,0,2,0,3
CCCAACCACACTAACA-1_V12D07-332_B1,0,1,0,0,0,1
CACCGCCGACCAGCGA-1_V12D07-332_B1,0,1,0,0,0,1
TGGTATCGCATCCCAA-1_V12D07-332_B1,0,0,0,0,0,0
CAGAGTGATTTAACGT-1_V12D07-332_B1,0,2,0,0,0,2
AACCCTGGTGGAACCA-1_V12D07-332_B1,0,0,0,0,1,1
GTCAGTTGTGCTCGTT-1_V12D07-332_B1,1,1,0,0,1,3
ATTGACGTAACTCGGT-1_V12D07-332_B1,0,1,0,0,0,1
GATGTCGGTCAACTGC-1_V12D07-332_B1,2,1,0,0,1,4
AGGGCAGCGGCGTGGT-1_V12D07-332_B1,0,0,0,0,0,0
ACATCGTTAACCTAGT-1_V12D07-332_B1,1,1,0,0,0,2
TCCATTGTGACCTCGT-1_V12D07-332_B1,0,1,0,0,0,1
TGTTTAATACTTCATC-1_V12D07-332_B1,0,2,0,0,0,2
TTGCTGGCCGGGCTTC-1_V12D07-332_B1,0,0,0,0,0,0
CATATTATTTGCCCTA-1_V12D07-332_B1,1,1,0,0,2,4
CTGCCTAGCCACCAAG-1_V12D07-332_B1,0,0,0,0,0,0
ACGAGATATTTGCTTA-1_V12D07-332_B1,1,0,0,0,0,1
GACTACAATTGCTCGT-1_V12D07-332_B1,0,1,0,0,1,2
AACGTGATGAAGGACA-1_V12D07-332_B1,0,2,0,0,0,2
ACTCTCTTATACACGA-1_V12D07-332_B1,0,1,0,0,1,2
CGCATCATGGCTTCAG-1_V12D07-332_B1,0,1,0,1,0,2
CGGCTCTTCGTCGAAC-1_V12D07-332_B1,0,0,0,0,0,0
ATTCTTCGTACTTATG-1_V12D07-332_B1,1,0,1,0,0,2
AGTGAGGGTTTCTGAC-1_V12D07-332_B1,1,0,0,0,0,1
GCCAGGCGTTCGCATG-1_V12D07-332_B1,1,3,0,0,0,4
GACTAACACAGCACCT-1_V12D07-332_B1,0,0,0,0,0,0
CAATGGAATCTACATA-1_V12D07-332_B1,1,5,0,0,0,6
GTGGTCAGCGAAGTAT-1_V12D07-332_B1,2,0,0,0,0,2
ATGGCTGGAAATGGCC-1_V12D07-332_B1,1,1,0,0,0,2
ATCAGGTCGCCATTGC-1_V12D07-332_B1,4,1,0,0,0,5
TATCACCATGTAAAGT-1_V12D07-332_B1,1,0,1,0,0,2
AGCGCTTATGGGCAAG-1_V12D07-332_B1,1,1,0,0,0,2
AAGCGGCGTCATGGGT-1_V12D07-332_B1,2,2,0,0,0,4
ACTAATACGTCAGGCG-1_V12D07-332_B1,2,0,0,0,1,3
GGCTGAGCATCGTAAG-1_V12D07-332_B1,5,2,0,0,0,7
CGGTTGGGTTCAAGTT-1_V12D07-332_B1,4,3,0,0,2,9
GACTGATTGGTCACAA-1_V12D07-332_B1,5,1,0,0,1,7
AGACGGGCCGATTTAA-1_V12D07-332_B1,5,2,0,0,0,7
ACCAGTGCCCGGTCAA-1_V12D07-332_B1,1,1,0,0,3,5
GTCCTTTAATGACTTC-1_V12D07-332_B1,4,1,0,0,0,5
CCTACAAGTCCGGAAT-1_V12D07-332_B1,5,2,0,0,0,7
GCCTGCTACACTGAGA-1_V12D07-332_B1,0,1,0,0,1,2
GACTCGGTCGGCGGAT-1_V12D07-332_B1,3,0,0,0,1,4
CTAGACATATATGTAG-1_V12D07-332_B1,0,0,0,1,1,2
TCGCCCAACTGACTCC-1_V12D07-332_B1,2,3,0,0,0,5
AAACTAACGTGGCGAC-1_V12D07-332_B1,0,2,0,0,0,2
AACTGAGGTCAGCGTC-1_V12D07-332_B1,1,0,0,0,1,2
ACAATGATTCTTCTAC-1_V12D07-332_B1,2,0,0,0,0,2
ATAAGTACCCGATTGT-1_V12D07-332_B1,1,2,0,0,0,3
ATTGGGAGTTCTGTAA-1_V12D07-332_B1,0,3,0,0,0,3
CGAACATAGTCAGAAA-1_V12D07-332_B1,1,0,0,0,0,1
TAGCTCAGATCCTAGT-1_V12D07-332_B1,0,0,0,0,0,0
GTGTCGTATTCACCTT-1_V12D07-332_B1,0,2,0,0,0,2
CTCACCGATCCAAACT-1_V12D07-332_B1,0,1,0,0,0,1
ATATGTGCACAAACCA-1_V12D07-332_B1,0,0,0,0,0,0
CAGTCCAACGCCTTCT-1_V12D07-332_B1,1,1,0,0,0,2
TCGTCCGGGTACACTC-1_V12D07-332_B1,0,1,0,0,1,2
GCAGAAACGTAATCCA-1_V12D07-332_B1,0,0,0,0,0,0
TTCGAGCCGGCGCTAC-1_V12D07-332_B1,0,1,0,0,0,1
GGAAGATAAGACTGTA-1_V12D07-332_B1,0,0,0,0,0,0
ATAAGCAAACACCGAG-1_V12D07-332_B1,0,0,0,0,0,0
GCATAAATTGAACGCC-1_V12D07-332_B1,0,2,0,0,0,2
CGCCGGTGTCGCAGTA-1_V12D07-332_B1,0,1,0,0,0,1
GACCTGGTCTGGGCGT-1_V12D07-332_B1,7,2,0,0,3,12
AGCCGCTTGATTAGCG-1_V12D07-332_B1,7,1,0,0,3,11
CCCGGCTAGGTGAGAA-1_V12D07-332_B1,3,0,0,1,5,9
CGAGCCGAGCACTCGA-1_V12D07-332_B1,6,2,0,0,0,8
TAGTGCTTGAATCCTT-1_V12D07-332_B1,2,0,0,0,1,3
CAACCGCACCTAGACA-1_V12D07-332_B1,6,2,0,0,0,8
ACCACTGTTCAAGAAG-1_V12D07-332_B1,3,1,0,0,0,4
AGATGCTATAACGAGC-1_V12D07-332_B1,4,1,0,0,1,6
AATTACTCGTACGCTC-1_V12D07-332_B1,4,0,0,0,0,4
CGTCAATCTTTAACAT-1_V12D07-332_B1,2,0,0,0,1,3
CCAAAGCAGTTGGTTG-1_V12D07-332_B1,4,0,0,0,1,5
CCATATTGGATCATGA-1_V12D07-332_B1,2,2,0,0,1,5
CGTACCGAAAGTCTAG-1_V12D07-332_B1,1,3,0,0,0,4
CTCGAGATCCAAAGCA-1_V12D07-332_B1,0,7,0,0,1,8
TGGATAGAGTAACAGA-1_V12D07-332_B1,0,2,0,1,0,3
TCACAGATCCTCAAAC-1_V12D07-332_B1,0,6,0,0,0,6
AGAGCTACGAAAGCAT-1_V12D07-332_B1,3,1,0,0,0,4
TGCGTGATTGGGTGTC-1_V12D07-332_B1,0,2,0,0,0,2
CACATGTTTGGACATG-1_V12D07-332_B1,0,1,0,0,0,1
TTCGCATCCGGAAGCA-1_V12D07-332_B1,0,2,0,0,0,2
CCCTAGTGTCAGGTGT-1_V12D07-332_B1,0,3,0,8,0,11
TTACCGCCTTAGGGAA-1_V12D07-332_B1,0,2,0,7,0,9
CCAGTCCATTATTCGA-1_V12D07-332_B1,0,1,0,2,1,4
CGTAAACGCTTGAGTG-1_V12D07-332_B1,0,2,0,0,2,4
ATTCCTTCCAGGCGGT-1_V12D07-332_B1,0,1,0,0,0,1
TTCCTTTCTGTGTTGC-1_V12D07-332_B1,1,1,0,0,0,2
AGTTGACATCGGCTGG-1_V12D07-332_B1,0,0,0,0,0,0
AACTCGATGGCGCAGT-1_V12D07-332_B1,0,0,0,1,0,1
GATAAGGCAGATGCAA-1_V12D07-332_B1,1,2,0,0,1,4
GGCTGGCTAGCTTAAA-1_V12D07-332_B1,1,6,0,0,0,7
CCTCATGCAGCTACGA-1_V12D07-332_B1,2,2,0,0,0,4
GACGCCTGTTGCAGGG-1_V12D07-332_B1,1,1,0,0,0,2
TAATTAGATGGATATG-1_V12D07-332_B1,0,1,0,0,0,1
GAGGGCATCGCGTATC-1_V12D07-332_B1,1,1,0,1,0,3
CTTGTGAGTCTTTGAC-1_V12D07-332_B1,0,0,0,0,0,0
TCAACACATTGGGTAA-1_V12D07-332_B1,1,1,0,0,0,2
ACTGTATACGCGAGCA-1_V12D07-332_B1,1,1,0,0,1,3
GTGAAACGTGCTCCAC-1_V12D07-332_B1,1,2,0,1,2,6
CGAGTGCTATAGTTCG-1_V12D07-332_B1,0,0,0,1,0,1
GTACTGCATGAAGCGT-1_V12D07-332_B1,0,0,0,0,1,1
GTAACTTGCGGCAGTC-1_V12D07-332_B1,0,1,0,1,0,2
GAATCGCCGGACACGG-1_V12D07-332_B1,0,0,0,0,0,0
GGGAGTAATGGCTGGC-1_V12D07-332_B1,0,0,0,1,0,1
CATGAACCGACATTTG-1_V12D07-332_B1,0,0,0,0,0,0
TCTGTCATACAAGAGC-1_V12D07-332_B1,0,1,0,0,1,2
GTCGTCAATTATAAGG-1_V12D07-332_B1,0,1,0,0,0,1
TAAAGAGCCCGAAACC-1_V12D07-332_B1,0,0,0,2,2,4
GTACTGAGGTCGTAAC-1_V12D07-332_B1,1,0,0,1,0,2
AAAGACCCAAGTCGCG-1_V12D07-332_B1,0,0,0,0,0,0
CGTCAGTGCGCACAAG-1_V12D07-332_B1,0,0,1,0,0,1
TGTATCCTTATTCCAT-1_V12D07-332_B1,0,0,0,0,1,1
ATTCTCGTCTCTTTAG-1_V12D07-332_B1,0,0,0,0,0,0
AAAGTCACTGATGTAA-1_V12D07-332_B1,0,4,0,0,0,4
TGTCTACAGTTTCTGT-1_V12D07-332_B1,1,2,0,0,1,4
TTAACGTCGCAAGACC-1_V12D07-332_B1,0,1,0,1,0,2
CTATGTCTATTGAAAC-1_V12D07-332_B1,0,0,0,1,1,2
TCGGGTGAAACTGCTA-1_V12D07-332_B1,0,1,0,0,0,1
TGTCCCGACATAGCAC-1_V12D07-332_B1,0,5,0,0,0,5
ACAGCATAGAGCCAGT-1_V12D07-332_B1,0,2,0,0,0,2
ATATTCCCACAGGTCA-1_V12D07-332_B1,2,1,0,0,0,3
TTGGATCGACTTCTGG-1_V12D07-332_B1,0,5,0,4,0,9
CACCATCGGAGGAGAC-1_V12D07-332_B1,0,5,0,2,0,7
CTTAACTTCGAAGTAC-1_V12D07-332_B1,0,2,0,0,0,2
GCACAAGTGTCGGAAG-1_V12D07-332_B1,1,2,0,5,0,8
TACCAGCTAGGTTTAA-1_V12D07-332_B1,0,0,0,1,0,1
ACGTACAGATTTCTCT-1_V12D07-332_B1,0,1,0,5,0,6
AATTTGGTTCCAAAGA-1_V12D07-332_B1,1,2,0,7,0,10
GTAAGGATTTGTCGGA-1_V12D07-332_B1,1,0,0,1,1,3
CATCATCTACCCGGAC-1_V12D07-332_B1,0,2,0,0,0,2
ACGATGGATCCGATGC-1_V12D07-332_B1,0,0,0,0,0,0
CACTCAGCTCTTGAGG-1_V12D07-332_B1,0,1,0,0,0,1
TAGATCCGAAGTCGCA-1_V12D07-332_B1,0,1,0,0,0,1
TGAAACTTATGCAAGC-1_V12D07-332_B1,0,1,0,0,0,1
GCGATTCTGGAAGCAG-1_V12D07-332_B1,0,2,0,0,0,2
CAAACTATTGAGCTTC-1_V12D07-332_B1,1,2,0,0,0,3
TAGAATTAAGGGCAAC-1_V12D07-332_B1,0,4,0,0,0,4
CGAAACATAGATGGCA-1_V12D07-332_B1,1,1,0,0,0,2
GATGGTGCCCTAGGCA-1_V12D07-332_B1,0,0,0,0,0,0
CCCGCAGGGCCCAAAG-1_V12D07-332_B1,0,2,0,0,0,2
ACAGCGCACCCGCAGC-1_V12D07-332_B1,1,1,0,0,1,3
GGTAAATGTGCGTTAC-1_V12D07-332_B1,1,0,0,0,0,1
GTCCTTCTAGTGGGTT-1_V12D07-332_B1,0,1,0,0,0,1
GGAAGCTCGCTTACAG-1_V12D07-332_B1,0,1,0,0,0,1
CACCGATACACCGAGC-1_V12D07-332_B1,0,0,0,0,1,1
CAGCCGGGCCCTCTAT-1_V12D07-332_B1,0,0,0,0,0,0
CGGAGCTTATAACACC-1_V12D07-332_B1,0,0,0,0,0,0
ATTACAACTACCGGCC-1_V12D07-332_B1,0,3,0,0,0,3
TCCTCTGGCCCATTAG-1_V12D07-332_B1,0,0,0,0,1,1
CGGCACCGTTAGCGCC-1_V12D07-332_B1,0,0,0,0,0,0
TCGGTCCCTGACTCCA-1_V12D07-332_B1,1,1,0,0,1,3
TGGTTGGAGGATCCTG-1_V12D07-332_B1,1,0,0,0,0,1
CTGCGGTAGTCACGTG-1_V12D07-332_B1,2,0,0,0,0,2
GTGCCTCAGTGTACGG-1_V12D07-332_B1,2,1,0,0,0,3
ATCGTTCACTTTCGCC-1_V12D07-332_B1,2,1,0,0,0,3
ACTTACCGGGCGCGCA-1_V12D07-332_B1,1,1,0,0,0,2
CTAGACTGCATTTCGT-1_V12D07-332_B1,6,1,0,0,0,7
TTGCCGGTGATCCCTC-1_V12D07-332_B1,4,0,0,0,0,4
CTGTCACGCCAGGCGC-1_V12D07-332_B1,4,0,0,1,1,6
CGGTATAGGTATTAGC-1_V12D07-332_B1,3,0,0,0,1,4
CCAACGCTTGCCAGGG-1_V12D07-332_B1,1,2,0,0,0,3
CGTTGAGTAATTGCGT-1_V12D07-332_B1,2,1,0,0,0,3
TGTATTTACCTAATGC-1_V12D07-332_B1,2,2,0,0,2,6
TAAATGCCGTCTCATG-1_V12D07-332_B1,4,1,0,0,0,5
CGGTTTATGAAGGAAC-1_V12D07-332_B1,6,2,0,0,0,8
GCAAGATGTGTTCGCG-1_V12D07-332_B1,3,1,0,0,0,4
AAAGGTAAGCTGTACC-1_V12D07-332_B1,4,4,0,0,0,8
GTACGTCACGTATTAA-1_V12D07-332_B1,4,0,0,0,0,4
AGTACCTTCGAGTGCT-1_V12D07-332_B1,1,4,0,0,0,5
ATTGTGACTTCGCTGC-1_V12D07-332_B1,4,1,0,1,1,7
TGTATCAGACTGAAGC-1_V12D07-332_B1,0,1,0,0,0,1
GAGACCCTGCAACGCC-1_V12D07-332_B1,1,0,0,0,0,1
TGGGTGGGATGTCATT-1_V12D07-332_B1,0,1,0,0,0,1
GGCTAATGATTGAAAT-1_V12D07-332_B1,0,1,0,0,1,2
ATAACGTTACCTCCAC-1_V12D07-332_B1,1,0,0,0,0,1
TGCGAGATGGCGGCCA-1_V12D07-332_B1,1,1,0,0,0,2
CACACTTGTATTGCGA-1_V12D07-332_B1,0,1,0,0,0,1
GCTGGTGACTCGTAGT-1_V12D07-332_B1,0,0,0,0,0,0
CGACACCGCTTAAGGA-1_V12D07-332_B1,0,0,0,1,0,1
GTAACAACTGACCTTG-1_V12D07-332_B1,0,1,0,0,0,1
CAACTGAGGGTATGAC-1_V12D07-332_B1,0,1,0,0,0,1
CTAATTATGAAGCGTA-1_V12D07-332_B1,0,0,0,0,0,0
CCGATCTTAAGAGGCT-1_V12D07-332_B1,0,3,0,1,0,4
CGACTCGGTACACGGT-1_V12D07-332_B1,0,1,0,0,0,1
TGCTGCGTCAGAGTTA-1_V12D07-332_B1,0,0,0,0,0,0
AGAGTTGCAGGCCTCC-1_V12D07-332_B1,0,0,0,0,0,0
ACTGGCGAACCTGCGT-1_V12D07-332_B1,0,0,0,0,0,0
ACTAAGGACGCACACC-1_V12D07-332_B1,0,2,0,0,0,2
CGTCCAGATGGCTCCA-1_V12D07-332_B1,7,4,0,0,2,13
ACTATCGCCGGCTAAA-1_V12D07-332_B1,3,3,0,0,2,8
GATAGCGTACCACGCG-1_V12D07-332_B1,6,3,0,0,1,10
AGGACTTATAGGAGAA-1_V12D07-332_B1,1,0,0,3,3,7
TAGTCGGGATTCTTCG-1_V12D07-332_B1,6,2,0,0,0,8
ACCATTAAGGGTGTCA-1_V12D07-332_B1,1,2,0,0,1,4
TTAATGTGTTTGCAGG-1_V12D07-332_B1,3,0,0,0,1,4
TCCGCAGCCACCTAGC-1_V12D07-332_B1,2,0,0,0,1,3
GAGGAGATCCTCATGC-1_V12D07-332_B1,5,0,0,0,2,7
GGTCCTTCATACGACT-1_V12D07-332_B1,2,1,0,0,0,3
CCCTGTTGGCAAAGAC-1_V12D07-332_B1,4,0,0,0,0,4
GTGCCTAGCTATGCTT-1_V12D07-332_B1,6,1,0,0,0,7
GTCATCTCCTACAGCT-1_V12D07-332_B1,4,1,0,0,0,5
GCGAGAAACGGGAGTT-1_V12D07-332_B1,6,3,0,0,0,9
CGTCGCGGCGGGATTT-1_V12D07-332_B1,0,3,0,0,0,3
CATTGTGTGCTAGATC-1_V12D07-332_B1,0,4,0,2,0,6
CGCGGCAGTATTACGG-1_V12D07-332_B1,0,5,0,0,3,8
GAAATGGGATGTAAAC-1_V12D07-332_B1,1,5,0,4,0,10
CATTCCCTAAGTACAA-1_V12D07-332_B1,0,3,0,0,0,3
AGTTCTGCGTTGTATC-1_V12D07-332_B1,0,0,0,0,0,0
ACCCTATAGGACTGAG-1_V12D07-332_B1,0,0,0,3,0,3
TTAGATAGGTCGATAC-1_V12D07-332_B1,0,1,0,9,0,10
ATTGATAGCAACGAGA-1_V12D07-332_B1,0,5,0,2,1,8
TCTCGGCTCCAGGACT-1_V12D07-332_B1,1,1,0,2,0,4
CTTGAGGTTATCCCGA-1_V12D07-332_B1,1,1,0,0,0,2
AAGAAGGATCAGTTAG-1_V12D07-332_B1,0,2,0,1,0,3
GTACGACGGCGCTGCG-1_V12D07-332_B1,0,1,0,3,0,4
CTTATGTTGACTACCA-1_V12D07-332_B1,0,1,0,0,0,1
CGGCACTCAAGAAAGT-1_V12D07-332_B1,0,0,0,0,0,0
GTCAAAGTTTACATAG-1_V12D07-332_B1,1,1,0,0,0,2
CTCCTAAGTTATGTCT-1_V12D07-332_B1,0,2,0,1,0,3
ACTGTGCTAGTAGATC-1_V12D07-332_B1,0,1,0,0,1,2
GTTTGGCCGCTCAGCG-1_V12D07-332_B1,1,0,0,0,0,1
TTATCCAATCGAACTC-1_V12D07-332_B1,1,0,0,0,1,2
CCGTACCCAAGCGCCA-1_V12D07-332_B1,0,0,0,0,0,0
CATACAAAGCCGAACC-1_V12D07-332_B1,0,0,0,0,0,0
GGTCGGTAATTAGACA-1_V12D07-332_B1,1,0,0,1,0,2
AGCGGGAAGGGTCCAT-1_V12D07-332_B1,1,0,0,1,0,2
GCCCACCAAGGCTGTC-1_V12D07-332_B1,0,1,0,1,0,2
GTAGACGTCGTTACAT-1_V12D07-332_B1,1,1,0,0,1,3
GAGCATCATCCCTGGG-1_V12D07-332_B1,0,0,0,0,0,0
AGGTAACCTCCTATTC-1_V12D07-332_B1,0,1,0,0,0,1
GGTTTGAGTGCTGGAA-1_V12D07-332_B1,1,0,0,0,0,1
GCACTAGTCGCGCTAT-1_V12D07-332_B1,0,0,0,0,0,0
GGTAACTATGTATCTG-1_V12D07-332_B1,2,1,0,0,0,3
GCGGTCCCTAGACGCA-1_V12D07-332_B1,0,0,1,0,0,1
CGAGCGTTGATCAGCC-1_V12D07-332_B1,0,0,0,1,0,1
AATCCAAGGGCCTGAG-1_V12D07-332_B1,0,1,0,0,0,1
CCGTGCCCATGACGGC-1_V12D07-332_B1,0,0,1,0,0,1
GAAATTCACATCGCTG-1_V12D07-332_B1,0,0,0,1,0,1
CTCTGCGAAGCAAGCA-1_V12D07-332_B1,1,0,0,0,1,2
AGTAGGTAACATACAT-1_V12D07-332_B1,1,1,0,1,0,3
ATTGGGAATATCTTGG-1_V12D07-332_B1,0,0,0,1,0,1
TAGAGCTACGAAGAAC-1_V12D07-332_B1,1,0,0,2,0,3
TGCGGCATAGTTCAAC-1_V12D07-332_B1,1,0,0,2,1,4
CCGCCGGTCAACACAC-1_V12D07-332_B1,1,2,0,0,2,5
TCGTATAGTGCAATTA-1_V12D07-332_B1,0,7,0,0,0,7
TAGTTTATTCTTGCTT-1_V12D07-332_B1,0,0,1,0,0,1
GATATCTCATGCAATA-1_V12D07-332_B1,0,1,0,0,0,1
CGTTTAAGCGGAGCAC-1_V12D07-332_B1,1,0,0,0,1,2
CATGCTGGCTCCAATT-1_V12D07-332_B1,0,1,0,0,0,1
GAAACAGCCATGCAGT-1_V12D07-332_B1,0,1,1,0,0,2
AGTTTCGCAGGTCGGA-1_V12D07-332_B1,0,1,0,1,2,4
CTCATGGCTCACAATC-1_V12D07-332_B1,1,1,1,0,0,3
AACCGTTGTGTTTGCT-1_V12D07-332_B1,0,0,0,2,1,3
ACCCTTCATCTGCGAA-1_V12D07-332_B1,0,1,0,0,1,2
TGCGGTGAAATTTCAT-1_V12D07-332_B1,0,0,0,11,0,11
CAAATTGTCAGCAAGC-1_V12D07-332_B1,0,1,0,11,0,12
GAGGTACATCCATCTT-1_V12D07-332_B1,0,1,0,14,0,15
AAATGGCATGTCTTGT-1_V12D07-332_B1,0,1,0,9,0,10
TCATCCCAGAGGGTGG-1_V12D07-332_B1,0,0,0,0,0,0
CGTAGCGAATTGTCAG-1_V12D07-332_B1,0,1,0,5,0,6
CCTAGTTAGTCGCATG-1_V12D07-332_B1,1,0,0,0,0,1
GAAACTCTAATGAAGG-1_V12D07-332_B1,3,2,0,1,0,6
TTGTATCACACAGAAT-1_V12D07-332_B1,0,1,0,0,1,2
TTCAAGCCGAGCTGAG-1_V12D07-332_B1,0,1,0,0,0,1
AGGTACGATATTGCCA-1_V12D07-332_B1,0,0,0,0,0,0
TTAAGCCGACAACTTC-1_V12D07-332_B1,0,1,0,0,0,1
GTCTTAGTACAGCCGG-1_V12D07-332_B1,1,2,0,0,0,3
TGGGTAAGGTTCCCGC-1_V12D07-332_B1,0,0,0,0,0,0
CTACGCCATTTCCGAT-1_V12D07-332_B1,0,0,0,0,0,0
GACCGTCAGGTCGTGA-1_V12D07-332_B1,1,0,0,0,0,1
TAGTTAAGATAGGATA-1_V12D07-332_B1,0,4,0,0,0,4
GAATATTCGGAGTCCC-1_V12D07-332_B1,0,2,1,0,0,3
CAAACTACGATAGAGA-1_V12D07-332_B1,1,2,0,0,0,3
CAGGAAGACTTTATAT-1_V12D07-332_B1,0,1,0,0,2,3
TTCGTAATCCCAGCGG-1_V12D07-332_B1,0,0,0,0,0,0
GTGAGGAGCGGTTGAG-1_V12D07-332_B1,0,0,0,0,1,1
CAATCCCTATACCAGC-1_V12D07-332_B1,0,0,0,0,0,0
AGGGAAACGAGGTACT-1_V12D07-332_B1,1,2,0,0,0,3
TCCTGCCAACTGGAGA-1_V12D07-332_B1,0,2,0,0,0,2
AATTTGGGACATAGTA-1_V12D07-332_B1,0,0,0,0,0,0
AACTCCTAATCCCATG-1_V12D07-332_B1,0,0,0,0,0,0
GCTCATTACTGCATGT-1_V12D07-332_B1,0,0,0,0,0,0
TCTCGAACGAGGTCAC-1_V12D07-332_B1,0,2,0,0,0,2
TCACTACGACCAATGC-1_V12D07-332_B1,1,1,0,0,0,2
GTGATGCACAACATCT-1_V12D07-332_B1,3,0,0,0,0,3
CCGACGTAAACACAAC-1_V12D07-332_B1,2,1,0,0,0,3
TGGGATGCACTCATTC-1_V12D07-332_B1,3,0,0,0,1,4
TTCCATCATGCGGTGA-1_V12D07-332_B1,4,0,0,0,0,4
TGCACAGTGAAGTTAT-1_V12D07-332_B1,4,0,0,0,0,4
CTATTGTGTTTGGTCA-1_V12D07-332_B1,0,2,0,0,1,3
TGCGAGCCCTTCCGCG-1_V12D07-332_B1,4,1,0,0,0,5
TTGAAAGGTGTAAAGG-1_V12D07-332_B1,5,2,0,0,0,7
GGTGCAGAGCCTATCG-1_V12D07-332_B1,9,1,0,0,0,10
ACTATATGCTGTGTTC-1_V12D07-332_B1,4,2,0,0,0,6
TCCTGGCGCTGCCTGG-1_V12D07-332_B1,2,1,0,0,0,3
GAGCCGAGCGTTTATT-1_V12D07-332_B1,2,1,0,0,1,4
AGAATGCGGGTTCGGA-1_V12D07-332_B1,2,1,0,0,0,3
ATGCGACAATTGGTCC-1_V12D07-332_B1,0,2,1,0,1,4
TTCCGGCTCGACTTCT-1_V12D07-332_B1,0,0,0,0,0,0
TGATTATGGCACGCAG-1_V12D07-332_B1,1,0,0,0,0,1
GGTTTGACAAGAAGCT-1_V12D07-332_B1,1,0,0,0,0,1
GCAGCTATGGACAGGT-1_V12D07-332_B1,1,1,0,0,0,2
CACCATGATCGCAAAG-1_V12D07-332_B1,0,0,1,0,0,1
GTCGGAAGGATACCAG-1_V12D07-332_B1,1,0,0,1,0,2
GGCCCAGTTATCAGCA-1_V12D07-332_B1,1,0,0,2,0,3
GGGCCTATTTAAGTAT-1_V12D07-332_B1,0,0,0,0,0,0
GTTGTTACATTGCGCT-1_V12D07-332_B1,0,0,0,0,0,0
CAACTCCGTAACTTGC-1_V12D07-332_B1,0,0,0,0,0,0
GATCTTTGCTCAAAGA-1_V12D07-332_B1,0,0,0,0,0,0
TCGCTTAATTACGAAG-1_V12D07-332_B1,1,1,0,0,0,2
CGATCATTAGAGGCAC-1_V12D07-332_B1,0,3,0,0,0,3
TGTTCTCTACTCCCTA-1_V12D07-332_B1,0,1,0,0,0,1
GCTTAGGGAAGCGGTA-1_V12D07-332_B1,0,0,0,0,0,0
CAGGTTTAGTACTACA-1_V12D07-332_B1,0,0,0,1,0,1
AAGCGGAGTGCGCGCA-1_V12D07-332_B1,0,1,0,1,0,2
TCAGATGGAGACGTAG-1_V12D07-332_B1,0,4,0,0,0,4
TCGCACTAACGTTTGT-1_V12D07-332_B1,5,2,0,0,3,10
CACGTCGGGTTCTAGA-1_V12D07-332_B1,8,0,0,0,4,12
GGAGTACACATGAGCT-1_V12D07-332_B1,5,2,0,0,4,11
GTGTGTCGACGTCGCT-1_V12D07-332_B1,2,4,0,0,10,16
GAAGCTCTTTGCTTAG-1_V12D07-332_B1,2,2,0,0,1,5
ACACCGAGCGCTCTTT-1_V12D07-332_B1,1,2,0,0,0,3
CGTAATAATTACGAGT-1_V12D07-332_B1,2,1,0,0,1,4
CATCAACACCTACTAA-1_V12D07-332_B1,3,1,0,0,2,6
CCAAGTTTCTACAGAT-1_V12D07-332_B1,2,0,0,0,3,5
ACGGGTCATGTGACTT-1_V12D07-332_B1,4,3,0,0,0,7
AGTGTGCTAAGATCGC-1_V12D07-332_B1,6,2,0,0,0,8
GGCGGTTTGCCGGTGC-1_V12D07-332_B1,3,0,0,0,0,3
GTATAATCTCCCGGAT-1_V12D07-332_B1,4,1,0,0,0,5
TAGTCCGTATGCATAA-1_V12D07-332_B1,1,3,0,0,1,5
CACTTCGTCTTATCTC-1_V12D07-332_B1,1,3,0,0,0,4
CATCCGCAGGCCCGAA-1_V12D07-332_B1,0,5,0,0,1,6
CCCTGATGTAACTCGT-1_V12D07-332_B1,0,1,0,0,0,1
CCATAGTCAGTAACCC-1_V12D07-332_B1,2,8,0,0,1,11
CGGGCCATAGCCGCAC-1_V12D07-332_B1,0,4,0,4,0,8
CTCCGGCTTGTAGACA-1_V12D07-332_B1,0,0,0,0,0,0
AACTTGCGTTCTCGCG-1_V12D07-332_B1,0,2,0,0,0,2
AATGAGTTCGCATATG-1_V12D07-332_B1,0,2,0,0,0,2
CGAGGCCAGGCATTGG-1_V12D07-332_B1,0,1,0,1,0,2
TCTGCGTCCGGTTTCT-1_V12D07-332_B1,1,1,0,0,0,2
CAATCCTGCCGTGGAG-1_V12D07-332_B1,0,0,0,0,1,1
CTGAGCAAGTAACAAG-1_V12D07-332_B1,0,3,0,0,0,3
GGGTACCCACGGTCCT-1_V12D07-332_B1,0,7,0,0,0,7
ACGGAATTTAGCAAAT-1_V12D07-332_B1,0,0,0,0,0,0
GGGCGGTCCTATTGTC-1_V12D07-332_B1,0,1,0,0,0,1
ATGTTACGAGCAATAC-1_V12D07-332_B1,0,0,0,1,0,1
AACCATGGGATCGCTA-1_V12D07-332_B1,0,0,0,0,1,1
TCGCATCCCTAAGTGT-1_V12D07-332_B1,0,0,0,1,0,1
ACTTAGTACGACAAGA-1_V12D07-332_B1,0,0,0,0,0,0
GAGCTCTCGGACCTAA-1_V12D07-332_B1,1,1,0,0,0,2
TCTATTACGCTGGCGA-1_V12D07-332_B1,0,0,0,0,0,0
AGATACGACTTCATAT-1_V12D07-332_B1,0,0,0,0,0,0
CGCTATACCGCCCACT-1_V12D07-332_B1,0,0,0,0,0,0
CAGTGTCCGCAGAATG-1_V12D07-332_B1,0,0,0,1,0,1
CCATCCATACCAAGTC-1_V12D07-332_B1,0,0,0,1,0,1
AACCCAGAGACGGAGA-1_V12D07-332_B1,0,2,0,0,0,2
GAAGAACGGTGCAGGT-1_V12D07-332_B1,1,1,0,1,0,3
GATAAATCGGTGGATG-1_V12D07-332_B1,0,1,0,0,1,2
CAGCTCGTGCTTGTGT-1_V12D07-332_B1,0,1,0,0,0,1
GAGTACGGGTATACAA-1_V12D07-332_B1,0,1,0,0,0,1
CATCGCCCGCGGCCAA-1_V12D07-332_B1,1,1,0,0,0,2
TCTTACAGAGGTACCG-1_V12D07-332_B1,1,1,1,1,3,7
TGGAAGACGAACACCA-1_V12D07-332_B1,3,2,0,0,0,5
GTTGTCGTGTTAGTTG-1_V12D07-332_B1,0,0,2,1,0,3
CCAAGGAACAGAGAGG-1_V12D07-332_B1,0,1,0,1,1,3
CTGCACCTGGAACCGC-1_V12D07-332_B1,0,0,1,1,0,2
CGCTTTCATACCGGTG-1_V12D07-332_B1,0,0,0,0,1,1
GTTCTTCCCTCGATGT-1_V12D07-332_B1,0,1,0,0,0,1
ATTTAACTCGTATTAC-1_V12D07-332_B1,1,0,0,0,0,1
AACGATAGAAGGGCCG-1_V12D07-332_B1,0,2,0,0,0,2
TATCCTGCATGGGAAT-1_V12D07-332_B1,0,1,0,0,2,3
AGGCCCATTGTACAGG-1_V12D07-332_B1,0,2,0,0,0,2
CCGGCGCATATTGGAT-1_V12D07-332_B1,0,1,1,0,0,2
ATCTGTAATTGTACCC-1_V12D07-332_B1,0,0,1,0,0,1
GAGCGAGGGAGTACCG-1_V12D07-332_B1,1,1,1,0,0,3
TTATTAGGGAAGCATC-1_V12D07-332_B1,1,2,0,0,0,3
CTTCTTACGTCGTATA-1_V12D07-332_B1,0,0,1,1,0,2
GAAGTGCTGGATAGCT-1_V12D07-332_B1,0,1,0,0,0,1
GTGCAACAAATGTGGC-1_V12D07-332_B1,0,1,0,0,1,2
CATGCGTTAGACAGAA-1_V12D07-332_B1,1,3,1,0,1,6
ACACACTTTCTACACG-1_V12D07-332_B1,1,0,0,1,2,4
AGCCCTAAGCGAAGTT-1_V12D07-332_B1,1,0,0,0,0,1
ATTAATTCGGTCACTC-1_V12D07-332_B1,0,1,0,1,2,4
AACAGGAAATCGAATA-1_V12D07-332_B1,0,0,0,0,0,0
ACGTTTAGTTGTGATC-1_V12D07-332_B1,0,1,0,5,1,7
TCCTTCAGTGGTCGAA-1_V12D07-332_B1,0,1,1,1,0,3
CGAACGCCCAGTGCCG-1_V12D07-332_B1,0,1,0,20,0,21
CCTCGAAGTGGACGGG-1_V12D07-332_B1,0,1,1,6,0,8
CTCTGTTTGAGGATTC-1_V12D07-332_B1,1,0,0,9,0,10
TGGGCACGTTCTATGG-1_V12D07-332_B1,0,3,0,13,0,16
ACTATTCGTCCGTGGT-1_V12D07-332_B1,0,1,0,0,0,1
CCTCTGGCCTAGACGG-1_V12D07-332_B1,0,3,0,7,0,10
CCATAAACAACCCGAC-1_V12D07-332_B1,0,4,0,0,0,4
CATAGTACATTGAGAG-1_V12D07-332_B1,1,0,0,0,0,1
ATTTCATTATTTCGCG-1_V12D07-332_B1,0,1,0,0,0,1
CAACTATATCGAATGC-1_V12D07-332_B1,0,0,0,0,0,0
CTAGTATTCGGAATTA-1_V12D07-332_B1,0,0,0,0,0,0
GTGGAACCTACATGCG-1_V12D07-332_B1,0,0,0,0,1,1
CCTAAAGGCTGACGCT-1_V12D07-332_B1,0,2,0,0,0,2
CGTGACATTGGGTCGT-1_V12D07-332_B1,0,2,0,0,0,2
CCAATCGGTAGATCGA-1_V12D07-332_B1,1,2,0,0,0,3
ATTGTCGCAATACCTT-1_V12D07-332_B1,0,0,0,0,0,0
AAATTACACGACTCTG-1_V12D07-332_B1,0,3,0,0,0,3
CACTCCTCTCGGTCGG-1_V12D07-332_B1,0,1,0,0,0,1
AAATAACCATACGGGA-1_V12D07-332_B1,0,0,1,0,0,1
AGTTACTCTATCGTGG-1_V12D07-332_B1,0,1,0,0,0,1
CGTTAGCTCACAACTG-1_V12D07-332_B1,0,1,0,0,0,1
GAATGTATGGCAGGTC-1_V12D07-332_B1,0,1,0,0,0,1
GCAACCACCAGACCGG-1_V12D07-332_B1,0,0,0,0,1,1
TCACTCGTGCAACGGC-1_V12D07-332_B1,0,1,0,0,1,2
AAACAGAGCGACTCCT-1_V12D07-332_B1,0,2,2,0,0,4
CAGCCTCTCCTCAAGA-1_V12D07-332_B1,0,1,0,0,0,1
TTGCGTGAACGCTTAG-1_V12D07-332_B1,0,0,0,0,0,0
CCGCCTGCGAATTGGT-1_V12D07-332_B1,2,2,0,0,0,4
AGATGAGGGTTGCGAT-1_V12D07-332_B1,3,1,0,0,2,6
CGGTGGGCTCCAGCCT-1_V12D07-332_B1,1,1,0,0,0,2
GGCAGCGGTAATCCTA-1_V12D07-332_B1,1,1,0,0,0,2
GCTAGCAGGGAGTGGG-1_V12D07-332_B1,2,1,0,0,0,3
CTCAAGACATTAGCGC-1_V12D07-332_B1,2,0,0,1,0,3
CACGGCGCGCCAAAGG-1_V12D07-332_B1,2,2,0,0,1,5
TGCAATTTGGGCACGG-1_V12D07-332_B1,4,0,0,0,2,6
ATGCCAATCGCTCTGC-1_V12D07-332_B1,5,3,0,0,3,11
GCTGGACCCAAAGTGG-1_V12D07-332_B1,2,3,1,0,0,6
ATTCCTAAGACGTGGA-1_V12D07-332_B1,1,0,0,0,0,1
TCCGGAGGAAGGGCTG-1_V12D07-332_B1,4,1,1,1,0,7
TCGGTGACCGCTCCGG-1_V12D07-332_B1,1,2,0,1,0,4
TCCGAAGTAGTCACCA-1_V12D07-332_B1,1,0,0,0,2,3
CATGTAGGAGCGCCAA-1_V12D07-332_B1,2,2,0,1,0,5
CACAAGAAAGATATTA-1_V12D07-332_B1,1,0,2,0,1,4
AGGGTCAGTAACCCTA-1_V12D07-332_B1,0,1,0,0,0,1
TAAGCCCTTACGACCA-1_V12D07-332_B1,0,0,0,0,0,0
ATACCGTCATCCATAA-1_V12D07-332_B1,0,0,0,0,0,0
GGACGTCCATAGTTGG-1_V12D07-332_B1,3,4,0,1,0,8
CATCAAACTGGCGCCC-1_V12D07-332_B1,0,2,1,0,0,3
AAACGTGTTCGCCCTA-1_V12D07-332_B1,0,0,0,0,1,1
AAATTGGTGAGAAGCA-1_V12D07-332_B1,0,2,0,0,0,2
GGTCATTGTAGTCATA-1_V12D07-332_B1,0,0,0,0,0,0
TGCAGTGAGGCTCGGG-1_V12D07-332_B1,0,0,0,0,1,1
GAACATTAGTATGTTA-1_V12D07-332_B1,0,1,0,0,0,1
GGTTTGCGAACACGTA-1_V12D07-332_B1,0,1,0,0,2,3
ACACAAATATTCCTAG-1_V12D07-332_B1,0,0,0,0,1,1
TTGGGTTTATTCAGCG-1_V12D07-332_B1,0,0,0,0,0,0
ATTCGCAGAGGACACT-1_V12D07-332_B1,0,0,0,0,0,0
GATTTAGTGCGTACTG-1_V12D07-332_B1,0,0,0,0,0,0
TAGAAACACAATAGTG-1_V12D07-332_B1,8,1,0,0,0,9
CAGTAGATGATGTCCG-1_V12D07-332_B1,7,0,0,0,3,10
TCTTAACTCGGATGTA-1_V12D07-332_B1,5,1,0,0,3,9
TACATCTTGTTTCTTG-1_V12D07-332_B1,3,1,0,0,7,11
TTCATAGGGTGTCCAT-1_V12D07-332_B1,2,2,0,0,0,4
TGAAGTAGCTTACGGA-1_V12D07-332_B1,3,0,0,0,0,3
GCACAAGTGGATCATA-1_V12D07-332_B1,4,0,0,0,1,5
GGGCGAATTTCTCCAC-1_V12D07-332_B1,1,1,0,0,0,2
ATGTTCCTGCCCACCT-1_V12D07-332_B1,1,0,0,0,1,2
GCTCAACCTCTTAGAG-1_V12D07-332_B1,4,0,0,0,2,6
ATAGCTGCTCTTGTTA-1_V12D07-332_B1,5,1,0,0,0,6
CGTCAGCTATTTACTC-1_V12D07-332_B1,5,3,0,0,1,9
ATCTGATAGTGTCTTA-1_V12D07-332_B1,2,1,0,0,1,4
TGCACTATGTGAGTGC-1_V12D07-332_B1,4,1,0,1,1,7
CCGACAAACACATGAG-1_V12D07-332_B1,4,0,0,0,1,5
GCCTTGTATATGCAGT-1_V12D07-332_B1,6,5,0,0,4,15
ATAATACCGTTAGCCG-1_V12D07-332_B1,4,9,0,0,3,16
ACACTCCAATGTCACT-1_V12D07-332_B1,2,6,0,0,2,10
AGTTGCTGACTGATAT-1_V12D07-332_B1,3,7,0,0,7,17
GGCGCTCCTCATCAAT-1_V12D07-332_B1,0,8,0,3,1,12
TGCCTGACATCGGTCA-1_V12D07-332_B1,0,4,0,0,2,6
TTGGCCATCTTGCGCT-1_V12D07-332_B1,1,2,1,1,0,5
CAGTGGTTGCACATGA-1_V12D07-332_B1,0,1,0,1,0,2
AGAATTGTTTGACATA-1_V12D07-332_B1,0,2,0,0,1,3
AAATGCTCGTTACGTT-1_V12D07-332_B1,1,1,0,1,0,3
CACCTAATAGAGTCGT-1_V12D07-332_B1,1,0,0,0,0,1
CATTTCTAGCAGACTA-1_V12D07-332_B1,0,2,0,0,1,3
CCGAAAGTGGTGAGCA-1_V12D07-332_B1,0,2,0,0,0,2
AGTCAGCCACCGCCTG-1_V12D07-332_B1,1,1,0,0,1,3
TCATCACTCGAGCTCG-1_V12D07-332_B1,1,1,0,0,0,2
CTCAGGACTCACCTGT-1_V12D07-332_B1,0,0,0,0,0,0
CGGTGTACTTGATCCC-1_V12D07-332_B1,0,1,0,0,0,1
CCTACGGCTCAGTCGA-1_V12D07-332_B1,0,2,0,0,0,2
GTACTTGGGCACTTCT-1_V12D07-332_B1,0,1,0,0,0,1
TGATTTCCTCCTGACG-1_V12D07-332_B1,0,0,0,0,0,0
CCTCACCAATCTTGAC-1_V12D07-332_B1,0,1,0,0,0,1
GGTGAGATGCAGATAA-1_V12D07-332_B1,0,0,0,0,0,0
GCTAGTTTCATTGAGG-1_V12D07-332_B1,0,0,0,0,0,0
AGGACATCGCACGTCG-1_V12D07-332_B1,0,1,0,1,0,2
GTGGACGTGCTGAGAC-1_V12D07-332_B1,2,0,0,0,0,2
TAAGGAACTTGTGGGA-1_V12D07-332_B1,0,0,0,1,0,1
TCGCTGTGCGTAAATC-1_V12D07-332_B1,0,2,0,0,0,2
GCATCCCTAACTTTGA-1_V12D07-332_B1,0,1,0,0,0,1
CACCCACACGTCACCC-1_V12D07-332_B1,0,0,0,0,0,0
GGTGCGGATAAGTGGC-1_V12D07-332_B1,0,0,0,0,0,0
TAATATTGAAATTCGC-1_V12D07-332_B1,0,0,0,0,0,0
CTTACACTGGGAAATA-1_V12D07-332_B1,0,1,0,0,0,1
ACCAAGAACGCGTGTC-1_V12D07-332_B1,0,0,0,2,0,2
GCCTTCAGCCCTACCG-1_V12D07-332_B1,0,1,0,1,0,2
GATGCTACAAGCGCCT-1_V12D07-332_B1,0,0,0,1,1,2
CCGGGACCCGCAGAGA-1_V12D07-332_B1,2,0,0,0,0,2
GTTCCAGTCTGACCAT-1_V12D07-332_B1,0,2,1,0,0,3
ATGATCGGGAATAGAC-1_V12D07-332_B1,0,2,0,0,0,2
TTGGATTGGGTACCAC-1_V12D07-332_B1,0,1,0,0,0,1
TACCTCACGCTTGTAC-1_V12D07-332_B1,0,0,0,1,0,1
CATGGCAGGAAGATCG-1_V12D07-332_B1,1,0,1,0,0,2
ATGACGCCGGCTCTAA-1_V12D07-332_B1,0,2,0,0,0,2
AGCGACATCCCATTCA-1_V12D07-332_B1,1,4,0,0,0,5
AGTAATGTCTTGCCGC-1_V12D07-332_B1,0,0,0,1,0,1
TTCTTAGTGGCTCAGA-1_V12D07-332_B1,0,0,1,0,1,2
CGTCTGGAAGGGCCCG-1_V12D07-332_B1,0,1,0,0,0,1
ACGTGCGCCTCGTGCA-1_V12D07-332_B1,1,0,0,0,0,1
AGAGCGGGCTAATCAT-1_V12D07-332_B1,0,1,0,1,0,2
GCGTCGAAATGTCGGT-1_V12D07-332_B1,0,1,1,1,0,3
AACTGATATTAGGCCT-1_V12D07-332_B1,0,0,0,1,1,2
CGAGCTGGGCTTTAGG-1_V12D07-332_B1,0,0,1,0,0,1
GGGTGTTTCAGCTATG-1_V12D07-332_B1,1,2,0,1,0,4
TTAATTTCAGACGCGG-1_V12D07-332_B1,1,0,0,0,0,1
ACTGCCGTCGTAACTC-1_V12D07-332_B1,0,0,0,0,0,0
GTGCACGAAAGTGACT-1_V12D07-332_B1,0,2,0,0,0,2
ATCTCCCTGCAATCTA-1_V12D07-332_B1,0,0,0,3,0,3
ACGCCAGATGATTTCT-1_V12D07-332_B1,0,4,0,1,0,5
AGCTATTTAATCCAAC-1_V12D07-332_B1,0,2,0,18,1,21
CCACGAGAAGAGAATC-1_V12D07-332_B1,0,2,0,12,0,14
GATTCCGCGTTTCCGT-1_V12D07-332_B1,0,1,0,5,0,6
GTCGGATGTAGCGCGC-1_V12D07-332_B1,0,2,0,17,0,19
TATTTATACCGAGTAG-1_V12D07-332_B1,1,1,0,0,0,2
GTAGGTGATCCGTGTA-1_V12D07-332_B1,0,1,0,3,0,4
AGTTAAGCGGTCCCGG-1_V12D07-332_B1,0,1,0,0,0,1
CTGGCGACATAAGTCC-1_V12D07-332_B1,0,1,0,0,0,1
TTGGCCTAGAATTTCG-1_V12D07-332_B1,0,1,0,0,0,1
GGCATATCGGTTCTGC-1_V12D07-332_B1,0,1,0,0,0,1
GGGCGTCCACTGGCTC-1_V12D07-332_B1,1,0,0,0,0,1
TTACCCATTGCCGGGT-1_V12D07-332_B1,0,2,0,0,0,2
TTAGACACGATCGTTG-1_V12D07-332_B1,0,0,0,0,1,1
GCGCTGATCCAGACTC-1_V12D07-332_B1,0,0,0,0,0,0
TTCGGCAACCCGCTGA-1_V12D07-332_B1,1,0,0,0,0,1
GATATTTCCTACATGG-1_V12D07-332_B1,1,1,0,0,1,3
CTGCGTTACGATATAA-1_V12D07-332_B1,0,0,0,0,0,0
TAATAAACAAGGAGAT-1_V12D07-332_B1,0,0,0,0,0,0
AACCTTTACGACGTCT-1_V12D07-332_B1,0,0,0,0,0,0
AGTCCCGCCTTTAATT-1_V12D07-332_B1,0,0,0,0,0,0
TGAGATTAGGCCCTAA-1_V12D07-332_B1,2,3,0,0,0,5
AGTGTATTGCGCATTG-1_V12D07-332_B1,0,1,0,0,2,3
GTTGGATTCAGTGGCT-1_V12D07-332_B1,1,1,0,0,0,2
TAAAGCTGCAATAGGG-1_V12D07-332_B1,1,1,0,0,0,2
AGTAGGAAGGAAGTTG-1_V12D07-332_B1,0,2,0,0,0,2
TATCACTTCGAGTAAC-1_V12D07-332_B1,1,0,0,0,0,1
TGATCTACGCTGATCT-1_V12D07-332_B1,0,1,0,0,0,1
GGATCATCCCGTACGC-1_V12D07-332_B1,3,0,0,0,0,3
TGACACTTCTCTTTGC-1_V12D07-332_B1,1,0,0,1,0,2
AGCCCTTCTAATCCGA-1_V12D07-332_B1,1,0,1,0,0,2
CACCGCGTCCACTCTA-1_V12D07-332_B1,3,2,0,0,0,5
TAATTGGAATCGGGAA-1_V12D07-332_B1,3,2,0,0,0,5
TCGTAAGCTCCGAGGA-1_V12D07-332_B1,4,2,0,0,1,7
TATATTACAAATGTCG-1_V12D07-332_B1,4,2,0,0,1,7
CGCGAGAGGGACTTGT-1_V12D07-332_B1,3,1,0,0,0,4
GGACCTACGGTAACGT-1_V12D07-332_B1,0,4,0,0,0,4
GAAATATGCTTGAATG-1_V12D07-332_B1,1,0,0,0,0,1
CCGTATTAGCGCAGTT-1_V12D07-332_B1,3,0,0,0,0,3
AGGCGTCTATGGACGG-1_V12D07-332_B1,0,0,0,0,0,0
AACATCGATACGTCTA-1_V12D07-332_B1,0,0,2,0,0,2
TGAATATGCTATAAAC-1_V12D07-332_B1,1,1,0,1,0,3
ACCAAACACCCAGCGA-1_V12D07-332_B1,0,1,0,0,1,2
TGGCTTGTACAAGCTT-1_V12D07-332_B1,1,0,0,0,0,1
GAATGAAGGTCTTCAG-1_V12D07-332_B1,0,0,0,0,0,0
AGATACCAGCACTTCA-1_V12D07-332_B1,0,0,0,0,1,1
GCGGTCCCGGTGAAGG-1_V12D07-332_B1,1,1,0,1,0,3
GAGGCATTTGCAGCAG-1_V12D07-332_B1,0,0,0,0,0,0
GGCAAGCCAGGGATAG-1_V12D07-332_B1,0,0,0,0,0,0
TCTACGGGCTCAGTTG-1_V12D07-332_B1,0,2,0,0,0,2
TCTGCGAATCGTTCGC-1_V12D07-332_B1,0,1,0,0,0,1
AGCTCGTTGATGGAAA-1_V12D07-332_B1,0,2,0,0,0,2
TGAATGAGATACAGCA-1_V12D07-332_B1,0,1,0,0,0,1
ACCCTTGCCTGGGTCG-1_V12D07-332_B1,0,1,0,0,0,1
GGCGAACCGTTCTGAT-1_V12D07-332_B1,0,0,0,0,0,0
GCGATGTCTGTGCTTG-1_V12D07-332_B1,8,0,0,0,2,10
ATTAACACCTGAGATA-1_V12D07-332_B1,7,0,0,0,4,11
GAAATCTGACCAAGTT-1_V12D07-332_B1,7,2,0,0,1,10
CCTGACAAACTCGCGC-1_V12D07-332_B1,0,0,0,0,5,5
ATGTCATTTCCCATTG-1_V12D07-332_B1,5,2,0,0,0,7
GCGGTGCGGAGCATCG-1_V12D07-332_B1,2,1,0,0,2,5
CGGAAAGCAAATGTGC-1_V12D07-332_B1,2,0,0,0,1,3
GCTGAGCAACGGTTCT-1_V12D07-332_B1,3,1,0,0,1,5
TCACTCTTCGTCTGTC-1_V12D07-332_B1,4,1,0,0,0,5
GATCTTCATTGTCCTC-1_V12D07-332_B1,2,2,0,0,1,5
ACTCGATGTATTTCAT-1_V12D07-332_B1,3,1,0,0,2,6
TGAAGAGCGGTCCTAG-1_V12D07-332_B1,4,1,0,0,0,5
TAAACGTCGTCAATGA-1_V12D07-332_B1,2,4,0,0,2,8
ATAGCCTCAGTACCCA-1_V12D07-332_B1,10,2,0,0,2,14
GTCCTACAGGCGGCTC-1_V12D07-332_B1,8,1,0,0,0,9
AACTTCTGCGTCTATC-1_V12D07-332_B1,0,9,0,1,6,16
GGGTTCAGACGAACAA-1_V12D07-332_B1,0,0,0,0,0,0
AGTCTGGACATCCTTG-1_V12D07-332_B1,2,8,0,0,1,11
TTGAACGAATCCTTTG-1_V12D07-332_B1,2,4,0,0,0,6
GAAATACTAAACGTTT-1_V12D07-332_B1,2,3,0,0,0,5
CCCGCGCAATGCACCC-1_V12D07-332_B1,0,2,0,0,1,3
TTCGGCTAGAGATGGT-1_V12D07-332_B1,0,3,0,0,1,4
GACACGAGTTAGAGGA-1_V12D07-332_B1,1,3,0,0,1,5
GAGGTCCCAAAGATCT-1_V12D07-332_B1,1,1,0,0,0,2
TAACTCCATGGAGGCT-1_V12D07-332_B1,0,0,0,0,0,0
CTTGTTTATGTAGCCA-1_V12D07-332_B1,1,0,0,0,0,1
GATGGCGCACACATTA-1_V12D07-332_B1,0,0,0,0,0,0
ATAATAGTGTAGGGAC-1_V12D07-332_B1,1,1,0,0,0,2
CGCTATTCAATGTATG-1_V12D07-332_B1,1,3,0,0,1,5
ATATTGCTGTCAAAGT-1_V12D07-332_B1,0,1,1,0,0,2
GGATTCAGTACGGTGG-1_V12D07-332_B1,1,0,0,0,0,1
TTCTTAGTGAACGGTG-1_V12D07-332_B1,0,2,0,0,0,2
AATGGTTCTCACAAGC-1_V12D07-332_B1,2,0,0,1,1,4
TATACACGCAAAGTAT-1_V12D07-332_B1,1,3,0,0,0,4
CTTCATAGCTCAAGAA-1_V12D07-332_B1,0,1,0,0,0,1
CAACGGTTCTTGATAC-1_V12D07-332_B1,1,1,0,0,0,2
ACACCCGAGAAATCCG-1_V12D07-332_B1,0,0,0,0,0,0
TCTATCATGCAGTTAC-1_V12D07-332_B1,1,0,0,1,0,2
CCCGCCATGCTCCCGT-1_V12D07-332_B1,0,2,1,0,0,3
CGCTTCCACTGAAATC-1_V12D07-332_B1,1,1,1,0,0,3
CACTGTCCAAGTGAGA-1_V12D07-332_B1,0,0,1,1,1,3
ATTACTAGCCTCTTGC-1_V12D07-332_B1,0,0,0,0,0,0
CATAGTAGCATAGTAG-1_V12D07-332_B1,0,0,0,0,0,0
GCGGGAACCAGGCCCT-1_V12D07-332_B1,0,1,1,0,0,2
ATTAGATTGATAGCGG-1_V12D07-332_B1,0,0,2,0,0,2
CTCGGTCCGTAGCCTG-1_V12D07-332_B1,0,0,0,0,1,1
TGGCTTTGGGTAGACA-1_V12D07-332_B1,1,0,2,0,0,3
TATCCATATCATGCGA-1_V12D07-332_B1,0,2,1,0,0,3
GGAGTGCCGCCCTGGA-1_V12D07-332_B1,0,1,0,1,0,2
TGAGAATGCTTTACCG-1_V12D07-332_B1,0,0,2,1,0,3
TTAACCAACCCTCCCT-1_V12D07-332_B1,0,3,0,0,0,3
TGTTTCGGTACTTCTC-1_V12D07-332_B1,0,0,0,0,0,0
TTGCTGAAGGAACCAC-1_V12D07-332_B1,0,0,0,0,0,0
TATTTAGTCTAGATCG-1_V12D07-332_B1,2,2,0,0,0,4
CTCCGGCCTAATATGC-1_V12D07-332_B1,0,0,1,0,0,1
TTGTGGCCCTGACAGT-1_V12D07-332_B1,0,1,1,0,1,3
TCGCCGGTCGATCCGT-1_V12D07-332_B1,0,0,0,0,0,0
CCATAGGTTGGCGTGG-1_V12D07-332_B1,0,2,1,0,1,4
GAACGACCGAATGATA-1_V12D07-332_B1,0,0,0,0,1,1
TCCGATAATTGCCATA-1_V12D07-332_B1,0,1,0,0,0,1
CATTACGTCGGCCCGT-1_V12D07-332_B1,1,2,1,0,0,4
CAAGCACCAAATGCCT-1_V12D07-332_B1,0,1,1,1,0,3
TGCATGGATCGGATCT-1_V12D07-332_B1,1,1,0,0,0,2
GAAATCGCGCGCAACT-1_V12D07-332_B1,0,0,0,2,1,3
CTGAAAGAGATCCGAC-1_V12D07-332_B1,0,0,1,2,0,3
CACCTCGATGGTGGAC-1_V12D07-332_B1,1,0,0,0,1,2
ATTTGTTCCAGGGCTC-1_V12D07-332_B1,0,2,1,0,1,4
TGGGCCACAAGAGCGC-1_V12D07-332_B1,1,0,0,0,3,4
CCTTCTTGATCCAGTG-1_V12D07-332_B1,1,1,0,1,0,3
CCTCGCCAGCAAATTA-1_V12D07-332_B1,0,1,0,1,0,2
TTCATGGCGCAACAGG-1_V12D07-332_B1,1,0,0,0,0,1
TTAATCAGTACGTCAG-1_V12D07-332_B1,0,1,0,0,0,1
CCTATCTATATCGGAA-1_V12D07-332_B1,2,4,0,0,0,6
ATTATACTTTGCTCGT-1_V12D07-332_B1,0,1,0,16,1,18
ATGGATCCGGCGTCCG-1_V12D07-332_B1,0,3,0,3,3,9
CGCCCGCTTCCGTACA-1_V12D07-332_B1,0,2,0,12,0,14
GGATTCCGCTATACCC-1_V12D07-332_B1,0,1,0,17,0,18
CGGTCTATCAACCCGT-1_V12D07-332_B1,0,0,0,0,0,0
ATGCCGGTTGATGGGA-1_V12D07-332_B1,0,0,0,0,0,0
TCATGCAGGTTCTCAT-1_V12D07-332_B1,0,0,0,0,0,0
TGAGCTTTAATGACGC-1_V12D07-332_B1,0,2,0,0,0,2
TCCCTTAGATTACTCG-1_V12D07-332_B1,1,2,0,0,0,3
ATATCTCCCTCGTTAA-1_V12D07-332_B1,1,0,0,0,0,1
AGCTCTTCCCAGTGCA-1_V12D07-332_B1,0,2,0,0,0,2
TCGCTAAACCGCTATC-1_V12D07-332_B1,0,1,0,0,1,2
CACATTCTTTCGATGG-1_V12D07-332_B1,0,3,0,0,0,3
GATATGCGGTAGCCAA-1_V12D07-332_B1,2,1,0,0,0,3
CGTTTCACTTCGGGCG-1_V12D07-332_B1,0,2,0,0,0,2
CCAATTACGGGTCGAG-1_V12D07-332_B1,0,2,0,0,0,2
GCAGGTAGAGTATGGT-1_V12D07-332_B1,2,1,0,0,0,3
GTCGTATTGGCGTACA-1_V12D07-332_B1,0,0,0,0,0,0
GAAATTAGCACGGATA-1_V12D07-332_B1,0,1,0,0,0,1
AATGCACCAAGCAATG-1_V12D07-332_B1,0,1,0,0,0,1
AGGACGCTCGATGTTG-1_V12D07-332_B1,0,2,0,0,0,2
GGCTAAAGGGCGGGTC-1_V12D07-332_B1,0,1,0,1,0,2
CATCTATCCCGTGTCT-1_V12D07-332_B1,3,0,0,0,0,3
CAGTAACTATTTATTG-1_V12D07-332_B1,1,0,0,0,0,1
CATATACTACTGATAA-1_V12D07-332_B1,2,0,0,0,0,2
GCGTTCGGAGACCGGG-1_V12D07-332_B1,1,2,0,0,0,3
AAGTTCAGTCTGCGTA-1_V12D07-332_B1,3,1,0,0,0,4
CGAAGCTATAAATTCA-1_V12D07-332_B1,0,2,0,0,1,3
CGCGGTCACAAACCAA-1_V12D07-332_B1,3,1,0,0,0,4
GGGAATGAGCCCTCAC-1_V12D07-332_B1,5,0,1,0,0,6
ACGGAGCGCAAATTAC-1_V12D07-332_B1,4,1,0,0,2,7
CGTTCTTCGCACACCT-1_V12D07-332_B1,4,2,0,0,0,6
GAATAGCCCTGCGGTC-1_V12D07-332_B1,3,4,0,0,0,7
AATAGCTACCGCGTGC-1_V12D07-332_B1,5,0,0,0,0,5
CCGAGCTGTGCTTGTC-1_V12D07-332_B1,2,1,0,1,0,4
GATGACGATGATCGCG-1_V12D07-332_B1,4,1,0,0,1,6
GCCTATGCTGGGCCTT-1_V12D07-332_B1,0,1,0,0,0,1
TTACTGTCTAGAGCTC-1_V12D07-332_B1,1,1,0,0,0,2
AGCGGTTGCCGCTCTG-1_V12D07-332_B1,0,0,0,0,0,0
GCTTGCAGCACAATTG-1_V12D07-332_B1,0,0,0,0,0,0
CCGGAGGTCTTATGGT-1_V12D07-332_B1,1,2,0,0,0,3
ACAGTATACCGTGGGA-1_V12D07-332_B1,0,1,0,0,0,1
GGGATCCCAATACAAA-1_V12D07-332_B1,0,0,0,0,0,0
ATTACGACTCCACAGT-1_V12D07-332_B1,0,0,0,0,0,0
CTCACACGCAAGCCTA-1_V12D07-332_B1,1,0,0,0,0,1
CCAGATGTAAATGGGT-1_V12D07-332_B1,0,1,0,0,0,1
GAACTTGTGCACGGGA-1_V12D07-332_B1,0,0,0,0,0,0
AAGCCGCTTTACCTTG-1_V12D07-332_B1,0,1,0,1,1,3
TCCATTCCCACTAGAG-1_V12D07-332_B1,0,0,0,0,0,0
AGAGCGCTTGTAACGG-1_V12D07-332_B1,0,0,0,0,0,0
TGGGTTCCCGGACGGA-1_V12D07-332_B1,9,0,0,0,1,10
GCTGCGCCTCCCACGT-1_V12D07-332_B1,6,0,0,0,2,8
CTGTTGGCTCTTCTGA-1_V12D07-332_B1,5,2,0,0,2,9
TTGTTCTAGATACGCT-1_V12D07-332_B1,5,1,0,0,6,12
CCCTCAAGCTCTTAGT-1_V12D07-332_B1,8,1,0,0,7,16
TGGTCTAGCTTACATG-1_V12D07-332_B1,5,1,0,0,1,7
ATGCACCTTCCTTAAT-1_V12D07-332_B1,3,1,0,0,0,4
GGGATACGGTAATAAT-1_V12D07-332_B1,1,2,0,0,2,5
AGTTCACCGGTTGGAC-1_V12D07-332_B1,5,1,0,0,1,7
GACATACTGTCGCAGA-1_V12D07-332_B1,6,0,0,0,1,7
TGGACACCGTTGCTTG-1_V12D07-332_B1,1,6,0,0,0,7
TGCGATGCTAATGGCT-1_V12D07-332_B1,0,0,0,0,1,1
TTCTGTTTCCTGTCGC-1_V12D07-332_B1,2,2,0,0,0,4
CGTTGTAAACGTCAGG-1_V12D07-332_B1,0,1,0,0,0,1
CGTCATACCATATCCA-1_V12D07-332_B1,0,0,0,0,0,0
TAGTACCTTAGTGGTC-1_V12D07-332_B1,1,4,0,0,0,5
CTGGCGGGAATAAGTA-1_V12D07-332_B1,1,5,0,0,0,6
AGTGTGGTCTATTGTG-1_V12D07-332_B1,0,5,0,0,0,5
GCTATCGCGGCGCAAC-1_V12D07-332_B1,0,0,0,0,0,0
CAGTAATCCCTCCCAG-1_V12D07-332_B1,0,0,0,0,0,0
GTATTAAGGCGTCTAA-1_V12D07-332_B1,0,0,0,0,0,0
CTAATTTCAACAACAC-1_V12D07-332_B1,1,2,0,0,0,3
TTAGCAACATGGATGT-1_V12D07-332_B1,1,4,0,1,1,7
ATGCTCAGTGTTGCAT-1_V12D07-332_B1,2,1,0,0,0,3
GATGTTTGTGCGAGAT-1_V12D07-332_B1,2,3,0,0,1,6
CACTTCGCCACAGGCT-1_V12D07-332_B1,1,2,0,0,0,3
CTGTATGGTGTAGAAA-1_V12D07-332_B1,1,0,0,0,1,2
TACGTGCACTATGCTG-1_V12D07-332_B1,0,2,0,0,0,2
GTATCAGCTTGGGTTC-1_V12D07-332_B1,0,4,0,0,0,4
TAACAAAGGGAGAAGC-1_V12D07-332_B1,1,0,0,0,0,1
TTACATCGTGGCCTGG-1_V12D07-332_B1,1,1,0,0,0,2
TCTGAACCGGTCGGCT-1_V12D07-332_B1,2,0,1,0,0,3
GGCTCGTGCCACCAGC-1_V12D07-332_B1,0,0,1,0,0,1
TATAAGTGAGGATAGC-1_V12D07-332_B1,0,0,0,0,1,1
GCCCGCGCGTTTGACA-1_V12D07-332_B1,2,2,0,0,0,4
TGCTGGTTGGACAATT-1_V12D07-332_B1,1,0,0,0,0,1
GCCTAGCGATCTGACC-1_V12D07-332_B1,1,1,1,0,0,3
CCATGCTCTGCAGGAA-1_V12D07-332_B1,0,0,0,0,0,0
TATAAATCCACAAGCT-1_V12D07-332_B1,0,0,0,0,0,0
CGCTCGACATAATGAT-1_V12D07-332_B1,0,0,0,0,0,0
CCAATTGAATGTTAAT-1_V12D07-332_B1,0,1,1,0,0,2
GCTAATACCGAATGCC-1_V12D07-332_B1,0,0,3,0,0,3
TTCAACGACCCGACCG-1_V12D07-332_B1,0,1,2,0,1,4
TTCCTCGAGGGTGTCT-1_V12D07-332_B1,0,1,1,2,1,5
CAACGACCCGTTTACA-1_V12D07-332_B1,1,0,2,0,0,3
CTTGTACTTGTTGACT-1_V12D07-332_B1,1,0,1,0,0,2
TCTCTAATAGCTGGTA-1_V12D07-332_B1,1,2,0,0,0,3
ATTATGCCATAGGGAG-1_V12D07-332_B1,0,0,1,1,0,2
GACAACGCAGCTTACG-1_V12D07-332_B1,0,0,1,0,1,2
AGATGACTCGCCCACG-1_V12D07-332_B1,0,0,0,0,1,1
GTGCGGGTCTCCAAAT-1_V12D07-332_B1,1,0,1,1,0,3
GTACGAGATTGCGACA-1_V12D07-332_B1,0,0,0,0,1,1
GTATAGGACTCAGTAG-1_V12D07-332_B1,0,2,1,1,0,4
TTGCACGGAGCAGCAC-1_V12D07-332_B1,1,0,1,0,2,4
CACAGCTAGGGAGTGA-1_V12D07-332_B1,0,1,0,0,0,1
ATACTAGCATGACCCT-1_V12D07-332_B1,0,2,0,0,0,2
CCAAGACTTCTGCGAA-1_V12D07-332_B1,0,4,0,0,0,4
ACATAATAAGGCGGTG-1_V12D07-332_B1,0,0,0,0,0,0
TAATACACAGTAGTAT-1_V12D07-332_B1,0,0,0,0,0,0
TCTTGGTAACACCAAA-1_V12D07-332_B1,0,0,0,1,0,1
AACTGGGTCCCGACGT-1_V12D07-332_B1,0,0,2,0,1,3
ATCACTTCATCCTCGC-1_V12D07-332_B1,0,0,1,0,0,1
TGGAAGGATAAAGATG-1_V12D07-332_B1,0,0,0,0,0,0
CATGATGCACAATTCT-1_V12D07-332_B1,0,0,2,0,1,3
TGCCTGATCAAACGAT-1_V12D07-332_B1,0,1,0,0,0,1
ATAGGGATATCCTTGA-1_V12D07-332_B1,0,1,0,3,0,4
CACCTAATCAGTTTAC-1_V12D07-332_B1,2,1,0,0,0,3
TGTGACTACGCCAGTC-1_V12D07-332_B1,0,2,0,2,1,5
CCCGACCATAGTCCGC-1_V12D07-332_B1,0,2,0,0,0,2
CGCGCCCGACTTAATA-1_V12D07-332_B1,2,3,1,0,0,6
TGCCACCTGGCGAAAC-1_V12D07-332_B1,1,1,0,2,1,5
CTGCCAAGGTTGGAAG-1_V12D07-332_B1,0,0,0,1,0,1
TCTCCAACGTAGGTTA-1_V12D07-332_B1,2,1,0,0,0,3
TTCTTGGAGTAATGAG-1_V12D07-332_B1,1,1,0,0,0,2
GTCTCGATCTGCTTTC-1_V12D07-332_B1,0,2,1,1,0,4
TACTCTCCGAACAAAT-1_V12D07-332_B1,0,0,4,3,0,7
ATCACATTAGAATATC-1_V12D07-332_B1,0,0,0,16,0,16
TACGGGATGCTAGCAG-1_V12D07-332_B1,0,1,1,12,0,14
AGCTGAAGTAAACCAA-1_V12D07-332_B1,0,1,0,2,0,3
CATGGGTCGGGTGTGG-1_V12D07-332_B1,0,1,0,9,0,10
CACCCACGAGGCAATT-1_V12D07-332_B1,0,0,0,0,0,0
TGCCATTACTAAAGAA-1_V12D07-332_B1,1,0,0,3,0,4
CCGTTACGTTAGAACA-1_V12D07-332_B1,0,2,0,0,0,2
GCCAGGAGTAACCGAT-1_V12D07-332_B1,0,2,0,3,1,6
GGAAAGTGCCCATGCC-1_V12D07-332_B1,0,2,0,0,1,3
TCTTACCGGAACTCGT-1_V12D07-332_B1,2,1,0,1,0,4
TATGTCAAGACCGACT-1_V12D07-332_B1,0,1,0,0,0,1
CCTAACTAAGGCTCTA-1_V12D07-332_B1,1,2,0,2,0,5
GCGGTGAACTGCGCTC-1_V12D07-332_B1,0,0,0,0,0,0
CCTCGCGCGATATAGG-1_V12D07-332_B1,0,0,0,1,0,1
ATCGGCAAGCAGTCCA-1_V12D07-332_B1,0,3,0,0,0,3
AGATCGTGCATAAGAT-1_V12D07-332_B1,0,2,0,0,0,2
ATTCAGGACCTATTTC-1_V12D07-332_B1,1,2,0,0,0,3
AGCTAGAAGCAGAAGT-1_V12D07-332_B1,1,4,0,0,0,5
TTCGCTATCTGACGTG-1_V12D07-332_B1,1,3,0,0,1,5
TTCCGCAGAGAAATAT-1_V12D07-332_B1,1,0,0,0,1,2
CAGTACATTCTCTAAA-1_V12D07-332_B1,1,2,0,0,0,3
GTGAAGATTTCAAGTG-1_V12D07-332_B1,1,1,0,0,0,2
AACGCATGATCTGGGT-1_V12D07-332_B1,3,3,0,0,1,7
CCCAGAGGAGGGCGTA-1_V12D07-332_B1,2,1,0,0,1,4
GGAAACCTTGTTGAAT-1_V12D07-332_B1,4,0,0,0,1,5
GTGAAGCCGTATAGTC-1_V12D07-332_B1,5,4,0,0,1,10
GAGCTGTCGTCTCGGA-1_V12D07-332_B1,4,0,0,0,1,5
TGTCATTTGTTGGGAA-1_V12D07-332_B1,3,2,0,0,1,6
ACCAACACCACACACT-1_V12D07-332_B1,3,2,0,0,1,6
AAATGATTCGATCAGC-1_V12D07-332_B1,1,2,0,0,1,4
CTGCTTTATGTCCGCG-1_V12D07-332_B1,2,2,0,0,0,4
GCGAGAGGCCATGTAA-1_V12D07-332_B1,2,1,0,0,0,3
ATTGACCGGCGATGAC-1_V12D07-332_B1,1,0,0,0,0,1
ACCCTGGTAACGCCCT-1_V12D07-332_B1,0,3,0,0,0,3
GTTGGACCGCATCAGG-1_V12D07-332_B1,0,1,0,0,0,1
CGTTTACAAGGCAGCT-1_V12D07-332_B1,0,1,0,0,0,1
CGGTCCATGAGACTCC-1_V12D07-332_B1,0,0,0,0,0,0
GTTCGTCTGGGTCCCT-1_V12D07-332_B1,0,2,0,0,0,2
TGTACTACTCTCACGG-1_V12D07-332_B1,1,3,0,0,1,5
AGTGAAGATGGTGTCC-1_V12D07-332_B1,0,0,0,0,0,0
GAGGGCCATAATATTA-1_V12D07-332_B1,0,4,0,0,0,4
ACTCCCGTAGACTAGG-1_V12D07-332_B1,0,0,0,0,0,0
CGTCAAATGGTCGCAG-1_V12D07-332_B1,0,0,0,0,0,0
AAGTCTAGTAGCTGCC-1_V12D07-332_B1,0,0,0,0,0,0
AAGAAATCACCAGATT-1_V12D07-332_B1,0,3,0,0,0,3
GAGTGCACGGACAACA-1_V12D07-332_B1,2,1,0,0,0,3
GTTCAAATCAGATGTC-1_V12D07-332_B1,11,0,0,0,3,14
CATGGCTCCCTATGTC-1_V12D07-332_B1,7,0,0,0,1,8
GGCCACACGAAAGCCT-1_V12D07-332_B1,6,0,0,0,4,10
GAAGCCGGGTAAGCTC-1_V12D07-332_B1,8,0,0,0,1,9
TTGCGCTCTCTCGCTT-1_V12D07-332_B1,9,0,0,0,7,16
TACATGACCTTATCCG-1_V12D07-332_B1,7,1,0,0,4,12
GTCCTTCTACAACCCA-1_V12D07-332_B1,2,5,0,2,2,11
TATATGCTGGGTTGCC-1_V12D07-332_B1,4,0,0,0,1,5
GTTTATGGGATTTAGA-1_V12D07-332_B1,2,2,0,0,0,4
GGAACCCGAACAAGAA-1_V12D07-332_B1,4,1,0,0,1,6
AACGTTATCAGCACCT-1_V12D07-332_B1,4,0,0,0,1,5
CATCGTCCGGTTACTA-1_V12D07-332_B1,2,0,0,0,0,2
AGACAGCTCAGAATCC-1_V12D07-332_B1,2,2,0,0,0,4
GCAGATCCTCGCAAAT-1_V12D07-332_B1,6,0,0,0,4,10
GGGTCATGCGTACCAT-1_V12D07-332_B1,4,3,0,0,1,8
CTGGTCATTCCAATCC-1_V12D07-332_B1,6,3,0,0,1,10
CCAGAGACAAAGCCGG-1_V12D07-332_B1,2,0,0,0,1,3
CCGAAGTATATTGTTC-1_V12D07-332_B1,1,3,0,0,0,4
GCTAAACCTGAGGTGA-1_V12D07-332_B1,0,2,0,1,0,3
TCATACTTACAGATCC-1_V12D07-332_B1,2,0,0,0,1,3
CGAGCACTTCAAGTTT-1_V12D07-332_B1,4,0,0,0,0,4
TAGCAACCTGTCACAA-1_V12D07-332_B1,0,1,0,0,2,3
TGGGAAATGCCTTTCC-1_V12D07-332_B1,0,3,0,0,0,3
AGACCATGGGATACAA-1_V12D07-332_B1,2,2,0,0,0,4
TAAATGAATCCGTTTC-1_V12D07-332_B1,0,2,0,0,0,2
ACAACGGTCCCTGCGA-1_V12D07-332_B1,1,2,0,0,1,4
GTCACTCTCCAAATCT-1_V12D07-332_B1,3,1,0,0,0,4
TTCTACTTGCGAGGGC-1_V12D07-332_B1,1,1,0,0,0,2
CGCAATTACTTTCGGT-1_V12D07-332_B1,0,1,0,0,0,1
CTGTTCATCTCACGGG-1_V12D07-332_B1,4,1,0,0,0,5
TTCTTGTAACCTAATG-1_V12D07-332_B1,2,1,0,1,1,5
GCTTGATGATAATCAG-1_V12D07-332_B1,2,0,1,0,0,3
TTGGCTCGCATGAGAC-1_V12D07-332_B1,1,4,0,1,0,6
GCCCAGTTGGTATGCC-1_V12D07-332_B1,0,2,2,0,0,4
ATTCCTCCGCCAGTGC-1_V12D07-332_B1,1,1,1,0,1,4
TCGTCCGCTGGCGTCT-1_V12D07-332_B1,1,1,1,1,1,5
GGAGAAGTCATTGGCA-1_V12D07-332_B1,0,1,0,0,0,1
TTGTTAGCAAATTCGA-1_V12D07-332_B1,0,1,0,0,1,2
TCTAGCATCTTCGATG-1_V12D07-332_B1,1,0,1,0,0,2
TTCTAGGCCAATTGTG-1_V12D07-332_B1,0,1,4,0,0,5
TCACGGTCATCGCACA-1_V12D07-332_B1,0,2,0,0,0,2
ATGAAGCCAAGGAGCC-1_V12D07-332_B1,1,1,0,0,1,3
AATGACTGTCAGCCGG-1_V12D07-332_B1,2,0,1,0,0,3
CCAAACAGAACCCTCG-1_V12D07-332_B1,0,0,0,1,0,1
TATCGATGATTAAACG-1_V12D07-332_B1,0,0,2,0,0,2
GAACACACATCAACCA-1_V12D07-332_B1,0,0,0,2,0,2
CCCGTCAGCGTCTGAC-1_V12D07-332_B1,0,0,0,1,0,1
AGCATCGTCGATAATT-1_V12D07-332_B1,0,0,1,0,0,1
GACTAAGATCATGCAC-1_V12D07-332_B1,1,0,3,0,0,4
TAGGGTGTTTCAAGAG-1_V12D07-332_B1,0,0,2,0,0,2
TGGTTCGTAGCAAAGG-1_V12D07-332_B1,0,0,1,0,1,2
CTGTTCACTGCCTGTG-1_V12D07-332_B1,0,1,0,1,0,2
ATGTGCATCCGACGCA-1_V12D07-332_B1,0,0,0,0,0,0
TTGTCGTTCAGTTACC-1_V12D07-332_B1,2,0,2,0,0,4
CGGGATCAATGTAAGA-1_V12D07-332_B1,0,1,0,0,0,1
TTATCTGTATCATAAC-1_V12D07-332_B1,0,0,0,0,0,0
ATCGACTCTTTCCGTT-1_V12D07-332_B1,1,0,3,0,0,4
CTCATTTGATGGGCGG-1_V12D07-332_B1,0,0,1,0,0,1
GTAAGCGGGCAGTCAG-1_V12D07-332_B1,0,0,0,0,0,0
TCTATCGGTCGCAACA-1_V12D07-332_B1,1,1,1,0,0,3
AACGCGGTCTCCAGCC-1_V12D07-332_B1,0,1,1,1,0,3
ATTAATACTACGCGGG-1_V12D07-332_B1,0,1,1,0,0,2
CTTTAACTTTCAAAGG-1_V12D07-332_B1,0,1,0,1,0,2
CGTACCTGATAGGCCT-1_V12D07-332_B1,0,2,0,0,0,2
GAATGTTGGGTAATCT-1_V12D07-332_B1,0,1,0,0,0,1
TGCGGAGTAAAGGTGC-1_V12D07-332_B1,0,1,1,0,0,2
CCTGAATATTTACATA-1_V12D07-332_B1,1,0,0,0,0,1
TTGCTCCCATACCGGA-1_V12D07-332_B1,1,1,0,0,0,2
CCTCTAATCTGCCAAG-1_V12D07-332_B1,0,0,1,0,0,1
AGGTTGAGGCACGCTT-1_V12D07-332_B1,0,0,4,0,0,4
TCCCGTCAGTCCCGCA-1_V12D07-332_B1,0,0,0,0,0,0
TCCGATGACTGAGCTC-1_V12D07-332_B1,0,1,0,0,0,1
CAGCCTCCTGCAGAGG-1_V12D07-332_B1,0,3,0,0,0,3
CTTAGCCTTCCACATG-1_V12D07-332_B1,0,2,1,0,0,3
ATTAATGAACCAGTCG-1_V12D07-332_B1,0,0,0,0,1,1
ACGATACATAGAACTA-1_V12D07-332_B1,2,2,0,0,1,5
AGCCACTCCCGTGCTT-1_V12D07-332_B1,1,1,0,1,0,3
ATACGGGTTTCGATTG-1_V12D07-332_B1,2,3,0,1,0,6
CTGTCAAATGGCTCGG-1_V12D07-332_B1,0,0,0,0,0,0
GCTCGGAATTTAAAGC-1_V12D07-332_B1,0,0,0,11,0,11
TAGGCATGTTACGCCA-1_V12D07-332_B1,0,7,0,4,0,11
TGGCAACTCGCGCGCC-1_V12D07-332_B1,0,2,0,12,1,15
ATCAGTAGGCAGGGAT-1_V12D07-332_B1,0,6,0,9,0,15
TATCGATCTATGCATA-1_V12D07-332_B1,0,0,0,14,0,14
CGACTCAGGATGTTAT-1_V12D07-332_B1,0,1,0,22,0,23
GCCATATTGCACACAG-1_V12D07-332_B1,0,1,0,4,0,5
AATTCATAAGGGATCT-1_V12D07-332_B1,0,2,0,16,0,18
CGGTAGAGGTGCAGGT-1_V12D07-332_B1,0,3,0,4,0,7
AATGATGATACGCTAT-1_V12D07-332_B1,0,1,0,20,0,21
CTTGTGCTCACCGATT-1_V12D07-332_B1,0,0,0,6,0,6
TTCCAATCAGAGCTAG-1_V12D07-332_B1,0,0,0,16,0,16
CGATGGACCCTACGCC-1_V12D07-332_B1,0,0,0,2,0,2
GGTCGGATAAACGGCG-1_V12D07-332_B1,0,0,0,1,0,1
TTAGCTAATACGATCT-1_V12D07-332_B1,0,0,0,0,0,0
CTCGATATTTGCGAGC-1_V12D07-332_B1,2,0,0,0,0,2
ATTACTTACTGGGCAT-1_V12D07-332_B1,0,0,0,0,0,0
CTAGCCGATGTTATGA-1_V12D07-332_B1,0,1,0,0,0,1
TACTGCAATCAATTAC-1_V12D07-332_B1,1,2,0,0,0,3
TAGTCTGTGACGTTGC-1_V12D07-332_B1,1,1,0,0,0,2
CTCGTTTCTAATGTTT-1_V12D07-332_B1,1,0,0,0,0,1
TTCGTTCAACGAAGTT-1_V12D07-332_B1,2,1,0,0,0,3
CTGAATTTATTGCCAG-1_V12D07-332_B1,2,1,0,0,1,4
TGGAATATCCTTGACC-1_V12D07-332_B1,3,0,0,0,0,3
CAGATCATTTAAAGTC-1_V12D07-332_B1,9,1,0,0,0,10
CTCCTTTACGCAAGTC-1_V12D07-332_B1,3,3,0,1,0,7
TCCCAAACAGACAACG-1_V12D07-332_B1,5,2,0,1,0,8
ATCGCTGCGTGCAGCA-1_V12D07-332_B1,2,0,0,0,0,2
TTAGTTCAAGTGTTCG-1_V12D07-332_B1,1,0,0,0,0,1
AAACTCGTGATATAAG-1_V12D07-332_B1,1,2,0,0,0,3
TTAACGAACAAGCAGT-1_V12D07-332_B1,2,2,1,0,0,5
GTTATATCAGGAGCCA-1_V12D07-332_B1,4,2,0,1,0,7
CAAATTGGATTATGCC-1_V12D07-332_B1,1,1,0,0,0,2
CGAGGAGCTTCCATAT-1_V12D07-332_B1,1,0,0,0,0,1
GGAGACCAATGTGCTT-1_V12D07-332_B1,0,1,0,0,0,1
CATTGATGAACACGCC-1_V12D07-332_B1,1,0,0,0,0,1
GTCAATGCTATAATTT-1_V12D07-332_B1,0,0,0,0,0,0
ACCACCCTCTCTTCTA-1_V12D07-332_B1,0,0,0,0,0,0
TGGAGGGAAACACCTC-1_V12D07-332_B1,0,1,0,0,0,1
CACGGACGTGGATGGC-1_V12D07-332_B1,0,4,0,0,0,4
AACTTTCTCGATCATG-1_V12D07-332_B1,0,0,0,0,0,0
CGTATTGTTTCCTAAT-1_V12D07-332_B1,0,0,0,0,0,0
CCTACTGCGGCGGCCA-1_V12D07-332_B1,0,0,0,0,0,0
CTTAGGTCCCAATCGT-1_V12D07-332_B1,0,0,0,0,0,0
CGCAATCGATCATTAG-1_V12D07-332_B1,10,1,0,0,1,12
TGGTTATGCTTGCGGT-1_V12D07-332_B1,4,0,0,0,4,8
GGCTTGGCTCTCACCT-1_V12D07-332_B1,9,0,0,0,1,10
ATTGGTAGGATCCGCT-1_V12D07-332_B1,5,1,0,0,3,9
TCAGGGCGACTTCCTT-1_V12D07-332_B1,7,0,0,0,3,10
TCTGCAGATTCGAGTC-1_V12D07-332_B1,5,1,0,0,0,6
CTCTCGCTGTACTATG-1_V12D07-332_B1,2,5,0,0,2,9
AATAGTCGCGAGTCGG-1_V12D07-332_B1,3,1,0,0,0,4
AGTTACCCTTAAGACT-1_V12D07-332_B1,3,3,0,0,1,7
CTTAAATAAGACCCAT-1_V12D07-332_B1,5,1,0,0,0,6
GGTTGTGCTCTTGTCC-1_V12D07-332_B1,0,1,0,0,0,1
GTGAGTCTAAGACGGA-1_V12D07-332_B1,5,2,0,0,2,9
CGCGACACTGCGCAGC-1_V12D07-332_B1,2,1,0,0,0,3
GCTCGCGGTTCCGCTC-1_V12D07-332_B1,2,0,0,0,1,3
TTAACTCACGCGTGGA-1_V12D07-332_B1,6,3,0,0,0,9
GGAACGGCCTGCAGCC-1_V12D07-332_B1,6,4,0,0,0,10
GTAGAAACGGGTGGAG-1_V12D07-332_B1,1,1,0,0,5,7
TAATGAAAGACCCTTG-1_V12D07-332_B1,3,4,0,0,3,10
AGGCTTGCTAGACACC-1_V12D07-332_B1,0,1,0,0,2,3
TTGCGTAGTTTGAGGA-1_V12D07-332_B1,1,5,0,0,0,6
CCCGGTGGAAGAACCT-1_V12D07-332_B1,4,2,0,0,0,6
TTAACACCTCGAACAT-1_V12D07-332_B1,3,3,0,0,1,7
GATTCCTATACGGCGC-1_V12D07-332_B1,1,3,0,0,0,4
TTACCCTAACAGTCCT-1_V12D07-332_B1,1,0,0,0,0,1
ACCCACCTACATGCTC-1_V12D07-332_B1,0,1,0,0,0,1
AAAGGGCAGCTTGAAT-1_V12D07-332_B1,0,2,0,0,0,2
CACACAGGGATAGATT-1_V12D07-332_B1,0,3,0,0,0,3
AGAGCGTACAAGCTCG-1_V12D07-332_B1,2,1,0,0,0,3
TCTTACGGCATCCGAC-1_V12D07-332_B1,0,1,0,0,0,1
GCCTATTCCGATATAG-1_V12D07-332_B1,1,1,0,0,1,3
GAAAGTGACTAACTGC-1_V12D07-332_B1,3,0,1,0,0,4
CCGGAATGGTTTCAGT-1_V12D07-332_B1,1,1,0,0,0,2
AGTATAATACTAGGCA-1_V12D07-332_B1,1,2,0,0,0,3
TAACTATCGAAGGTCC-1_V12D07-332_B1,2,1,0,0,0,3
ATGAGGAGTGTTAATC-1_V12D07-332_B1,3,3,0,0,0,6
TGTGTCGCGAGTTGCA-1_V12D07-332_B1,0,0,0,0,1,1
ATCCAACGCAGTCATA-1_V12D07-332_B1,0,1,1,0,1,3
AAGGCGCGTAAAGCTT-1_V12D07-332_B1,1,0,0,0,0,1
AGTCGGCCCAAACGAC-1_V12D07-332_B1,0,0,2,0,0,2
AACGTCAGACTAGTGG-1_V12D07-332_B1,0,0,1,0,0,1
ACTACCAGCTCTCTGG-1_V12D07-332_B1,0,0,0,0,0,0
GCAAGTGCACAGAGAA-1_V12D07-332_B1,1,1,0,0,0,2
ACACCTTAAGTAGGGC-1_V12D07-332_B1,0,0,0,0,0,0
TTCGACGGGAAGGGCG-1_V12D07-332_B1,0,0,0,0,0,0
TTCGCACTCGCGTGCT-1_V12D07-332_B1,0,0,2,0,0,2
TATTTGTTACCCTTTA-1_V12D07-332_B1,3,0,0,0,0,3
CGCTGTGACGCCGCAC-1_V12D07-332_B1,0,0,1,1,1,3
GTTGCACGGAGTTTCG-1_V12D07-332_B1,0,1,1,0,0,2
GTTTCCTGGAGGGTGA-1_V12D07-332_B1,0,0,0,0,0,0
ACACCCAGCATGCAGC-1_V12D07-332_B1,1,0,2,0,0,3
TCAACCATGTTCGGGC-1_V12D07-332_B1,0,1,0,0,0,1
TTACAACTACGCATCC-1_V12D07-332_B1,2,1,2,0,0,5
TCCGATGGTGCGACAT-1_V12D07-332_B1,1,0,1,0,1,3
GGGCGTACATTTATAT-1_V12D07-332_B1,0,0,0,0,0,0
AGCGACCAACGATATT-1_V12D07-332_B1,1,0,0,0,0,1
ACACAAAGACGGGTGG-1_V12D07-332_B1,1,0,1,0,0,2
ATCGCACGCCGGGAGA-1_V12D07-332_B1,0,1,1,1,0,3
GCTCTAAACCCTGACG-1_V12D07-332_B1,0,0,0,0,0,0
AATGCAACCGGGTACC-1_V12D07-332_B1,0,0,0,2,0,2
TCAAACAACCGCGTCG-1_V12D07-332_B1,0,1,1,1,0,3
TATGCTCCCTACTTAC-1_V12D07-332_B1,0,0,0,1,0,1
AAAGGGATGTAGCAAG-1_V12D07-332_B1,0,2,1,0,0,3
ACGATCATACATAGAG-1_V12D07-332_B1,0,1,0,0,1,2
TTGTTCAGTGTGCTAC-1_V12D07-332_B1,1,2,0,1,1,5
ATGCATGATCCAGGAT-1_V12D07-332_B1,0,0,0,0,0,0
AGTCTTCTCCTCAAAT-1_V12D07-332_B1,0,0,0,0,0,0
GATTCCCTTGTCGCAG-1_V12D07-332_B1,0,0,1,1,0,2
CTCGCACCTATATAGT-1_V12D07-332_B1,0,4,1,1,0,6
ACTCAATAAAGGCACG-1_V12D07-332_B1,1,0,0,1,1,3
AACCGAGCTTGGTCAT-1_V12D07-332_B1,0,0,0,1,0,1
TAAGGCAACATAAGAT-1_V12D07-332_B1,0,0,0,0,0,0
CACGCACAGCGCAGCT-1_V12D07-332_B1,1,0,1,1,0,3
GGTTTACAATCTCAAT-1_V12D07-332_B1,0,0,1,1,0,2
TGCAGGATCGGCAAAG-1_V12D07-332_B1,0,2,0,2,0,4
ATAACGGAGTCCAACG-1_V12D07-332_B1,0,0,0,0,1,1
AACGATATGTCAACTG-1_V12D07-332_B1,0,0,0,0,1,1
GACAACGACCATTGAA-1_V12D07-332_B1,1,1,0,0,1,3
TTGACCATGTTCTCCG-1_V12D07-332_B1,0,3,2,0,0,5
AGTACGGGCACCTGGC-1_V12D07-332_B1,0,1,0,0,1,2
CGCCATCCGATTATGA-1_V12D07-332_B1,0,2,0,0,0,2
AAGGTATCCTAATATA-1_V12D07-332_B1,1,0,0,0,0,1
TGTTGTCAAGAAGTCT-1_V12D07-332_B1,0,0,1,0,0,1
CAGTGAATAAATGACT-1_V12D07-332_B1,0,1,0,0,0,1
CACCTTGCGAAACTCG-1_V12D07-332_B1,0,2,0,0,0,2
CATTTAGCGGACCATG-1_V12D07-332_B1,1,3,0,0,2,6
CCAGTCTAGACGGCGC-1_V12D07-332_B1,1,0,0,2,0,3
TCGCTTTAAACGTTTG-1_V12D07-332_B1,0,2,0,0,0,2
GTGAAACGGCGCCACC-1_V12D07-332_B1,1,3,0,9,0,13
GGGCTCATCGAACCCA-1_V12D07-332_B1,0,3,0,1,0,4
TTGATGTGTAGTCCCG-1_V12D07-332_B1,0,2,0,19,0,21
CAGTAGCCCACGCGGT-1_V12D07-332_B1,1,4,0,10,0,15
AGCGCGGGTGCCAATG-1_V12D07-332_B1,0,0,0,25,0,25
TAATCGATCCGTACGT-1_V12D07-332_B1,0,5,0,9,0,14
AGTGGCGGCAATTTGA-1_V12D07-332_B1,0,0,0,22,0,22
CCTTTCAATGAAGAAA-1_V12D07-332_B1,0,0,0,15,2,17
CTCAGTCACGACAAAT-1_V12D07-332_B1,1,1,0,18,0,20
ATAGGCTAGCTTCGCA-1_V12D07-332_B1,0,0,0,16,0,16
CGGTTCAAGTAGGTGT-1_V12D07-332_B1,2,2,0,2,0,6
CAGTCGAGGATGCAAT-1_V12D07-332_B1,1,3,0,0,0,4
TATCACCCAACCGACC-1_V12D07-332_B1,0,1,0,0,0,1
AATGATGCGACTCCTG-1_V12D07-332_B1,1,0,0,0,1,2
TGGAACCACTGACACA-1_V12D07-332_B1,1,0,0,1,1,3
GCCAATAGGGCATCTC-1_V12D07-332_B1,1,1,0,0,0,2
TTCTTTGGTCGCGACG-1_V12D07-332_B1,1,0,0,0,0,1
ATTAGATTCCTCAGCA-1_V12D07-332_B1,2,2,0,0,0,4
CCGTGGAACGATCCAA-1_V12D07-332_B1,3,1,0,0,0,4
GGGTCGTGGCAAGTGT-1_V12D07-332_B1,1,1,0,0,0,2
TCGCTCGGCACCAGCG-1_V12D07-332_B1,3,4,0,0,0,7
ACGCAATCACTACAGC-1_V12D07-332_B1,3,2,0,0,0,5
CTCTAATGCATTGATC-1_V12D07-332_B1,2,1,0,0,0,3
GTCTCGACTAAGTTTG-1_V12D07-332_B1,2,1,0,0,0,3
TGGTTTAAACGTGGGT-1_V12D07-332_B1,4,0,0,0,1,5
CGCAGATCTTCACCCG-1_V12D07-332_B1,1,0,0,1,0,2
TCCAGATGTACGCCAA-1_V12D07-332_B1,3,0,0,0,0,3
CATTGCGGGTCAATTC-1_V12D07-332_B1,3,0,0,0,0,3
GACGTTCGTAAATACA-1_V12D07-332_B1,2,3,0,0,1,6
TACACCGTCGTTAGTC-1_V12D07-332_B1,2,0,0,0,0,2
ACGGGCGTATGCGACA-1_V12D07-332_B1,3,0,0,0,0,3
GAAGGCTACCATTGTT-1_V12D07-332_B1,1,1,0,1,0,3
TAAATCTTTACACCTC-1_V12D07-332_B1,0,0,0,0,0,0
AGTTTATGTAAAGACA-1_V12D07-332_B1,0,0,0,0,0,0
AGGAGACATCCACAGT-1_V12D07-332_B1,0,2,0,0,0,2
CAACCTGAACCTGCCA-1_V12D07-332_B1,0,0,0,0,0,0
AGTCCCTCGCAGAAAG-1_V12D07-332_B1,0,1,0,0,0,1
TGTATACGGATGATGA-1_V12D07-332_B1,0,1,0,0,0,1
TTGTGGTATAGGTATG-1_V12D07-332_B1,0,0,0,0,0,0
TCTGCACCATTAGTAA-1_V12D07-332_B1,0,0,0,0,0,0
AAATGTATCTTATCCC-1_V12D07-332_B1,7,1,0,0,6,14
ACTCTAAACCTGGGAT-1_V12D07-332_B1,10,1,0,0,2,13
GCTGGCAGGTGCCGTG-1_V12D07-332_B1,11,1,0,0,1,13
CTCATTCGTGAACATC-1_V12D07-332_B1,6,1,0,0,2,9
TCGCCGGATGGGCAAG-1_V12D07-332_B1,7,0,0,0,5,12
GGACTAAGTCAGGAGT-1_V12D07-332_B1,10,0,0,0,2,12
TATCAAAGGTCTGTAA-1_V12D07-332_B1,6,3,0,1,3,13
TTCAGTTTGTGGCAGC-1_V12D07-332_B1,4,2,0,4,2,12
TGTTCATAAATGTGCT-1_V12D07-332_B1,2,1,0,0,0,3
CTTAGCCCGGATAGTG-1_V12D07-332_B1,1,0,0,0,0,1
GATGCGAATGGTATTA-1_V12D07-332_B1,3,0,0,0,0,3
TCTAACTGTATGTAAA-1_V12D07-332_B1,3,1,0,0,1,5
TTAAACCTGGTTCCTT-1_V12D07-332_B1,2,1,0,0,2,5
GCTAAGTAAAGGCGAT-1_V12D07-332_B1,3,2,0,0,0,5
AGTTACCGCACATGGT-1_V12D07-332_B1,3,1,0,0,0,4
GACTGCGGCACGTGTA-1_V12D07-332_B1,3,2,0,0,0,5
TGGTGATCGTATTTGT-1_V12D07-332_B1,1,4,0,0,1,6
TTATCGCCTGCGAAGC-1_V12D07-332_B1,0,1,0,0,1,2
TGGAATTAGACGCTTT-1_V12D07-332_B1,3,0,0,0,2,5
TCGTCACACTGTTAGC-1_V12D07-332_B1,5,1,0,0,0,6
TTATGTTTGCGATAGA-1_V12D07-332_B1,1,2,0,0,3,6
GGTGCTGATCACAAAG-1_V12D07-332_B1,4,3,0,0,0,7
CATAGCCGCCCGGGAT-1_V12D07-332_B1,2,2,0,0,0,4
GGTTAGTTACGGCGCC-1_V12D07-332_B1,0,0,0,0,0,0
ATTCCCACATAAACAA-1_V12D07-332_B1,2,1,0,0,0,3
ATTCAGTAGCAGGGTC-1_V12D07-332_B1,1,0,0,0,0,1
CAGTTCCGCGGGTCGA-1_V12D07-332_B1,0,4,0,0,0,4
AAGAGATGAATCGGTA-1_V12D07-332_B1,0,2,0,0,0,2
CGCAATTCTACAATAA-1_V12D07-332_B1,1,0,0,0,0,1
TAACGCTTTGAGAGCG-1_V12D07-332_B1,0,0,0,0,0,0
AGGCTATGGTTAGCTT-1_V12D07-332_B1,1,1,0,0,1,3
GAGGAATGGAGAGGTT-1_V12D07-332_B1,2,0,0,0,0,2
TCCTCTACGAGATGGC-1_V12D07-332_B1,1,0,1,0,1,3
TTGATTATGCAGATGA-1_V12D07-332_B1,0,3,1,0,0,4
TCAGTACTGACCCGCG-1_V12D07-332_B1,2,0,0,0,1,3
TTATGACAAACTGGAT-1_V12D07-332_B1,2,0,0,0,0,2
GTAAGTAGGGTATACC-1_V12D07-332_B1,0,2,1,0,0,3
CGCAAACACGAGTTAC-1_V12D07-332_B1,0,1,0,0,0,1
TGGCCGTATATTGACC-1_V12D07-332_B1,1,0,1,0,0,2
ACTGTAGCACTTTGGA-1_V12D07-332_B1,0,0,1,0,0,1
GCTCTATGTTACGTGC-1_V12D07-332_B1,0,1,1,0,0,2
TGCGCGATTAACGGAG-1_V12D07-332_B1,2,1,0,0,0,3
GAATCGACATGGTCAC-1_V12D07-332_B1,0,1,2,0,0,3
GACTAAGTAGGCTCAC-1_V12D07-332_B1,1,0,1,0,1,3
ATCTTGACCTGCAACG-1_V12D07-332_B1,0,0,2,0,0,2
ATGCACTACCGCATTG-1_V12D07-332_B1,0,0,0,0,0,0
CAGATACTAACATAGT-1_V12D07-332_B1,1,0,0,0,0,1
GATCGACACTATCTGA-1_V12D07-332_B1,2,0,1,1,0,4
ATAGAGTACTGGGACA-1_V12D07-332_B1,1,0,0,0,0,1
CCTACTGCTTACACTT-1_V12D07-332_B1,1,0,0,0,0,1
CCTGCTATTTGAGAAG-1_V12D07-332_B1,1,0,1,0,0,2
CGCGTTCATGAAATAC-1_V12D07-332_B1,1,0,0,0,0,1
CATTATGCTTGTTGTG-1_V12D07-332_B1,0,1,0,0,0,1
CCAGGGACGTGGCCTC-1_V12D07-332_B1,0,0,0,0,0,0
TATGGATGTGCTACGC-1_V12D07-332_B1,0,0,0,0,0,0
GTACTAAGATTTGGAG-1_V12D07-332_B1,0,0,1,0,1,2
AGACCCGCCCTCCTCG-1_V12D07-332_B1,1,0,1,0,0,2
CGCATTAGCTAATAGG-1_V12D07-332_B1,0,2,1,0,0,3
GCTCTCGGGTACCGAA-1_V12D07-332_B1,0,0,2,0,0,2
CACCGCCAGAAGGTTT-1_V12D07-332_B1,0,1,0,0,0,1
TCCCAAAGACGAAGGA-1_V12D07-332_B1,0,0,0,0,1,1
ATGGATTGACCAAACG-1_V12D07-332_B1,0,0,2,1,0,3
GTCATGGACATGACTA-1_V12D07-332_B1,0,0,0,0,0,0
CTACTGCCACCTGACC-1_V12D07-332_B1,2,1,1,0,0,4
TTATATTTGGCAATCC-1_V12D07-332_B1,0,3,0,1,0,4
AGCACCAGTACTCACG-1_V12D07-332_B1,0,0,1,0,0,1
CATGGTCTAGATACCG-1_V12D07-332_B1,1,0,0,0,0,1
TCTACCGTCCACAAGC-1_V12D07-332_B1,0,1,0,0,1,2
CTAGTTGGGCCCGGTA-1_V12D07-332_B1,0,0,1,1,0,2
TCCCGCGTACTCCTGG-1_V12D07-332_B1,0,1,0,0,1,2
CAGAGCATGAGCTTGC-1_V12D07-332_B1,0,2,0,0,0,2
ACACGGGAACTTAGGG-1_V12D07-332_B1,0,3,0,0,0,3
GGCTCTGCTCCAACGC-1_V12D07-332_B1,0,0,0,0,0,0
AGAACGTGGTACATTC-1_V12D07-332_B1,0,0,0,0,0,0
CAATAAACCTTGGCCC-1_V12D07-332_B1,0,1,0,0,0,1
ACTTCGCCATACGCAC-1_V12D07-332_B1,0,1,0,3,1,5
ATCTGGTTAAGACTGT-1_V12D07-332_B1,1,0,1,0,0,2
TCGTAAGACGACATTG-1_V12D07-332_B1,1,1,0,0,0,2
GTGTACCTTGGCTACG-1_V12D07-332_B1,1,3,0,0,0,4
GCCCGTAATACCTTCT-1_V12D07-332_B1,0,1,2,0,0,3
CGGTCAAGTGGGAACC-1_V12D07-332_B1,2,2,1,1,2,8
TTGTAAGGCCAGTTGG-1_V12D07-332_B1,2,0,0,1,2,5
GGAGCACCAAGAACTA-1_V12D07-332_B1,2,0,0,0,0,2
TAATAGTGACGACCAG-1_V12D07-332_B1,0,1,0,1,1,3
CTAAATCCTATTCCGG-1_V12D07-332_B1,0,0,0,0,0,0
CGAGTTCTGTCCCACC-1_V12D07-332_B1,1,1,0,0,0,2
AGGCAGATGCGTAAAC-1_V12D07-332_B1,1,2,0,0,0,3
AAGGATGAGGGACCTC-1_V12D07-332_B1,0,4,0,0,0,4
AGAGAACCGTCTAGGA-1_V12D07-332_B1,1,0,0,1,1,3
GAGGGCGCAGCTCTGC-1_V12D07-332_B1,1,1,0,0,0,2
AAGATTGGCGGAACGT-1_V12D07-332_B1,1,2,0,3,1,7
CCAGTAGTCTGATCCA-1_V12D07-332_B1,0,0,0,0,2,2
AAGGGACAGATTCTGT-1_V12D07-332_B1,0,0,0,2,0,2
ATAGAGTTATCAACTT-1_V12D07-332_B1,0,4,0,0,0,4
AAATTACCTATCGATG-1_V12D07-332_B1,0,6,0,7,0,13
GATCCTAAATCGGGAC-1_V12D07-332_B1,0,1,0,2,0,3
TTACAGACCTAAATGA-1_V12D07-332_B1,0,1,0,17,0,18
CCTCACCTTAGCATCG-1_V12D07-332_B1,0,0,0,13,0,13
CATGCGACCAGTTTAA-1_V12D07-332_B1,0,1,0,17,0,18
AACATATCAACTGGTG-1_V12D07-332_B1,1,3,0,8,0,12
CTATAAGAGCCAATCG-1_V12D07-332_B1,0,0,0,0,1,1
AATATCGAGGGTTCTC-1_V12D07-332_B1,1,1,0,0,0,2
GTACTCCTGGGTATGC-1_V12D07-332_B1,0,0,0,0,0,0
ATAAGTAGGATTCAGA-1_V12D07-332_B1,0,1,0,0,0,1
AGGTCGCGGAGTTACT-1_V12D07-332_B1,0,1,0,0,0,1
CTAATTCTCAGATATT-1_V12D07-332_B1,1,0,0,0,0,1
GCCAACCATTTCCGGA-1_V12D07-332_B1,0,1,0,0,0,1
TGATCCCAGCATTAGT-1_V12D07-332_B1,6,2,0,0,0,8
CGTTGTAAGATTGATT-1_V12D07-332_B1,0,7,0,0,0,7
GAAACCATGGTGCGCT-1_V12D07-332_B1,1,1,0,0,3,5
AATCTATGCCGGAGCC-1_V12D07-332_B1,5,3,0,0,2,10
GACTCCCAGAATAAGG-1_V12D07-332_B1,6,1,0,0,0,7
TATGATCCGGCACGCC-1_V12D07-332_B1,5,2,0,0,0,7
CCGCTTGCTGACATGG-1_V12D07-332_B1,7,0,0,0,0,7
TGGTTAAGGGCGCTGG-1_V12D07-332_B1,0,1,0,0,1,2
TTGATAGTCAATACAT-1_V12D07-332_B1,3,0,0,0,0,3
GGTTTAATTGAGCAGG-1_V12D07-332_B1,2,3,0,1,0,6
CATTACATAGATTGTG-1_V12D07-332_B1,0,0,0,0,0,0
GGTACACCAGATTTAT-1_V12D07-332_B1,0,2,0,0,0,2
GGCCCGTATACCATGC-1_V12D07-332_B1,1,1,0,0,0,2
ATCTTTCGTATAACCA-1_V12D07-332_B1,0,1,0,0,0,1
GAGATGACAATCCTTA-1_V12D07-332_B1,0,1,0,0,0,1
AAAGCTTGCCTACATA-1_V12D07-332_B1,0,0,0,0,1,1
GAACGATAAGTTAAAG-1_V12D07-332_B1,0,1,0,0,1,2
TAATAGCTAAATGATG-1_V12D07-332_B1,0,2,0,0,0,2
TATGGCTAGGCTAATT-1_V12D07-332_B1,0,1,0,0,0,1
AGGAGAGTCTGGCTAC-1_V12D07-332_B1,0,0,0,0,0,0
TGCTCTGCCGGTTCAC-1_V12D07-332_B1,0,1,0,0,1,2
CCAATAGATTTCATCT-1_V12D07-332_B1,1,0,0,0,5,6
GGGCACGAATTGGCCG-1_V12D07-332_B1,5,0,0,0,4,9
TCGTTGACAGGGTCCC-1_V12D07-332_B1,3,1,0,0,3,7
ATCGTATTCCGAGAAC-1_V12D07-332_B1,3,1,0,0,1,5
GGGAATTCTGTCCAGT-1_V12D07-332_B1,5,0,0,0,3,8
ACGCGTTTCTTAAGAG-1_V12D07-332_B1,6,3,0,0,2,11
GAGAGCGCAGTCCCTG-1_V12D07-332_B1,7,0,0,1,4,12
GTCCTATTGTTGTGGT-1_V12D07-332_B1,5,2,0,0,3,10
CATCTGCAGGATCATT-1_V12D07-332_B1,2,1,0,0,0,3
GAGTCGACAGACCCTC-1_V12D07-332_B1,1,1,0,0,0,2
AAGTGCAAAGGTAGAC-1_V12D07-332_B1,4,0,0,0,0,4
AGGGTGGATAGTGCAT-1_V12D07-332_B1,4,1,0,0,1,6
TGATAGCGGGATTCTA-1_V12D07-332_B1,5,0,0,0,1,6
GTCAGTTTGGTAGTCG-1_V12D07-332_B1,0,3,0,0,0,3
GCATTCGAAATGAACA-1_V12D07-332_B1,2,1,0,0,1,4
AAAGACTGGGCGCTTT-1_V12D07-332_B1,0,1,0,0,3,4
TAACAATATTTGTTGC-1_V12D07-332_B1,3,0,0,0,1,4
CCAGCTTCCGCCCGCA-1_V12D07-332_B1,2,2,0,0,1,5
GATATGGATTACGCGG-1_V12D07-332_B1,2,2,0,0,1,5
AGAGCAGTTATGAGAC-1_V12D07-332_B1,3,1,0,0,0,4
TCACATCTTATCTGAT-1_V12D07-332_B1,2,4,0,0,3,9
TATGAAGACAGGTGCG-1_V12D07-332_B1,0,3,0,0,1,4
TACCTGCTGCACTGTG-1_V12D07-332_B1,3,2,0,0,1,6
TAGGTCCAAGTAAGGA-1_V12D07-332_B1,0,0,0,0,1,1
GAAACTCGTGCGATGC-1_V12D07-332_B1,3,0,0,0,0,3
AACAATTACTCTACGC-1_V12D07-332_B1,2,0,0,0,0,2
CCGCACGTGACCTCGG-1_V12D07-332_B1,1,3,0,0,0,4
AACTTGCCCGTATGCA-1_V12D07-332_B1,2,3,0,0,0,5
GGGTATGTATGCACTT-1_V12D07-332_B1,0,0,0,0,0,0
TTCGTACTCCAGAACG-1_V12D07-332_B1,3,2,1,0,0,6
GAATTTCTCGCTGCAG-1_V12D07-332_B1,4,0,0,0,0,4
AACAGGATGGGCCGCG-1_V12D07-332_B1,1,0,0,0,0,1
GACGTGTAGGGATTAT-1_V12D07-332_B1,0,0,0,1,0,1
TAGGTGAGCCCTACTC-1_V12D07-332_B1,0,1,0,0,1,2
CTAATTCGCACGCGCT-1_V12D07-332_B1,1,0,0,0,0,1
GAAGCTTGCTGACCGC-1_V12D07-332_B1,1,1,1,0,0,3
GGTTAGGCTTGGAGAA-1_V12D07-332_B1,0,1,0,0,0,1
ACAAGGACAAGAGGTT-1_V12D07-332_B1,0,1,0,0,0,1
AGGCCACCCGTTATGA-1_V12D07-332_B1,0,0,0,0,1,1
GTGGGCTTAGACACAC-1_V12D07-332_B1,1,0,0,0,1,2
CGTGTCCCATTCGCGA-1_V12D07-332_B1,0,0,0,0,0,0
TGGAGTGATGCGATGA-1_V12D07-332_B1,1,0,0,0,1,2
AACAACTGGTAGTTGC-1_V12D07-332_B1,0,0,0,0,0,0
CCTGGCTAGACCCGCC-1_V12D07-332_B1,1,3,0,0,1,5
CGCAATTAGGGTAATA-1_V12D07-332_B1,0,1,0,0,0,1
TCGAAATTTAGGACCA-1_V12D07-332_B1,0,0,3,0,0,3
AGACTAGCCTTCCAGA-1_V12D07-332_B1,1,0,0,0,1,2
TTGATCTAACTTTGTC-1_V12D07-332_B1,0,1,2,0,1,4
AAGGAGCGGTTGGTGC-1_V12D07-332_B1,0,1,0,0,0,1
ACTTGGGACCCGGTGG-1_V12D07-332_B1,0,0,0,0,0,0
TGATCTCCGGCGCCAG-1_V12D07-332_B1,0,0,0,1,0,1
CAGTTCAAATTGACAC-1_V12D07-332_B1,0,0,0,0,0,0
GTCCGGCTGAATTGCG-1_V12D07-332_B1,0,0,5,0,1,6
CTGGAAATGGATGCTT-1_V12D07-332_B1,1,0,0,1,0,2
TGATCGGTTTGACCCT-1_V12D07-332_B1,1,1,0,0,0,2
TAGAGTCTAAGCGAAC-1_V12D07-332_B1,1,0,0,0,1,2
GAGACTGATGGGTAGA-1_V12D07-332_B1,0,0,0,0,0,0
TAGCTAAGTCCGGGAG-1_V12D07-332_B1,0,1,0,0,0,1
GGGCGATATGTGTGAA-1_V12D07-332_B1,0,1,0,0,0,1
CTCGAGGTCGAACAGT-1_V12D07-332_B1,1,0,0,0,0,1
GATCCCTTTATACTGC-1_V12D07-332_B1,0,2,0,0,0,2
GTCATGCACCTCCGTT-1_V12D07-332_B1,1,0,0,0,0,1
ACTTTCCTATAGCTTC-1_V12D07-332_B1,0,1,0,0,0,1
TCGCTCGATATATTCC-1_V12D07-332_B1,0,0,0,0,1,1
ATAGGTTGGGCAGATG-1_V12D07-332_B1,0,2,0,0,0,2
CAATTAAGGGTGATGA-1_V12D07-332_B1,0,1,1,1,0,3
ACCGACTGAGTCCCAC-1_V12D07-332_B1,0,0,1,0,0,1
CCTGTCACCCGGGCTC-1_V12D07-332_B1,0,0,2,1,0,3
GATCGGTGGCCATAAC-1_V12D07-332_B1,0,0,0,0,0,0
CCTATGGGTTACCGTC-1_V12D07-332_B1,0,2,1,0,0,3
TTGGGACACTGCCCGC-1_V12D07-332_B1,0,2,0,0,0,2
CGAGGCTAAATATGGC-1_V12D07-332_B1,1,1,3,1,0,6
TCAGGGTGTAACGTAA-1_V12D07-332_B1,0,0,0,0,0,0
CGAGAGATGTGAACCT-1_V12D07-332_B1,0,0,0,1,1,2
TCGCTGGGCGGATTGT-1_V12D07-332_B1,0,2,1,0,1,4
AGATCTCAGGTGTGAT-1_V12D07-332_B1,0,0,2,0,0,2
TGGCCAAACTGAAGTA-1_V12D07-332_B1,0,2,1,0,0,3
GCTTCCGTCCCTAGAC-1_V12D07-332_B1,0,1,5,0,0,6
CAGCAGCCCGTTCCTT-1_V12D07-332_B1,0,0,2,0,0,2
TGTATAACAGATCCTG-1_V12D07-332_B1,1,3,1,0,0,5
CGCGGGAATTAGGCAG-1_V12D07-332_B1,1,0,0,0,1,2
TGCATGTGGTAATCTA-1_V12D07-332_B1,0,1,0,0,0,1
ACAATTTGAGCAGTGG-1_V12D07-332_B1,1,0,1,0,1,3
GAGCTAAGGGCATATC-1_V12D07-332_B1,0,1,1,0,0,2
CCAGATAGTTGAGTGA-1_V12D07-332_B1,1,0,0,0,0,1
CCACAATGTACGTCTT-1_V12D07-332_B1,1,1,1,0,2,5
CAATGGATCTCTACCA-1_V12D07-332_B1,0,1,0,0,0,1
TGTGGCAAAGCGTATG-1_V12D07-332_B1,1,0,0,0,1,2
TAAAGCGTTAGGAGAA-1_V12D07-332_B1,0,1,0,0,0,1
TCCGTTTAGCCTTGAA-1_V12D07-332_B1,0,3,0,0,1,4
CAGCTCGACAAGTTAA-1_V12D07-332_B1,2,3,0,0,0,5
GCCTATAGTGTCAGGG-1_V12D07-332_B1,2,3,0,0,1,6
ATAGACAACGGGACCT-1_V12D07-332_B1,2,2,0,2,3,9
CTACTATCTTTCAGAG-1_V12D07-332_B1,0,1,0,0,0,1
GCGCTGCTTTGCATTT-1_V12D07-332_B1,0,1,0,0,0,1
GCGCATCCAGTCAGCA-1_V12D07-332_B1,0,1,0,0,0,1
GACTCGCGGGAATGAC-1_V12D07-332_B1,0,3,0,2,0,5
CTGGTAACGAGCTCTT-1_V12D07-332_B1,0,2,0,4,0,6
TCCGGCCTAGCGTACA-1_V12D07-332_B1,0,1,0,13,0,14
TCTAGGTGGCGACGCT-1_V12D07-332_B1,0,1,0,21,1,23
ACGCTAGTGATACACT-1_V12D07-332_B1,0,0,0,8,0,8
ATCTGCACCTCTGCGA-1_V12D07-332_B1,1,1,0,0,0,2
CCTCACCTGAGGGAGC-1_V12D07-332_B1,0,2,0,0,0,2
AGTGAGCCTCGCCGCC-1_V12D07-332_B1,0,0,0,0,0,0
ACGAGTACGGATGCCC-1_V12D07-332_B1,3,5,0,0,0,8
GGTACCATTAAGACGG-1_V12D07-332_B1,1,3,0,0,0,4
TTCTGCTAGACTCCAA-1_V12D07-332_B1,1,0,0,0,0,1
TAACTATTACGCCAAA-1_V12D07-332_B1,0,0,0,0,0,0
GCATTCAAGGCAACGC-1_V12D07-332_B1,2,0,0,0,0,2
AGTACATCATTTATCA-1_V12D07-332_B1,1,1,0,0,0,2
GTCGTGTCTGGTCATC-1_V12D07-332_B1,4,4,0,0,0,8
AGTCTAAAGTATACTC-1_V12D07-332_B1,3,2,0,1,0,6
CGGCCCAACCTGTAGT-1_V12D07-332_B1,2,1,0,0,0,3
AGGGAGACATACTTCG-1_V12D07-332_B1,7,0,0,1,0,8
TCCCTAGATCAATAGG-1_V12D07-332_B1,1,1,0,0,0,2
TCCCGTCGCGTCATAG-1_V12D07-332_B1,2,2,0,0,1,5
CGCATCCATCAGCCAG-1_V12D07-332_B1,0,1,0,0,1,2
CTGCACCTAGTCCACA-1_V12D07-332_B1,0,1,0,0,0,1
CGAGGATCGGGAACGA-1_V12D07-332_B1,0,0,0,0,0,0
CAATGAGGTTCGACTA-1_V12D07-332_B1,1,0,0,0,0,1
TCTGACGGGCTAACCC-1_V12D07-332_B1,0,2,0,0,1,3
TTCTATGCCTTTCGCA-1_V12D07-332_B1,0,1,0,0,0,1
AGAGTATAGTGTTACG-1_V12D07-332_B1,0,0,0,0,0,0
CCATTGTTTCCTCCAT-1_V12D07-332_B1,0,0,0,0,0,0
CTCATCACTTAGTGAT-1_V12D07-332_B1,0,0,0,0,0,0
CCGAAGGGCGTACCGC-1_V12D07-332_B1,0,1,0,0,0,1
TCAAGCTGCCTTGAAA-1_V12D07-332_B1,0,2,0,0,0,2
CTCATTAACGTTGCCC-1_V12D07-332_B1,0,0,0,0,0,0
GTCTTCCTCACCTAAG-1_V12D07-332_B1,7,1,0,0,2,10
GGTGATGAAGGAAGTG-1_V12D07-332_B1,3,1,0,0,2,6
TCAATACAATTGCTGC-1_V12D07-332_B1,6,0,0,0,1,7
GCAACCCAAGTTGTTT-1_V12D07-332_B1,11,0,0,0,2,13
ATGAAGTGGACCCAGC-1_V12D07-332_B1,2,0,0,0,5,7
GAGAATCTCACGATCA-1_V12D07-332_B1,7,0,0,0,5,12
TATATCATTGATCAGT-1_V12D07-332_B1,7,0,0,0,3,10
AACTTTACGGGAGCTT-1_V12D07-332_B1,6,1,0,0,5,12
TTCTTGTGTCCATCAG-1_V12D07-332_B1,6,5,0,0,2,13
ACAATTTAGGAGGCTC-1_V12D07-332_B1,8,4,0,0,2,14
ATACTTGTTCTCGAGC-1_V12D07-332_B1,0,0,0,0,2,2
CACGGGATTGAGGGTT-1_V12D07-332_B1,3,0,0,0,2,5
GTTAATGTCTATCTTA-1_V12D07-332_B1,1,2,0,0,0,3
GCGTTATATTTGGAAC-1_V12D07-332_B1,2,1,0,0,0,3
CGTCAAGGCTATAAAT-1_V12D07-332_B1,0,2,0,0,1,3
TTAGCTCTGTAATCCG-1_V12D07-332_B1,4,1,0,0,1,6
AATGGTCCACCGTTCA-1_V12D07-332_B1,2,1,0,0,2,5
GTCATTGCATTGACCC-1_V12D07-332_B1,1,2,0,0,0,3
TGTCCGTGGCGCCTTT-1_V12D07-332_B1,3,5,0,0,0,8
TCAACTAACGTATAAC-1_V12D07-332_B1,2,1,0,0,2,5
TCCTCTCCAGTTGTCC-1_V12D07-332_B1,3,3,0,0,1,7
TGTGTTCGTATCCAAG-1_V12D07-332_B1,3,2,0,0,1,6
CCGCGTAGGTAAGGGC-1_V12D07-332_B1,0,2,0,0,0,2
CTGCGGGTGAAATGTT-1_V12D07-332_B1,3,0,0,0,0,3
TATCTACAGAGGTAAT-1_V12D07-332_B1,0,1,0,0,0,1
CTACTCTAGGCCCGGC-1_V12D07-332_B1,1,2,0,0,0,3
ACAAGCAGTGCCTAGC-1_V12D07-332_B1,0,3,0,0,0,3
TACAAGTCTCGTGCAT-1_V12D07-332_B1,3,0,0,0,0,3
TCGGAATGCGCTCTGA-1_V12D07-332_B1,2,1,0,0,1,4
TCGCGTCCAGAAGGTC-1_V12D07-332_B1,2,1,1,0,0,4
TATGGCCCGGCCTCGC-1_V12D07-332_B1,1,0,0,0,0,1
GCTGGCATATTCACCT-1_V12D07-332_B1,0,1,0,0,0,1
GTCAGAATAGTCTATG-1_V12D07-332_B1,0,2,0,0,0,2
GGCGTCCTATCCGCTG-1_V12D07-332_B1,0,2,1,0,0,3
CGGAGTTTGAGAGACA-1_V12D07-332_B1,2,0,0,1,0,3
AGCACTTAAGGACGCC-1_V12D07-332_B1,0,0,1,0,0,1
TCCACAATGGTTTACG-1_V12D07-332_B1,1,0,0,0,1,2
CCAACGATGCACTGAT-1_V12D07-332_B1,0,0,0,0,0,0
ATTTACAGTTTACTGG-1_V12D07-332_B1,1,1,1,0,1,4
CCCTGAAATGAGTTGA-1_V12D07-332_B1,0,0,0,0,1,1
CAAACGGTCGCACTTT-1_V12D07-332_B1,0,1,0,0,0,1
TGATTCGTCTATCACT-1_V12D07-332_B1,1,0,0,0,0,1
TCAGGTTCTTTGAGAA-1_V12D07-332_B1,0,1,0,0,0,1
CACGCAGCGAGGCTTT-1_V12D07-332_B1,0,0,0,1,0,1
TTAAGCGCCTGACCCA-1_V12D07-332_B1,0,1,0,1,0,2
CTTACACGGTATTCCA-1_V12D07-332_B1,0,0,0,1,0,1
AAGGCTGTGCTCATCG-1_V12D07-332_B1,0,0,0,0,0,0
GACCAGAGCCCTGTAG-1_V12D07-332_B1,0,0,0,1,0,1
TCCCAGGCTTAGCTAA-1_V12D07-332_B1,0,0,2,0,1,3
ATTGAAGATCTTAGTG-1_V12D07-332_B1,0,2,1,0,0,3
AGTTCCTACAGAATTA-1_V12D07-332_B1,0,0,0,0,0,0
GGGCTGGTTAGTCGCG-1_V12D07-332_B1,0,1,1,1,0,3
GAAATGGCGGTGTTAG-1_V12D07-332_B1,0,1,1,0,0,2
TACGAACACGACTTCA-1_V12D07-332_B1,0,0,2,0,0,2
ACCACAAGTTTCTATC-1_V12D07-332_B1,0,0,1,0,1,2
ATATTTAACCCTCAAG-1_V12D07-332_B1,0,0,0,0,0,0
GATCATTCCAAACATT-1_V12D07-332_B1,0,0,1,0,0,1
TCCAGGCGAGTACGGT-1_V12D07-332_B1,0,1,2,0,0,3
GTTTGACCAAATCCTA-1_V12D07-332_B1,2,0,2,0,1,5
CACAGCACCCACGGCA-1_V12D07-332_B1,0,0,0,0,0,0
TGCAAGAATGACGTAA-1_V12D07-332_B1,0,0,0,0,0,0
GCGAAGCCATACCCGT-1_V12D07-332_B1,1,0,1,0,1,3
TCCTTTCTTACGCTTA-1_V12D07-332_B1,0,1,1,0,0,2
GCTGCTCTCCGGACAC-1_V12D07-332_B1,0,2,3,0,0,5
ACTGTCTTCTTTAGAA-1_V12D07-332_B1,1,1,0,0,0,2
TCAAACTTAGATTGTT-1_V12D07-332_B1,0,1,2,0,0,3
CTATGTCACTAGCCCA-1_V12D07-332_B1,0,0,0,0,1,1
TGCGCAAAGCATTTGG-1_V12D07-332_B1,0,1,0,0,0,1
TTAATGTAGACCAGGT-1_V12D07-332_B1,0,1,1,0,0,2
GGCGGTAGGATCATTG-1_V12D07-332_B1,1,0,1,0,0,2
GGCAATAGTCAATGAG-1_V12D07-332_B1,0,1,0,0,0,1
ACACGAGACTCCTTCT-1_V12D07-332_B1,0,1,0,0,0,1
GACACAAGGGAAGAAA-1_V12D07-332_B1,0,0,3,0,0,3
TCAGCAAATGCATCTC-1_V12D07-332_B1,0,0,0,0,0,0
GAGATCTGTCACTCCG-1_V12D07-332_B1,1,4,0,0,1,6
ATGCCGGTCTTGCATA-1_V12D07-332_B1,0,2,0,0,0,2
TTGGGCGGCGGTTGCC-1_V12D07-332_B1,0,0,1,0,0,1
TTGTTGTGTGTCAAGA-1_V12D07-332_B1,0,0,1,2,0,3
ACTGTACGATACACAT-1_V12D07-332_B1,1,0,0,0,0,1
TCCACTTTATCTAGGT-1_V12D07-332_B1,1,0,0,0,0,1
GGTCTGAGAATCTGGA-1_V12D07-332_B1,0,1,0,0,0,1
TAGAAAGGTGGCGCTA-1_V12D07-332_B1,0,0,0,0,0,0
TATGTCTCATTGTGCC-1_V12D07-332_B1,2,0,0,0,1,3
GGATTTCACTTCTATA-1_V12D07-332_B1,0,1,0,0,0,1
TGAGTGGTCCGTGACG-1_V12D07-332_B1,0,0,0,0,1,1
CGCTTTCTTGCATTCG-1_V12D07-332_B1,1,0,0,0,0,1
ACCCAACGCCCGTGGC-1_V12D07-332_B1,1,1,0,1,1,4
GAACGTCTCATGGTCG-1_V12D07-332_B1,0,1,0,0,0,1
AGGGTTCCCTTTGGTT-1_V12D07-332_B1,3,1,0,0,0,4
GTAGCTTCCTCTTGTT-1_V12D07-332_B1,0,3,0,0,1,4
GCATGAGGGACGCGGC-1_V12D07-332_B1,0,1,0,0,0,1
CTACCCTAAGGTCATA-1_V12D07-332_B1,1,1,0,0,2,4
TCACCGCTCGGCACTC-1_V12D07-332_B1,0,1,0,0,1,2
GGCTCGCGTTGAGGTA-1_V12D07-332_B1,4,3,0,0,0,7
CTAACGAAACTTGCTG-1_V12D07-332_B1,0,2,0,0,1,3
TTAAACTCGAATTCAT-1_V12D07-332_B1,0,3,0,1,0,4
TACTTTACTGAGCCGG-1_V12D07-332_B1,0,1,0,0,0,1
GCTTGGATCGATTAGG-1_V12D07-332_B1,0,1,0,0,0,1
CGGTTATCCAACAGTG-1_V12D07-332_B1,0,1,0,3,0,4
CAGACCTGTAAGTGTT-1_V12D07-332_B1,0,1,0,16,1,18
GACGGTCAATAGAAGC-1_V12D07-332_B1,0,0,0,14,0,14
CTGACTGCGCAGCTCG-1_V12D07-332_B1,1,0,0,5,0,6
CCATACCTTTACTTGT-1_V12D07-332_B1,0,2,0,0,0,2
GTAATAAAGGGCTCCC-1_V12D07-332_B1,0,1,0,0,0,1
GTGAACTCCCATTCGA-1_V12D07-332_B1,0,0,0,0,0,0
GTGGTTACTTCTTTCG-1_V12D07-332_B1,0,0,0,0,1,1
TCAGAACCTCCACAGG-1_V12D07-332_B1,0,2,0,0,0,2
TCCCACTCTCTTCCGG-1_V12D07-332_B1,1,0,0,0,0,1
ATCTTGACTTGTCCAA-1_V12D07-332_B1,2,0,0,0,0,2
TCGGGAACGTGCCTAG-1_V12D07-332_B1,4,0,0,1,0,5
GTTAGCCGTAAATCAA-1_V12D07-332_B1,4,1,0,0,1,6
ATTTACTAAGTCCATT-1_V12D07-332_B1,0,6,0,0,0,6
GGGTGCATATGAAAGC-1_V12D07-332_B1,1,1,0,1,0,3
TCCGAATGGTCCTGAG-1_V12D07-332_B1,5,1,0,0,0,6
TGATGGCTGTTTCTGA-1_V12D07-332_B1,2,1,0,0,1,4
AAATAAGGTAGTGCCC-1_V12D07-332_B1,2,1,0,0,0,3
CCACTATCCGGGTCAC-1_V12D07-332_B1,2,2,0,0,0,4
ACACCACATAATTAGC-1_V12D07-332_B1,0,0,0,0,0,0
CGCGGTAAGTCTAGCT-1_V12D07-332_B1,1,0,0,0,0,1
GCGGGCATTACGATGC-1_V12D07-332_B1,0,0,0,0,1,1
AGGATTGCTTACGACA-1_V12D07-332_B1,0,1,0,0,0,1
CTCGGGATAACACCTA-1_V12D07-332_B1,1,3,0,0,0,4
GTCGTCTGGTTGGCTA-1_V12D07-332_B1,0,0,0,0,0,0
GCAATTAGTCGCACCG-1_V12D07-332_B1,0,1,0,0,0,1
GTGACCTAAAGAATAA-1_V12D07-332_B1,0,0,0,0,0,0
CTGAGCGAGACTTATT-1_V12D07-332_B1,0,0,0,0,0,0
CAAGACTCAGAAGCGC-1_V12D07-332_B1,0,1,0,0,1,2
ACTTCGCTAGCGAGTG-1_V12D07-332_B1,0,1,0,0,0,1
CCATACTCGCCTCTCC-1_V12D07-332_B1,3,0,0,0,3,6
ACGATACCTATCCTGA-1_V12D07-332_B1,5,1,0,0,4,10
CTCACCAGTACAAGTG-1_V12D07-332_B1,4,1,0,1,4,10
CGAAGACGGTGAGTGC-1_V12D07-332_B1,12,0,0,0,2,14
AAATTAATAAGCGCGA-1_V12D07-332_B1,4,3,0,0,3,10
GGGCCCTTATCTATAC-1_V12D07-332_B1,6,2,0,0,7,15
CTGCCCACGAAGCGTT-1_V12D07-332_B1,5,0,0,0,5,10
GGACAAGTTGCAGTGA-1_V12D07-332_B1,4,1,0,1,3,9
GTCCGAGAGCAATCAT-1_V12D07-332_B1,4,2,0,0,8,14
ATGGCAGCCGAGAAAC-1_V12D07-332_B1,6,4,0,0,1,11
CCTCGGATGCTACCTG-1_V12D07-332_B1,7,1,0,0,2,10
ATACGGTGAAGATGCA-1_V12D07-332_B1,3,3,0,0,5,11
ACATCAGCTGGGACGC-1_V12D07-332_B1,2,0,0,0,1,3
GGTTGTGTAGCCTGGC-1_V12D07-332_B1,3,2,0,0,0,5
CCTGCGTTCTACGCTT-1_V12D07-332_B1,2,1,0,0,0,3
GAACGTTAGGAAGACG-1_V12D07-332_B1,3,1,0,0,4,8
CTGATAGTGTATCTCA-1_V12D07-332_B1,2,1,0,0,0,3
TTCTGCGAGCGCCCTT-1_V12D07-332_B1,0,0,0,0,2,2
CTTTGGCGCTTTATAC-1_V12D07-332_B1,2,4,0,0,0,6
TCCGAACTTGGCTTAC-1_V12D07-332_B1,4,1,0,0,1,6
TAGATTCCTGGTTATT-1_V12D07-332_B1,4,1,0,0,2,7
CCGACAAAGGGAGTGC-1_V12D07-332_B1,1,0,0,0,1,2
CCATGGCCCTTGTACC-1_V12D07-332_B1,3,0,0,0,0,3
GAAATATCACCATCAG-1_V12D07-332_B1,2,0,0,0,0,2
ACGAAATGGGCGGCAC-1_V12D07-332_B1,0,1,0,0,0,1
GTGAGCGTGCTGCACT-1_V12D07-332_B1,2,2,0,0,0,4
CCGCGGGTACGAAGAA-1_V12D07-332_B1,1,0,0,0,0,1
TCCCTGGCTCGCTGGA-1_V12D07-332_B1,1,1,0,0,0,2
CAGCTTAGTAGGTAGC-1_V12D07-332_B1,1,0,1,0,0,2
CACGAAAGTTAGTCCC-1_V12D07-332_B1,0,1,0,0,0,1
ACCTAATCGACTTCCT-1_V12D07-332_B1,1,0,0,0,2,3
AAGTAGTGACGCGAGG-1_V12D07-332_B1,1,2,0,0,1,4
TCCGATTACATTGCCG-1_V12D07-332_B1,0,0,0,0,1,1
CCTCCGACAATTCAAG-1_V12D07-332_B1,0,0,1,0,0,1
GTTCACAGGAGTCTAG-1_V12D07-332_B1,1,1,0,0,1,3
CGAAGTTGCTCTGTGT-1_V12D07-332_B1,0,0,0,1,0,1
GTCGGATATCTCAGAC-1_V12D07-332_B1,1,0,0,2,0,3
CGCTCTCCGTAGATTA-1_V12D07-332_B1,0,2,0,1,1,4
CAAGCAACGTCGGAGT-1_V12D07-332_B1,0,0,0,0,0,0
CCATTCCCTGCCCACA-1_V12D07-332_B1,0,0,0,0,0,0
CTTTGGCTTTAGTAAA-1_V12D07-332_B1,0,0,2,1,0,3
GGCTATTAAGTTGTAT-1_V12D07-332_B1,0,0,0,0,0,0
CCATTAGCGATAATCC-1_V12D07-332_B1,2,1,0,1,0,4
TGTTCTTCCATTGACT-1_V12D07-332_B1,0,0,0,0,1,1
AGATAACTTCAGGGCC-1_V12D07-332_B1,0,0,2,0,1,3
ATAGACGAAGAGAAAG-1_V12D07-332_B1,1,0,1,1,0,3
GGCGGAGTAATATTAG-1_V12D07-332_B1,0,0,0,0,0,0
TGACCCACGTTAGACA-1_V12D07-332_B1,1,0,0,0,0,1
TCACAGGTTATTGGGC-1_V12D07-332_B1,0,1,3,0,0,4
TCACGCATTGTAGATC-1_V12D07-332_B1,0,0,1,0,0,1
TTGAAGAATTCCCAGG-1_V12D07-332_B1,0,0,0,1,1,2
AAATGGTCAATGTGCC-1_V12D07-332_B1,0,0,0,1,0,1
TAGTGCCCTCCAGAGT-1_V12D07-332_B1,1,1,1,1,1,5
GGTATTGCCGAGTTTA-1_V12D07-332_B1,0,1,0,1,0,2
CGTATTAAGAGATCTA-1_V12D07-332_B1,0,0,0,0,0,0
ACTGTCCAGGATTATA-1_V12D07-332_B1,0,1,0,0,0,1
CGGGCAGCTAAACCGC-1_V12D07-332_B1,0,1,0,0,0,1
TTGCTGATCATGTTCG-1_V12D07-332_B1,0,1,1,0,0,2
TATGGGTACGTATCGT-1_V12D07-332_B1,1,0,0,0,0,1
CAGCTCACTGAGACAT-1_V12D07-332_B1,0,1,1,1,0,3
GGGACTGCATAGATAG-1_V12D07-332_B1,0,0,1,0,0,1
ACGCATTCGTGAGTAC-1_V12D07-332_B1,0,1,0,1,0,2
CTCTGGACGCCTGGTG-1_V12D07-332_B1,1,0,0,0,0,1
AGGGTTTAGTTCGGGA-1_V12D07-332_B1,1,0,1,0,1,3
GGGAGAACTCACAGTA-1_V12D07-332_B1,0,0,1,0,1,2
ATCAATCTGGGCTGCA-1_V12D07-332_B1,0,0,0,0,1,1
TCTTCGATACCAATAA-1_V12D07-332_B1,0,1,0,1,0,2
ACGTAGATTGCTGATG-1_V12D07-332_B1,0,1,1,0,0,2
TCTTGATGCGTAGCGA-1_V12D07-332_B1,0,0,0,1,0,1
GGGCTGCCTAGGGCGA-1_V12D07-332_B1,0,2,1,0,0,3
CTCTCACAATCGATGA-1_V12D07-332_B1,0,1,2,0,0,3
CCAAGCGTAACTCGTA-1_V12D07-332_B1,0,2,0,1,0,3
ACAACAGCATGAGCTA-1_V12D07-332_B1,0,0,0,0,0,0
GTCCCAACGTAAAGTA-1_V12D07-332_B1,0,0,0,0,1,1
TCGGAGTACATGAGTA-1_V12D07-332_B1,0,0,0,1,1,2
GGGAGTTAATGAGGCG-1_V12D07-332_B1,0,0,1,1,0,2
CCGGGCGGTCTCGTCA-1_V12D07-332_B1,1,1,1,1,0,4
CCGTAAGTTGGTCCCA-1_V12D07-332_B1,0,0,1,0,0,1
GGAGGGCTTGGTTGGC-1_V12D07-332_B1,0,0,0,0,0,0
TCGGACGCCCAGCCCA-1_V12D07-332_B1,1,1,1,0,0,3
TCTGTGCCATCATAGT-1_V12D07-332_B1,0,1,2,0,0,3
GTACTGGAGTTAGACC-1_V12D07-332_B1,1,0,0,0,0,1
GGAATGCGCTAGCGTG-1_V12D07-332_B1,0,0,0,0,1,1
GTGTGAATAACTTAGG-1_V12D07-332_B1,0,3,0,0,0,3
GGTCGGCCAGGAGCTT-1_V12D07-332_B1,0,2,1,0,0,3
TAGCCGGCGGTCAGCG-1_V12D07-332_B1,1,1,0,0,0,2
CGGGTGTACCCATTTA-1_V12D07-332_B1,0,4,0,0,0,4
AGTGATTCAAGCAGGA-1_V12D07-332_B1,0,2,0,0,1,3
GTTGGATTGAGAACAC-1_V12D07-332_B1,0,0,0,0,0,0
CACACGCGCTGTCTTA-1_V12D07-332_B1,0,2,0,0,0,2
TAGACGCCCGTACCGG-1_V12D07-332_B1,2,0,0,0,1,3
GGTTTCAATCGGTCAG-1_V12D07-332_B1,0,1,0,0,0,1
AATCTGCGTTGGGACG-1_V12D07-332_B1,0,1,0,0,0,1
TTACGGATGGTTCGAG-1_V12D07-332_B1,2,1,0,0,1,4
CGGCAGGGTCGGGTTG-1_V12D07-332_B1,2,2,0,0,0,4
GCTTTCAGAGGAGGTG-1_V12D07-332_B1,2,0,0,0,0,2
TCTTCCCATGGGCACA-1_V12D07-332_B1,0,1,0,0,2,3
TACCGCGGACTTGCAG-1_V12D07-332_B1,3,7,0,0,0,10
AGAATTATGGATTCGA-1_V12D07-332_B1,0,1,0,1,1,3
ATTGATGAGTCCTAAC-1_V12D07-332_B1,0,1,0,3,1,5
TAGGTCGCCGGAACTG-1_V12D07-332_B1,0,1,0,20,0,21
TAACCTACCGTCCGAG-1_V12D07-332_B1,0,0,0,12,0,12
CTTAGTAGGCCTACAG-1_V12D07-332_B1,1,1,0,0,0,2
CTAGATGTGAGTGTAA-1_V12D07-332_B1,0,2,0,1,0,3
ACTCCCGAATTCGTTT-1_V12D07-332_B1,0,2,0,0,0,2
GTTCATCGTTTGGCTG-1_V12D07-332_B1,1,2,0,0,0,3
ACTTTACCCTCATGAA-1_V12D07-332_B1,1,3,0,0,2,6
GCGAGAGTTGCGTCCA-1_V12D07-332_B1,0,1,0,0,0,1
GTTCGGGCGTACCATT-1_V12D07-332_B1,2,1,0,0,1,4
CGACTTTGTATAGCCT-1_V12D07-332_B1,3,1,0,0,0,4
GCCATCGATGCTGCAT-1_V12D07-332_B1,2,2,0,0,0,4
GCATTTCCAAGGCTCC-1_V12D07-332_B1,0,2,0,0,0,2
ATGTAAGGCTGCTCTT-1_V12D07-332_B1,0,1,0,0,0,1
ACGTTCGCAATCAATT-1_V12D07-332_B1,3,2,0,0,0,5
GTGACGAGGGTGACCC-1_V12D07-332_B1,8,0,0,0,0,8
ATTATAGCTACTTTAC-1_V12D07-332_B1,3,2,0,0,0,5
CGTGTGTTAAACCCTG-1_V12D07-332_B1,1,2,0,0,0,3
TTGGTATGGCTTGTGT-1_V12D07-332_B1,0,2,0,0,1,3
CATTCCCATTCCGTCG-1_V12D07-332_B1,2,4,0,0,0,6
TGCCGAAAGCGTATTC-1_V12D07-332_B1,3,1,0,0,0,4
CAACACATCTCCTGCC-1_V12D07-332_B1,0,0,0,0,0,0
CTGCCTCATATGCAAC-1_V12D07-332_B1,0,0,0,0,0,0
TCCCGCCTATGTGCGT-1_V12D07-332_B1,0,1,0,0,0,1
GGTTACCCGACACTTT-1_V12D07-332_B1,0,0,0,0,1,1
CCAGCGGGATCACCAG-1_V12D07-332_B1,0,1,0,0,0,1
ATGTTTCGGCCCGGAG-1_V12D07-332_B1,0,0,0,0,0,0
GCGTCTAACCTCCTAA-1_V12D07-332_B1,0,0,0,0,0,0
ATCAGGTAGCTGACAG-1_V12D07-332_B1,0,1,0,0,0,1
GGTATGAAAGAACTGA-1_V12D07-332_B1,1,0,0,0,1,2
GTGGCCTAATATCATT-1_V12D07-332_B1,7,1,0,0,4,12
CCTGTGAAACCGTAAC-1_V12D07-332_B1,3,0,0,0,4,7
GGCAGAGAGATCGGGA-1_V12D07-332_B1,4,0,0,0,2,6
TAGCGTCGAATATTGA-1_V12D07-332_B1,10,1,0,0,5,16
CGCCGACTATTCGCTA-1_V12D07-332_B1,4,1,0,0,3,8
TCTGGCGCAAGCCGGG-1_V12D07-332_B1,9,0,0,0,2,11
AGTGGTTGCGTATAGG-1_V12D07-332_B1,5,1,0,0,1,7
ATCGGTTACCTAGTAA-1_V12D07-332_B1,5,0,0,0,1,6
CCTGCCCGTTGTCTAG-1_V12D07-332_B1,4,4,0,0,2,10
GCACACGCCCATGGTC-1_V12D07-332_B1,5,1,0,0,3,9
AGTACGGCCCGTATCG-1_V12D07-332_B1,6,1,0,0,3,10
TATCTAGCCTAAAGGA-1_V12D07-332_B1,2,1,0,0,5,8
CACTCGGTTAGGAGGA-1_V12D07-332_B1,3,2,0,0,2,7
ATGTTCGTCGACCCAC-1_V12D07-332_B1,2,0,0,0,0,2
TTCCTCTGCCCGAATA-1_V12D07-332_B1,5,1,0,0,0,6
TTACTATCGGCTTCTC-1_V12D07-332_B1,4,1,0,0,1,6
GCCGCATTAGTCCGGC-1_V12D07-332_B1,3,1,0,0,0,4
TAAGGGCTGGGAGAGG-1_V12D07-332_B1,3,3,0,0,0,6
TAAGCAGGCGACACGC-1_V12D07-332_B1,3,0,0,0,0,3
AGCACTACCGGCCTGT-1_V12D07-332_B1,2,1,0,0,1,4
GAAAGCCCTTTGGACC-1_V12D07-332_B1,3,1,0,0,1,5
GACCGACTGAAGCGTC-1_V12D07-332_B1,1,2,0,0,1,4
CGGTGAAGACTAAAGT-1_V12D07-332_B1,3,2,1,0,0,6
CCCTGCGCTACGCATA-1_V12D07-332_B1,2,0,0,0,0,2
TACTGGACAGCTCGGC-1_V12D07-332_B1,1,1,0,0,0,2
TTAGTAGGGCGGCGGG-1_V12D07-332_B1,2,1,1,1,0,5
GAGGCTATCAAAGTCG-1_V12D07-332_B1,1,0,0,0,0,1
TTACCATTGATTACCC-1_V12D07-332_B1,0,1,1,0,0,2
ATACCACGGGCAACTT-1_V12D07-332_B1,1,0,0,0,0,1
TGTCCTAAGTCACCGC-1_V12D07-332_B1,0,0,0,0,0,0
AGGTAGGTACAAAGCT-1_V12D07-332_B1,2,0,0,0,0,2
GGCATACAGGTAGCGG-1_V12D07-332_B1,0,0,0,1,0,1
TGTAGTGATCTATAAT-1_V12D07-332_B1,0,0,0,0,0,0
TCCCGGGTGTGCTGCT-1_V12D07-332_B1,0,1,1,2,0,4
TACGATGTTGATCATC-1_V12D07-332_B1,0,1,1,3,0,5
CCTCTCTCCCATCTAG-1_V12D07-332_B1,0,0,0,1,1,2
GCAGGACTATAGAATA-1_V12D07-332_B1,0,0,0,0,0,0
CTAGTGAAGGACAGGA-1_V12D07-332_B1,0,0,1,0,0,1
TACGAGAACTTCACGT-1_V12D07-332_B1,0,0,0,0,2,2
CGTTGTTTCAATTCCC-1_V12D07-332_B1,0,0,0,1,0,1
GCAAATATTACGCTTT-1_V12D07-332_B1,0,1,1,0,0,2
CCAATAGTGCCGTCGA-1_V12D07-332_B1,1,0,0,0,0,1
ATTGCTGCTCCTCCAT-1_V12D07-332_B1,0,0,0,3,0,3
GAGATCTGCTTGGCAT-1_V12D07-332_B1,0,0,0,0,0,0
GCCGAAATTCCTACGT-1_V12D07-332_B1,0,1,0,0,0,1
GGCACTCCACTGGGCA-1_V12D07-332_B1,0,0,0,0,0,0
GGGTCACCGTGACGGT-1_V12D07-332_B1,0,0,0,0,0,0
CACTTAATCAGACGGA-1_V12D07-332_B1,0,0,0,0,1,1
CGTTTCGCTCATTACA-1_V12D07-332_B1,0,0,1,0,1,2
ATAAAGGCTCGGTCGT-1_V12D07-332_B1,1,2,2,2,1,8
CACTAAAGTTGCCTAT-1_V12D07-332_B1,1,0,0,0,0,1
GTGCTCAAGTACTGTC-1_V12D07-332_B1,1,0,0,3,0,4
CCATGCCTGTTTAGTA-1_V12D07-332_B1,0,0,0,0,0,0
TCTAGTTATCAGAAGA-1_V12D07-332_B1,0,0,1,1,0,2
TTGTAATCCGTACTCG-1_V12D07-332_B1,0,0,1,1,1,3
TCCCAGCTTTAGTCTG-1_V12D07-332_B1,0,1,0,0,1,2
CTACGCACGGAGTACC-1_V12D07-332_B1,1,0,1,0,1,3
AAATTAACGGGTAGCT-1_V12D07-332_B1,0,0,0,0,0,0
CGGCCACGCACAAAGT-1_V12D07-332_B1,0,0,0,0,0,0
GAAGCGTGAGGAATTT-1_V12D07-332_B1,0,0,1,0,0,1
ATATCTTAGGGCCTTC-1_V12D07-332_B1,0,0,1,1,0,2
ACGCGGGCCAAGGACA-1_V12D07-332_B1,0,1,0,0,0,1
GCGAGTTCTGCAAAGA-1_V12D07-332_B1,0,1,0,0,1,2
TATTCGTGCCAGAATA-1_V12D07-332_B1,0,3,0,0,0,3
AGGGCTGCAGTTACAG-1_V12D07-332_B1,1,1,0,1,0,3
CTAGCATAGTATAATG-1_V12D07-332_B1,2,0,0,1,0,3
TAGGTTCGAGTTCGTC-1_V12D07-332_B1,2,2,1,0,0,5
GAATTATAGTGAAAGG-1_V12D07-332_B1,0,1,2,0,0,3
CTATCGGGTCTCAACA-1_V12D07-332_B1,0,1,0,0,0,1
GCGCTAATTGAATAGA-1_V12D07-332_B1,0,3,0,0,0,3
ATGCGACAGTCCCATT-1_V12D07-332_B1,0,1,0,0,0,1
GGTAGTGCTCGCACCA-1_V12D07-332_B1,0,1,0,0,2,3
AAGCTCGTGCCAAGTC-1_V12D07-332_B1,1,0,1,0,1,3
TATTCAATTCTAATCC-1_V12D07-332_B1,1,1,0,0,0,2
TTCAAAGTCTCTAGCC-1_V12D07-332_B1,0,1,0,2,0,3
TTGAATATGGACTTTC-1_V12D07-332_B1,0,1,0,1,1,3
AAGAGCTCTTTATCGG-1_V12D07-332_B1,0,0,0,2,0,2
TTACTCCGGCCGGGAA-1_V12D07-332_B1,0,0,1,0,0,1
AAACGAGACGGTTGAT-1_V12D07-332_B1,0,2,0,0,0,2
GCTAAGTAGTTTCTCT-1_V12D07-332_B1,0,2,0,2,0,4
ATAACGCCGGAGGGTC-1_V12D07-332_B1,0,1,0,0,0,1
GGATCCGGAATATACT-1_V12D07-332_B1,0,1,0,0,0,1
TGAAAGGACCTGACTC-1_V12D07-332_B1,1,0,0,0,0,1
TCCGCGGCAGCATCTG-1_V12D07-332_B1,1,0,0,0,0,1
TGCATATGTCTGTCAC-1_V12D07-332_B1,2,0,0,0,0,2
TGTAGGAGAAATTTCC-1_V12D07-332_B1,1,0,0,0,0,1
AGTGAGACTTCCAGTA-1_V12D07-332_B1,1,0,0,0,1,2
CCCAAACATGCTGCTC-1_V12D07-332_B1,1,1,0,0,0,2
GCTTATGAAGCAGGAA-1_V12D07-332_B1,2,1,0,1,0,4
TTCTAACCGAAGCTTA-1_V12D07-332_B1,2,1,0,1,1,5
GGATGTCCTTACCGCA-1_V12D07-332_B1,0,4,0,0,1,5
AGGGTGCTCTCGAGGG-1_V12D07-332_B1,0,0,0,0,1,1
AACTCTCAATAGAGCG-1_V12D07-332_B1,3,2,0,0,1,6
TCTGAATTCCGTACAA-1_V12D07-332_B1,0,0,0,2,0,2
GCGTGGTACTGGGTTA-1_V12D07-332_B1,0,0,0,0,0,0
CGTCGGATAGTGTTGA-1_V12D07-332_B1,1,0,1,1,0,3
ATATGTCTCCCTAGCC-1_V12D07-332_B1,0,1,0,0,0,1
TCTTTAAGACTATGAA-1_V12D07-332_B1,1,2,0,0,3,6
TCATTTAAGTCTCCGA-1_V12D07-332_B1,0,1,0,0,0,1
GATATTGAGATTGGCG-1_V12D07-332_B1,0,5,0,14,1,20
TGACATCGAGCGGACC-1_V12D07-332_B1,0,1,0,16,0,17
GCGTAAATGGCCATAA-1_V12D07-332_B1,0,0,0,3,0,3
ATTGTACAACTCGGCT-1_V12D07-332_B1,0,2,0,4,0,6
TACGCTATAGAAACCT-1_V12D07-332_B1,0,0,0,0,0,0
CACCCAAATCTTATGT-1_V12D07-332_B1,0,1,0,0,0,1
AGATGATGGAGTCTGG-1_V12D07-332_B1,0,0,0,0,0,0
CCACGGTGCCCGGTAG-1_V12D07-332_B1,1,0,0,0,0,1
TCAAGAAATACTAGCT-1_V12D07-332_B1,0,0,0,0,0,0
AGGTATAATTGATAGT-1_V12D07-332_B1,2,1,0,0,0,3
CAAGGTCCTATAGGCT-1_V12D07-332_B1,1,0,0,0,0,1
CCGGCACGACCGTTTC-1_V12D07-332_B1,4,0,0,0,0,4
ACCTCCGTTATTCACC-1_V12D07-332_B1,1,1,0,0,0,2
GCAGCCTATATCACAT-1_V12D07-332_B1,4,1,0,0,1,6
GGTATAGTGACACATA-1_V12D07-332_B1,3,3,0,0,0,6
AAATTCCAGGTCCAAA-1_V12D07-332_B1,3,4,0,0,0,7
TCTTTAGCAGGCGAAC-1_V12D07-332_B1,3,1,0,0,0,4
TATTGACATTTCTGCC-1_V12D07-332_B1,3,0,0,0,1,4
TCTGATCGGGTGCTAG-1_V12D07-332_B1,1,0,0,0,0,1
GGCCCGGAGCATGTCT-1_V12D07-332_B1,2,2,0,1,0,5
GGGCGCAGCGTTACTC-1_V12D07-332_B1,1,4,0,0,0,5
TTGGCGATCCGAATAT-1_V12D07-332_B1,1,0,0,0,0,1
CCACGTAAATTAGACT-1_V12D07-332_B1,0,0,0,0,0,0
TCTGATTGGAAATGGA-1_V12D07-332_B1,3,0,0,0,0,3
ATGGCGGAATAGTCGC-1_V12D07-332_B1,0,0,0,0,0,0
ATCGCTTTACGTCTCA-1_V12D07-332_B1,0,0,0,0,0,0
TACGTGCAAGGTTCCT-1_V12D07-332_B1,0,0,0,0,0,0
CAGGACAGCTGCCCTT-1_V12D07-332_B1,1,1,0,0,0,2
ACAAGCTATATGGAAG-1_V12D07-332_B1,4,1,0,0,2,7
TCGCCCACTGCGAGAG-1_V12D07-332_B1,4,1,0,0,1,6
AGCCGCAAATTCAAAT-1_V12D07-332_B1,3,0,0,0,3,6
TTAACGTTAAAGCCTG-1_V12D07-332_B1,6,0,0,0,3,9
CAGCGCCAACACGATA-1_V12D07-332_B1,6,1,0,0,1,8
ATCCAATGGTACCGAA-1_V12D07-332_B1,10,0,0,0,1,11
GTGCTGCAGATAAGGA-1_V12D07-332_B1,5,0,0,0,4,9
GGCCTTTGCAACTGGC-1_V12D07-332_B1,4,1,0,0,3,8
GTCGTACCTACGATTG-1_V12D07-332_B1,1,1,0,0,5,7
TAGAAATTCACGTATA-1_V12D07-332_B1,8,2,0,0,0,10
AGAATAAATCTTCAGG-1_V12D07-332_B1,7,2,0,0,2,11
CATTGCGAAATGGGCG-1_V12D07-332_B1,3,3,0,0,3,9
GTCTACTCAATTACAA-1_V12D07-332_B1,8,1,0,0,2,11
TGTAATGACCACAATA-1_V12D07-332_B1,6,0,0,0,4,10
AAAGTCGACCCTCAGT-1_V12D07-332_B1,3,3,0,1,0,7
TACTCGGCACGCCGGG-1_V12D07-332_B1,2,0,0,0,2,4
AGGTGTATCGCCATGA-1_V12D07-332_B1,0,0,0,0,2,2
TGTGCTTTACGTAAGA-1_V12D07-332_B1,0,2,0,0,1,3
AAACCTCATGAAGTTG-1_V12D07-332_B1,3,1,0,0,1,5
TATAGGGTACTCATGA-1_V12D07-332_B1,4,1,0,0,0,5
CCAGCTGATGGTACTT-1_V12D07-332_B1,5,0,0,0,0,5
AATATTGGAGTATTGA-1_V12D07-332_B1,3,0,1,0,0,4
GGCCCTCACCCACTTA-1_V12D07-332_B1,3,0,0,0,0,3
AACCAAGACTTCTCTG-1_V12D07-332_B1,0,0,0,0,0,0
TCGTATTACCCATTGC-1_V12D07-332_B1,0,0,0,0,0,0
ATTCGACGCCGGGCCT-1_V12D07-332_B1,1,0,0,0,0,1
GGCGCAGGACATCTTC-1_V12D07-332_B1,0,0,0,0,0,0
GTACTCCCTTATCGCT-1_V12D07-332_B1,1,0,3,0,0,4
TGGTCTGTTGGGCGTA-1_V12D07-332_B1,0,1,0,1,1,3
AATAACAACGCTCGGC-1_V12D07-332_B1,1,1,0,0,0,2
CATACCCGTACCCAGT-1_V12D07-332_B1,0,1,0,0,0,1
ACAATCCATTTAAACC-1_V12D07-332_B1,0,0,1,0,2,3
GTTACAATTGGTGACG-1_V12D07-332_B1,0,1,0,1,0,2
TTGCCCTGATCACGGG-1_V12D07-332_B1,0,0,0,1,0,1
CTAACCGCGCGCCCGT-1_V12D07-332_B1,0,0,1,2,1,4
CTAAAGAATGCCTACT-1_V12D07-332_B1,1,0,0,0,0,1
ACCCATCTTGAGGGTA-1_V12D07-332_B1,0,2,0,0,1,3
GATCTTTGCAGGGTAT-1_V12D07-332_B1,1,0,0,2,1,4
GGGTACTTCATGAACT-1_V12D07-332_B1,1,1,0,0,0,2
GCCGCTTGTGAGAAAC-1_V12D07-332_B1,1,0,1,0,0,2
CCTGTAAGACATGATA-1_V12D07-332_B1,3,1,1,0,0,5
CGACAGTTCGCGTTAT-1_V12D07-332_B1,0,0,2,0,0,2
ACGATGCATATGTTAT-1_V12D07-332_B1,0,2,1,0,1,4
TGTTCCGCTTCCATGA-1_V12D07-332_B1,1,0,0,0,1,2
GGATGACGCGAGTTTA-1_V12D07-332_B1,0,1,1,0,0,2
GAAGTTTCCACTCAAT-1_V12D07-332_B1,0,0,0,1,1,2
GCGAGGCCCGAGCAGA-1_V12D07-332_B1,1,0,0,0,0,1
CATACTATGTAATTGT-1_V12D07-332_B1,0,0,0,1,0,1
CCAATGTCACAGCAAG-1_V12D07-332_B1,0,0,0,0,0,0
GTTGGATTTGCGTTGG-1_V12D07-332_B1,0,0,1,0,1,2
GGGAGGATGCCCGAAA-1_V12D07-332_B1,1,0,1,3,0,5
GATCGCGGGCTCTCCA-1_V12D07-332_B1,1,0,2,0,0,3
GTTCGCCATAAGTGCC-1_V12D07-332_B1,0,0,1,0,0,1
AGATTATAGGACGTTT-1_V12D07-332_B1,0,1,0,0,0,1
TCGAGACCAACACCGT-1_V12D07-332_B1,2,0,1,0,0,3
TATGGGACCGAGCAGG-1_V12D07-332_B1,1,1,0,1,0,3
GATGCGTCCTGCATTC-1_V12D07-332_B1,1,0,1,0,1,3
TATGGTCTGAGTAACA-1_V12D07-332_B1,0,0,1,0,0,1
GCATAGAGCACTCAGG-1_V12D07-332_B1,0,0,0,0,0,0
CTTCATTGTCAGTGGA-1_V12D07-332_B1,0,0,0,0,0,0
GCAGATTAGGGATATC-1_V12D07-332_B1,3,1,0,0,1,5
CCTGTCGCCCGTAAAT-1_V12D07-332_B1,0,0,1,0,0,1
CAATTTCGTATAAGGG-1_V12D07-332_B1,1,0,0,1,0,2
GTACACTTACCTGAAG-1_V12D07-332_B1,1,1,0,0,0,2
CCAGCCTGGACCAATA-1_V12D07-332_B1,1,3,0,0,1,5
ATGGAGCAGGCCGTGA-1_V12D07-332_B1,0,1,0,0,0,1
GTCATTAGAGCGAACG-1_V12D07-332_B1,1,0,0,1,0,2
AAGACTGCAAGCTACT-1_V12D07-332_B1,0,0,0,0,0,0
CTAGTCACGTCTTAAG-1_V12D07-332_B1,0,0,0,1,0,1
ACTCTTGTATAGTAAC-1_V12D07-332_B1,1,2,0,1,1,5
ATTAGGCGATGCTTTC-1_V12D07-332_B1,3,0,0,0,3,6
TTCGGGACTAATCGCG-1_V12D07-332_B1,0,0,0,0,0,0
TGGACTGTTCGCTCAA-1_V12D07-332_B1,1,0,0,1,1,3
AACGTGCGAAAGTCTC-1_V12D07-332_B1,0,0,0,3,1,4
CCACCCAAGGAAAGTG-1_V12D07-332_B1,1,2,0,1,0,4
CCGCACAAAGACCAAC-1_V12D07-332_B1,0,0,0,0,0,0
GCGATTGTTAACGTTA-1_V12D07-332_B1,2,0,0,0,0,2
ACTCGTCAGTAATCCC-1_V12D07-332_B1,0,1,1,1,0,3
GGTGATAAGGAGCAGT-1_V12D07-332_B1,0,1,0,1,1,3
AAGAGGCATGGATCGC-1_V12D07-332_B1,0,0,0,0,0,0
CACGTTCGTGCTCTAG-1_V12D07-332_B1,0,3,0,0,0,3
CTATTTGGTTACGGAT-1_V12D07-332_B1,0,0,0,0,0,0
GTACAGAGGCAAGGGT-1_V12D07-332_B1,0,1,0,0,0,1
GGGCCGGCCGAAGTAC-1_V12D07-332_B1,3,0,0,0,0,3
CCTGAACGATATATTC-1_V12D07-332_B1,2,5,0,0,0,7
CCGGGCTGCTCCATAC-1_V12D07-332_B1,1,1,0,0,0,2
TACTTGTTAGTAGTCC-1_V12D07-332_B1,1,1,1,0,0,3
CCTAGGCGTAGCGATC-1_V12D07-332_B1,0,0,0,0,1,1
CTGGCGCACAGGTCTG-1_V12D07-332_B1,0,2,0,0,1,3
ACTTATACTTACCCGG-1_V12D07-332_B1,1,2,0,0,2,5
GAAGTCTCCCTAGCGA-1_V12D07-332_B1,1,1,0,1,0,3
ACCGATGGTAGCATCG-1_V12D07-332_B1,2,2,0,0,0,4
CGAGTTTATCGGACTG-1_V12D07-332_B1,1,1,1,0,0,3
CATAACGGACAGTCGT-1_V12D07-332_B1,1,0,1,0,0,2
TGACGATGCACTAGAA-1_V12D07-332_B1,0,1,0,0,1,2
TAGGGAGCTTGGGATG-1_V12D07-332_B1,1,1,0,0,0,2
AGGGTCGATGCGAACT-1_V12D07-332_B1,1,3,0,0,0,4
TATATCCCTGGGAGGA-1_V12D07-332_B1,0,2,0,0,0,2
CATCTTACACCACCTC-1_V12D07-332_B1,1,2,0,0,0,3
GTGCGACAGGGAGTGT-1_V12D07-332_B1,0,5,0,1,1,7
CCGATCTCAACCTTAT-1_V12D07-332_B1,0,1,0,1,0,2
ACGATCATCTTGTAAA-1_V12D07-332_B1,0,1,0,19,0,20
GAAAGAACAGCGTTAT-1_V12D07-332_B1,0,0,0,9,0,9
CTAGGTCTGAAGGAAT-1_V12D07-332_B1,0,2,0,0,0,2
ATATCAACCTACAGAG-1_V12D07-332_B1,0,1,0,0,1,2
AAATAGCTTAGACTTT-1_V12D07-332_B1,0,0,0,0,0,0
GCGACATGTAAACATC-1_V12D07-332_B1,0,0,0,0,0,0
ATAAGTAGGGCGACTC-1_V12D07-332_B1,0,0,0,0,0,0
GCGAGCGCATGCTCCC-1_V12D07-332_B1,0,0,0,0,0,0
AGGGACCGGCTGCGTT-1_V12D07-332_B1,0,1,0,0,0,1
CCTATGAAGTGGTGCC-1_V12D07-332_B1,0,1,0,0,0,1
GCTTACGTAGTTAGTA-1_V12D07-332_B1,1,3,0,0,1,5
CATACTTAGGCAATAC-1_V12D07-332_B1,1,0,0,0,0,1
CCTGTCCCTCACGTTA-1_V12D07-332_B1,2,2,0,0,2,6
CAATGTGCCAACCCTT-1_V12D07-332_B1,1,1,0,0,0,2
GTTAAGTTAGAGTGGG-1_V12D07-332_B1,6,1,0,0,0,7
CTGGGATACGCTACCC-1_V12D07-332_B1,2,3,0,0,0,5
AACCTGTCACGGAATT-1_V12D07-332_B1,1,1,0,0,0,2
ACTGCGGACACACCGT-1_V12D07-332_B1,3,2,0,0,0,5
CCGTGAGGCATTCATG-1_V12D07-332_B1,2,0,0,0,0,2
GCCCAGATGCTGGAGA-1_V12D07-332_B1,0,0,0,0,0,0
TCTGGCCGTTCAAGTT-1_V12D07-332_B1,0,0,0,0,0,0
ATACGAAGGCTTTCCA-1_V12D07-332_B1,0,0,0,0,0,0
GATCCGAATATAAGTG-1_V12D07-332_B1,1,0,0,0,0,1
GTGGAGCATGTCGGCC-1_V12D07-332_B1,0,0,0,1,0,1
ACTCTTCAGCTCCCGC-1_V12D07-332_B1,0,1,0,0,0,1
CCCGATAGCCTCGCCT-1_V12D07-332_B1,1,0,0,1,0,2
TGAACTGCTATGACTT-1_V12D07-332_B1,3,0,0,0,1,4
TGACATATATGACGAT-1_V12D07-332_B1,3,0,0,0,6,9
AAGTCTTCTGTGGCCT-1_V12D07-332_B1,8,1,0,0,3,12
ACCAGACCATAACAAC-1_V12D07-332_B1,7,1,0,0,7,15
TGAGACGTACCTCTCA-1_V12D07-332_B1,5,2,0,0,1,8
GACCGTTACATGCGAC-1_V12D07-332_B1,3,1,0,0,4,8
GGTTCGGATTATACTA-1_V12D07-332_B1,1,2,0,0,2,5
CCTCCTGAGCCCACAT-1_V12D07-332_B1,3,1,0,0,0,4
CCGCGATTTGGTAGGT-1_V12D07-332_B1,6,4,0,0,1,11
AATCTCTACTGTGGTT-1_V12D07-332_B1,6,0,0,0,1,7
ACTTTGACTGCATCCT-1_V12D07-332_B1,6,3,0,1,1,11
CCCTGACTAACAAATT-1_V12D07-332_B1,6,4,0,0,0,10
ACGCTGTGAGGCGTAG-1_V12D07-332_B1,2,3,0,0,3,8
GCATACGAGGTCTTTA-1_V12D07-332_B1,5,4,0,0,2,11
TCGGGATTCAAACATA-1_V12D07-332_B1,3,3,0,0,4,10
GGGCCCTACGAAAGGG-1_V12D07-332_B1,1,0,0,0,1,2
CGCCAAGAAGCCGAGT-1_V12D07-332_B1,3,1,0,0,2,6
GGTACATCTGGGACGA-1_V12D07-332_B1,4,0,0,0,1,5
GGATGCTGGCGTTCCT-1_V12D07-332_B1,1,1,0,0,0,2
CCGATTCGAGGGACCC-1_V12D07-332_B1,2,0,0,0,1,3
CCACTGGTGGCTGGTT-1_V12D07-332_B1,3,0,1,0,0,4
GACAGGCACACACTAT-1_V12D07-332_B1,3,0,0,0,1,4
TCAACGCGACCGGCAG-1_V12D07-332_B1,2,2,1,0,0,5
CTACGACTAGCTATAA-1_V12D07-332_B1,2,0,0,0,0,2
CGGTTGACCTGGCATA-1_V12D07-332_B1,0,0,1,0,0,1
ATCCTGAATCGCTGCG-1_V12D07-332_B1,0,0,0,0,0,0
GTTTCATATCGTCGCT-1_V12D07-332_B1,1,1,0,0,1,3
ATAAATATTAGCAGCT-1_V12D07-332_B1,1,3,0,0,0,4
AAGAGGATGTACGCGA-1_V12D07-332_B1,1,1,0,0,0,2
TCCTGCGTTGATACTC-1_V12D07-332_B1,0,3,0,0,1,4
CGTGCATTGTCGACGC-1_V12D07-332_B1,0,2,0,1,0,3
CCGGGTTCGAGGTTAC-1_V12D07-332_B1,0,2,0,0,0,2
CCCAATTTCACAACTT-1_V12D07-332_B1,0,0,0,0,0,0
TGATTTATTAGCTGTG-1_V12D07-332_B1,1,2,1,1,0,5
TGGAAGAAGGGAACGT-1_V12D07-332_B1,1,0,0,0,1,2
GACGCTTGCTTCTAAA-1_V12D07-332_B1,0,1,1,0,0,2
GGGAACGGGAGGTTAG-1_V12D07-332_B1,0,1,0,0,0,1
GCGGCTCTGACGTACC-1_V12D07-332_B1,0,0,0,0,1,1
ACGTTAGATTTGCCCG-1_V12D07-332_B1,1,0,0,0,1,2
GAGAGGGCGCGAGGTT-1_V12D07-332_B1,1,0,0,1,2,4
GCGTCTCTGCATTGGG-1_V12D07-332_B1,0,3,0,0,0,3
GCAGCACACAGCCCAG-1_V12D07-332_B1,2,1,0,0,1,4
CAGGCCGTTTGGGTGT-1_V12D07-332_B1,0,0,0,0,0,0
AACTCAAGTTAATTGC-1_V12D07-332_B1,0,1,0,0,0,1
CTTCGTAGATAGGTGA-1_V12D07-332_B1,1,1,0,0,0,2
TGCAGAGTACCGAGCA-1_V12D07-332_B1,1,0,0,0,0,1
GAAGTGATTTATCGTG-1_V12D07-332_B1,0,1,0,0,0,1
CGCTACGGGACATTTA-1_V12D07-332_B1,0,1,0,0,0,1
CCACACTGAGATATTA-1_V12D07-332_B1,0,0,1,0,1,2
CGATCCGACCCAGTGC-1_V12D07-332_B1,0,1,2,2,0,5
CTGTACTTCTTAGCAT-1_V12D07-332_B1,0,0,0,0,0,0
ACTTATTAGGATCGGT-1_V12D07-332_B1,0,0,0,1,2,3
TAGTCCGCAGAGAATG-1_V12D07-332_B1,0,0,3,0,0,3
TTCACGAAAGGATCAC-1_V12D07-332_B1,0,0,0,0,0,0
TACATTTCTAACGTGC-1_V12D07-332_B1,0,1,1,0,0,2
ACCATATCCGCAATAA-1_V12D07-332_B1,1,0,1,1,0,3
CACTCAAGAGCTATGG-1_V12D07-332_B1,1,2,0,0,0,3
TGTACGAACAAATCCG-1_V12D07-332_B1,1,0,0,1,0,2
ATCATCCAATATTTGT-1_V12D07-332_B1,0,1,0,0,1,2
CGCTATTCTTAGGCTC-1_V12D07-332_B1,0,1,1,1,0,3
TGGCAGCAGTAATAGT-1_V12D07-332_B1,0,0,0,0,0,0
TCACGTGCCCGATTCA-1_V12D07-332_B1,0,0,0,0,0,0
CATACGGCGTCTGGGC-1_V12D07-332_B1,2,0,0,0,0,2
CACATGATTCAGCAAC-1_V12D07-332_B1,0,0,1,0,0,1
GCTAGTAGAGCTTGTA-1_V12D07-332_B1,0,1,0,2,0,3
TGCTGTTGAAGAACTC-1_V12D07-332_B1,1,1,0,0,1,3
CGGAGCATGGCGATCC-1_V12D07-332_B1,0,0,1,1,0,2
TAGCGTTGGGTCTTAC-1_V12D07-332_B1,0,1,0,0,0,1
GTAGCGGCTATACACT-1_V12D07-332_B1,0,1,0,0,0,1
TAACATACAATGTGGG-1_V12D07-332_B1,0,0,0,1,1,2
TCTTCGAATAGACGTT-1_V12D07-332_B1,1,2,0,1,0,4
GATCGTGACTGATATC-1_V12D07-332_B1,0,1,0,0,0,1
GATCCGGGAATTAACA-1_V12D07-332_B1,0,0,0,0,0,0
TTATATACGCTGTCAC-1_V12D07-332_B1,1,0,0,0,3,4
GTCGCGTAACCCGTTG-1_V12D07-332_B1,1,2,0,1,0,4
AGCTCTAGACGTTCCA-1_V12D07-332_B1,0,3,0,0,0,3
GTCAAGCGGACTCGGG-1_V12D07-332_B1,0,1,1,0,0,2
CGAGGGACTGCGGTCG-1_V12D07-332_B1,0,1,0,0,0,1
AATCGCCTCAGCGCCA-1_V12D07-332_B1,0,1,0,0,0,1
CTTGTTGCTGAGTCAA-1_V12D07-332_B1,0,2,0,0,0,2
GATATGAGACACTAAC-1_V12D07-332_B1,0,1,0,0,0,1
TTATGATCTTAACGAA-1_V12D07-332_B1,0,1,0,0,0,1
CGCCGCCCATGCCTGT-1_V12D07-332_B1,0,2,0,0,0,2
CTGGGATAAATAATGG-1_V12D07-332_B1,0,1,0,0,0,1
GTGCCCGTTCGGATTC-1_V12D07-332_B1,0,1,2,0,0,3
TTCAATACTCTGAATC-1_V12D07-332_B1,2,1,1,0,0,4
CGCACATGTCCACTAC-1_V12D07-332_B1,2,0,0,0,1,3
AGAAGAGCGCCGTTCC-1_V12D07-332_B1,1,2,0,0,0,3
GATAACTCGCACTGTG-1_V12D07-332_B1,0,1,1,0,1,3
AGTCGACGGTCTCAAG-1_V12D07-332_B1,0,0,0,0,0,0
GTGACCGCACACTACG-1_V12D07-332_B1,1,0,0,0,0,1
GTATGTGGGTCTAGTT-1_V12D07-332_B1,1,3,0,1,0,5
CTTGAGTTAGGGTAAT-1_V12D07-332_B1,0,0,0,1,1,2
TTAGCTGATTTGCCGT-1_V12D07-332_B1,1,0,0,2,2,5
GCTGTTGCTACCGAAC-1_V12D07-332_B1,4,0,0,0,1,5
TATTACCATCCTGCTT-1_V12D07-332_B1,1,1,0,0,1,3
TTGAATTCACGTGAGG-1_V12D07-332_B1,0,0,0,0,0,0
CCATCTCACCAGTGAA-1_V12D07-332_B1,1,1,0,0,1,3
CGCACGTGCGCTATCA-1_V12D07-332_B1,2,2,0,0,0,4
ACCCGGATGACGCATC-1_V12D07-332_B1,0,1,0,0,1,2
CGCTAGAGACCGCTGC-1_V12D07-332_B1,0,3,0,3,0,6
ATAGTTCCACCCACTC-1_V12D07-332_B1,0,0,0,10,0,10
GCAGACCCAGCACGTA-1_V12D07-332_B1,0,2,0,13,0,15
TAGACTACCTAGCGTT-1_V12D07-332_B1,0,0,0,2,0,2
GGTTCTACTCGTCTGA-1_V12D07-332_B1,0,0,0,1,0,1
GACTCACCCACGTGAG-1_V12D07-332_B1,0,0,0,0,0,0
AGCTCTTCGTAACCTT-1_V12D07-332_B1,0,0,0,0,1,1
ACTATCCAGGGCATGG-1_V12D07-332_B1,0,0,0,0,0,0
AAGGATCGATCGCTTG-1_V12D07-332_B1,0,1,0,0,0,1
ATATCGGTAGGGAGAT-1_V12D07-332_B1,0,1,0,0,0,1
TTCCAGACGAGATTTA-1_V12D07-332_B1,3,0,0,2,0,5
GACCGACGTGAAAGCA-1_V12D07-332_B1,3,3,0,0,0,6
CCTGGAAACGTTCTGC-1_V12D07-332_B1,4,0,1,0,0,5
CCGGTAATGGCTAGTC-1_V12D07-332_B1,3,1,0,0,1,5
GCCGTGGAAGAAATGT-1_V12D07-332_B1,1,0,0,0,0,1
GTCTTGAGGAGCAGTG-1_V12D07-332_B1,4,1,0,0,1,6
TCCCAAAGCCCTAAAT-1_V12D07-332_B1,5,1,0,1,0,7
TTGAGCGCCACGTGAT-1_V12D07-332_B1,1,1,0,0,0,2
TTGAGTCCCGCTGCTG-1_V12D07-332_B1,3,3,0,0,1,7
ATGGAACCTTTGCACA-1_V12D07-332_B1,6,0,0,0,2,8
GCTAGCACCTGGGCCA-1_V12D07-332_B1,2,1,0,0,0,3
CGCCGTCTACCCATCG-1_V12D07-332_B1,1,3,0,1,0,5
GATAGGTGTCCCGGGC-1_V12D07-332_B1,0,0,0,0,0,0
AGGTATGCGGACATTA-1_V12D07-332_B1,4,2,0,0,0,6
TTGGTTCGCTCAAAGG-1_V12D07-332_B1,1,0,0,0,0,1
TCTGGAGCGTAAGAGT-1_V12D07-332_B1,0,1,0,0,0,1
TGCCTAAATTTAATAG-1_V12D07-332_B1,0,0,0,0,0,0
TACCTATCCCTAGAGG-1_V12D07-332_B1,4,0,0,0,2,6
GCATGGGTACTGACGC-1_V12D07-332_B1,10,1,0,0,0,11
GTCGGGAACATGGTAG-1_V12D07-332_B1,6,1,0,0,2,9
GCAAATGAGGACACTT-1_V12D07-332_B1,7,1,0,0,2,10
GAATGGGCTTATCGAC-1_V12D07-332_B1,5,1,0,0,5,11
TGGTCGTGCAAGGCAA-1_V12D07-332_B1,7,2,0,0,2,11
CACCACGCCACACAGA-1_V12D07-332_B1,5,3,0,0,2,10
GAACCTCGACCTACAC-1_V12D07-332_B1,3,2,0,0,0,5
CAATACGCTCTGAGGC-1_V12D07-332_B1,6,1,0,0,2,9
TGGTAAGCAGGATTGA-1_V12D07-332_B1,7,2,0,0,3,12
AGTGGCTCCGTCGGCC-1_V12D07-332_B1,2,4,0,0,1,7
GATCGGATAGAACCAT-1_V12D07-332_B1,6,1,0,0,4,11
GCTACAGTACGGACCG-1_V12D07-332_B1,6,3,0,0,4,13
TCTATTACTAGAGGAT-1_V12D07-332_B1,9,2,0,0,1,12
TTCAGGCGTCAAAGCC-1_V12D07-332_B1,2,2,0,0,1,5
AGACCGGGAAACCCTG-1_V12D07-332_B1,1,0,0,0,0,1
AGAGATCTCTAAAGCG-1_V12D07-332_B1,3,0,0,0,0,3
CCCTGCCCAATCCGCT-1_V12D07-332_B1,2,1,0,0,1,4
GTGGCGGTCCCAGCGT-1_V12D07-332_B1,1,0,0,0,0,1
GCATTGTAATTCATAT-1_V12D07-332_B1,0,0,0,0,1,1
CCGTTCCGAATCTCGG-1_V12D07-332_B1,1,0,0,0,1,2
AGCTTGATCTTAACTT-1_V12D07-332_B1,0,0,0,0,0,0
CCTGTACTCACGCCCA-1_V12D07-332_B1,0,1,0,0,0,1
AAGTGACGACCGAATT-1_V12D07-332_B1,1,1,1,0,0,3
CTCACTTGGCTGGTAA-1_V12D07-332_B1,1,0,0,0,0,1
CGCCTGGCCTACGTAA-1_V12D07-332_B1,0,0,0,0,1,1
CCCGTAAGTCTAGGCC-1_V12D07-332_B1,0,2,0,0,0,2
TTGGACATGTGGCTTA-1_V12D07-332_B1,2,1,0,0,0,3
ATTACGCGCTGGCAGG-1_V12D07-332_B1,0,1,0,0,0,1
ACGCGCTACACAGGGT-1_V12D07-332_B1,2,0,0,2,0,4
TACGTTTACCGGCAAT-1_V12D07-332_B1,0,1,0,0,0,1
CGAAACGCAATTCATG-1_V12D07-332_B1,1,2,0,1,0,4
TAGTCTAACAACGAGA-1_V12D07-332_B1,0,0,0,0,0,0
TTGCATGCTGATCACG-1_V12D07-332_B1,0,1,0,1,0,2
TCTGGGTAGCGCTCAT-1_V12D07-332_B1,1,0,1,0,1,3
ACATCGGTCAGCCGCG-1_V12D07-332_B1,0,0,1,0,1,2
AGATACCGGTGTTCAC-1_V12D07-332_B1,0,2,0,0,0,2
GATTACTGAATTTGGG-1_V12D07-332_B1,0,0,0,0,1,1
TCCAACTTTAAATTCT-1_V12D07-332_B1,1,0,1,0,2,4
TCCTAGCAAAGAAGCT-1_V12D07-332_B1,2,1,0,0,2,5
GTCTATCTGAGTTTCT-1_V12D07-332_B1,0,0,0,1,1,2
GATGTTCAATCCACGA-1_V12D07-332_B1,0,0,0,0,0,0
AGTTAAACACTTGCGA-1_V12D07-332_B1,2,1,0,0,0,3
AGCTCTTTACTCAGTT-1_V12D07-332_B1,1,1,0,3,0,5
ATCCAGGATTCGTGAA-1_V12D07-332_B1,0,1,0,0,0,1
AGTCAACACCACCATC-1_V12D07-332_B1,0,0,0,0,0,0
CGATACCTCGCGGACA-1_V12D07-332_B1,0,0,0,0,0,0
TACAACGCACAACTCA-1_V12D07-332_B1,1,1,1,0,0,3
AATTAAAGGTCGGCGT-1_V12D07-332_B1,0,1,0,0,0,1
TACGCAGTTCTTTCCT-1_V12D07-332_B1,0,5,1,0,1,7
GACCGTGCTGACGGTG-1_V12D07-332_B1,0,0,0,0,1,1
GGCAAATTACTTTACT-1_V12D07-332_B1,0,4,0,0,0,4
GGTACAAACATGCTAT-1_V12D07-332_B1,0,0,0,0,0,0
CGGGCCTTCTTTGTAA-1_V12D07-332_B1,0,0,0,1,0,1
CGTGAAGTTAATTCAC-1_V12D07-332_B1,1,0,0,0,0,1
ATAGTGAAGCGTTCTC-1_V12D07-332_B1,0,1,1,0,0,2
TACGCCATATTCTAAT-1_V12D07-332_B1,0,0,0,0,0,0
GCCGGGTTAGGGTCGC-1_V12D07-332_B1,0,1,0,0,0,1
TACATAGGCATACACC-1_V12D07-332_B1,0,1,0,0,0,1
GCCGATTGGCCAAGCT-1_V12D07-332_B1,0,0,0,2,0,2
CTGCCATGCATCACAT-1_V12D07-332_B1,0,0,0,1,0,1
TTATGAATGAAAGGGA-1_V12D07-332_B1,1,0,1,0,0,2
GCTGAGGCGTGAGTAT-1_V12D07-332_B1,0,0,0,0,1,1
GCGCCGTTCCACGATA-1_V12D07-332_B1,0,2,0,0,0,2
CGCATGGTGCGATGCT-1_V12D07-332_B1,2,1,0,0,0,3
AGGTTTCACACACCTT-1_V12D07-332_B1,0,2,3,0,0,5
CAAGGATCGCATGTTC-1_V12D07-332_B1,0,0,1,0,1,2
ACGTTAATGTCGAAGA-1_V12D07-332_B1,0,0,0,0,1,1
TCCAGAGCACCGGTTC-1_V12D07-332_B1,1,0,1,0,1,3
GATTCGACGGTTCACG-1_V12D07-332_B1,0,1,0,0,1,2
GTTTCTGCAGTCTCCC-1_V12D07-332_B1,0,1,0,0,0,1
GCTGCACGGTTTCTTA-1_V12D07-332_B1,1,1,0,0,0,2
CGTGCAGACTGGGACA-1_V12D07-332_B1,1,0,0,2,1,4
GTGTTACTATGCGTCC-1_V12D07-332_B1,1,1,0,0,0,2
TCCTCGGGCTGGGCTT-1_V12D07-332_B1,2,3,0,0,2,7
GTGAGGACACTTAAGG-1_V12D07-332_B1,0,1,0,1,1,3
ATACGCCGGCGAAACC-1_V12D07-332_B1,1,0,0,0,0,1
TCTGCCAGAAACTGCA-1_V12D07-332_B1,1,0,1,1,0,3
TTCTGCGGGTTAGCGG-1_V12D07-332_B1,0,1,0,1,0,2
CTCGGTACCACTGCTC-1_V12D07-332_B1,1,4,0,0,0,5
GTAAGTAACAGTCTGG-1_V12D07-332_B1,0,2,0,0,1,3
GTGCGTGTATATGAGC-1_V12D07-332_B1,1,0,0,0,0,1
ATTTGTCTTGGGAGCT-1_V12D07-332_B1,0,1,1,0,0,2
CCTCGGACCGGGATAG-1_V12D07-332_B1,0,2,0,0,2,4
TAGGTGCTCGCCTAGC-1_V12D07-332_B1,2,1,0,1,0,4
CTTTAGGAACACTGTT-1_V12D07-332_B1,0,1,0,1,0,2
TCGGGCCGTCGTGGTA-1_V12D07-332_B1,2,0,0,0,0,2
AGTGCTTGCACGAATA-1_V12D07-332_B1,0,1,0,0,0,1
TGCAGTTTCCTCCCAT-1_V12D07-332_B1,0,1,0,0,0,1
TGAGAGATTTACCACG-1_V12D07-332_B1,0,3,0,0,0,3
GAAACAGATGACCACC-1_V12D07-332_B1,1,3,0,0,1,5
AGCAACATATCTTATT-1_V12D07-332_B1,0,0,0,2,0,2
CAAGTGTGGTTGCAAA-1_V12D07-332_B1,3,1,0,0,1,5
GCCTCATCTGGAAATA-1_V12D07-332_B1,0,0,1,0,0,1
AACCCTACTGTCAATA-1_V12D07-332_B1,1,1,0,0,0,2
ACGTATTACTCCGATC-1_V12D07-332_B1,0,2,0,0,0,2
TCTGGGAACCTTTGAA-1_V12D07-332_B1,1,0,0,0,0,1
GCTCGCTCATGTCCAA-1_V12D07-332_B1,0,1,0,1,1,3
GCGCAAGAGCGCGCTG-1_V12D07-332_B1,2,2,0,0,0,4
TTGACGCTCCATGAGC-1_V12D07-332_B1,0,4,0,0,0,4
TATAGATGGTCGCAGT-1_V12D07-332_B1,1,3,0,1,1,6
TTACATGCCACAACTA-1_V12D07-332_B1,0,1,0,5,1,7
ACATGGCGCCAAAGTA-1_V12D07-332_B1,0,0,0,16,0,16
TATGGTTAGTGGGAGA-1_V12D07-332_B1,1,2,0,2,3,8
CATGACTTCGCTGAAT-1_V12D07-332_B1,0,0,0,0,0,0
ACCACCAATGTAACAA-1_V12D07-332_B1,1,1,0,1,0,3
TCTTAGAGCTCCAATT-1_V12D07-332_B1,1,2,0,0,0,3
CCACGAATTTAACCTC-1_V12D07-332_B1,1,2,0,0,0,3
TTCTTGCTAGCATCTC-1_V12D07-332_B1,0,2,0,0,0,2
ACACCTTACTACTTGC-1_V12D07-332_B1,1,1,0,0,0,2
AGTCGGTTGCGTGAGA-1_V12D07-332_B1,0,1,0,0,1,2
ACCTACAGTATGTGGT-1_V12D07-332_B1,0,2,0,0,1,3
GAGGATAAACAGTGCT-1_V12D07-332_B1,2,1,1,0,0,4
TTCCGGTATCTGTGTC-1_V12D07-332_B1,4,1,0,0,1,6
GGAGGCCGAAGTCGTC-1_V12D07-332_B1,4,3,0,0,0,7
TTCGCTAGGAAGTTGT-1_V12D07-332_B1,6,2,0,0,0,8
TAAAGACAACCCTTTA-1_V12D07-332_B1,4,3,0,0,0,7
GTTGCGCTAACATTAC-1_V12D07-332_B1,4,1,0,0,0,5
GCTGAACTCTCCAGGG-1_V12D07-332_B1,2,5,0,0,1,8
AGCCCTGTCGCACCGT-1_V12D07-332_B1,1,1,0,0,0,2
AGCGCTAGAGCGATGT-1_V12D07-332_B1,1,1,0,1,0,3
TGCGCCGTTAATAACG-1_V12D07-332_B1,0,0,0,0,0,0
TGACAACGCATGTCGC-1_V12D07-332_B1,0,0,0,0,0,0
CGTCTTGAGTGTGACG-1_V12D07-332_B1,0,0,0,0,0,0
GATAGGATTAATTACA-1_V12D07-332_B1,0,2,0,0,0,2
GATACCGTGTCGGAGT-1_V12D07-332_B1,0,0,0,0,0,0
GTCCCAATCATCCCGC-1_V12D07-332_B1,2,0,0,0,0,2
TGCCACACTAGAGGAA-1_V12D07-332_B1,5,1,0,0,0,6
TGAATTTCACTTGCCT-1_V12D07-332_B1,5,0,0,0,0,5
CTCAGATTGTGATAAG-1_V12D07-332_B1,6,2,0,0,1,9
CGGACGTTACTTGAAG-1_V12D07-332_B1,7,1,0,0,3,11
CCGCCTTGCGATGTCG-1_V12D07-332_B1,3,3,0,0,0,6
CCAGTCAAATCTCTTA-1_V12D07-332_B1,5,0,0,0,3,8
AAACAGCTTTCAGAAG-1_V12D07-332_B1,2,1,0,1,7,11
TAGCTGATGTGAAGCG-1_V12D07-332_B1,5,4,0,0,1,10
CTTATGCGCTCAGGGC-1_V12D07-332_B1,8,1,0,0,2,11
TGGCTCTTGTCGCGTA-1_V12D07-332_B1,3,2,0,0,3,8
TTGTGAGGCATGACGC-1_V12D07-332_B1,3,3,0,1,0,7
CATAAGCTCTCCGTCT-1_V12D07-332_B1,4,3,0,0,4,11
CCTTCTCAGCGTTCCT-1_V12D07-332_B1,5,2,1,1,2,11
TGCAGCTACGTACTTC-1_V12D07-332_B1,1,0,0,0,1,2
CTCTACACTGGCGATT-1_V12D07-332_B1,1,3,0,0,1,5
TGCAGATCGTCCTAGG-1_V12D07-332_B1,1,1,0,0,0,2
TGCCAAAGTCAGACTT-1_V12D07-332_B1,1,3,0,0,0,4
ACAATAGTCGTACGTT-1_V12D07-332_B1,1,0,0,0,1,2
CATGCCAACTCGCAAA-1_V12D07-332_B1,3,1,0,0,0,4
TGCAGAACTATATCGT-1_V12D07-332_B1,4,0,0,0,1,5
TCGTGTCACGCTGACA-1_V12D07-332_B1,0,0,0,0,0,0
TGATCAGGGAACTGCT-1_V12D07-332_B1,2,0,0,0,1,3
CTTGCAACCGCCTCCT-1_V12D07-332_B1,1,0,1,1,0,3
AGCCCATACATGTAAG-1_V12D07-332_B1,0,1,0,0,0,1
ATCCAATGGAGGGTCC-1_V12D07-332_B1,1,0,0,0,0,1
AAACCGGGTAGGTACC-1_V12D07-332_B1,0,0,0,0,0,0
GCAACCACGGCCGCGT-1_V12D07-332_B1,0,1,0,0,0,1
CGCTTATTCCCGGTCG-1_V12D07-332_B1,0,3,0,1,1,5
TTACTCTGGTACGTAC-1_V12D07-332_B1,0,1,0,2,0,3
GTGGTTTCCGCCTTTC-1_V12D07-332_B1,0,1,0,1,0,2
ATAGGCGGCTATAGAA-1_V12D07-332_B1,1,1,0,0,0,2
GTGCCATCACACGGTG-1_V12D07-332_B1,1,2,0,2,0,5
CCCAACATACGTCGCG-1_V12D07-332_B1,0,0,1,0,0,1
CGGTGCAGATAGAACG-1_V12D07-332_B1,1,4,0,0,1,6
GGGCGGGTTCCCTACG-1_V12D07-332_B1,0,0,0,0,0,0
TGAGCCATACAGTCTC-1_V12D07-332_B1,0,0,0,0,0,0
CTCCGCCCACATGAGG-1_V12D07-332_B1,1,1,0,0,0,2
GTTGAACCGGTTCCAT-1_V12D07-332_B1,1,2,0,0,0,3
TTGACTACCATATGGT-1_V12D07-332_B1,2,0,2,0,0,4
ACCATCGTATATGGTA-1_V12D07-332_B1,0,1,1,0,0,2
TGCGTAAGAACCTGAT-1_V12D07-332_B1,1,1,1,0,1,4
AGAAGGTTGCCGAATT-1_V12D07-332_B1,0,1,0,0,1,2
AGGACGACCCATTAGA-1_V12D07-332_B1,4,0,0,1,1,6
GGTGCTGGTACACATT-1_V12D07-332_B1,0,1,0,0,0,1
GCGCTATGCCGAGGCA-1_V12D07-332_B1,0,1,0,0,1,2
ACCCGGTTACACTTCC-1_V12D07-332_B1,4,1,0,0,0,5
TAACTCATCCGCGCGG-1_V12D07-332_B1,1,1,0,0,0,2
CACAATGAGCTGCTAT-1_V12D07-332_B1,0,1,0,0,0,1
GTTACTTTGGGCCTAG-1_V12D07-332_B1,4,0,0,0,0,4
GGGCCCGTCTTAAACA-1_V12D07-332_B1,0,0,1,0,0,1
GAAATTGTCTCTATAA-1_V12D07-332_B1,0,2,0,0,0,2
GGCGCATGAATTGATG-1_V12D07-332_B1,0,1,2,0,0,3
CATATAGGTACAGTCA-1_V12D07-332_B1,0,1,3,0,0,4
TCAACGAGGAGACAAA-1_V12D07-332_B1,0,0,0,1,0,1
TTGCACAATTCAGAAA-1_V12D07-332_B1,1,1,1,0,0,3
CATCGGACGGGTTAAT-1_V12D07-332_B1,0,2,1,0,0,3
ATTAAACATGCGGACC-1_V12D07-332_B1,0,1,0,0,0,1
TATCTACCACAGCGGG-1_V12D07-332_B1,0,1,2,0,0,3
CGAGACCCTAGAGTGT-1_V12D07-332_B1,1,0,0,0,0,1
ACATCGATCGTTTACC-1_V12D07-332_B1,0,4,0,0,0,4
ATCGACCCAATACAGA-1_V12D07-332_B1,0,3,1,0,0,4
GAATCTGAACATTCTC-1_V12D07-332_B1,0,0,0,0,1,1
AGTTCCTATTTATGTT-1_V12D07-332_B1,0,0,0,0,1,1
CAGTCTGTATACTGGG-1_V12D07-332_B1,0,9,0,0,0,9
GGAGACGACACCTTTG-1_V12D07-332_B1,0,0,0,1,1,2
CCTAAATTAACGGTTC-1_V12D07-332_B1,0,5,0,0,1,6
GCTACGACTTATTGGG-1_V12D07-332_B1,0,0,0,0,0,0
CTGTGCAGGGTAGGTC-1_V12D07-332_B1,0,0,0,0,1,1
ACGCCGCTAGACGACC-1_V12D07-332_B1,0,1,0,0,1,2
ACTTGACTCCCTCTTT-1_V12D07-332_B1,0,0,0,0,0,0
CGCCTCCCTCCTCTAT-1_V12D07-332_B1,1,1,0,0,3,5
CTAGATTTACGACGGC-1_V12D07-332_B1,2,0,1,0,2,5
GATGCTGTATTTCATC-1_V12D07-332_B1,0,1,0,0,1,2
TGCGTTTGTTGACACT-1_V12D07-332_B1,0,3,1,0,1,5
CGTGCCCTCCCGAAGA-1_V12D07-332_B1,2,1,0,0,0,3
ACTCTCTGACTTAGGT-1_V12D07-332_B1,0,0,0,0,1,1
CTGGGTAGGCAGTTAA-1_V12D07-332_B1,0,2,0,0,0,2
GTTTGGCCCAAGTTAT-1_V12D07-332_B1,0,1,0,0,0,1
GAATGTGGTCCGGATT-1_V12D07-332_B1,0,4,1,0,0,5
CCCAGTTAAGGCGCCG-1_V12D07-332_B1,1,4,0,1,0,6
CGGTACTAGAATCAAA-1_V12D07-332_B1,1,1,0,1,1,4
GCTTAATGTAACTAAC-1_V12D07-332_B1,0,0,0,0,0,0
AGGACAGTCGAATCCC-1_V12D07-332_B1,0,0,0,0,0,0
GACAGCCAGACCTGAC-1_V12D07-332_B1,0,1,1,0,2,4
GGCGAAATCTAACTTG-1_V12D07-332_B1,0,1,0,0,0,1
CTGGTAACACATAGAA-1_V12D07-332_B1,0,2,0,1,0,3
TAGCCATTTCAAAGTC-1_V12D07-332_B1,0,1,0,0,0,1
GGGATTTACCGCACCT-1_V12D07-332_B1,0,1,0,0,0,1
ATGCCATTTGCGACCA-1_V12D07-332_B1,0,2,0,0,0,2
GAATAGACGCGACCCA-1_V12D07-332_B1,1,2,0,0,0,3
TGTATGGCGCAGACAG-1_V12D07-332_B1,1,0,0,1,0,2
GGATGAAGATCGCTGA-1_V12D07-332_B1,0,1,1,1,0,3
CGACAATTTGATCTAA-1_V12D07-332_B1,0,0,0,0,0,0
AAAGTTGACTCCCGTA-1_V12D07-332_B1,0,2,0,0,0,2
CGCGGCTCAACTTGAA-1_V12D07-332_B1,0,2,0,0,0,2
CACGCGGAACTGTTGC-1_V12D07-332_B1,1,0,0,0,0,1
TCTTAGAGTGAACTCT-1_V12D07-332_B1,0,2,0,0,2,4
AGTCCATTGGCTGATG-1_V12D07-332_B1,0,5,0,0,1,6
TTAAGATAGGATTGAC-1_V12D07-332_B1,1,2,0,0,1,4
ACATCCTGGTAACTGT-1_V12D07-332_B1,2,0,0,0,1,3
CACCTTGGCGCCTTTG-1_V12D07-332_B1,0,0,0,1,0,1
GCTAGACCGTCTACTG-1_V12D07-332_B1,1,1,0,13,0,15
CGGCCCAGGTATATCC-1_V12D07-332_B1,0,0,0,9,0,9
GTCCATTACTGCTACG-1_V12D07-332_B1,0,1,0,3,0,4
GGGTTTAGGATAGGAT-1_V12D07-332_B1,0,1,0,0,0,1
TAATTAGGACATCCGT-1_V12D07-332_B1,1,2,0,1,0,4
GCTCCCAGTCGGTCCA-1_V12D07-332_B1,0,3,0,0,0,3
ATTCGTGCTATCTCTT-1_V12D07-332_B1,0,5,0,1,0,6
GTTAACTATGTTGTCA-1_V12D07-332_B1,0,0,0,0,0,0
GCTCCGCTCGCTTCAG-1_V12D07-332_B1,0,0,0,0,0,0
GCAACGGCTAGTTATG-1_V12D07-332_B1,1,0,0,0,0,1
AATCGCGCAGAGGACT-1_V12D07-332_B1,2,1,0,0,0,3
AGGTTACACCATGCCG-1_V12D07-332_B1,0,0,0,0,0,0
CGAGATTTCGCTCGGG-1_V12D07-332_B1,3,1,0,0,0,4
CGATAATACTCAGGTT-1_V12D07-332_B1,4,0,0,0,1,5
AAGGCAGGCTGTCTCC-1_V12D07-332_B1,6,1,0,0,1,8
GTAAGTCCACACTCTA-1_V12D07-332_B1,5,1,0,0,0,6
ATGAGGGCAGCGGCTA-1_V12D07-332_B1,3,3,0,0,1,7
GCCGCACTCCGTTTCA-1_V12D07-332_B1,1,0,0,0,0,1
GAGCACGGCGCCTCTT-1_V12D07-332_B1,1,1,0,0,2,4
ACAATTTGGCCATATT-1_V12D07-332_B1,1,0,0,0,0,1
CTGGTTCGCGAGCTAC-1_V12D07-332_B1,2,1,0,0,0,3
GACGGTCCTAGGGTGT-1_V12D07-332_B1,0,0,0,0,0,0
ACTCGCGATCTGACGC-1_V12D07-332_B1,1,0,0,0,0,1
GTGTACGAACCGTTCC-1_V12D07-332_B1,1,1,0,1,0,3
CAGTCGGCCTAGATAT-1_V12D07-332_B1,3,2,0,0,1,6
CCCGTGAGGGCGGTGA-1_V12D07-332_B1,9,1,0,0,1,11
TCTCGTGTTACGAGGA-1_V12D07-332_B1,5,3,0,0,0,8
ACGTCTCGTTCCGGGA-1_V12D07-332_B1,1,1,0,0,2,4
CGAGAGCGCGTAGATA-1_V12D07-332_B1,4,2,0,0,0,6
GACAGATTTCTGGCTC-1_V12D07-332_B1,3,2,0,0,4,9
GGGCCTAAATGGGCTA-1_V12D07-332_B1,4,1,0,0,2,7
ACTTGTAGTCCCTTCA-1_V12D07-332_B1,5,4,0,0,1,10
CCCGAAGTTTCGCGAA-1_V12D07-332_B1,8,4,0,0,3,15
ACCATCCGCCAACTAG-1_V12D07-332_B1,4,3,0,0,2,9
TGCGAATATGGGATTT-1_V12D07-332_B1,2,3,0,0,1,6
TACATCCCTATCCCTG-1_V12D07-332_B1,2,0,0,0,0,2
GTGGGAAGACTGAATC-1_V12D07-332_B1,1,0,0,0,2,3
TCAACATCGACCGAGA-1_V12D07-332_B1,3,0,0,0,1,4
CTATGTGAGTCACGGC-1_V12D07-332_B1,1,0,0,0,0,1
CCGAACACTGGGCCTC-1_V12D07-332_B1,4,2,0,0,0,6
AAACTTGCAAACGTAT-1_V12D07-332_B1,1,0,0,0,1,2
AGGGCGAGCAGCTGAT-1_V12D07-332_B1,4,0,0,0,0,4
AACACGAGACGCGGCC-1_V12D07-332_B1,0,3,0,0,1,4
TGACGAATATTTCCCT-1_V12D07-332_B1,2,1,0,0,2,5
TCGGAGAGTATCGGGA-1_V12D07-332_B1,1,1,1,0,0,3
CAAATCTCTCACAAGG-1_V12D07-332_B1,0,0,1,0,0,1
AGGCCCTAGAACGCCA-1_V12D07-332_B1,0,0,0,0,0,0
TAGAGATCATGCAACT-1_V12D07-332_B1,4,0,0,0,0,4
TTGTTTCCATACAACT-1_V12D07-332_B1,0,1,0,0,0,1
GAGAGGTGCATTCTGG-1_V12D07-332_B1,2,1,0,1,0,4
GTGGACCAACCCGATT-1_V12D07-332_B1,1,1,0,1,0,3
CTGGGCCTGCTATATC-1_V12D07-332_B1,0,0,0,0,0,0
CATAGTCCACAAGAAC-1_V12D07-332_B1,0,0,0,0,0,0
TTGACATGAACGTGGA-1_V12D07-332_B1,1,0,0,0,1,2
GGTTACCACCCTCGGG-1_V12D07-332_B1,0,1,0,0,0,1
TACCGGTCGTTTCCAT-1_V12D07-332_B1,2,1,1,0,1,5
CGAGTACTAAAGAGGA-1_V12D07-332_B1,0,0,0,0,0,0
GCAAGAATTCCTTGGC-1_V12D07-332_B1,0,0,0,1,0,1
TCGCCGAAGTTGCGTC-1_V12D07-332_B1,0,0,0,0,0,0
TTGAGAGTACTGCTAA-1_V12D07-332_B1,0,2,0,0,0,2
GCCACAATTTAAGGAC-1_V12D07-332_B1,0,0,1,0,0,1
ATATTCAGTTAAACCT-1_V12D07-332_B1,2,1,1,0,0,4
TGAGTGCCTCTTAAAT-1_V12D07-332_B1,1,0,0,0,0,1
ATCAGACGGCACGCCG-1_V12D07-332_B1,1,1,0,0,0,2
GTGCGAAATCGAACAC-1_V12D07-332_B1,1,0,0,0,0,1
GTGCCGCTTCAAAGGT-1_V12D07-332_B1,0,0,0,0,1,1
GATACGATGGGAGTCA-1_V12D07-332_B1,1,0,0,0,1,2
GACACTGAGTTCAGTG-1_V12D07-332_B1,1,1,1,0,0,3
ATCCTGCGTGGAATGG-1_V12D07-332_B1,0,1,1,0,0,2
ATCCTACCTAAGCTCT-1_V12D07-332_B1,0,0,0,0,0,0
AGTGATATGAGTAGTT-1_V12D07-332_B1,1,1,0,0,0,2
ATGATGCAATGGTACA-1_V12D07-332_B1,1,0,0,1,0,2
GAAACCGAATTACCTT-1_V12D07-332_B1,3,0,0,0,1,4
AGTGACCTACTTTACG-1_V12D07-332_B1,2,0,0,0,0,2
CAAATGTCCTTCCGTG-1_V12D07-332_B1,0,1,0,0,1,2
TTACTGGGATATTTCA-1_V12D07-332_B1,1,0,1,0,1,3
CTTGCCCAGGCTCTAC-1_V12D07-332_B1,1,0,0,0,0,1
AAATCGTGTACCACAA-1_V12D07-332_B1,2,0,1,0,0,3
GTGATCATAGATCTGC-1_V12D07-332_B1,0,0,0,0,0,0
TGGCAGATTACGATCA-1_V12D07-332_B1,1,0,2,0,0,3
TCACCCTCTTAAGATT-1_V12D07-332_B1,0,0,1,0,0,1
CAGGATATATCGTTGT-1_V12D07-332_B1,0,0,4,0,0,4
CCTGACCACCGATGGT-1_V12D07-332_B1,1,0,1,0,0,2
CTAAAGGGAAATAGGA-1_V12D07-332_B1,1,1,1,0,0,3
CCGCTATCAGCACCAG-1_V12D07-332_B1,0,0,0,0,0,0
CTTTAGTGCTATTATT-1_V12D07-332_B1,0,1,0,0,0,1
CGGGAATTTATGTAAA-1_V12D07-332_B1,0,2,0,0,0,2
TACGACTGCCTCTTAG-1_V12D07-332_B1,0,0,1,1,0,2
AAACTGCTGGCTCCAA-1_V12D07-332_B1,0,0,0,0,0,0
GTACGTTTGCCCGTCA-1_V12D07-332_B1,0,3,0,0,0,3
GGCAAGGCGAAATAGC-1_V12D07-332_B1,0,1,0,0,0,1
GATCTTGGAGGGCATA-1_V12D07-332_B1,3,0,0,2,0,5
AGCGTGGTATTCTACT-1_V12D07-332_B1,0,0,1,0,1,2
CTAAGGGAATGATTGG-1_V12D07-332_B1,0,2,0,0,0,2
CATGGTAAGTAGCGTT-1_V12D07-332_B1,0,2,0,0,0,2
CGTTGAGCGACCGTCG-1_V12D07-332_B1,2,1,1,1,1,6
TGCCCGTACCGTTAAA-1_V12D07-332_B1,0,0,0,0,0,0
ACAAGGGCAGGCTCTG-1_V12D07-332_B1,0,1,0,0,1,2
GAGATCTTCCATGACA-1_V12D07-332_B1,0,1,0,0,0,1
AATGACGTAGGATGTC-1_V12D07-332_B1,0,0,1,0,0,1
GTGGTGGCCAAGTGAA-1_V12D07-332_B1,2,3,1,0,0,6
TCCCGTGTGCAATTTG-1_V12D07-332_B1,0,1,0,0,1,2
ACATCGTATGCAATGG-1_V12D07-332_B1,1,1,0,0,0,2
GCGAAACTTAACTGGA-1_V12D07-332_B1,0,1,0,0,0,1
AATTGAACGCTCTGGT-1_V12D07-332_B1,0,3,1,0,1,5
ACAAATGGTAGTGTTT-1_V12D07-332_B1,0,0,0,0,1,1
ATGGTCGCGTGGTTTC-1_V12D07-332_B1,0,2,1,0,1,4
TGTTATTGTATGTGGC-1_V12D07-332_B1,0,0,0,0,0,0
TTCCGGTTACCCACTT-1_V12D07-332_B1,0,0,0,0,0,0
GAGTGTGCGGTACCCA-1_V12D07-332_B1,1,2,0,0,0,3
CAAGATATTATAACGT-1_V12D07-332_B1,0,1,0,0,0,1
ACACACCAGGACCAGT-1_V12D07-332_B1,1,1,0,1,0,3
ATGGGCCTCGGCCTCT-1_V12D07-332_B1,1,3,0,0,0,4
AAGGTGATAAACCAGC-1_V12D07-332_B1,2,3,1,0,1,7
TCTTACTTATGCCTCT-1_V12D07-332_B1,0,3,0,0,2,5
AAAGTGTGATTTATCT-1_V12D07-332_B1,0,1,0,0,1,2
TGCTCCACAGTTCTTA-1_V12D07-332_B1,0,2,0,0,0,2
CTGGCTGATTCATCCT-1_V12D07-332_B1,0,2,1,0,0,3
TAAGGCTGAATCCCTC-1_V12D07-332_B1,0,3,1,0,1,5
TCTAGTGATATCGTGG-1_V12D07-332_B1,0,1,0,0,0,1
TCGAAGAACCGAGCAC-1_V12D07-332_B1,0,3,0,0,0,3
GACAAACATATGCAGG-1_V12D07-332_B1,2,6,1,0,1,10
AAGTCAATTGTCGTCA-1_V12D07-332_B1,2,0,0,0,0,2
AGTGAACAAACTTCTC-1_V12D07-332_B1,0,3,0,0,1,4
CATGATGGAAGTTAGC-1_V12D07-332_B1,1,1,0,1,1,4
AAGTGCCTTGACTGTA-1_V12D07-332_B1,0,2,0,1,1,4
ATCGCCAGTCAACATT-1_V12D07-332_B1,1,1,0,12,0,14
ACCGCGGTGGAAGTCG-1_V12D07-332_B1,0,0,0,13,0,13
TCTTCTATAACCCGCC-1_V12D07-332_B1,0,2,0,7,0,9
CACATTTCTTGTCAGA-1_V12D07-332_B1,1,1,0,1,0,3
TAGCGTCCCTCGATTG-1_V12D07-332_B1,0,4,0,0,1,5
GTTCGGATCGGGAACA-1_V12D07-332_B1,0,0,0,0,0,0
CAAACTCGCGACGCCG-1_V12D07-332_B1,0,0,0,0,0,0
GTCTTGTAGCTATTCA-1_V12D07-332_B1,2,1,0,0,0,3
TCTCGACGTATCGCCG-1_V12D07-332_B1,1,0,0,0,0,1
TTGCCAAGCAGAACCC-1_V12D07-332_B1,0,4,0,0,1,5
AAACCCGAACGAAATC-1_V12D07-332_B1,6,0,0,0,0,6
TTGAGCAGCCCACGGT-1_V12D07-332_B1,2,3,1,0,1,7
CGCCTTTAGCATGCTC-1_V12D07-332_B1,1,0,1,0,0,2
TGTGGCTCCCACCAAC-1_V12D07-332_B1,6,1,0,0,1,8
CCGCCGTTGAGGATAA-1_V12D07-332_B1,3,1,0,0,1,5
CAATACGAGAGTCTGA-1_V12D07-332_B1,2,2,0,0,0,4
CATCTAGTGAAGGGAA-1_V12D07-332_B1,4,0,0,0,0,4
GGTGGAGGTTGATACG-1_V12D07-332_B1,2,1,0,0,0,3
CCGCACACGAACGTGT-1_V12D07-332_B1,1,1,0,0,0,2
AGAACCCAGCGTGACA-1_V12D07-332_B1,0,1,0,0,0,1
GCGCTCGATCACCTGT-1_V12D07-332_B1,1,2,0,1,0,4
ATCATGGACTACCGAC-1_V12D07-332_B1,0,1,0,0,0,1
TACGCCGCCTCAGAAG-1_V12D07-332_B1,3,4,0,0,0,7
ACAAAGAAGGTAGGCC-1_V12D07-332_B1,3,5,0,0,1,9
CCCTGGCTGTTCCTTC-1_V12D07-332_B1,5,1,0,0,1,7
TCGCCGCACCGCGTGA-1_V12D07-332_B1,6,0,0,0,0,6
TATAGCGCACGTTATC-1_V12D07-332_B1,1,6,0,0,0,7
TTATCTGACATTAGGA-1_V12D07-332_B1,1,4,0,0,0,5
AGTGGTGTTACCCGTG-1_V12D07-332_B1,4,1,0,0,5,10
GCCAAGAATACTTCTG-1_V12D07-332_B1,5,7,0,0,2,14
CCGGCGTGAGACTCTG-1_V12D07-332_B1,4,5,0,0,3,12
TTCCCGGCGCCAATAG-1_V12D07-332_B1,2,9,0,0,1,12
AAACAGGGTCTATATT-1_V12D07-332_B1,2,5,0,0,0,7
ACAGTAATACAACTTG-1_V12D07-332_B1,4,1,0,0,1,6
CGAACGGCCGGACAAC-1_V12D07-332_B1,2,0,0,0,0,2
GCAACACACTAGAACT-1_V12D07-332_B1,3,3,0,0,1,7
ACTCCCATTCCTAAAG-1_V12D07-332_B1,3,1,0,0,1,5
ACCTGCGTGTCATGTT-1_V12D07-332_B1,2,1,0,0,0,3
TACTTTCCGCACGCCA-1_V12D07-332_B1,6,1,0,0,0,7
AGGTCAGGTGAGAGTG-1_V12D07-332_B1,1,2,0,0,1,4
TCCTCCTAAGACATTC-1_V12D07-332_B1,2,0,0,0,0,2
ATGTGAAAGCCTAATG-1_V12D07-332_B1,1,0,0,0,0,1
AGTCGGCTCAACTTTA-1_V12D07-332_B1,2,1,0,0,0,3
CGATCTGTTGGAGGAC-1_V12D07-332_B1,0,0,0,0,0,0
ACGGGAGTGTCGGCCC-1_V12D07-332_B1,1,1,0,0,0,2
TTAACTTCAGGTAGGA-1_V12D07-332_B1,0,1,0,0,1,2
CCACGGAGCCATAAGA-1_V12D07-332_B1,1,1,0,1,0,3
CTTCTATGTTGAAGTA-1_V12D07-332_B1,0,1,0,0,2,3
CACCGTTGCGCGATAT-1_V12D07-332_B1,0,0,0,2,0,2
TCTAGCAATCTCCGCC-1_V12D07-332_B1,0,1,0,0,0,1
AGTTTGGCCAGACCTA-1_V12D07-332_B1,0,0,0,0,0,0
TTGTAAGGACCTAAGT-1_V12D07-332_B1,0,1,0,0,0,1
AAATTTGCGGGTGTGG-1_V12D07-332_B1,0,0,0,0,0,0
AAGTTCGGCCAACAGG-1_V12D07-332_B1,0,1,2,0,0,3
CCGCTTACCTCACTCT-1_V12D07-332_B1,1,0,0,0,0,1
ATCACGTGCTAATTAA-1_V12D07-332_B1,0,0,0,0,1,1
GGTGAAGTACAGGGAT-1_V12D07-332_B1,2,0,1,0,0,3
GCTGTATTACTGGCCC-1_V12D07-332_B1,3,2,1,0,0,6
AACGGCCATCTCCGGT-1_V12D07-332_B1,0,1,0,0,0,1
TAAGTAACATCTTGAC-1_V12D07-332_B1,0,2,0,0,0,2
TTCTTGAGCCGCGCTA-1_V12D07-332_B1,2,1,0,0,0,3
AGTGCGTAGCTCGTAA-1_V12D07-332_B1,0,0,0,0,0,0
GGGATGGTCGTAACCG-1_V12D07-332_B1,1,1,0,0,0,2
GTCTGGGCGGTCGAGA-1_V12D07-332_B1,2,0,0,0,0,2
CGGAACGTAAACATAG-1_V12D07-332_B1,2,3,0,0,0,5
TGCGACACCCTAGTGC-1_V12D07-332_B1,2,0,0,0,0,2
CAAACGAGTATCGCAG-1_V12D07-332_B1,2,1,0,0,0,3
TCAGTAGGGACTATAA-1_V12D07-332_B1,2,1,0,0,0,3
GCGGTTCCCTATCATG-1_V12D07-332_B1,1,0,0,0,0,1
GTGACTTCAGTAGTGC-1_V12D07-332_B1,2,1,0,0,2,5
CGTCACGTCCATTGGT-1_V12D07-332_B1,2,0,1,0,0,3
ATAAGTTACCGCGACG-1_V12D07-332_B1,1,0,0,0,1,2
CTGAATCCGAGACCTC-1_V12D07-332_B1,3,0,1,0,0,4
TACGACGCTTGCTGCG-1_V12D07-332_B1,1,0,0,0,0,1
GAATTCACCCGGGTGT-1_V12D07-332_B1,2,0,1,0,0,3
GGGTGACACCTTAACT-1_V12D07-332_B1,0,3,1,0,0,4
TGAGTAAATTAGCGTA-1_V12D07-332_B1,1,3,0,0,0,4
GAGTCCGCTTACCGGA-1_V12D07-332_B1,1,0,0,0,0,1
GGCGCGTTCGAGTTTA-1_V12D07-332_B1,2,0,0,0,0,2
ATTCATATACTGTCCA-1_V12D07-332_B1,2,5,0,0,0,7
ATAAACGGACCCGTAA-1_V12D07-332_B1,1,0,0,0,0,1
GTCGTACCATCTCGGG-1_V12D07-332_B1,2,0,0,2,0,4
ATAATAGCTGTTGAAT-1_V12D07-332_B1,0,2,0,14,0,16
TTCCGCGTGAGGCGAT-1_V12D07-332_B1,0,0,0,1,0,1
TACCGGCTCACTGCCC-1_V12D07-332_B1,0,1,1,5,0,7
GTATCTTTCATAACCA-1_V12D07-332_B1,0,0,0,0,0,0
GTTACCTACAACTTGC-1_V12D07-332_B1,0,1,0,0,1,2
TGACTATAATCCTTTC-1_V12D07-332_B1,0,2,1,0,0,3
AAATACCTATAAGCAT-1_V12D07-332_B1,0,1,0,1,0,2
TTATTAGAGCGTGTTC-1_V12D07-332_B1,0,1,0,0,0,1
ATGTGGACATCTTGAT-1_V12D07-332_B1,0,2,0,1,1,4
GTACGCTTCATTGCAC-1_V12D07-332_B1,0,2,0,0,0,2
CACATATTAGCAGGAT-1_V12D07-332_B1,0,2,1,0,0,3
CAAGAGGGCGGAGTAC-1_V12D07-332_B1,1,4,0,0,0,5
TCGCAAAGATGCATTT-1_V12D07-332_B1,0,1,0,0,1,2
GTCGTTATTCGCTTAT-1_V12D07-332_B1,5,0,0,1,0,6
TCGTGTACTATGGATG-1_V12D07-332_B1,1,1,0,0,0,2
GCGGAGAGGGAGAACG-1_V12D07-332_B1,1,1,1,0,0,3
TCACAGGGAATCGCAA-1_V12D07-332_B1,0,1,0,0,0,1
GACTGCACCAGCCCAG-1_V12D07-332_B1,1,2,0,0,0,3
TCCGCTGTCATCCCGG-1_V12D07-332_B1,0,3,0,0,0,3
AGATACTCAAGATCGA-1_V12D07-332_B1,1,2,0,0,0,3
ACTGAATGGCGAAAGT-1_V12D07-332_B1,0,1,0,1,2,4
TCCTACATCCACGGCC-1_V12D07-332_B1,0,0,0,0,1,1
TTCAGCCCTGGTCCAC-1_V12D07-332_B1,2,2,0,0,1,5
TTAGAGTTTAGAAGGA-1_V12D07-332_B1,1,4,0,0,1,6
GGTTAGCTATATGTCT-1_V12D07-332_B1,0,0,0,0,0,0
CTGGTTTCGAGCAAGA-1_V12D07-332_B1,0,0,0,0,1,1
TGGGCCCATACTAATT-1_V12D07-332_B1,0,0,0,0,1,1
ACTTATTTATGTGCCA-1_V12D07-332_B1,1,2,0,0,0,3
TTAGTTATTCGTGGCA-1_V12D07-332_B1,0,0,0,0,1,1
AACCGCTAAGGGATGC-1_V12D07-332_B1,0,0,0,0,2,2
ATACGTCCACTCCTGT-1_V12D07-332_B1,0,0,0,0,0,0
CGACACGCTCCGACAG-1_V12D07-332_B1,1,1,0,0,0,2
TCTGAACTCGTACCCG-1_V12D07-332_B1,0,2,0,0,0,2
AGGATATAGGGATTTA-1_V12D07-332_B1,2,3,0,0,0,5
GTGATCACTAACGCCT-1_V12D07-332_B1,0,1,1,0,0,2
ACCGGGCCTTTGTTGA-1_V12D07-332_B1,0,2,0,0,0,2
TTGACAGGAGCTCCCG-1_V12D07-332_B1,1,1,0,0,0,2
CTCTTCTATTGACTGG-1_V12D07-332_B1,0,1,0,1,3,5
CGTGGCCGAATATCTA-1_V12D07-332_B1,0,1,0,0,1,2
GGTTTAGCCTTTCTTG-1_V12D07-332_B1,0,0,0,0,0,0
TCAAGGTTACTACACC-1_V12D07-332_B1,0,0,0,0,0,0
TTGACTATTGTCCGGC-1_V12D07-332_B1,1,1,0,1,0,3
CGGGAATATAGTATAC-1_V12D07-332_B1,0,2,1,1,0,4
GCAACAGCAGTATGCG-1_V12D07-332_B1,1,0,0,13,0,14
ATCAAACACTGTTCCA-1_V12D07-332_B1,0,1,0,13,0,14
TGGGCAATAGTTGGGT-1_V12D07-332_B1,0,0,0,7,0,7
TGAATGTCAGCCGGCC-1_V12D07-332_B1,0,1,0,2,0,3
CGGCTCTAAAGCTGCA-1_V12D07-332_B1,0,0,0,0,0,0
GGACACAAGTTTACAC-1_V12D07-332_B1,0,4,0,0,0,4
CCGAGAAGTCGCATAA-1_V12D07-332_B1,0,1,1,0,0,2
AACTACCCGTTTGTCA-1_V12D07-332_B1,1,0,0,0,0,1
GCACAAACGAGGCGTG-1_V12D07-332_B1,1,3,1,0,0,5
CACACAGCTTGCGCTC-1_V12D07-332_B1,1,1,0,0,2,4
GTGCTTACATCAGCGC-1_V12D07-332_B1,0,1,0,0,0,1
GCAAACGTCGCCAGGT-1_V12D07-332_B1,3,1,0,0,0,4
GAATAGCATTTAGGGT-1_V12D07-332_B1,2,2,0,0,0,4
TACTGTTTCTCTGGTA-1_V12D07-332_B1,1,2,0,0,0,3
TCCTATCATAGGTAAC-1_V12D07-332_B1,3,1,0,0,0,4
TTCGGTGGAGACGCCC-1_V12D07-332_B1,1,2,0,0,0,3
TGTTGCCGTCGTCCCA-1_V12D07-332_B1,2,2,0,0,2,6
CCAACTTGATAGATCC-1_V12D07-332_B1,2,2,0,0,0,4
CAAAGGTCATCTGAAA-1_V12D07-332_B1,0,2,0,1,2,5
CTAGCTTAATGGTCCC-1_V12D07-332_B1,2,4,0,0,0,6
AGGCCACATTGGTTAC-1_V12D07-332_B1,0,0,0,0,0,0
TTAGGATGGGAGGGTA-1_V12D07-332_B1,0,0,0,0,0,0
AGATGCATCCTGTGTC-1_V12D07-332_B1,0,6,0,0,0,6
GTGAAGTCACGACTCG-1_V12D07-332_B1,2,7,0,14,1,24
TGATTCAGGTCCCGCG-1_V12D07-332_B1,4,1,0,0,0,5
CGCCACAGGTCGCGAT-1_V12D07-332_B1,6,1,0,1,1,9
TTGAATCGTTGTATAA-1_V12D07-332_B1,3,6,0,0,2,11
TGGCCAATTTGGTACT-1_V12D07-332_B1,5,3,0,0,3,11
CGACCCTTAACGCCGG-1_V12D07-332_B1,1,12,0,0,4,17
TCGGCGTACTGCACAA-1_V12D07-332_B1,1,5,0,0,1,7
GAGTAAGGCCACGGGA-1_V12D07-332_B1,3,1,0,0,0,4
ATCAGCTCGTCCACTA-1_V12D07-332_B1,6,1,0,0,0,7
AGGATCACGCGATCTG-1_V12D07-332_B1,2,0,0,0,0,2
AAATGGCCCGTGCCCT-1_V12D07-332_B1,3,0,0,0,0,3
CAGTACCAGTTTACGT-1_V12D07-332_B1,2,0,0,0,1,3
GGTCGTAAGCTCGCAC-1_V12D07-332_B1,2,1,0,0,0,3
CGTTCATGGTGCGCGT-1_V12D07-332_B1,1,1,0,0,1,3
GACTACAAAGCGGTGG-1_V12D07-332_B1,4,0,0,0,0,4
CAGCTGGCGTAACCGT-1_V12D07-332_B1,1,0,0,0,0,1
ACTCGTAACCCGTCCT-1_V12D07-332_B1,0,0,0,0,0,0
CATATGTCAGGCTACG-1_V12D07-332_B1,2,0,0,0,1,3
GCCCGACTTCTTCCCG-1_V12D07-332_B1,1,1,1,0,0,3
CTGGCATCCGAATGAG-1_V12D07-332_B1,1,1,0,1,0,3
AAGTGCGTTAGAATCT-1_V12D07-332_B1,1,1,0,0,0,2
AGAAGTGATTCGTGAT-1_V12D07-332_B1,2,1,1,0,0,4
TACCTTAAGATTTCCC-1_V12D07-332_B1,0,1,0,0,1,2
AATGACAGCAATGTCT-1_V12D07-332_B1,0,2,0,1,0,3
TCAACGCAGGAAATAA-1_V12D07-332_B1,1,1,0,0,0,2
TATTCCTCCGCCCACT-1_V12D07-332_B1,1,0,0,3,1,5
ATCAAACGAAGGTTTG-1_V12D07-332_B1,0,0,0,2,0,2
TTGATTAGCTGTTTCT-1_V12D07-332_B1,0,0,0,1,0,1
CTGCTGAGGCCACGAA-1_V12D07-332_B1,0,1,0,0,0,1
CCGTGTTAAATTCCAT-1_V12D07-332_B1,0,0,0,0,0,0
CACGTCGGCAACCTCT-1_V12D07-332_B1,0,0,1,0,0,1
GTATTCTGAGAAACGA-1_V12D07-332_B1,1,1,2,0,0,4
CGGTGCGCGTTGGTCC-1_V12D07-332_B1,1,0,0,0,0,1
GTGATTCGCCGCTCAA-1_V12D07-332_B1,0,0,0,0,0,0
GCCCGCGCGTAAACGG-1_V12D07-332_B1,3,1,0,0,2,6
AACGTACTGTGGGTAC-1_V12D07-332_B1,2,1,0,0,0,3
GAGTATGCCCGCCTTG-1_V12D07-332_B1,1,2,1,0,0,4
TGATTCTGTCGCCGGT-1_V12D07-332_B1,1,2,0,0,0,3
GGGCGGCAAATGAATT-1_V12D07-332_B1,2,0,0,0,0,2
TTCCAATCTGGCTATC-1_V12D07-332_B1,2,0,0,0,0,2
GGAACCGTGTAAATTG-1_V12D07-332_B1,0,0,2,0,0,2
TTGGTCACACTCGTAA-1_V12D07-332_B1,1,0,0,1,0,2
CGAACCCGCATGCGTC-1_V12D07-332_B1,0,2,1,0,0,3
GGGCGTCACCACGTAA-1_V12D07-332_B1,3,1,1,0,1,6
TACCAGAAGTAGGTTC-1_V12D07-332_B1,0,0,2,0,0,2
TTGGATATCGTCTACG-1_V12D07-332_B1,0,3,1,0,0,4
TAGATATGGACTGGAA-1_V12D07-332_B1,3,0,2,0,1,6
GCGACGATAGTTGTAC-1_V12D07-332_B1,0,0,0,0,1,1
CTGGATTTACACTTGA-1_V12D07-332_B1,3,0,3,0,0,6
GTTATATTATCTCCCT-1_V12D07-332_B1,1,0,1,0,0,2
TATTCCACTCAGCTCG-1_V12D07-332_B1,1,1,1,0,1,4
CTGTTACCCAATCTAG-1_V12D07-332_B1,2,0,0,0,0,2
ACGCGAAGTCAGACGA-1_V12D07-332_B1,1,2,0,0,0,3
GATAGGTAACGTTGAC-1_V12D07-332_B1,1,3,0,0,0,4
TGTTCGTATTGCGGTG-1_V12D07-332_B1,0,0,0,0,0,0
GGTCAGTGGGTCCCAC-1_V12D07-332_B1,1,0,0,3,1,5
AATTCTAGAGTTAGGC-1_V12D07-332_B1,1,0,0,0,0,1
GTTTACGTTCCATCTG-1_V12D07-332_B1,0,1,0,5,0,6
AGACCCACCGCTGATC-1_V12D07-332_B1,0,0,0,4,0,4
TCTAGCATGCCCAGAA-1_V12D07-332_B1,0,0,0,17,1,18
CCCGCAGCGCGAACTA-1_V12D07-332_B1,1,0,0,5,0,6
CTCTATTTGGCTGCAG-1_V12D07-332_B1,0,6,1,3,2,12
TTCTGCCGCGCCTAGA-1_V12D07-332_B1,0,0,0,15,0,15
ACTCCCTAGAATAGTA-1_V12D07-332_B1,3,0,0,1,0,4
CCGAACCTTCCCGGCC-1_V12D07-332_B1,0,3,0,4,1,8
TCAGACGCTATAGAAG-1_V12D07-332_B1,0,3,0,0,0,3
CAGGCGCCATGCTAGG-1_V12D07-332_B1,1,2,0,1,0,4
CACTCGAGCTGAACAA-1_V12D07-332_B1,1,0,0,1,0,2
ACAAGGAAATCCGCCC-1_V12D07-332_B1,2,1,0,1,1,5
ACCACGTGCAGCTATA-1_V12D07-332_B1,0,3,0,0,0,3
ACGGCGACGATGGGAA-1_V12D07-332_B1,1,2,0,0,0,3
TTACTAAAGGACTTTA-1_V12D07-332_B1,0,0,0,0,0,0
GGCTGAAATAGCAAAG-1_V12D07-332_B1,0,1,0,0,0,1
TTAGACGAGTCACCTC-1_V12D07-332_B1,2,7,0,0,1,10
GTAGTCGCGGGAATCA-1_V12D07-332_B1,0,8,0,0,1,9
GCAAACCCTACATTAT-1_V12D07-332_B1,0,2,0,0,0,2
GTTAAAGTAGGACTGG-1_V12D07-332_B1,1,2,0,0,0,3
ACCCTCCCTTGCTATT-1_V12D07-332_B1,0,2,0,0,1,3
CATGTCTCATTTATGG-1_V12D07-332_B1,1,2,0,0,0,3
AATAGAATCTGTTTCA-1_V12D07-332_B1,0,3,0,0,0,3
TCTCATGAGATAGGGT-1_V12D07-332_B1,1,0,0,0,0,1
ATGACTATGCGACATT-1_V12D07-332_B1,0,2,0,0,0,2
CCTAACCCAAACAAGT-1_V12D07-332_B1,1,1,0,0,0,2
AGTCAAGATGACACTT-1_V12D07-332_B1,3,1,0,1,0,5
CGGGAGCTTCAGTGTA-1_V12D07-332_B1,0,4,0,0,1,5
CCACAGTACCCATCCT-1_V12D07-332_B1,2,1,1,1,1,6
GAGCGCGCACGAGTAG-1_V12D07-332_B1,0,2,1,0,1,4
ACCAGTGCGGGAGACG-1_V12D07-332_B1,0,1,0,0,0,1
TCCTTACGACGGTCCG-1_V12D07-332_B1,0,2,0,0,0,2
TAGTCGATCACGGGTT-1_V12D07-332_B1,1,1,0,0,0,2
AGACGAAGTGCCGGTC-1_V12D07-332_B1,0,1,0,0,0,1
CGCTGGTGACTACCCT-1_V12D07-332_B1,0,1,0,0,0,1
AGGCATTGTCGTAGGG-1_V12D07-332_B1,1,1,0,1,0,3
TGGTAGAATATATGGG-1_V12D07-332_B1,0,1,2,0,0,3
TTCTTATCCGCTGGGT-1_V12D07-332_B1,1,1,0,0,0,2
AGTTTGGCACGGGTTG-1_V12D07-332_B1,2,0,0,0,1,3
GCATCGGCCGTGTAGG-1_V12D07-332_B1,2,0,0,0,1,3
ATGCGAGTCCCACCAC-1_V12D07-332_B1,0,2,0,0,1,3
TCGGCGAACCCAAACC-1_V12D07-332_B1,1,0,0,1,0,2
AGAGTAAACTTCACTA-1_V12D07-332_B1,0,0,0,8,1,9
AAGCCGAAGCGGTTTA-1_V12D07-332_B1,1,2,0,4,1,8
CCCGAGTTTCTCCGTA-1_V12D07-332_B1,1,1,0,14,0,16
AATATCGAATCAATGC-1_V12D07-332_B1,0,0,0,11,0,11
GCGCCTCCCACTCCGA-1_V12D07-332_B1,0,1,0,0,0,1
CGTTAAACTAGTTAGG-1_V12D07-332_B1,0,0,0,0,0,0
TGAGTTAAAGACATTC-1_V12D07-332_B1,1,0,0,0,0,1
AACAGGTAGTATGGAT-1_V12D07-332_B1,1,0,0,0,0,1
GAACGCGGGTCACACG-1_V12D07-332_B1,1,1,0,0,0,2
TGTTTGAGATCGTCAG-1_V12D07-332_B1,1,0,0,0,0,1
ATCTCGTGAGCGAAAC-1_V12D07-332_B1,1,3,0,0,0,4
CTGAGAAAGTTCGGCG-1_V12D07-332_B1,6,1,0,0,2,9
ATTACCACACTGCCTG-1_V12D07-332_B1,6,1,0,0,0,7
CTGCTGTCTAACGAGC-1_V12D07-332_B1,2,1,0,0,0,3
CGTGGAAGCCTCGTAC-1_V12D07-332_B1,4,1,0,0,0,5
GGACTCACAAATTAGG-1_V12D07-332_B1,4,0,0,0,0,4
CTTTGCTGTCATGGAT-1_V12D07-332_B1,4,1,0,0,0,5
GGTGTTGGGCGTCTTA-1_V12D07-332_B1,4,0,0,0,0,4
TACCATGTATTGATTT-1_V12D07-332_B1,2,3,0,0,0,5
GGTCTCCAAGTAGTGC-1_V12D07-332_B1,2,0,1,0,0,3
ATCCTTCTGAAAGAAC-1_V12D07-332_B1,2,1,0,0,0,3
CCGGAAGTTATCAGTC-1_V12D07-332_B1,0,1,0,2,0,3
GGAGACCATCTACATA-1_V12D07-332_B1,1,2,0,19,0,22
AGACCAAACCACACCT-1_V12D07-332_B1,0,2,0,10,0,12
CGACGCATCCGTACCT-1_V12D07-332_B1,1,4,0,0,0,5
CCTAGGTAAAGGTAGC-1_V12D07-332_B1,1,3,0,0,0,4
AGCGGCGGTTAGCGGT-1_V12D07-332_B1,0,0,0,0,1,1
CTGGACGCAGTCCGGC-1_V12D07-332_B1,3,2,0,0,1,6
AGCCTAATACCCACGT-1_V12D07-332_B1,4,1,0,0,1,6
AATCTGGCTTTCTAGT-1_V12D07-332_B1,1,1,0,0,2,4
CACCCTTGGTGAGACC-1_V12D07-332_B1,2,4,0,0,0,6
GGATCTTGACTCAACC-1_V12D07-332_B1,3,1,1,0,1,6
ACGAGGATACCACTCT-1_V12D07-332_B1,5,1,0,0,0,6
GAGTTGATGGCAATTT-1_V12D07-332_B1,0,2,0,0,1,3
GTGGCAAACAGCGGCA-1_V12D07-332_B1,4,1,0,0,1,6
GATGTAACGAACCACC-1_V12D07-332_B1,2,1,0,0,0,3
AGCCGTGGCTAAATGT-1_V12D07-332_B1,0,3,0,0,0,3
CTCCCTCCTTTCGATC-1_V12D07-332_B1,0,1,0,0,1,2
TTGGAAGAATACAGTC-1_V12D07-332_B1,1,1,1,0,1,4
AGTTAAGTCAACCGCT-1_V12D07-332_B1,0,1,0,0,0,1
CTCATGGTAATTTGCG-1_V12D07-332_B1,0,0,0,0,0,0
AAAGTAGCATTGCTCA-1_V12D07-332_B1,0,0,0,0,2,2
TTGTGGTAGGAGGGAT-1_V12D07-332_B1,2,0,0,0,0,2
AGTCGTGGGCATTACG-1_V12D07-332_B1,1,2,0,0,0,3
ACCTAAGTACCTTTCA-1_V12D07-332_B1,2,4,1,0,0,7
GTAGAGGGAGACAAGT-1_V12D07-332_B1,0,0,0,1,0,1
GATCCTCGACACTGGC-1_V12D07-332_B1,0,2,0,0,1,3
CCTACATTCACAGACG-1_V12D07-332_B1,0,0,0,1,1,2
TTGACCGTGTTAATGA-1_V12D07-332_B1,0,1,0,2,1,4
TCTGTTACCCAGCATA-1_V12D07-332_B1,1,0,1,1,0,3
CTAACTGGTCCGGTTC-1_V12D07-332_B1,0,0,1,0,0,1
AGCGACAGGAACGGTC-1_V12D07-332_B1,0,0,0,0,0,0
TAATAGAACAGAGTTA-1_V12D07-332_B1,0,0,0,0,0,0
ACAGGTGGAGGTGAGG-1_V12D07-332_B1,1,0,0,0,0,1
TGCGAGAATATTACCC-1_V12D07-332_B1,0,0,0,0,0,0
TTGCGTCGGCCAACCG-1_V12D07-332_B1,1,0,0,0,0,1
AGGCTTCCCGAAGAAG-1_V12D07-332_B1,2,0,0,0,0,2
GCGGACCGCGTTGTGG-1_V12D07-332_B1,0,2,0,0,0,2
GTAATCTGATTCTTCG-1_V12D07-332_B1,2,0,0,0,0,2
CCGCGGAATGCGTCAC-1_V12D07-332_B1,2,1,0,0,1,4
TTCCACACAGATTTGA-1_V12D07-332_B1,2,0,0,0,0,2
CTTCTATTAATGCTAG-1_V12D07-332_B1,1,1,0,0,0,2
CATTTGAGTGGTACGT-1_V12D07-332_B1,0,0,0,0,0,0
TCACAGCAAACTCGAA-1_V12D07-332_B1,0,1,0,0,0,1
CAGACGAACCTGATAC-1_V12D07-332_B1,1,0,2,0,1,4
TAGCTAGAAGGCATGA-1_V12D07-332_B1,3,0,0,0,1,4
ATCCAGAGCAACAACC-1_V12D07-332_B1,1,0,0,0,0,1
TCCGGTTCGTCCGGTC-1_V12D07-332_B1,3,0,0,0,0,3
CGCGCATGTTTGATTG-1_V12D07-332_B1,2,1,0,0,0,3
TGGCGATCAAGTTATG-1_V12D07-332_B1,0,0,0,0,0,0
CCCTTTGACAGGTCTT-1_V12D07-332_B1,0,0,0,0,0,0
CAGAGACGGTCACCCA-1_V12D07-332_B1,1,0,0,0,0,1
TAGCTCGCCTGATAAC-1_V12D07-332_B1,0,3,0,0,0,3
TTGTGTTTCCCGAAAG-1_V12D07-332_B1,0,2,0,0,0,2
TATACACAGACGCCTT-1_V12D07-332_B1,2,2,0,0,0,4
ACATTAGTTTATATCC-1_V12D07-332_B1,0,0,0,0,0,0
CCATCGCAGTTAAACT-1_V12D07-332_B1,1,1,0,0,0,2
AATTAGCGCTGCAGCG-1_V12D07-332_B1,0,3,0,0,0,3
TCCGCTTATCCCATTA-1_V12D07-332_B1,0,0,0,0,0,0
GTTTGGGCTTGTGAGC-1_V12D07-332_B1,0,0,0,0,0,0
CTTGTCAACATTCGAG-1_V12D07-332_B1,0,4,0,0,0,4
GGACCAACAGGATAAC-1_V12D07-332_B1,0,0,0,0,1,1
AAGCTAGATCGAGTAA-1_V12D07-332_B1,0,6,0,0,0,6
TACCGTGCCTCGGACC-1_V12D07-332_B1,0,0,0,0,0,0
GTAGCCAAACATGGGA-1_V12D07-332_B1,0,2,0,2,1,5
TGCCAGTACGTGGAGA-1_V12D07-332_B1,1,0,0,0,0,1
ATAAGGTGGAGAACAT-1_V12D07-332_B1,0,2,0,7,0,9
CTTTAATATTGGTCGA-1_V12D07-332_B1,0,1,0,0,0,1
TGGTTCAACGGGTAAT-1_V12D07-332_B1,0,1,0,7,0,8
GCTGCTACTGCGTAGC-1_V12D07-332_B1,0,1,0,0,0,1
CTGCACAACTACATAT-1_V12D07-332_B1,0,2,0,4,0,6
ATATTCCACATAGTGA-1_V12D07-332_B1,0,3,0,1,0,4
TGGCAAACTAAATTAC-1_V12D07-332_B1,1,1,0,5,0,7
ACCGCAATAACTGCCT-1_V12D07-332_B1,0,0,0,15,0,15
TCGCACCAGGAGGCAG-1_V12D07-332_B1,0,0,0,2,1,3
ACTTCAGGCTGATCCC-1_V12D07-332_B1,0,1,0,0,1,2
ACAAATCGCACCGAAT-1_V12D07-332_B1,0,8,0,0,3,11
TCTGATGTATTCTGTC-1_V12D07-332_B1,1,1,0,0,0,2
CTTTACCGAATAGTAG-1_V12D07-332_B1,1,0,0,1,0,2
GCAGATCCATAAGACT-1_V12D07-332_B1,0,1,0,0,0,1
TTCCTCGGACTAACCA-1_V12D07-332_B1,0,4,0,0,0,4
TTATCCGGGATCTATA-1_V12D07-332_B1,0,2,1,0,1,4
CTGGAAGACACGGTGG-1_V12D07-332_B1,2,0,1,0,0,3
GTTCGTCTAAAGAACT-1_V12D07-332_B1,1,0,1,1,0,3
GTCTATTGGTTCCGGT-1_V12D07-332_B1,1,2,1,0,0,4
CTAGGCGCCCTATCAG-1_V12D07-332_B1,1,0,0,0,0,1
AACGGACGTACGTATA-1_V12D07-332_B1,0,2,0,1,0,3
AACACACGCTCGCCGC-1_V12D07-332_B1,1,2,1,0,0,4
GCTACTATAGTAGAGT-1_V12D07-332_B1,1,3,1,0,1,6
AGCATATCAATATGCT-1_V12D07-332_B1,1,2,0,0,1,4
CGAACAGTATGGGCGT-1_V12D07-332_B1,1,1,1,0,0,3
ACAATTGTGTCTCTTT-1_V12D07-332_B1,0,1,1,0,0,2
GATCGCTACCCGATTT-1_V12D07-332_B1,1,2,1,0,1,5
ATTGCGATCAGTAACT-1_V12D07-332_B1,1,0,0,0,0,1
CAGCAGTCCAGACTAT-1_V12D07-332_B1,0,4,0,0,0,4
AGAGGCTTCGGAAACC-1_V12D07-332_B1,0,2,0,1,0,3
AAACAAGTATCTCCCA-1_V12D07-332_B1,1,1,0,0,3,5
GGCAGCAAACCTATGC-1_V12D07-332_B1,1,1,0,1,3,6
ACTAGTTGCGATCGTC-1_V12D07-332_B1,1,1,0,1,0,3
TTGGACCATCTGGCAA-1_V12D07-332_B1,0,2,1,3,0,6
CCCTCCTCGCTCGTAT-1_V12D07-332_B1,1,1,0,3,2,7
GAGCGCAAATACTCCG-1_V12D07-332_B1,1,0,0,3,0,4
ATTACATGTCAGTCTT-1_V12D07-332_B1,0,1,0,10,0,11
TTGGGACGTAAGAGTT-1_V12D07-332_B1,0,4,0,11,0,15
CTTCGGCCAATTGTTT-1_V12D07-332_B1,0,1,0,5,0,6
AGACCGCTCCGCGGTT-1_V12D07-332_B1,0,0,0,2,0,2
GACCGCGTCTGACGTG-1_V12D07-332_B1,0,1,0,0,1,2
CCAAATAACAAGATTC-1_V12D07-332_B1,0,0,0,0,1,1
TCTTTAGAGTCTAACA-1_V12D07-332_B1,0,1,0,0,0,1
CTCCCAATGAGTCGCG-1_V12D07-332_B1,3,2,0,0,0,5
TAGTCTTTCCGAATTG-1_V12D07-332_B1,0,1,0,0,0,1
GAGTAAACCGGAAAGT-1_V12D07-332_B1,2,0,0,0,1,3
GATCTCGACGCTGTGG-1_V12D07-332_B1,5,1,0,0,1,7
CTGACATAGAAATAGA-1_V12D07-332_B1,7,0,0,0,0,7
TATACCGAGTGCCACA-1_V12D07-332_B1,2,0,0,0,0,2
TCCGAACGTTGCCGCT-1_V12D07-332_B1,4,1,0,0,0,5
GCAGAAGGTAATCTCC-1_V12D07-332_B1,1,2,0,0,0,3
GGTACTAAGTGCTTTG-1_V12D07-332_B1,2,0,0,0,0,2
CAGAATATTCGTTATC-1_V12D07-332_B1,1,2,0,0,0,3
TAATCAACCAAATGGG-1_V12D07-332_B1,0,0,0,0,1,1
TCTGCTTAGAACAAGC-1_V12D07-332_B1,4,1,1,0,0,6
AACTGAGTTATACTGA-1_V12D07-332_B1,0,0,0,0,0,0
TCTAAAGAACAGTCTC-1_V12D07-332_B1,0,10,0,7,6,23
CTGGGTTGAGTTAAAG-1_V12D07-332_B1,0,0,1,0,0,1
CCCAGTAAACTTGGGA-1_V12D07-332_B1,1,4,0,0,0,5
AGATTCACAACCGATA-1_V12D07-332_B1,1,4,0,0,0,5
AGAAGGTACACTTCAC-1_V12D07-332_B1,0,4,0,0,0,4
GCAGGAACTTAGATCT-1_V12D07-332_B1,1,2,0,0,3,6
AATCTAGGTTTACTTG-1_V12D07-332_B1,0,2,0,0,0,2
CCCGGTGTATCGGAAT-1_V12D07-332_B1,0,1,0,0,1,2
TTATCCTCAAGGAATA-1_V12D07-332_B1,2,2,0,0,0,4
AGCATCATTTCGAAAG-1_V12D07-332_B1,1,0,0,0,1,2
CGCGAGTCTGCCGGGT-1_V12D07-332_B1,4,1,0,0,0,5
TGCGTCATGACTGAGC-1_V12D07-332_B1,1,1,1,0,0,3
GTATGAAATTTCACTC-1_V12D07-332_B1,0,1,0,0,0,1
TTGGTTGCGGTGCGCG-1_V12D07-332_B1,1,1,2,0,0,4
ACAGAACTGAGAACAA-1_V12D07-332_B1,2,2,0,0,0,4
CTACTATCATAGGTTT-1_V12D07-332_B1,1,0,0,0,1,2
CCTCTATCGATTAGCA-1_V12D07-332_B1,0,2,1,0,1,4
CCGTATCTCGTCGTAG-1_V12D07-332_B1,2,0,0,0,0,2
TCACGATGTCCGTGGA-1_V12D07-332_B1,1,1,1,0,0,3
TCAACAAAGATAATTC-1_V12D07-332_B1,0,0,0,0,0,0
ATGACGCGTTCTATCC-1_V12D07-332_B1,0,1,0,0,0,1
ATTTGCGCGAGTAGCT-1_V12D07-332_B1,0,1,0,0,1,2
TTCTTGGACGATCTGC-1_V12D07-332_B1,1,1,0,1,0,3
AGACGACGATGCCGCT-1_V12D07-332_B1,1,2,0,1,0,4
GGTCTCTGAATGGACT-1_V12D07-332_B1,0,0,0,1,1,2
GCTCAATCCGTTTATT-1_V12D07-332_B1,0,0,0,1,1,2
CCAGAAAGCAACTCAT-1_V12D07-332_B1,0,0,1,0,0,1
CACCGTTAGGGATCAC-1_V12D07-332_B1,0,0,0,1,0,1
AATAACACTAGAACAA-1_V12D07-332_B1,1,1,2,0,1,5
CACCCGGTTTGTGACT-1_V12D07-332_B1,0,0,0,0,0,0
CCACCAACTTTACTGT-1_V12D07-332_B1,0,1,0,0,0,1
AACTCTCAGTGTGCTC-1_V12D07-332_B1,0,0,0,0,0,0
AAACCGTTCGTCCAGG-1_V12D07-332_B1,1,0,0,1,0,2
CAGCGATTCCCTTCAA-1_V12D07-332_B1,1,0,0,0,0,1
GCTAGCTTGAATAGCT-1_V12D07-332_B1,3,1,0,0,0,4
TTGCGGCATCAGAAAG-1_V12D07-332_B1,3,0,0,0,0,3
AATAGAACAGAGTGGC-1_V12D07-332_B1,3,0,0,1,0,4
GCCATCGAGCTGCGTG-1_V12D07-332_B1,3,2,0,0,1,6
ACACTGATCAAGGTGT-1_V12D07-332_B1,0,0,0,0,0,0
ACCAACGCTTATTTAT-1_V12D07-332_B1,2,2,1,0,1,6
GACATCGATTTATAAC-1_V12D07-332_B1,2,0,0,0,0,2
CAGACACCGATCGCTG-1_V12D07-332_B1,4,2,0,2,0,8
CCAAGAAAGTGGGCGA-1_V12D07-332_B1,0,2,0,0,1,3
GGTAGACCGTTGGGCG-1_V12D07-332_B1,3,0,0,0,0,3
TCGTTAGGAGTCCCTA-1_V12D07-332_B1,3,0,0,0,0,3
ACGGCCAACATGGACT-1_V12D07-332_B1,0,0,0,0,0,0
GTGAGTGGTACAACGC-1_V12D07-332_B1,0,0,0,0,0,0
GAGACTTCGCGACCGA-1_V12D07-332_B1,1,0,0,0,0,1
GAAGTCAGTTGCACTA-1_V12D07-332_B1,1,0,0,0,0,1
GTTTGGTAGGGTCAAC-1_V12D07-332_B1,0,1,2,0,1,4
ACGGCACTTGCTTGGG-1_V12D07-332_B1,4,3,0,0,1,8
CCTCTGTACTATTCTA-1_V12D07-332_B1,0,2,0,0,0,2
CTATTCATGTGTCCCA-1_V12D07-332_B1,0,1,0,0,0,1
GCCCGATCTGTGGTCG-1_V12D07-332_B1,0,0,0,0,2,2
TTAGAAGAACATGACT-1_V12D07-332_B1,1,1,0,0,0,2
AGGATAAAGTCGGGAT-1_V12D07-332_B1,0,1,0,0,0,1
CGGCAAACATCGTGCG-1_V12D07-332_B1,0,0,0,0,0,0
CTAGTTACAACCCGGT-1_V12D07-332_B1,1,1,0,0,0,2
TTCGACAGAGCCCGTG-1_V12D07-332_B1,0,2,0,1,0,3
AAGCATACTCTCCTGA-1_V12D07-332_B1,0,1,0,0,0,1
GACGACGATCCGCGTT-1_V12D07-332_B1,0,0,0,0,0,0
GGTAGAAGACCGCCTG-1_V12D07-332_B1,0,1,0,0,0,1
GAGATGGGAGTCGACA-1_V12D07-332_B1,0,0,0,0,0,0
AACGATAATGCCGTAG-1_V12D07-332_B1,0,1,0,0,0,1
TGGTCCCACGCTACGG-1_V12D07-332_B1,0,0,0,0,0,0
CTGCTTGGCGATAGCT-1_V12D07-332_B1,0,0,0,0,0,0
ATCGGAGACAGACGGC-1_V12D07-332_B1,2,1,0,1,0,4
TAGCGTCCGGTGTGGT-1_V12D07-332_B1,0,0,0,0,0,0
GTTGAGTCCCGCCGGT-1_V12D07-332_B1,0,1,0,0,0,1
AAATAGGGTGCTATTG-1_V12D07-332_B1,0,0,0,0,0,0
AAGTGTTTGGAGACGG-1_V12D07-332_B1,0,1,0,11,0,12
AGCACTACCTCACCAG-1_V12D07-332_B1,0,0,0,0,1,1
TGCCTTGGCCAGGCAA-1_V12D07-332_B1,0,1,0,4,1,6
TCGTCTTAGGCGTTAA-1_V12D07-332_B1,0,1,0,8,0,9
TTCTGACCGGGCTCAA-1_V12D07-332_B1,2,2,0,1,0,5
CAGAACTTAGCCCTCT-1_V12D07-332_B1,1,2,0,11,0,14
AGCTCCTTCGCACATC-1_V12D07-332_B1,0,0,0,0,0,0
ACAGGCTTGCCCGACT-1_V12D07-332_B1,0,1,0,3,0,4
GCTATACGTCTCGGAC-1_V12D07-332_B1,0,0,0,1,0,1
GAGCCAGCTACCTGTG-1_V12D07-332_B1,0,0,2,0,0,2
TGCTAAGTGTCTATTT-1_V12D07-332_B1,1,2,1,1,0,5
GTCCTACGAATAGTCT-1_V12D07-332_B1,0,2,0,0,0,2
CAGTGTCGGCTGGCCC-1_V12D07-332_B1,1,3,0,1,2,7
CTATCGACGAAATACA-1_V12D07-332_B1,0,2,0,2,1,5
CATCATTACCCTGAGG-1_V12D07-332_B1,1,3,1,0,1,6
TAAGTTGCGACGTAGG-1_V12D07-332_B1,0,1,1,0,0,2
AGTGCACGCTTAAGAA-1_V12D07-332_B1,1,1,0,2,0,4
TGTGCCGGTGCCGGAA-1_V12D07-332_B1,0,1,0,0,1,2
AGGAGGCCTTCGCGCG-1_V12D07-332_B1,0,2,0,0,0,2
TCCGCGGCCCAATGAA-1_V12D07-332_B1,1,3,0,2,0,6
TCCGTTAAGCTAATAT-1_V12D07-332_B1,1,3,0,1,1,6
AAATCTAGCCCTGCTA-1_V12D07-332_B1,0,2,1,8,0,11
CGCAGGCGATCCAAAC-1_V12D07-332_B1,2,3,0,3,1,9
CCATATGGAAACTATA-1_V12D07-332_B1,0,1,0,23,0,24
CACCGTATCCCATCCG-1_V12D07-332_B1,1,1,2,6,0,10
GGTCAAGACTACTTCG-1_V12D07-332_B1,0,1,0,12,0,13
CCCGTTTCGCAGATGT-1_V12D07-332_B1,0,0,0,4,0,4
GTTATAATACGGTGAA-1_V12D07-332_B1,0,0,0,15,0,15
ACTTGTGGATGGAACG-1_V12D07-332_B1,0,1,0,7,1,9
GTTCGCTGAGACGTCT-1_V12D07-332_B1,0,0,0,17,0,17
GACACTGGAACCCGAT-1_V12D07-332_B1,0,2,0,7,0,9
CCCAGGTCTGAAGGCT-1_V12D07-332_B1,1,0,0,11,0,12
TCTCGAGGAGGTTCGC-1_V12D07-332_B1,0,0,0,0,1,1
ACTATCTGCCCGCGTA-1_V12D07-332_B1,0,1,0,0,1,2
CCTAAATTGTATCCTA-1_V12D07-332_B1,1,2,0,0,0,3
AGAAATTATGACTCGC-1_V12D07-332_B1,0,0,0,0,0,0
TCCAGCGCTATAAGCG-1_V12D07-332_B1,4,1,0,1,0,6
TCGTGTATTGGTCACG-1_V12D07-332_B1,4,0,0,0,0,4
CCACATACTGCACCCA-1_V12D07-332_B1,1,1,0,1,1,4
GTTGCGGACGGTCAGG-1_V12D07-332_B1,5,4,0,0,0,9
GTATTTAATGGCATAA-1_V12D07-332_B1,9,4,0,0,0,13
GTCGATAGGTGACTTT-1_V12D07-332_B1,2,7,0,0,1,10
AATAATCTTCGTATCG-1_V12D07-332_B1,5,0,0,0,1,6
ATTGTTCAACGATCCG-1_V12D07-332_B1,2,0,0,1,0,3
GTGCAGCGTAGAGTAG-1_V12D07-332_B1,3,2,0,0,0,5
TGTGGTAGGGTGCCTT-1_V12D07-332_B1,0,1,0,0,0,1
TGTGGACTATCTACGT-1_V12D07-332_B1,0,0,0,0,0,0
GGCGGGCTCTAAGAGT-1_V12D07-332_B1,0,0,0,0,0,0
TAGGCGATGAGGTCTC-1_V12D07-332_B1,0,8,1,4,1,14
CCGCCGGAACTTCTCG-1_V12D07-332_B1,3,1,2,0,0,6
GCCATTAGCCTCAAAC-1_V12D07-332_B1,0,2,0,0,0,2
GTTAGGCTACCCGTTT-1_V12D07-332_B1,2,0,0,0,0,2
GGGTATTCTAGCAAAC-1_V12D07-332_B1,1,0,0,0,0,1
GCCCTAGCCGTCGCGA-1_V12D07-332_B1,2,0,0,0,0,2
CAGATCCTGGTTTGAA-1_V12D07-332_B1,2,1,0,0,0,3
CTTCAGTGGTCGCCTA-1_V12D07-332_B1,2,3,0,0,0,5
GGGCAACCGCACGTGC-1_V12D07-332_B1,2,0,0,0,0,2
GACCCAATTATGATAC-1_V12D07-332_B1,3,3,0,0,0,6
GAAGCTCGGACCCGTC-1_V12D07-332_B1,2,1,0,0,2,5
CGTCGGGTCTAAGCGC-1_V12D07-332_B1,1,0,0,0,0,1
GAGGCCCGACTCCGCA-1_V12D07-332_B1,2,0,1,0,1,4
TTGCCATAGCCCGCTC-1_V12D07-332_B1,3,0,1,0,1,5
TAACATACACGCGATC-1_V12D07-332_B1,2,0,0,0,0,2
CCGACGGGCATGAGGT-1_V12D07-332_B1,0,0,0,0,0,0
AATGTGCCCGAGGTGT-1_V12D07-332_B1,0,1,0,0,0,1
AGCTGTAACCTCAATC-1_V12D07-332_B1,1,1,0,0,0,2
CGAGTGAAGGTACCAG-1_V12D07-332_B1,0,0,1,0,0,1
AGTCTCACAAGACTAC-1_V12D07-332_B1,2,0,0,0,0,2
AAATTGATAGTCCTTT-1_V12D07-332_B1,0,2,0,0,0,2
TAAGTCGCCGAGTATC-1_V12D07-332_B1,1,0,0,0,1,2
GCGGAGAAACTTCGCA-1_V12D07-332_B1,0,2,0,0,0,2
GGCAAAGGCGCCAATA-1_V12D07-332_B1,1,1,0,1,1,4
ATTTCCGGGTTCTGCG-1_V12D07-332_B1,1,1,0,1,0,3
TAAACCCAGGAGGGCA-1_V12D07-332_B1,0,2,1,2,0,5
TTCGGGCGCTAGTCTT-1_V12D07-332_B1,2,1,0,0,0,3
GTGGAGTCGGCGGTTG-1_V12D07-332_B1,2,0,0,0,0,2
GCACGCCTACTTAGAT-1_V12D07-332_B1,2,0,1,0,0,3
CAATATTCTTGACCTA-1_V12D07-332_B1,0,0,0,0,0,0
CGTTTGTGTAGAGGGT-1_V12D07-332_B1,0,2,0,0,0,2
CATAGCGTTGCCCACC-1_V12D07-332_B1,1,0,0,0,0,1
TGATACATTTAGCCGT-1_V12D07-332_B1,2,0,0,0,0,2
TTCCGGCCTTGAGGCT-1_V12D07-332_B1,1,1,0,1,0,3
CCTATACCGTCCTGTC-1_V12D07-332_B1,0,0,0,0,1,1
TCGTTGCTATCCGGTC-1_V12D07-332_B1,2,0,0,0,0,2
TGGCGACTGCTCCAAA-1_V12D07-332_B1,2,0,0,0,0,2
CAGAGGCGATGCATGA-1_V12D07-332_B1,4,2,0,0,0,6
TCACAGGAGAATAAGA-1_V12D07-332_B1,3,0,0,0,0,3
GGGTTAACATTTGAGT-1_V12D07-332_B1,0,1,0,0,0,1
GCGGGCGAGCCTTACC-1_V12D07-332_B1,2,3,0,0,0,5
TGCCAATGGGTACTCT-1_V12D07-332_B1,0,0,0,0,1,1
AGGGACTCTACGCGAC-1_V12D07-332_B1,1,0,0,0,0,1
GACGCCGTAAAGGCTA-1_V12D07-332_B1,0,0,0,0,0,0
AAAGGCTCTCGCGCCG-1_V12D07-332_B1,0,0,0,0,0,0
CTGGCTGGTTGTCAGT-1_V12D07-332_B1,0,0,0,0,0,0
ACATCCCGGCCATACG-1_V12D07-332_B1,1,0,0,0,0,1
CTCTTGTCCCGCTTGG-1_V12D07-332_B1,0,1,0,0,0,1
TACGCCTCCATTCCGA-1_V12D07-332_B1,0,0,1,0,1,2
CGGAGCAATTTAATCG-1_V12D07-332_B1,0,2,0,0,0,2
AACTAGGCTTGGGTGT-1_V12D07-332_B1,1,0,1,0,0,2
GCGTCGCCAGGGTGAT-1_V12D07-332_B1,1,0,0,0,0,1
GTTGGTCATGCTATCC-1_V12D07-332_B1,1,1,0,0,1,3
GCTGGCGGCGCATGCT-1_V12D07-332_B1,1,2,0,0,0,3
TGAGCGGAAAGTGTTC-1_V12D07-332_B1,0,0,0,1,1,2
CTTTCTGTGCGGGCTT-1_V12D07-332_B1,2,3,0,0,0,5
ATCTAATATCCTACGG-1_V12D07-332_B1,1,0,0,0,1,2
AACCTTTAAATACGGT-1_V12D07-332_B1,3,3,0,0,0,6
TTCACTCGAGCACCTA-1_V12D07-332_B1,1,3,0,0,0,4
CTGCACTCCAGTACAG-1_V12D07-332_B1,0,1,0,0,0,1
CCATTTCTACCTATTA-1_V12D07-332_B1,0,0,0,0,0,0
CAAGCGGCACATAATT-1_V12D07-332_B1,0,1,0,0,1,2
GTTAACATCACTTAAA-1_V12D07-332_B1,1,1,0,0,1,3
ATATAAATGTAGCTGC-1_V12D07-332_B1,1,2,0,0,0,3
GCCTCTATACATAGCA-1_V12D07-332_B1,0,1,0,0,0,1
GTGTCGTATAGCGTTC-1_V12D07-332_B1,0,1,0,0,0,1
ATACGTACTTAGCCAC-1_V12D07-332_B1,1,1,0,0,1,3
GCTATCATACTCATGG-1_V12D07-332_B1,0,0,0,0,0,0
TATCCAATTGGTTATC-1_V12D07-332_B1,1,1,0,0,0,2
TCTCCCTGGGCAGCGT-1_V12D07-332_B1,0,1,0,0,0,1
CCTATAATGAGTGCCC-1_V12D07-332_B1,0,2,0,0,0,2
CAATGCGAGAAGTATC-1_V12D07-332_B1,0,1,0,0,0,1
TACCAATAAAGTACCA-1_V12D07-332_B1,0,2,0,0,0,2
GCTAGGCACCACGGAG-1_V12D07-332_B1,0,1,0,1,0,2
GGTGGACTGCTCTGGC-1_V12D07-332_B1,0,0,0,0,0,0
TATTCCGAGCTGTTAT-1_V12D07-332_B1,0,0,0,8,0,8
TTGAGAAGTTTAGCAT-1_V12D07-332_B1,0,0,0,0,0,0
GTCCGGACCTGAAATT-1_V12D07-332_B1,0,0,0,7,0,7
CTGTGGTCGGGAGATA-1_V12D07-332_B1,0,2,0,21,0,23
CATGTAAGAGACATTT-1_V12D07-332_B1,0,2,2,1,1,6
CACGTTTCGTACACAC-1_V12D07-332_B1,0,0,0,9,0,9
CATCCTCTCAAAGATC-1_V12D07-332_B1,1,1,0,1,0,3
GATTAACCGAAAGCCC-1_V12D07-332_B1,0,1,0,1,0,2
AACGCTGTTGCTGAAA-1_V12D07-332_B1,2,0,1,0,1,4
TTCAGCTGGCGTGCCC-1_V12D07-332_B1,0,0,0,2,0,2
TAGAGGTTCTACTTGT-1_V12D07-332_B1,0,2,0,2,2,6
GTATCAAACGTTAGCT-1_V12D07-332_B1,0,4,0,1,3,8
AATCATGTAAAGACTC-1_V12D07-332_B1,0,1,0,3,0,4
AGTCACTAGCTCTCGA-1_V12D07-332_B1,0,1,0,13,0,14
GCGAAACGATCGGGAG-1_V12D07-332_B1,0,0,0,9,0,9
CATGGATTGTCTTCCG-1_V12D07-332_B1,0,0,0,15,0,15
ATTGGATTACAGCGTA-1_V12D07-332_B1,0,0,1,15,0,16
CACACACGCTAACGAG-1_V12D07-332_B1,0,1,0,3,0,4
CTATGGGAAGCGGAAT-1_V12D07-332_B1,0,1,0,15,0,16
TGCCTAATTGAAGATT-1_V12D07-332_B1,0,1,0,2,0,3
TGGCAATGGGACGGCG-1_V12D07-332_B1,0,0,1,16,0,17
ACCTCCGCCCTCGCTG-1_V12D07-332_B1,2,1,0,8,0,11
CGGCAATAAGATCGCC-1_V12D07-332_B1,0,2,0,12,0,14
CCTTGACCACTTTATT-1_V12D07-332_B1,0,2,0,11,1,14
TCATTTAGAAGTGTGA-1_V12D07-332_B1,1,1,0,12,0,14
CAGAATAACACACGGA-1_V12D07-332_B1,0,1,0,2,0,3
TCTGAGCAATTGACTG-1_V12D07-332_B1,0,1,0,0,0,1
CAACGTGGTGGAGTCT-1_V12D07-332_B1,0,0,0,0,0,0
CACAGTTCGCTTCCCA-1_V12D07-332_B1,0,1,0,1,0,2
TCTCTCGCCGCACATA-1_V12D07-332_B1,0,2,0,0,0,2
TGGGCAGGCCACCGCA-1_V12D07-332_B1,2,1,0,0,0,3
CTCCTGTTCAAGGCAG-1_V12D07-332_B1,2,2,0,0,0,4
TATTTGATTTGCACAG-1_V12D07-332_B1,4,1,1,0,0,6
GCCACTCCTTACGGTA-1_V12D07-332_B1,3,1,0,0,0,4
ACCGATATTTAATCAT-1_V12D07-332_B1,6,0,0,0,1,7
TTATTATCTGGAAGGC-1_V12D07-332_B1,8,2,0,0,0,10
TACATGCCGGAATTGT-1_V12D07-332_B1,2,2,0,1,1,6
GGCACTCAGCCGACCC-1_V12D07-332_B1,3,0,0,0,1,4
AAACCGGAAATGTTAA-1_V12D07-332_B1,1,2,0,0,0,3
AGACAGGCATCTCAGC-1_V12D07-332_B1,0,2,0,0,0,2
GTGGTGATGGTTTGTG-1_V12D07-332_B1,2,0,0,0,1,3
CCGATATGACGTAAGG-1_V12D07-332_B1,1,0,0,0,0,1
TGGCATGAAGTTTGGG-1_V12D07-332_B1,0,6,0,16,2,24
ACGAGGTTTACAACGT-1_V12D07-332_B1,0,1,0,17,1,19
AACCCATCCCATGATC-1_V12D07-332_B1,1,3,1,0,0,5
TCGACAACTGAACCCG-1_V12D07-332_B1,0,5,0,0,0,5
TATCTTGCAATACAAC-1_V12D07-332_B1,1,3,0,0,0,4
TATTATGTTTGCCTGC-1_V12D07-332_B1,3,2,0,0,0,5
GTCAAAGAAGTGGTGT-1_V12D07-332_B1,1,2,1,0,0,4
GGGACAGAGTTACTCC-1_V12D07-332_B1,2,2,0,0,1,5
AGCAACCGAAAGTAAT-1_V12D07-332_B1,3,0,0,0,0,3
CTCTCTAACTGCCTAG-1_V12D07-332_B1,1,2,0,0,1,4
ATACGGAACGTCGTTT-1_V12D07-332_B1,4,0,0,0,0,4
TCGGTCCCGACAATAG-1_V12D07-332_B1,1,0,0,0,2,3
CGCGCAAATGTCCAGA-1_V12D07-332_B1,2,1,1,0,0,4
TCTAATACTGCCTCAG-1_V12D07-332_B1,1,1,0,0,0,2
CTCGGTTGTCGGCCCT-1_V12D07-332_B1,4,1,1,0,0,6
GGTAACCGGGAGGATA-1_V12D07-332_B1,0,1,1,0,0,2
CAGGCGCACGGTGGTC-1_V12D07-332_B1,2,0,0,1,0,3
TCATCGATGGTCCCAA-1_V12D07-332_B1,1,0,1,0,0,2
CAAAGATTATTGGGCC-1_V12D07-332_B1,1,0,1,0,1,3
ACAATGAATACGGAGA-1_V12D07-332_B1,1,1,0,0,0,2
GCTCCTGACATACTGG-1_V12D07-332_B1,0,1,0,0,0,1
GATGACAAGTAGGGCA-1_V12D07-332_B1,1,0,0,0,1,2
TACGCCGAGGGTACCC-1_V12D07-332_B1,0,2,0,1,0,3
AAGCGTCCCTCATCGA-1_V12D07-332_B1,0,2,0,1,0,3
CACTCCTATGTAAGAT-1_V12D07-332_B1,1,1,0,2,0,4
TCGAGCCAGGCAGGCC-1_V12D07-332_B1,1,1,0,1,0,3
TCGTCAAGTACGCGCA-1_V12D07-332_B1,0,1,0,1,1,3
CCCGTAGCTGGGAAGA-1_V12D07-332_B1,0,0,0,1,0,1
ACCCTATGCCATATCG-1_V12D07-332_B1,0,2,0,0,0,2
GTGGTATAGTCTGCCG-1_V12D07-332_B1,0,0,0,0,1,1
CCGGTTTGTAATTGTG-1_V12D07-332_B1,1,0,1,0,0,2
GTCGCCGTTGTGTGTT-1_V12D07-332_B1,1,0,0,1,0,2
TACTGAACAGATTTAG-1_V12D07-332_B1,1,0,1,0,0,2
TATTAACCTGACCGCG-1_V12D07-332_B1,1,0,0,1,0,2
CTGTAGCCATCTCACT-1_V12D07-332_B1,1,0,0,0,0,1
TACTATGGTTCCTCAG-1_V12D07-332_B1,0,0,0,0,0,0
GAGTCAGACCAGAATC-1_V12D07-332_B1,2,0,0,0,0,2
TAAGGCATAACATCAA-1_V12D07-332_B1,3,2,0,0,0,5
CTTCCGCTCCGTGAAG-1_V12D07-332_B1,3,1,0,0,0,4
GGGCTATGATCGATGG-1_V12D07-332_B1,2,0,0,0,1,3
GGTCGGTCGTCCACAG-1_V12D07-332_B1,1,0,0,0,0,1
GGGACCCGTATATCTT-1_V12D07-332_B1,3,0,0,0,0,3
GAAAGCAGTGCACTTT-1_V12D07-332_B1,1,0,0,0,0,1
AGCGCATAATGAATCG-1_V12D07-332_B1,3,1,0,0,0,4
GCTGCTAAGTAGTCGA-1_V12D07-332_B1,2,0,0,0,0,2
AATAGTCCGTCCCGAC-1_V12D07-332_B1,3,1,0,0,0,4
AGCAGCCAGATGAATA-1_V12D07-332_B1,1,0,0,0,0,1
CCTCGCGCTGTGCGAT-1_V12D07-332_B1,0,1,0,0,0,1
TTGTGTATGCCACCAA-1_V12D07-332_B1,3,0,0,0,0,3
TGCTCGGCGAAACCCA-1_V12D07-332_B1,0,1,0,0,1,2
CGATTAAATATCTCCT-1_V12D07-332_B1,3,1,0,0,0,4
TGCCGTGGATCGTCCT-1_V12D07-332_B1,1,0,1,0,0,2
GTGGACGCATTTGTCC-1_V12D07-332_B1,3,0,0,0,0,3
ACCCGGAAACTCCCAG-1_V12D07-332_B1,1,1,0,0,0,2
CCGCATGTGGTACGAT-1_V12D07-332_B1,1,0,0,0,0,1
GCAAACCTTGGCCATA-1_V12D07-332_B1,3,1,0,0,0,4
ATTCACTGATGTTGGA-1_V12D07-332_B1,3,0,1,0,0,4
ACTCCCTAATGCTAAA-1_V12D07-332_B1,2,0,0,0,1,3
TCCTAAATTGGGAAGC-1_V12D07-332_B1,0,1,0,0,0,1
GAACAGATTACTAAAT-1_V12D07-332_B1,0,0,0,1,0,1
ATACAGGCCCTCCAAT-1_V12D07-332_B1,0,2,0,0,1,3
CGATTCGCCTGGCTGC-1_V12D07-332_B1,0,0,1,0,0,1
TCCGCCTGTCTACAAG-1_V12D07-332_B1,0,1,0,0,0,1
CACATCTCACCGACGA-1_V12D07-332_B1,0,3,0,0,0,3
CGTCGTCCTTCGCGAA-1_V12D07-332_B1,1,0,0,0,0,1
CGTTGAATACCGCGCT-1_V12D07-332_B1,1,1,0,0,0,2
ACCAATATGCAAGTTA-1_V12D07-332_B1,0,1,0,0,0,1
ACGGATGGTGCGGATA-1_V12D07-332_B1,0,3,0,0,0,3
CACCCTAACAAGATCT-1_V12D07-332_B1,0,1,0,0,0,1
AAGCTCTTTCATGGTG-1_V12D07-332_B1,0,1,0,0,1,2
CATGGGTATGCCTTAT-1_V12D07-332_B1,0,3,0,0,0,3
GCGCGTCATTGGTACA-1_V12D07-332_B1,2,1,0,0,0,3
TCTGAAGCACGTGGTC-1_V12D07-332_B1,0,2,0,0,1,3
AAGTTCACTCCAAGCT-1_V12D07-332_B1,1,2,0,0,0,3
TTGGACCTATAACAGT-1_V12D07-332_B1,0,7,0,0,0,7
ATCAGCCTCATGCTGC-1_V12D07-332_B1,0,0,0,0,0,0
AGTACTCTTATGCCCA-1_V12D07-332_B1,0,0,0,0,0,0
GCGCTTAAATAATTGG-1_V12D07-332_B1,0,1,0,0,0,1
TTGTGAACCTAATCCG-1_V12D07-332_B1,0,0,0,3,0,3
AGTCGTCGACCACCAA-1_V12D07-332_B1,0,0,0,0,0,0
TCCTTTAAATCCGCTT-1_V12D07-332_B1,0,0,0,6,0,6
ACTGAAACGCCGTTAG-1_V12D07-332_B1,0,1,0,9,0,10
GCACACACTGGTAGCC-1_V12D07-332_B1,0,2,0,6,0,8
TAAGGGCCTGTCCGAT-1_V12D07-332_B1,1,1,0,16,0,18
GCTAGAGTAGAGATGT-1_V12D07-332_B1,0,2,0,7,0,9
CACAGGGCCATATAGT-1_V12D07-332_B1,0,0,0,13,0,13
CCATGCCCTAGATTTC-1_V12D07-332_B1,0,1,0,12,0,13
TCGCGTAGCAGTGTCC-1_V12D07-332_B1,0,1,0,5,0,6
GACGAGGCTAATAAAC-1_V12D07-332_B1,1,2,0,14,0,17
CTACACTCGCAGATGG-1_V12D07-332_B1,0,0,0,0,0,0
ACGCATACGTTTACTA-1_V12D07-332_B1,1,0,0,2,0,3
GGAGCAACATTTCAAG-1_V12D07-332_B1,0,0,0,0,0,0
CGAGAGGGTAGCCGCG-1_V12D07-332_B1,1,0,0,0,0,1
TCGTGTTCGACCACAA-1_V12D07-332_B1,1,1,0,0,0,2
TCTACCCAATAGAGAG-1_V12D07-332_B1,0,1,0,4,0,5
ATAAACGTTGCACCAC-1_V12D07-332_B1,0,1,0,1,0,2
TCAACTGCAGAGTCAG-1_V12D07-332_B1,1,0,0,4,1,6
AGCTCCATATATGTTC-1_V12D07-332_B1,1,4,0,2,0,7
GTAACATCTAAGATAA-1_V12D07-332_B1,0,3,0,5,0,8
CCGACAATAGGCCGCC-1_V12D07-332_B1,1,3,0,0,0,4
ATGCTTAGGAGTTGAT-1_V12D07-332_B1,1,0,0,1,0,2
AACCCGAGCAGAATCG-1_V12D07-332_B1,1,0,0,0,0,1
CGGGTTTGTTAGGGCT-1_V12D07-332_B1,1,1,0,0,0,2
AGGCACGTGACTGTCC-1_V12D07-332_B1,1,0,0,0,0,1
GACAAGAGATGAGATT-1_V12D07-332_B1,3,0,0,0,1,4
AGCCCTTGGACATCCC-1_V12D07-332_B1,0,0,1,0,0,1
GCAGTTCGATCCGAGC-1_V12D07-332_B1,4,0,0,0,0,4
TCGAGGGCAACAGACG-1_V12D07-332_B1,4,1,0,0,2,7
ACTTTGTCGACGCACT-1_V12D07-332_B1,0,7,0,0,3,10
GAGTATCAAAGTTACA-1_V12D07-332_B1,3,1,0,0,0,4
CCAGGCTGGCGTCTGA-1_V12D07-332_B1,1,0,0,0,1,2
GGACTCTTCCGGTTGA-1_V12D07-332_B1,1,0,0,0,0,1
TCCCAGCACACGACAT-1_V12D07-332_B1,0,0,0,0,1,1
GCTCCATGAGTGCAGA-1_V12D07-332_B1,5,0,0,0,0,5
GCAGTGCGGGCGGATG-1_V12D07-332_B1,0,2,0,0,0,2
GCGTTCTGACTAAGCG-1_V12D07-332_B1,0,0,0,0,0,0
GATGCCTTCTGCGGCA-1_V12D07-332_B1,0,12,0,14,1,27
GTGGAGCGTTTACCGA-1_V12D07-332_B1,0,2,1,0,0,3
AGGCGGTTTGTCCCGC-1_V12D07-332_B1,0,2,3,0,0,5
TCCCTGGCGTATTAAC-1_V12D07-332_B1,0,1,0,0,1,2
AAACACCAATAACTGC-1_V12D07-332_B1,3,1,0,0,0,4
TGGACGCAATCCAGCC-1_V12D07-332_B1,2,1,0,0,1,4
GGAACCTTGACTCTGC-1_V12D07-332_B1,2,1,0,0,0,3
GTATCTCAGTCTTGAC-1_V12D07-332_B1,2,0,0,0,3,5
GCTGAATCTTCCAATC-1_V12D07-332_B1,3,0,0,0,0,3
AGATGCAAGACGTGCA-1_V12D07-332_B1,1,0,0,0,1,2
TTAAGGCCCGTACTTT-1_V12D07-332_B1,5,0,0,0,0,5
AGTATGCTGGAGACCA-1_V12D07-332_B1,3,1,0,0,0,4
GCGGCAAAGTATTGCC-1_V12D07-332_B1,2,0,1,0,1,4
GCGCAAATATATTCAA-1_V12D07-332_B1,4,0,2,0,0,6
GAAGAAACGATATTGT-1_V12D07-332_B1,4,1,1,0,1,7
GGACCTCTAGGCCGCC-1_V12D07-332_B1,2,2,1,0,0,5
AACAGCTGTGTGGCAA-1_V12D07-332_B1,3,2,0,0,0,5
TCGAATATCCCGCAGG-1_V12D07-332_B1,2,2,0,0,0,4
GCGACCCAACCATCTG-1_V12D07-332_B1,1,1,0,0,0,2
AGAGAAGGAGTACAAT-1_V12D07-332_B1,0,0,0,0,0,0
GGCTCCTCCACCTGTT-1_V12D07-332_B1,0,0,0,0,0,0
TCAGTGTATACGTCAT-1_V12D07-332_B1,1,1,1,0,0,3
ATTATTATGTCCGTCA-1_V12D07-332_B1,0,1,0,0,0,1
TTAGGTCATAACCGAC-1_V12D07-332_B1,0,1,0,1,1,3
AAGATGGCACCGGACC-1_V12D07-332_B1,0,1,1,2,0,4
CTACAAGAAATAACCC-1_V12D07-332_B1,1,0,0,0,1,2
ACTATTTCCGGGCCCA-1_V12D07-332_B1,0,2,0,0,1,3
TTGTTTCACATCCAGG-1_V12D07-332_B1,0,0,0,0,1,1
CGCTGTGTGGATGTTG-1_V12D07-332_B1,0,2,0,0,0,2
TCAACATAGCGCCCTA-1_V12D07-332_B1,1,1,0,0,0,2
GGCCGTTTGGGTTTCA-1_V12D07-332_B1,0,1,0,0,0,1
TACTCTTTCGTCTTCA-1_V12D07-332_B1,0,2,0,0,2,4
TTCGCGCGCCATACGA-1_V12D07-332_B1,0,2,0,0,0,2
CGGAAAGAATCAAACG-1_V12D07-332_B1,1,1,0,0,0,2
AGGCAGGGAGCGTACT-1_V12D07-332_B1,2,0,0,0,0,2
CCTTTAAGGGAGCACT-1_V12D07-332_B1,3,0,0,0,0,3
CGCCCAGCACGCCTAG-1_V12D07-332_B1,0,0,0,0,0,0
AGTATTTGGCACGACC-1_V12D07-332_B1,3,1,0,0,0,4
TATCCGCACCGTCGGG-1_V12D07-332_B1,2,1,0,0,1,4
ACCCGTGTCATCAGTA-1_V12D07-332_B1,3,0,0,0,0,3
CAACTGCTCATCCGAT-1_V12D07-332_B1,1,0,0,0,1,2
CCGGAGCGTACTTTCT-1_V12D07-332_B1,3,3,0,0,0,6
TACCGTAGGTTAACTA-1_V12D07-332_B1,0,1,0,0,0,1
TGAGGAGTGCCAGCTT-1_V12D07-332_B1,2,1,0,0,0,3
CCAGTCTTGTCATAGA-1_V12D07-332_B1,1,0,0,0,1,2
GGGCAGAGCAATCGTT-1_V12D07-332_B1,0,0,0,0,1,1
TACCAAATAGCCCAGA-1_V12D07-332_B1,2,0,0,0,0,2
TACCTACTCCCAGTAT-1_V12D07-332_B1,3,0,2,0,0,5
TGTGAGACTAGCCCAA-1_V12D07-332_B1,1,0,2,0,0,3
ATACCTAACCAAGAAA-1_V12D07-332_B1,3,1,0,0,1,5
GTCGGGAAGCAGAAAC-1_V12D07-332_B1,2,0,0,0,0,2
AATTAACGGATTTCCA-1_V12D07-332_B1,0,0,2,0,1,3
GAACCCTCTGTGTTCT-1_V12D07-332_B1,3,0,1,0,0,4
ATATAAAGCGCTCGTG-1_V12D07-332_B1,3,0,1,0,0,4
CCTGGTCGAATGTGGG-1_V12D07-332_B1,5,1,0,0,0,6
CTAGGTTCGGACGTGA-1_V12D07-332_B1,0,0,0,0,1,1
TCGGGAGACAGCGTAC-1_V12D07-332_B1,1,1,0,0,0,2
CATAAGAAGCTTGGCT-1_V12D07-332_B1,2,0,2,0,0,4
AAGCACCCTGCGTATC-1_V12D07-332_B1,1,0,1,0,1,3
AGTTTGCACCTGCCTC-1_V12D07-332_B1,1,0,1,0,0,2
GACTGCAAATCGAGCT-1_V12D07-332_B1,4,0,0,0,0,4
GTGTATATCAGCGGGC-1_V12D07-332_B1,0,0,0,0,0,0
CTTCAACTCCACTTGG-1_V12D07-332_B1,2,1,0,0,0,3
ACTTACGCATCCACGC-1_V12D07-332_B1,1,1,0,0,0,2
CATGAGATGCACTCTC-1_V12D07-332_B1,1,0,1,0,0,2
GAGCACCTGTGTCCAG-1_V12D07-332_B1,1,0,0,0,0,1
CGCGACCGCGACAGAT-1_V12D07-332_B1,1,1,2,0,0,4
GTCCCGCGACGTTATG-1_V12D07-332_B1,1,3,0,0,0,4
GCAGTGTGGCTATAGG-1_V12D07-332_B1,2,2,0,0,0,4
ATACTGCCTTACACCG-1_V12D07-332_B1,1,0,0,0,0,1
TACAGAAACGGTGGGC-1_V12D07-332_B1,0,0,0,0,0,0
GGCGCGGAGATCTTTC-1_V12D07-332_B1,1,0,0,0,0,1
CGTTAATGTCCCGACG-1_V12D07-332_B1,0,0,0,0,1,1
GCTAACTGAAGTCTGA-1_V12D07-332_B1,0,2,0,0,0,2
AGTGATAACCTGCGCG-1_V12D07-332_B1,1,1,0,0,0,2
TATGATCTTCTCTTTA-1_V12D07-332_B1,0,0,0,0,1,1
TGTACCTACACGAGGG-1_V12D07-332_B1,0,0,0,0,0,0
ATATCGTTCCTCGAAC-1_V12D07-332_B1,0,0,0,0,0,0
CGGCGCCATCAATCCC-1_V12D07-332_B1,2,1,0,0,0,3
CCTGTTTGAAGACACG-1_V12D07-332_B1,0,0,0,7,0,7
GCCACTCAGAGCGCGA-1_V12D07-332_B1,2,0,1,2,1,6
TCGGCTTGTATCGACG-1_V12D07-332_B1,0,0,0,10,0,10
TAGATGGTTCCTTACT-1_V12D07-332_B1,0,2,0,1,0,3
ATCGTTAGCTAGCGGA-1_V12D07-332_B1,1,0,0,7,0,8
ACAGCGACATTCTCAT-1_V12D07-332_B1,0,0,0,0,0,0
ATTCAACCATTTAAGG-1_V12D07-332_B1,0,0,0,0,1,1
CACTCTTCTGCTAGCC-1_V12D07-332_B1,0,0,0,0,0,0
CTAACTGATAATCGCC-1_V12D07-332_B1,0,1,0,0,0,1
TGATGTCAATTAAGTG-1_V12D07-332_B1,0,1,0,0,0,1
CGCCGTTCAGCATAGT-1_V12D07-332_B1,0,2,1,0,0,3
ATACTACCCGTACCAC-1_V12D07-332_B1,0,0,0,0,0,0
CCACTGTTTGGATTAA-1_V12D07-332_B1,2,3,0,0,0,5
CACTACGGGAGCTGCC-1_V12D07-332_B1,1,3,0,0,0,4
GACCAAACGTTGACTG-1_V12D07-332_B1,0,1,0,0,0,1
AAGAGGCCCTTTGGAA-1_V12D07-332_B1,1,1,0,0,0,2
ACACGTAGGCCACAAG-1_V12D07-332_B1,1,1,0,0,0,2
TACTCTTACTTTACTG-1_V12D07-332_B1,0,0,0,0,0,0
AGAGCCGCCGAGATTT-1_V12D07-332_B1,1,1,0,0,0,2
GGCCTGCTTCTCCCGA-1_V12D07-332_B1,2,0,0,0,0,2
TCAAGCGCGGACGGTA-1_V12D07-332_B1,1,2,0,0,0,3
ACACTGGGACAGTCGT-1_V12D07-332_B1,2,0,1,0,0,3
TGTGTAGTAGCACGTG-1_V12D07-332_B1,2,1,0,0,0,3
CTAGCCACAGGCGAGC-1_V12D07-332_B1,5,3,0,0,1,9
CTATCGCGTAGAGAAC-1_V12D07-332_B1,5,2,0,0,1,8
GTTCCCGTAAACATAT-1_V12D07-332_B1,3,1,0,0,0,4
TCTTTCCTTCGAGATA-1_V12D07-332_B1,1,6,1,0,0,8
ATATTGGAGAGGCCTT-1_V12D07-332_B1,2,1,0,0,0,3
AGGCGATAACTGGCGT-1_V12D07-332_B1,3,1,0,0,0,4
ACCCGGAGCACCACAA-1_V12D07-332_B1,2,1,0,0,0,3
TGAGCTCAACTGTATA-1_V12D07-332_B1,0,2,0,0,0,2
ACGACCCATGAGTTGC-1_V12D07-332_B1,2,1,0,2,1,6
CGGTCAGTCCATATTT-1_V12D07-332_B1,0,2,0,0,0,2
TCCGGCTGTCGGGTCG-1_V12D07-332_B1,0,0,0,0,0,0
ATCAATGCCGTGGCTG-1_V12D07-332_B1,0,0,3,0,0,3
GAAACATAGGAAACAG-1_V12D07-332_B1,4,2,0,0,0,6
TAATAGGTCACCAGAA-1_V12D07-332_B1,3,1,0,0,0,4
CACCAGTCAGCATGCA-1_V12D07-332_B1,3,0,0,0,0,3
GAGCGCTGTTAGGTAA-1_V12D07-332_B1,4,1,0,0,1,6
CCCTATGTAGAGCAGA-1_V12D07-332_B1,0,0,0,0,0,0
GATCGCTATATCTCAG-1_V12D07-332_B1,3,1,0,0,1,5
AAGGGACTATGCATTC-1_V12D07-332_B1,7,0,0,0,0,7
CTCGGGTTCTCTGGCC-1_V12D07-332_B1,3,2,1,0,0,6
TATATATCGAGAAATG-1_V12D07-332_B1,1,1,1,0,1,4
ACCCGAGCGAAATTAC-1_V12D07-332_B1,2,0,0,0,1,3
TTGTTTCATTAGTCTA-1_V12D07-332_B1,2,0,0,0,0,2
ATGGGACCTGCTGAAC-1_V12D07-332_B1,5,0,0,0,0,5
TGCGACGGCCGAACGT-1_V12D07-332_B1,3,0,0,0,0,3
AGCTAACAAGCAATGT-1_V12D07-332_B1,2,0,0,0,0,2
CGTGTCTCGTTACGAC-1_V12D07-332_B1,1,3,0,0,0,4
CTAAATCCGGTGTACA-1_V12D07-332_B1,1,0,0,0,0,1
GAATAGTGCTCGATTA-1_V12D07-332_B1,1,0,0,0,0,1
AACAATACATTGTCGA-1_V12D07-332_B1,0,1,0,0,1,2
CACATCGTGCACGCGC-1_V12D07-332_B1,0,1,0,0,0,1
ACCGTGACCACGTGGG-1_V12D07-332_B1,0,2,0,1,0,3
CCCAATGAGATTTGCA-1_V12D07-332_B1,0,2,0,0,0,2
TCAGCAGTAGGCCCTG-1_V12D07-332_B1,0,0,0,1,1,2
CTACTCAAGGTATAGT-1_V12D07-332_B1,1,1,0,1,1,4
TAGTAGCTTATACCAG-1_V12D07-332_B1,0,3,0,0,1,4
ACGTTCGTTCAGGAAA-1_V12D07-332_B1,0,2,0,1,0,3
TTAGAATAAGGGTCGG-1_V12D07-332_B1,1,1,1,0,0,3
TTCTAGAAAGTCTTAT-1_V12D07-332_B1,0,0,0,0,0,0
CCTTCAGTTAAAGTGA-1_V12D07-332_B1,0,1,0,0,0,1
TAGCTAGTGATGATGG-1_V12D07-332_B1,0,1,0,0,0,1
AGCCCGGTAGCCTGTA-1_V12D07-332_B1,0,0,0,0,0,0
TACCTCAGTTGTCTGT-1_V12D07-332_B1,2,0,0,0,0,2
GACGGGTTGGCCCGTA-1_V12D07-332_B1,2,0,0,0,0,2
GAAACCTATACAAATG-1_V12D07-332_B1,2,0,0,0,1,3
TCCACCTCTAGCCTTT-1_V12D07-332_B1,3,2,0,0,0,5
AAGACCCAACTGAACA-1_V12D07-332_B1,0,0,0,0,0,0
CATACACGGTTCCCAC-1_V12D07-332_B1,0,0,1,0,1,2
ACTACGCGTTAGAATT-1_V12D07-332_B1,2,2,0,0,0,4
CTTGGCCAAGCTGGGA-1_V12D07-332_B1,1,0,0,0,1,2
TTACCCTAGGGATTGG-1_V12D07-332_B1,2,1,0,1,1,5
TTCGCACTGTACGACA-1_V12D07-332_B1,1,0,0,0,0,1
TAGGTGTTCCACAGAT-1_V12D07-332_B1,4,1,0,0,1,6
GAAGCCTGCACATTCC-1_V12D07-332_B1,1,1,0,0,0,2
GGCTTTCAATAAGGGT-1_V12D07-332_B1,0,2,0,0,0,2
TCCAGGGTATATACGA-1_V12D07-332_B1,1,0,0,0,0,1
CTCGCCGAATGTAGGG-1_V12D07-332_B1,1,0,0,0,0,1
AGGAAGCTGTCCGCCG-1_V12D07-332_B1,2,0,0,1,0,3
GTCTCAAGGCCCGGCT-1_V12D07-332_B1,0,1,0,1,0,2
ACCGACACATCTCCCA-1_V12D07-332_B1,2,0,1,0,0,3
TATACGCGTCATCACT-1_V12D07-332_B1,1,0,0,0,0,1
ATCTGGGCTGTTCTTG-1_V12D07-332_B1,3,0,0,0,1,4
TCAAATTTGAGACTCA-1_V12D07-332_B1,2,1,0,0,1,4
GTTAAGGGTGCGATGT-1_V12D07-332_B1,5,1,0,0,0,6
AGCAAAGGCCGCTAGT-1_V12D07-332_B1,6,1,0,0,0,7
TTATAGGTAATTGTCT-1_V12D07-332_B1,2,0,1,0,0,3
TTGTGCAGCCACGTCA-1_V12D07-332_B1,0,0,3,0,0,3
ACGGACTCTCAAAGCG-1_V12D07-332_B1,4,0,0,0,1,5
ATGCTCTGGCGCGGTA-1_V12D07-332_B1,4,0,0,0,0,4
ATAATCTTGGAGAACC-1_V12D07-332_B1,1,0,0,0,0,1
CTCATTGCTCTAACAA-1_V12D07-332_B1,2,1,0,0,1,4
TAGGTGACGATAACCT-1_V12D07-332_B1,4,1,0,0,0,5
CGGATCCTCAAGGACT-1_V12D07-332_B1,0,0,2,0,0,2
GGGCGTGGTTTCCCAG-1_V12D07-332_B1,1,0,2,0,1,4
TGGCTATGTGACATAC-1_V12D07-332_B1,0,0,2,0,0,2
CTTAGTGTAGTAGCAT-1_V12D07-332_B1,1,1,0,0,0,2
GGATTGCTGTGACTCC-1_V12D07-332_B1,2,0,0,0,0,2
ACTTCCATGCGGGACA-1_V12D07-332_B1,3,0,0,0,0,3
ACTCAAGTGCAAGGCT-1_V12D07-332_B1,2,0,4,0,0,6
ACAAGGATGCTTTAGG-1_V12D07-332_B1,1,0,0,0,0,1
TTGAACGACGTGCTGA-1_V12D07-332_B1,0,0,0,0,1,1
ATTCATCGTTGAGGCA-1_V12D07-332_B1,0,0,0,0,0,0
TGCAACCCATCTGCGG-1_V12D07-332_B1,0,0,0,0,0,0
AGTGCTAAACACAGCA-1_V12D07-332_B1,1,2,0,0,0,3
AACTCCAGAGCGTGTT-1_V12D07-332_B1,0,0,0,0,0,0
TCTCCACAAGTTGAAT-1_V12D07-332_B1,0,0,1,0,0,1
CTTTGCATCGCTCTTG-1_V12D07-332_B1,0,1,0,0,0,1
TCACAAACCGAGGTAC-1_V12D07-332_B1,0,0,0,0,0,0
CCGTAGGAAATCCCTG-1_V12D07-332_B1,0,3,0,0,0,3
AAACATTTCCCGGATT-1_V12D07-332_B1,0,1,0,0,0,1
GCCTCCGACAATTCAC-1_V12D07-332_B1,0,3,0,0,0,3
TCTGCATACCTTGCTT-1_V12D07-332_B1,0,2,0,0,0,2
ACCCATTTGTCCCTCT-1_V12D07-332_B1,0,0,0,0,0,0
CTGCAGAGAATCAGAG-1_V12D07-332_B1,0,0,1,0,0,1
GGAAACTAAATGGGCC-1_V12D07-332_B1,0,0,0,0,0,0
CAACCTACCGAGCAGT-1_V12D07-332_B1,2,3,1,0,1,7
CCGTAGGGTTGTTTAC-1_V12D07-332_B1,0,0,1,0,0,1
GGTTTGTGACCTGAGG-1_V12D07-332_B1,1,1,1,0,1,4
TAACCTAGGGAGTCCA-1_V12D07-332_B1,0,2,0,0,0,2
TTCCATCGACAGCGTG-1_V12D07-332_B1,0,2,0,0,1,3
ATCTCCCACGGAATAT-1_V12D07-332_B1,1,0,0,0,0,1
GTTTCAAACGAGTTGT-1_V12D07-332_B1,1,0,2,0,0,3
GGAACTTTGGCGATTA-1_V12D07-332_B1,0,1,0,0,0,1
CTGCAAGCACGTTCCG-1_V12D07-332_B1,0,0,0,0,0,0
CACAGTCCCGCTTCGC-1_V12D07-332_B1,0,1,0,0,0,1
TACGCTCGGTATTGGA-1_V12D07-332_B1,4,2,0,0,0,6
CTGGTAAAGTGTGGGC-1_V12D07-332_B1,2,1,0,0,0,3
CAACCAGTGGCCTACC-1_V12D07-332_B1,1,2,1,0,0,4
TCTTCGCGGTGAGAGG-1_V12D07-332_B1,3,4,0,0,0,7
TTCGGGTTGCCACGGG-1_V12D07-332_B1,4,1,0,0,2,7
ACCGATAGGCATAACC-1_V12D07-332_B1,3,4,1,0,1,9
CTTATAGATGGCTGTT-1_V12D07-332_B1,3,2,0,0,1,6
AGACGCCCACTTCGCC-1_V12D07-332_B1,3,1,0,0,0,4
AGGTCGCCTCCCAACA-1_V12D07-332_B1,3,1,0,0,1,5
CCTCACGTCAGCTAAT-1_V12D07-332_B1,10,0,0,0,1,11
CCACCTGTATGGAATA-1_V12D07-332_B1,2,0,0,0,0,2
GGACTCGAAGCTTTCA-1_V12D07-332_B1,3,2,0,0,1,6
AAGCCGGAGAGCAGGA-1_V12D07-332_B1,3,1,0,0,0,4
GCCTATCAGGTAAGAT-1_V12D07-332_B1,0,2,0,0,1,3
TCAGAGTGTGAGCATG-1_V12D07-332_B1,0,4,0,0,1,5
CGAATCTGCTCGACGC-1_V12D07-332_B1,3,2,1,0,0,6
ATCGTGGAAAGTCTGG-1_V12D07-332_B1,1,2,0,0,0,3
CCTATGGCTCCTAGTG-1_V12D07-332_B1,2,1,0,0,0,3
CGTCGCTTGGTTATAC-1_V12D07-332_B1,1,1,0,0,1,3
TGCTTAGAGAGAATGC-1_V12D07-332_B1,2,0,0,0,0,2
GATTGCTCCAGTTGCA-1_V12D07-332_B1,5,0,0,0,0,5
CGTGCTTCTACCTAAA-1_V12D07-332_B1,2,2,1,0,1,6
ACTCCAATATCATCAT-1_V12D07-332_B1,3,1,0,0,0,4
GCCGACCCACGACTGC-1_V12D07-332_B1,2,0,0,0,0,2
GAGGGTAGTAACAAAG-1_V12D07-332_B1,3,0,0,0,0,3
GGCCGAGACTCTGGTG-1_V12D07-332_B1,4,0,0,0,0,4
TATATAGGGCTTTACG-1_V12D07-332_B1,3,1,0,0,1,5
TGCCGGATGTACGAGC-1_V12D07-332_B1,1,0,1,0,1,3
AGGTAGATCGAGATAT-1_V12D07-332_B1,0,0,1,0,1,2
GATCAACATAAAGGGA-1_V12D07-332_B1,0,0,0,0,1,1
TAACAGCGTTTGTGCT-1_V12D07-332_B1,2,1,1,0,2,6
CTATAGGCGTTGATGT-1_V12D07-332_B1,1,1,0,0,0,2
GGTTTAATTACCATCG-1_V12D07-332_B1,0,2,0,0,0,2
CTCTTCTGGAAGTTAG-1_V12D07-332_B1,2,0,1,1,0,4
ATCTGACATGGAAGGA-1_V12D07-332_B1,0,2,0,1,2,5
TACGTACTAGTGCTGA-1_V12D07-332_B1,0,2,1,1,0,4
ATGACTATCAGCTGTG-1_V12D07-332_B1,1,0,0,0,0,1
CTTTGGGATTGTTGCA-1_V12D07-332_B1,0,1,0,0,1,2
AGACTGTTACCGGGTC-1_V12D07-332_B1,0,3,0,0,1,4
TCCTAACCGTCGGGCA-1_V12D07-332_B1,1,1,0,1,1,4
ACGCAAACTAATAGAT-1_V12D07-332_B1,0,1,0,0,0,1
AAGTGAGTCGGGTTTA-1_V12D07-332_B1,0,0,0,1,0,1
TAAAGCGGTATTTCCA-1_V12D07-332_B1,0,0,1,0,0,1
CTCCTCCAGCTCACAC-1_V12D07-332_B1,0,6,3,0,0,9
CGGTCCGTCGCAAGCC-1_V12D07-332_B1,0,0,0,0,0,0
CCTATATTTGTCCTGG-1_V12D07-332_B1,2,1,0,0,0,3
TCCAATAAAGGCTACC-1_V12D07-332_B1,2,0,1,0,0,3
AAAGGCTACGGACCAT-1_V12D07-332_B1,3,1,1,0,0,5
CGTGACCAGTCCTCTG-1_V12D07-332_B1,3,0,0,0,0,3
GATCTGCTATCTAAGG-1_V12D07-332_B1,1,0,1,0,1,3
CGAATGACGCATAATG-1_V12D07-332_B1,0,1,0,0,0,1
GCTCAATGTAATACCG-1_V12D07-332_B1,2,2,0,0,0,4
CTATGCCCGAATGCAA-1_V12D07-332_B1,0,0,0,0,0,0
CACAGGGCCGTTGTCA-1_V12D07-332_B1,1,1,1,0,0,3
TCAATACGCCGTCATG-1_V12D07-332_B1,0,1,0,0,0,1
AGCGGACACTTCGTAG-1_V12D07-332_B1,3,0,0,0,0,3
ATACGTTATGCACGGA-1_V12D07-332_B1,1,0,0,0,0,1
GAGTAGATACTAGTTG-1_V12D07-332_B1,1,1,0,0,0,2
CCAGCTCGAACGCATT-1_V12D07-332_B1,4,1,0,1,0,6
TGCTTCCCAAGCAGTA-1_V12D07-332_B1,4,1,0,0,0,5
GTAGACACGCCTGACT-1_V12D07-332_B1,1,0,0,0,0,1
CTCACATTTACTAAAT-1_V12D07-332_B1,2,0,1,0,1,4
GAATGCGAATCGGTTC-1_V12D07-332_B1,3,1,0,0,0,4
TAAGGCCCGTCACCCT-1_V12D07-332_B1,2,0,0,0,0,2
GAGTATGCGCGTGCAT-1_V12D07-332_B1,4,0,1,0,0,5
ATCCACATCGACAGAA-1_V12D07-332_B1,2,1,0,0,2,5
TAGACGAAACGCCAAT-1_V12D07-332_B1,0,1,0,0,0,1
CAGCAGTCTGTGCTGC-1_V12D07-332_B1,1,0,2,0,0,3
CTCACTGTGATACTTA-1_V12D07-332_B1,1,1,0,0,0,2
TTAATTGCTTTGGGTG-1_V12D07-332_B1,1,0,0,0,0,1
GTAGTCTACGATATTG-1_V12D07-332_B1,4,0,0,0,0,4
TTGCCGCTTTCTAGTA-1_V12D07-332_B1,1,2,0,0,0,3
GAACCTTTAACGATCC-1_V12D07-332_B1,2,0,0,0,0,2
TGGACCAATCTAAGAT-1_V12D07-332_B1,0,2,1,0,1,4
CTAGTAGAAAGGGATT-1_V12D07-332_B1,4,2,0,0,0,6
AACCTCGCTTTAGCCC-1_V12D07-332_B1,2,1,0,0,0,3
GAGTGTCAACCAGAAA-1_V12D07-332_B1,1,0,0,0,0,1
GTGATCCTTGTCATGA-1_V12D07-332_B1,3,0,4,0,0,7
CTCAACTAACCCGGAT-1_V12D07-332_B1,6,0,1,0,0,7
AGTGGCGTCTGAAGGT-1_V12D07-332_B1,2,1,1,0,0,4
GGGAAGGGCTTTCTCA-1_V12D07-332_B1,0,1,2,0,0,3
AGGCCTGAGAATCTCG-1_V12D07-332_B1,0,1,1,0,0,2
AGCCACAGGTTACCCG-1_V12D07-332_B1,1,0,0,0,0,1
TGCAATCTAACACGGT-1_V12D07-332_B1,2,0,1,0,1,4
GTTTGGGTTTCGCCCG-1_V12D07-332_B1,3,1,0,0,0,4
CCTATGTCCACTCCAC-1_V12D07-332_B1,2,2,1,0,0,5
CTGCCTTTCTAGTAAA-1_V12D07-332_B1,0,0,0,0,0,0
TTAGTAAACCTGCTCT-1_V12D07-332_B1,3,1,1,0,0,5
TTGTGGTGGTACTAAG-1_V12D07-332_B1,0,1,2,0,0,3
CCTCCTGTTGTGTCGT-1_V12D07-332_B1,0,0,0,0,0,0
ACAAAGCATGACCTAG-1_V12D07-332_B1,0,0,2,0,0,2
ATAGCAACTAGGGAAG-1_V12D07-332_B1,0,0,4,0,0,4
CCGCTCTTCCGAACTA-1_V12D07-332_B1,0,0,0,0,1,1
TAGAATAGCCGATGAA-1_V12D07-332_B1,0,0,4,0,0,4
GGTCTCCGTCCAGGTT-1_V12D07-332_B1,1,0,2,0,0,3
TAATTACGTCAGTAGA-1_V12D07-332_B1,0,0,1,0,0,1
TACGTAAAGCGGAGTG-1_V12D07-332_B1,0,0,1,0,0,1
GCTACAATCGAGGATA-1_V12D07-332_B1,3,0,2,0,0,5
TCAGCCAATCCGTAAA-1_V12D07-332_B1,1,4,2,0,0,7
ATCATAGCCCTATGTA-1_V12D07-332_B1,1,0,0,0,0,1
GAGGCCTGTTGATACA-1_V12D07-332_B1,1,1,1,0,0,3
ATATACGCTCGTGACG-1_V12D07-332_B1,0,1,0,0,0,1
CCCTTTAATGGAGTTC-1_V12D07-332_B1,2,1,0,0,0,3
TTACACGATCTGCGAC-1_V12D07-332_B1,0,1,0,0,0,1
TCGCATAAAGGGCGCA-1_V12D07-332_B1,2,1,0,0,0,3
TGTAGCCATCCCATTC-1_V12D07-332_B1,1,2,2,0,0,5
GGGTCTATCGCTTTCC-1_V12D07-332_B1,2,0,2,0,1,5
GGAGGGTCAAGTAAGA-1_V12D07-332_B1,1,1,0,0,1,3
TACGGCATGGACGCTA-1_V12D07-332_B1,3,0,1,0,2,6
CACGTCAATCAATGGA-1_V12D07-332_B1,8,0,1,0,0,9
CGCTTGGACGGATAGA-1_V12D07-332_B1,2,1,0,0,1,4
CGCGGTACGGTATACA-1_V12D07-332_B1,5,0,0,0,1,6
CCTACTCAACACGATT-1_V12D07-332_B1,2,2,0,1,0,5
CGTTTGGTGTTGTGGG-1_V12D07-332_B1,5,2,0,0,2,9
GTTGTTGCAAGATGGC-1_V12D07-332_B1,0,1,0,0,0,1
CATTCGTCGTAGCGGT-1_V12D07-332_B1,0,0,0,1,0,1
CAGCCTCGATAGCGGT-1_V12D07-332_B1,0,1,0,0,0,1
TCATAAGTCCAAGAAG-1_V12D07-332_B1,1,1,0,0,0,2
AAAGTGCCATCAATTA-1_V12D07-332_B1,1,0,0,0,0,1
GTTGCAGTCGACAACA-1_V12D07-332_B1,1,1,0,0,0,2
TAAATGGGCTACTGAG-1_V12D07-332_B1,1,1,0,0,0,2
CACAGAGACGAGGACG-1_V12D07-332_B1,0,0,1,0,0,1
GCACAAACCCTAGATG-1_V12D07-332_B1,0,2,8,0,0,10
ACTATGTCCAGCTGCC-1_V12D07-332_B1,0,3,1,0,0,4
AAGCCGCCGTGAAATC-1_V12D07-332_B1,0,2,1,0,0,3
ATGGGTGTATACCTCC-1_V12D07-332_B1,2,1,0,0,0,3
TAAGCGCGAATCAAAT-1_V12D07-332_B1,2,3,0,0,0,5
AGCCCGGCATTAGAGG-1_V12D07-332_B1,4,0,0,0,0,4
GTGATCAAGCGTGCAC-1_V12D07-332_B1,4,2,0,0,1,7
CTGCCTTTAATACCTT-1_V12D07-332_B1,2,0,0,0,0,2
TACCTCCACACCAATG-1_V12D07-332_B1,2,1,0,0,0,3
GAGCATCAACAACTTG-1_V12D07-332_B1,1,2,0,0,1,4
CATACGAACTAGCTGG-1_V12D07-332_B1,3,0,0,0,0,3
GGGAACGGTTTCAGAT-1_V12D07-332_B1,3,2,0,0,0,5
AGGGTGCCGTTCTTTA-1_V12D07-332_B1,2,1,1,0,0,4
ACGACTGGTCATACTC-1_V12D07-332_B1,2,1,1,0,0,4
GGATCTTACTGCCCTT-1_V12D07-332_B1,4,0,1,0,0,5
TACTCCTCTAGTTGAC-1_V12D07-332_B1,1,1,1,0,0,3
GTAGCTCCGGGAGGCT-1_V12D07-332_B1,4,0,0,0,0,4
GGACTCGTGAGTGGTC-1_V12D07-332_B1,1,1,0,0,0,2
GTAGTTCGAAGGCGAA-1_V12D07-332_B1,0,0,0,0,0,0
CTCAAACCACTGCCCG-1_V12D07-332_B1,0,0,1,0,0,1
GAGGGAGTCAGATCGC-1_V12D07-332_B1,2,0,0,0,0,2
GCGTCCCTAAGACATA-1_V12D07-332_B1,0,2,0,1,1,4
TCTCTTACCGCGAACC-1_V12D07-332_B1,0,1,0,1,0,2
GGCTACTATACACTCC-1_V12D07-332_B1,1,0,0,2,1,4
CGTTGCCCGCGTGGGA-1_V12D07-332_B1,0,0,1,0,0,1
TATAGAGTCGCTTGAA-1_V12D07-332_B1,0,0,0,1,0,1
ATGTTGTAGTCTGTTT-1_V12D07-332_B1,0,1,0,0,0,1
AGTATACACAGCGACA-1_V12D07-332_B1,1,0,0,0,0,1
TGTGGTTGCTAAAGCT-1_V12D07-332_B1,1,0,2,0,0,3
TGATTCCCGGTTACCT-1_V12D07-332_B1,1,9,1,0,0,11
CACTGACGATTGTGGA-1_V12D07-332_B1,0,4,1,2,0,7
AACATTGTGACTCGAG-1_V12D07-332_B1,1,0,0,0,1,2
GTCCAATATTTAGCCT-1_V12D07-332_B1,0,0,0,0,0,0
GCTCTTTCCGCTAGTG-1_V12D07-332_B1,0,1,0,0,1,2
GGGTCAGGAGCTAGAT-1_V12D07-332_B1,0,0,0,0,0,0
AGGTGGTGACCTTCGC-1_V12D07-332_B1,3,1,0,0,1,5
CCCGGGTCGTTCAGGG-1_V12D07-332_B1,0,0,0,0,0,0
AGCCAAGCTTTGTGTC-1_V12D07-332_B1,3,1,0,1,0,5
TGTGGCGGGCTTCTGG-1_V12D07-332_B1,2,0,0,0,0,2
CGAGGGTATCCAGGTG-1_V12D07-332_B1,1,1,0,0,0,2
CGTTCAGACCCGCGAA-1_V12D07-332_B1,3,0,0,0,0,3
TCATATGAGCTTTGTT-1_V12D07-332_B1,1,2,0,0,0,3
AGTTGACGGTCCTTGC-1_V12D07-332_B1,1,1,0,0,0,2
ATAATTAGCTAAGTAG-1_V12D07-332_B1,3,0,0,0,0,3
GGTCTTGAGCGCTCTT-1_V12D07-332_B1,1,0,0,0,0,1
CGTTGTCGGCAATTGA-1_V12D07-332_B1,2,1,1,0,0,4
TCTTGCTCCCGATACT-1_V12D07-332_B1,0,1,0,0,0,1
AGCAGAAGGAGAAAGA-1_V12D07-332_B1,1,1,0,0,0,2
GAAGCCACTGATTATG-1_V12D07-332_B1,4,1,0,0,0,5
TGCTCTTGAGAGTTTG-1_V12D07-332_B1,1,1,0,0,0,2
GACATCCGTCGAACTG-1_V12D07-332_B1,2,2,0,0,0,4
AGATATAATACGACTA-1_V12D07-332_B1,1,0,0,0,0,1
TCGCTACTGGCTTTGA-1_V12D07-332_B1,0,1,0,1,0,2
GTGACAGCTTCCCACT-1_V12D07-332_B1,1,0,0,0,0,1
GTGACGCAGGTTTCAT-1_V12D07-332_B1,0,1,0,0,1,2
GGGAAGACGGTCTGTC-1_V12D07-332_B1,3,1,0,0,0,4
CGTCGCATGTGAGCCA-1_V12D07-332_B1,4,0,1,0,0,5
AGAAGGTTGTAGGTCG-1_V12D07-332_B1,2,0,0,0,0,2
GGCCGGCGTCTGCTAT-1_V12D07-332_B1,3,0,0,0,0,3
TTGACCAGGAACAACT-1_V12D07-332_B1,2,1,0,0,1,4
AGTCGTATAAAGCAGA-1_V12D07-332_B1,2,1,1,0,0,4
GGCGTAGGGAAAGCTG-1_V12D07-332_B1,6,0,1,0,0,7
AAACCTAAGCAGCCGG-1_V12D07-332_B1,2,0,1,0,1,4
ATTGCCTTTATGTTTG-1_V12D07-332_B1,6,2,0,0,0,8
CAGGCAGTCTTACCAG-1_V12D07-332_B1,1,0,0,0,0,1
AGCTAAGTACGCAGGC-1_V12D07-332_B1,3,0,0,0,1,4
AAATCCGATACACGCC-1_V12D07-332_B1,8,0,0,0,1,9
CGAGAGCTTTCACTAC-1_V12D07-332_B1,2,1,1,0,0,4
CGCCCAGCGTTTCACG-1_V12D07-332_B1,3,0,2,0,0,5
TTAAGTATTGTTATCC-1_V12D07-332_B1,3,0,0,0,0,3
AAACGGGCGTACGGGT-1_V12D07-332_B1,3,0,1,1,0,5
GTATCCTTTGGTAACC-1_V12D07-332_B1,0,0,1,0,0,1
CATAGTCAAATACATA-1_V12D07-332_B1,2,0,2,0,1,5
TCTATGCTATAACGAC-1_V12D07-332_B1,1,0,1,0,0,2
ACGTTCTGTACAAGTC-1_V12D07-332_B1,3,0,2,0,0,5
CGCGAAGTGGCATACT-1_V12D07-332_B1,0,1,2,0,0,3
ACCAACCGCACTCCAC-1_V12D07-332_B1,2,1,1,0,0,4
GTCATGCGCGAGGGCT-1_V12D07-332_B1,1,0,0,0,0,1
TAGGCTAAAGTGGCAC-1_V12D07-332_B1,1,1,4,1,1,8
TGGCTACACTCTACCT-1_V12D07-332_B1,4,0,2,0,0,6
TGTCCACGGCTCAACT-1_V12D07-332_B1,3,0,3,0,0,6
AATTGCAGCAATCGAC-1_V12D07-332_B1,1,0,0,0,1,2
GTCAACCAGGCCTATA-1_V12D07-332_B1,3,1,1,1,0,6
ATCTTATCGCACACCC-1_V12D07-332_B1,1,0,1,0,0,2
GTCTATTGCATGCTCG-1_V12D07-332_B1,4,0,3,0,0,7
GCACGTGGTTTACTTA-1_V12D07-332_B1,1,0,2,0,0,3
ATTCGCGCCTTGAGAG-1_V12D07-332_B1,1,1,2,0,0,4
AGCGATGCGCCTAATA-1_V12D07-332_B1,3,0,3,0,0,6
TCTATAGGTGGGTAAT-1_V12D07-332_B1,7,1,3,0,2,13
AGATACCAATAGAACC-1_V12D07-332_B1,0,0,1,0,0,1
CGTGTATGGGAGCTGA-1_V12D07-332_B1,6,0,1,0,1,8
ATGTACATGCGGTGAG-1_V12D07-332_B1,4,0,3,0,0,7
TTGGCTCAATATGTGT-1_V12D07-332_B1,3,5,2,0,0,10
GTTCGGAGCACTCAAC-1_V12D07-332_B1,1,3,1,0,0,5
TCCCTCTTCTCAAGGG-1_V12D07-332_B1,1,1,2,0,1,5
TTACGTATCTATGACA-1_V12D07-332_B1,1,1,0,0,1,3
CCCATATAGGTCGATT-1_V12D07-332_B1,1,0,1,0,1,3
GTCCACGTCGCATTCG-1_V12D07-332_B1,4,2,0,0,0,6
AATTGTGGTTGCCAAA-1_V12D07-332_B1,3,0,1,1,0,5
AGGAACGAACGACTTC-1_V12D07-332_B1,2,2,0,0,0,4
TAATTCCAATGCTTCA-1_V12D07-332_B1,2,2,0,1,0,5
AGGGCCCTAATGTTCT-1_V12D07-332_B1,0,1,0,0,0,1
AGGTGTTGCCGACCAC-1_V12D07-332_B1,1,0,0,0,0,1
CTGAGAGTAGAAATAC-1_V12D07-332_B1,0,2,0,0,1,3
TAGAAGAAGGGTTACA-1_V12D07-332_B1,1,1,0,0,0,2
GGTGACTGATAGAGAG-1_V12D07-332_B1,1,1,0,0,0,2
TACCCTCGGTAACCCT-1_V12D07-332_B1,0,2,0,0,0,2
GCAAAGGGCGTTAGCC-1_V12D07-332_B1,0,0,0,0,0,0
CTGTTGTTCAGTCGTA-1_V12D07-332_B1,0,6,0,0,0,6
AAAGGCCCTATAATAC-1_V12D07-332_B1,0,0,12,0,1,13
AACATTGAAGTTGATC-1_V12D07-332_B1,0,4,4,0,0,8
GCTAGCGATAGGTCTT-1_V12D07-332_B1,0,0,4,0,0,4
ATTGCCTATTAGACCG-1_V12D07-332_B1,0,2,2,0,0,4
GGGCGTTTACATTCAT-1_V12D07-332_B1,3,0,0,0,0,3
CCTCTACAAGGATTGG-1_V12D07-332_B1,0,9,0,0,2,11
AGTGACTGTGACACAA-1_V12D07-332_B1,2,1,0,0,0,3
AGCCCTCCCTGGTGGC-1_V12D07-332_B1,2,2,0,0,0,4
CGGTTGAGTATCCTTC-1_V12D07-332_B1,1,1,0,0,1,3
CATTATCCCATTAACG-1_V12D07-332_B1,4,0,0,0,2,6
AATGTGCTAATCTGAG-1_V12D07-332_B1,3,1,0,0,0,4
CTTAGTTGAGGAATCG-1_V12D07-332_B1,2,2,0,0,0,4
CTTCTGGGCGTACCTA-1_V12D07-332_B1,3,0,0,0,1,4
AGTCAAATGATGTGAT-1_V12D07-332_B1,2,1,0,0,0,3
TGAACAAGCAGGGACT-1_V12D07-332_B1,1,2,0,0,1,4
AATACCGGAGGGCTGT-1_V12D07-332_B1,3,0,2,0,1,6
GTTTGGTGATCGGTGC-1_V12D07-332_B1,1,0,0,0,0,1
GACTGCTGGTGAGAAA-1_V12D07-332_B1,1,0,1,0,0,2
CGATCCTCGCAACATA-1_V12D07-332_B1,0,1,0,0,0,1
CCAACCTTATGTAACT-1_V12D07-332_B1,0,0,1,0,1,2
CGTGGTACCCAAAGGC-1_V12D07-332_B1,2,0,0,0,0,2
AACCCGACAACCCGTG-1_V12D07-332_B1,0,1,1,0,0,2
TATGTAAAGTGCTTAA-1_V12D07-332_B1,0,3,0,1,0,4
GCAAGTGTAAAGCATG-1_V12D07-332_B1,2,1,0,1,2,6
GTAACTGCCCAAGGAG-1_V12D07-332_B1,0,1,0,1,1,3
GGTGCATAAATGATTA-1_V12D07-332_B1,1,1,1,0,1,4
TAGTCCCGGAGACCAC-1_V12D07-332_B1,2,2,0,1,0,5
CGGCCAGAGCGACCAT-1_V12D07-332_B1,1,1,0,0,1,3
TGAATGAGTGTTTCCC-1_V12D07-332_B1,1,2,0,1,1,5
TTCACTTCCTAGAACG-1_V12D07-332_B1,0,0,0,0,1,1
CGCTTAGTATTGATAC-1_V12D07-332_B1,1,1,0,0,0,2
AACGCGACCTTGGGCG-1_V12D07-332_B1,0,0,1,0,0,1
GTGCACCAGCTTCAAC-1_V12D07-332_B1,2,0,0,1,0,3
TTCTATTAAACGCAGC-1_V12D07-332_B1,0,0,0,0,1,1
TGGCAAGCACAAGTCG-1_V12D07-332_B1,0,0,0,0,0,0
ATCTGCTGTTATCGCC-1_V12D07-332_B1,4,1,0,0,0,5
AATTCCAAGCATGTAC-1_V12D07-332_B1,1,1,0,0,0,2
AAACGGTTGCGAACTG-1_V12D07-332_B1,4,0,0,0,0,4
GAAGGAGTCGAGTGCG-1_V12D07-332_B1,2,2,0,0,0,4
GGCAAGCCCATAGTGG-1_V12D07-332_B1,5,0,0,0,0,5
TGACCAAATCTTAAAC-1_V12D07-332_B1,0,0,0,0,0,0
TTCGGTACTGTAGAGG-1_V12D07-332_B1,2,1,0,0,0,3
ATGTACGATGACGTCG-1_V12D07-332_B1,2,3,2,0,0,7
ATCTAGCTTGTGAGGG-1_V12D07-332_B1,0,0,0,0,0,0
AGCGGGTCTGACACTC-1_V12D07-332_B1,3,1,0,0,0,4
GAGGTACGCGTGTCCC-1_V12D07-332_B1,2,1,0,0,0,3
GCACTGCCTACCTTTA-1_V12D07-332_B1,0,0,0,0,0,0
GGAGCGAGGCCTACTT-1_V12D07-332_B1,0,0,1,0,0,1
AAACTCGGTTCGCAAT-1_V12D07-332_B1,0,0,0,0,0,0
GGCGCTTCATTCCCTG-1_V12D07-332_B1,0,1,0,0,0,1
TGCTCGGTGGGTCACC-1_V12D07-332_B1,0,1,0,0,0,1
AAGCGCAGGGCTTTGA-1_V12D07-332_B1,4,1,0,0,1,6
GACCTTCCACGTCTAC-1_V12D07-332_B1,2,0,0,0,0,2
GTTAGCCCATGACATC-1_V12D07-332_B1,1,2,0,0,1,4
AATTCGATTCGAGGAT-1_V12D07-332_B1,2,0,0,1,0,3
AGTCTTTAAAGTGTCC-1_V12D07-332_B1,2,0,1,0,0,3
GACTAGGCCGTTAGGT-1_V12D07-332_B1,0,1,1,0,0,2
TCCAAGCCTAGACACA-1_V12D07-332_B1,1,0,0,0,0,1
GATTGGGAAAGGTTGT-1_V12D07-332_B1,1,1,0,0,0,2
GATGAGGAACCTTCGG-1_V12D07-332_B1,1,2,1,0,0,4
TGAATACCGACGCGTA-1_V12D07-332_B1,1,1,0,0,0,2
AATCGTGAGCCGAGCA-1_V12D07-332_B1,1,0,0,0,0,1
GCGAAGAATCTGACGG-1_V12D07-332_B1,2,0,1,0,0,3
GAACAACTGGGATGAA-1_V12D07-332_B1,3,0,0,0,0,3
TCGCCGACATATTCGC-1_V12D07-332_B1,0,1,1,0,1,3
CGTAGAGAGTAATTAT-1_V12D07-332_B1,4,2,0,0,0,6
CGATAGTCGTACTGCA-1_V12D07-332_B1,2,0,2,0,0,4
CGCATGCCGAATGCGT-1_V12D07-332_B1,2,0,2,0,0,4
CTCTAGCCCTCGGAAA-1_V12D07-332_B1,1,1,0,0,0,2
TCCAACTCAGCTATCT-1_V12D07-332_B1,0,4,2,0,0,6
GTCTAGTGAGCCGCTT-1_V12D07-332_B1,4,0,1,0,0,5
TACCGAATAATTGTAA-1_V12D07-332_B1,1,2,2,0,1,6
ATATAACACGGGCGCA-1_V12D07-332_B1,3,1,3,0,0,7
GCATGCTAATAACGAT-1_V12D07-332_B1,3,1,0,0,0,4
TCCGGGCTTGACGGGA-1_V12D07-332_B1,4,0,1,0,1,6
ATTATTCAGAGTCACT-1_V12D07-332_B1,4,0,0,0,0,4
TAGCAGTATGACTAAA-1_V12D07-332_B1,1,0,1,0,0,2
TATGAAGAATTAAGGT-1_V12D07-332_B1,3,0,0,0,0,3
CAAGGCCAGTGGTGCA-1_V12D07-332_B1,6,2,0,0,0,8
TGCGTACGGCTAATTG-1_V12D07-332_B1,3,1,0,0,0,4
CAGATAATGGGCGGGT-1_V12D07-332_B1,8,0,2,0,1,11
GAGAACGGTTCTGACT-1_V12D07-332_B1,2,0,0,0,0,2
CGCTTCGGTCTAAGAC-1_V12D07-332_B1,4,0,1,0,0,5
AGCATTACGAGGCAAG-1_V12D07-332_B1,3,2,0,0,0,5
AAGTTGTGATGTTATA-1_V12D07-332_B1,2,1,2,0,3,8
TTGCTCATAGTACGTG-1_V12D07-332_B1,5,1,1,0,1,8
TACTTAAACATGTACA-1_V12D07-332_B1,10,3,0,0,0,13
AGTGAGTCGAATTAAC-1_V12D07-332_B1,8,2,0,0,5,15
TAGGCCTATATAGTCT-1_V12D07-332_B1,6,2,3,0,1,12
ACTCGCCGTTCGATAA-1_V12D07-332_B1,5,2,0,0,2,9
GGTACGTTGCGGCCGG-1_V12D07-332_B1,5,3,1,0,0,9
TATTGCCGGGCTTGTA-1_V12D07-332_B1,4,0,2,0,4,10
GGTAAACTCTGCGCTG-1_V12D07-332_B1,5,2,0,0,0,7
TCCCTTGTCTGAAACT-1_V12D07-332_B1,6,1,0,0,1,8
CATGATCGCTTTGAGA-1_V12D07-332_B1,4,1,0,0,2,7
GGACGGGCGACCAACC-1_V12D07-332_B1,4,0,1,0,0,5
GAGAGGCCTATGTGTA-1_V12D07-332_B1,6,0,1,0,1,8
TCGTAACTCCCAAGAC-1_V12D07-332_B1,5,1,2,0,4,12
CGTATCTAGAACTAAG-1_V12D07-332_B1,7,1,0,0,0,8
GCACCTTCCCGAAGGT-1_V12D07-332_B1,4,0,0,0,0,4
TACCTCTTTACCATCC-1_V12D07-332_B1,4,0,0,0,0,4
TGACTCTAACTGGTAA-1_V12D07-332_B1,0,1,0,0,0,1
GAGAAACTGGATCCCA-1_V12D07-332_B1,2,1,0,1,0,4
ATCCGGACCAGCCTGA-1_V12D07-332_B1,0,0,0,0,0,0
TTATTTAGGTTCCTTA-1_V12D07-332_B1,1,1,0,0,0,2
CGAATTCCCGGTTCAA-1_V12D07-332_B1,0,2,0,0,0,2
TGCAGTGGTAGGGAAC-1_V12D07-332_B1,0,0,0,0,0,0
TTGCCTAATCCAAAGT-1_V12D07-332_B1,0,8,0,0,0,8
AGCGAGACGTGAAGGC-1_V12D07-332_B1,0,1,0,0,0,1
TTCTACCTCAATCGGT-1_V12D07-332_B1,0,9,0,1,0,10
TACGCTGCTGTGTTAA-1_V12D07-332_B1,0,2,2,0,0,4
TAGTCCTGCACTAAGC-1_V12D07-332_B1,0,7,0,1,0,8
AGCACACGTTTAGACT-1_V12D07-332_B1,0,0,4,0,0,4
GTTCGACAATTGTATA-1_V12D07-332_B1,0,2,4,0,0,6
CCATGTTCATCTATAT-1_V12D07-332_B1,4,2,0,0,0,6
CCCTCGATAATACACA-1_V12D07-332_B1,4,3,0,0,0,7
ACTGCCCGCCATTCTC-1_V12D07-332_B1,6,1,0,0,0,7
CTATATCCAGCCTGGC-1_V12D07-332_B1,2,0,0,0,2,4
CGCACGTCTGTTTATG-1_V12D07-332_B1,2,0,0,0,0,2
AATCAGGTTTCATTTA-1_V12D07-332_B1,2,2,0,0,0,4
AGAGAAACACCAGAAA-1_V12D07-332_B1,3,1,0,0,0,4
ACCCGATTGGTTCCGA-1_V12D07-332_B1,2,1,0,0,0,3
TACCAGGAATCCCGTC-1_V12D07-332_B1,6,0,0,0,0,6
AAGTGCTTCTCTATTG-1_V12D07-332_B1,2,0,0,0,1,3
TGCATGTGACCCATAG-1_V12D07-332_B1,5,0,1,0,0,6
TAGATTCAAAGTGCGG-1_V12D07-332_B1,1,0,0,0,0,1
AGGGTCAGAGCACTCG-1_V12D07-332_B1,2,0,1,0,0,3
GTGAGATAACCTTATA-1_V12D07-332_B1,1,0,0,0,0,1
GTGTCAGTGTACGTGG-1_V12D07-332_B1,0,0,1,0,0,1
CTGTAGTGAGGATCGA-1_V12D07-332_B1,0,1,1,0,2,4
GATAGTGCGAGTAAGT-1_V12D07-332_B1,1,0,0,0,0,1
AGGGTTCAGACGGTCC-1_V12D07-332_B1,2,0,0,0,0,2
GGACTCGACAGCGCAT-1_V12D07-332_B1,0,2,0,1,0,3
CACTCTCAAGCATCGA-1_V12D07-332_B1,2,1,0,0,2,5
GAGCGGAATGCGGTGT-1_V12D07-332_B1,0,1,0,0,0,1
CAGTTCGAGGACCCGA-1_V12D07-332_B1,0,3,0,0,0,3
CGTAACTTCGACACTT-1_V12D07-332_B1,0,2,0,1,0,3
TGATCACCACACTGAC-1_V12D07-332_B1,0,1,0,1,0,2
CATACTTCTTTCTCCG-1_V12D07-332_B1,1,1,0,0,0,2
CAAGTAAGTGATAGAC-1_V12D07-332_B1,0,1,0,1,1,3
AGCCCGCAACAAGCAG-1_V12D07-332_B1,1,0,0,0,0,1
GCTCCATGCAAAGCAA-1_V12D07-332_B1,1,1,0,1,0,3
TCGTACCGACGTCAAG-1_V12D07-332_B1,1,0,1,0,0,2
ATTATCGGAATGTACG-1_V12D07-332_B1,3,1,0,1,0,5
ACCTACTATAAATCTA-1_V12D07-332_B1,1,0,0,0,0,1
TATCCTATCAACTGGT-1_V12D07-332_B1,0,0,0,0,0,0
GCGCGGTCTAGTAACT-1_V12D07-332_B1,2,0,0,0,1,3
CCTTCGTATAGAATCC-1_V12D07-332_B1,2,0,0,0,0,2
TGGGCGATACAATAAG-1_V12D07-332_B1,0,1,0,0,1,2
TGACATGTAACGTGAC-1_V12D07-332_B1,0,0,0,0,0,0
TTGGGAAGACGAGCCG-1_V12D07-332_B1,3,1,0,0,0,4
GGTGTAAATCGATTGT-1_V12D07-332_B1,4,0,0,0,1,5
GAACTGTGGAGAGACA-1_V12D07-332_B1,1,0,0,0,0,1
TCCACATCGTATATTG-1_V12D07-332_B1,1,0,0,0,0,1
CCTATGGTCAAAGCTG-1_V12D07-332_B1,0,0,0,0,0,0
TCCTTGTCCTTTAATT-1_V12D07-332_B1,1,1,0,0,0,2
AAGTTTATGGGCCCAA-1_V12D07-332_B1,0,2,0,0,0,2
GTCCGGGTTCACATTA-1_V12D07-332_B1,5,2,0,0,0,7
ATGTAGCGCGCGTAGG-1_V12D07-332_B1,1,1,0,0,0,2
TACGGAAGCCAAACCA-1_V12D07-332_B1,2,0,0,0,0,2
GCCCTGAGGATGGGCT-1_V12D07-332_B1,1,0,0,0,0,1
CGGGCGATGGATCACG-1_V12D07-332_B1,2,1,0,0,0,3
TGCGGACTTGACTCCG-1_V12D07-332_B1,3,0,1,0,0,4
TAATACTAGAACAGAC-1_V12D07-332_B1,1,1,1,0,0,3
TCAAATTGTTGTGCCG-1_V12D07-332_B1,0,1,1,0,0,2
GGGCAGTCAACGCCAA-1_V12D07-332_B1,0,0,0,0,0,0
TCGCTGCCAATGCTGT-1_V12D07-332_B1,1,1,0,0,0,2
TACGTGGGCCCAGGGC-1_V12D07-332_B1,1,2,0,0,0,3
GCCTACGTTCTGTGCA-1_V12D07-332_B1,2,0,0,0,0,2
TTGCGTGTGTAGGCAT-1_V12D07-332_B1,0,1,0,0,0,1
TCCTAAAGATTCAGAC-1_V12D07-332_B1,3,1,1,0,1,6
TGGGTGCACAAGCCAT-1_V12D07-332_B1,1,1,0,0,0,2
GGGAGCGACCGTAGTG-1_V12D07-332_B1,1,0,0,0,0,1
CATAGAGGAGATACTA-1_V12D07-332_B1,0,0,0,0,0,0
CTTCGATTGCGCAAGC-1_V12D07-332_B1,4,2,1,0,0,7
GTGCCTGAGACCAAAC-1_V12D07-332_B1,0,0,0,0,0,0
TCATCCTCAGCTGCTT-1_V12D07-332_B1,3,0,1,0,0,4
TGCAACTACTGGTTGA-1_V12D07-332_B1,1,0,0,0,0,1
ATGTTGATTAGAGACT-1_V12D07-332_B1,1,1,0,0,0,2
GTTTCTAGAGGCGCGG-1_V12D07-332_B1,2,1,0,0,1,4
TACAAGGGCTTCTTTA-1_V12D07-332_B1,3,0,0,0,0,3
ACAGGCACGGATCCTT-1_V12D07-332_B1,2,0,0,0,0,2
CCCAAGTCATTACACT-1_V12D07-332_B1,4,2,0,0,0,6
ACTCTGACCTAATAGA-1_V12D07-332_B1,1,0,0,0,0,1
GGATGGCTTGAAGTAT-1_V12D07-332_B1,4,0,1,0,0,5
ACCCTCCCGTCAGGGC-1_V12D07-332_B1,4,1,0,1,0,6
AGCTTCTTCTCGAGCA-1_V12D07-332_B1,3,1,0,0,0,4
TTGCGCTTGATCAATA-1_V12D07-332_B1,1,0,1,0,1,3
TGGGTGTAATAGATTT-1_V12D07-332_B1,2,0,0,0,2,4
CATGGTTTATTAATCA-1_V12D07-332_B1,3,0,0,0,1,4
TTGCCTTCTCGCCGGG-1_V12D07-332_B1,2,2,0,0,1,5
TTAAAGTAAGTCGCCA-1_V12D07-332_B1,3,0,0,0,0,3
AGTTGGCAAGGCTAGA-1_V12D07-332_B1,4,0,0,0,1,5
CCGCACTTGCAATGAC-1_V12D07-332_B1,8,0,0,0,1,9
AATGTTGTCGTGAGAC-1_V12D07-332_B1,7,2,1,0,1,11
CCAAGGTTGCCCTTTC-1_V12D07-332_B1,3,0,0,0,1,4
TGTGACTAGAGTTTGC-1_V12D07-332_B1,8,3,0,0,0,11
TTGTGATCTGTTCAGT-1_V12D07-332_B1,9,0,0,1,1,11
GGAGTTGATTCTGTGT-1_V12D07-332_B1,2,1,2,0,0,5
GTAGTGAGCAACCTCA-1_V12D07-332_B1,0,0,0,0,0,0
AAGACATACGTGGTTT-1_V12D07-332_B1,6,0,1,0,0,7
CATCCCGAGATTCATA-1_V12D07-332_B1,1,0,3,0,0,4
GGCCGCAGGAACCGCA-1_V12D07-332_B1,8,0,0,0,0,8
CCAGAAACTGATGCGA-1_V12D07-332_B1,0,0,8,0,0,8
ACCCGTAGTCTAGTTG-1_V12D07-332_B1,2,0,1,0,0,3
AGGGTCTGGACGCAGT-1_V12D07-332_B1,1,1,0,0,0,2
TTGAAACCCTCATTCC-1_V12D07-332_B1,3,3,2,0,0,8
TCAATCCCGCGCCAAA-1_V12D07-332_B1,3,0,0,0,0,3
AGGACATCGGCACACT-1_V12D07-332_B1,2,1,0,0,0,3
GACAAGACGCCCGTGC-1_V12D07-332_B1,2,1,0,0,0,3
GAGTAAATTAAGAACC-1_V12D07-332_B1,3,0,0,0,0,3
TAAGTCGGTGAGCTAG-1_V12D07-332_B1,1,0,0,0,0,1
CTTACTGACTCCTCTG-1_V12D07-332_B1,0,0,1,1,1,3
TTAACTGATCGTTTGG-1_V12D07-332_B1,0,0,0,0,1,1
CGGATGAATGCTGTGA-1_V12D07-332_B1,0,8,0,1,0,9
CTCTGCAGGCATTCTT-1_V12D07-332_B1,0,16,0,3,0,19
TCAAAGTCACGGCGTC-1_V12D07-332_B1,0,4,0,0,0,4
TGGGTTTCGGGCGTAC-1_V12D07-332_B1,0,1,0,2,0,3
TGCTATGGCAAAGGGA-1_V12D07-332_B1,0,10,0,2,0,12
TTCACGGTCGTCACGT-1_V12D07-332_B1,0,7,0,10,0,17
CGTAAAGCAAGAAATC-1_V12D07-332_B1,0,3,1,0,0,4
CTGATCCCTTTATGCA-1_V12D07-332_B1,0,9,0,0,0,9
GAGTATACCCTAATCA-1_V12D07-332_B1,2,2,0,0,0,4
CCACGGCAGGTGTAGG-1_V12D07-332_B1,0,3,0,0,0,3
ACGTACTTTGGCACGG-1_V12D07-332_B1,1,1,0,0,1,3
CCTGAGAATAAATGCA-1_V12D07-332_B1,7,1,0,0,0,8
TTGATGCCGCTCGTCG-1_V12D07-332_B1,1,0,0,0,0,1
GCCAGGAAAGAACACT-1_V12D07-332_B1,5,1,0,0,1,7
TCCGACCGCTAATCAA-1_V12D07-332_B1,5,0,0,0,0,5
TATATCAAAGTGATCT-1_V12D07-332_B1,3,1,1,0,0,5
CCTCGGTTTCCTTGCC-1_V12D07-332_B1,3,1,0,0,0,4
TAAATTTAGTAACACC-1_V12D07-332_B1,0,2,0,0,0,2
CTCGTTACGGCTACCA-1_V12D07-332_B1,5,1,0,0,1,7
GCCGTCGGTTTCGGGC-1_V12D07-332_B1,3,2,0,0,0,5
GTTCCGTCCGCCTGCA-1_V12D07-332_B1,1,1,2,0,0,4
CTAGGGATAGGGACAA-1_V12D07-332_B1,1,1,0,0,0,2
GTCCAGGCACGTGTGC-1_V12D07-332_B1,1,1,3,0,0,5
GAGGAATATCTCTTTG-1_V12D07-332_B1,2,0,0,0,0,2
CGTTCAAGGAAACGGA-1_V12D07-332_B1,1,1,0,0,0,2
GTGGGAACAAACCGGG-1_V12D07-332_B1,4,0,2,1,0,7
GGGCACGTAGTACTGT-1_V12D07-332_B1,2,0,0,0,0,2
ACTACAAAGAGAGGTG-1_V12D07-332_B1,3,3,0,0,0,6
GGTGTAGGTAAGTAAA-1_V12D07-332_B1,1,2,1,0,1,5
CCTGTTCAACCTCGGG-1_V12D07-332_B1,3,0,0,1,4,8
TGAGGTGTGTGGCGGA-1_V12D07-332_B1,0,2,0,0,0,2
ATTGTCTGTTTCATGT-1_V12D07-332_B1,0,0,0,0,0,0
GCCGGTCGTATCTCTC-1_V12D07-332_B1,0,3,0,1,1,5
ATATGGGATAGCAACT-1_V12D07-332_B1,1,1,3,0,1,6
GATAGAACCCGCTAGG-1_V12D07-332_B1,1,3,0,1,0,5
ATCCCATTTCCGTGGG-1_V12D07-332_B1,0,1,0,0,0,1
GATGCTACCTTCGATG-1_V12D07-332_B1,1,1,2,0,0,4
TGCAAAGTTCGTCTGT-1_V12D07-332_B1,1,0,0,0,0,1
GTTCAGTCGCCAAATG-1_V12D07-332_B1,0,2,1,0,0,3
GTCTCCGCCTCAATAC-1_V12D07-332_B1,1,1,0,0,0,2
AGTAGAAGGCGCCTCA-1_V12D07-332_B1,3,0,0,0,1,4
GTTGTAGATTTATGAG-1_V12D07-332_B1,2,1,1,1,0,5
CTATTTGCTTGGAGGA-1_V12D07-332_B1,1,1,0,0,0,2
AGCCATATAGTATGTG-1_V12D07-332_B1,0,0,0,0,0,0
TGTTCCGGCCTGAGCT-1_V12D07-332_B1,2,0,0,0,0,2
TGCCGTGGGACCCAAT-1_V12D07-332_B1,0,1,0,0,0,1
TTGCAAGAAGACTCCT-1_V12D07-332_B1,0,1,0,0,0,1
CCGCTCCAGGGCGATC-1_V12D07-332_B1,2,1,0,0,0,3
CAAACCCTCCGGCGGG-1_V12D07-332_B1,1,0,0,0,0,1
CGGACCTTTACGTCCC-1_V12D07-332_B1,2,0,0,0,0,2
ACGTAGGAGAGTCGCT-1_V12D07-332_B1,2,0,0,0,0,2
CTGCGACCTCGCCGAA-1_V12D07-332_B1,1,0,0,0,0,1
GGCCCAGCTGGTTTGC-1_V12D07-332_B1,2,0,0,0,0,2
GGATTAATCATGGACC-1_V12D07-332_B1,1,2,0,0,0,3
GAGATGGCTTTAATCA-1_V12D07-332_B1,0,0,0,0,0,0
AGTACAGAAGCTTATA-1_V12D07-332_B1,0,1,0,0,1,2
GCGGCTTTAGCAAGTT-1_V12D07-332_B1,2,2,0,0,0,4
ACCGAGTCTCCTTATT-1_V12D07-332_B1,1,0,0,0,0,1
GACCACACTTCCCTTT-1_V12D07-332_B1,2,1,0,0,0,3
TGTAGCCAATTCCGTT-1_V12D07-332_B1,2,1,0,0,0,3
CTCGTCTGTGCCTTCG-1_V12D07-332_B1,3,3,1,0,0,7
GGACTCTTTGACTAAG-1_V12D07-332_B1,3,0,0,0,0,3
TCATCGACGACCGTCG-1_V12D07-332_B1,2,2,0,1,0,5
TACTACGTGCAATGCG-1_V12D07-332_B1,2,0,0,0,0,2
CCCTACTTGAACAATG-1_V12D07-332_B1,2,3,0,0,0,5
GCAGCTGTCAACGCAT-1_V12D07-332_B1,2,0,0,0,0,2
ATCTACCATCTGCTCC-1_V12D07-332_B1,1,0,0,0,0,1
TCTCAAATCAATCGGG-1_V12D07-332_B1,3,2,0,0,0,5
ACTCCGGCCGACCACT-1_V12D07-332_B1,0,0,0,0,0,0
TACACCTCTTCGAATC-1_V12D07-332_B1,1,0,0,0,0,1
GTGGCTGTTTCTGTTC-1_V12D07-332_B1,1,0,0,0,1,2
ACGACTCTAGGGCCGA-1_V12D07-332_B1,1,1,1,0,0,3
TCGTTTACGCGACCCT-1_V12D07-332_B1,1,1,2,0,0,4
AGGATATCCGACTGCA-1_V12D07-332_B1,0,3,0,0,1,4
GACACTTCCAATTACC-1_V12D07-332_B1,1,2,1,0,0,4
ACGGTACAGTTCAATG-1_V12D07-332_B1,0,2,0,0,0,2
CTTGATGACCATCCAG-1_V12D07-332_B1,2,0,0,0,0,2
CTGGTAAAGACTTACA-1_V12D07-332_B1,1,2,0,0,0,3
CTTGCCCACCCACGCA-1_V12D07-332_B1,5,1,2,1,0,9
CATTACGCAGGAAGGG-1_V12D07-332_B1,1,0,1,0,0,2
GGACAACCATGAAGCC-1_V12D07-332_B1,2,0,2,0,0,4
GTTATCAAGCTATCGA-1_V12D07-332_B1,2,0,1,0,0,3
AGGTGCACGTCCACAT-1_V12D07-332_B1,4,0,1,0,0,5
AAAGAATGTGGACTAA-1_V12D07-332_B1,3,0,4,1,1,9
ACCAAGTCATCGGCAG-1_V12D07-332_B1,2,0,2,0,0,4
AGTAACTATAGCAGCC-1_V12D07-332_B1,1,0,0,0,0,1
GGGAAAGAATGCCAAC-1_V12D07-332_B1,4,0,2,0,1,7
AATCGGTATAGCCCTC-1_V12D07-332_B1,1,0,0,0,0,1
GGCACTGCGGTGGTTT-1_V12D07-332_B1,4,0,3,0,1,8
CGTCCTCATCGCGTGC-1_V12D07-332_B1,2,0,1,0,0,3
CTTAACTTACAGTATA-1_V12D07-332_B1,3,0,0,0,2,5
GTGAGTCGACTAATAG-1_V12D07-332_B1,3,0,0,0,1,4
TGTACTTCCGGGCATG-1_V12D07-332_B1,6,0,0,0,1,7
CACAAACCGCAGAACT-1_V12D07-332_B1,0,1,1,0,0,2
GCTTTACACAACTGGG-1_V12D07-332_B1,4,0,0,0,0,4
CACCGATGATGGGTAC-1_V12D07-332_B1,3,0,0,0,0,3
TCAATATACAGGAGGC-1_V12D07-332_B1,5,0,1,0,0,6
AACGACCTCCTAGCCG-1_V12D07-332_B1,1,2,1,0,1,5
GTTACCAAGGCGTACG-1_V12D07-332_B1,4,2,0,0,1,7
TAGCTCACTGTGTTTG-1_V12D07-332_B1,2,1,0,0,0,3
TCGGCAGGGTTAAGGG-1_V12D07-332_B1,3,0,0,0,0,3
TGTTAACAAAGTGACT-1_V12D07-332_B1,1,2,0,0,1,4
CAGAGCGATGGATGCT-1_V12D07-332_B1,1,2,0,0,0,3
CATAGTGGGCACGCCT-1_V12D07-332_B1,1,1,0,0,0,2
AAACGCTGGGCACGAC-1_V12D07-332_B1,1,2,0,0,0,3
TGTTCTCATACTATAG-1_V12D07-332_B1,0,0,0,0,0,0
CCAAATCAAAGGGCAA-1_V12D07-332_B1,0,4,0,7,0,11
GTAGTTTAAGCACACG-1_V12D07-332_B1,0,13,0,0,0,13
CTCGAGGCAAGTTTCA-1_V12D07-332_B1,1,7,1,0,0,9
GCTGGGAGCGCGTCAA-1_V12D07-332_B1,0,2,1,0,0,3
GACGATATCACTGGGT-1_V12D07-332_B1,5,2,0,0,0,7
CAGCTCTGGGCTCACT-1_V12D07-332_B1,2,1,0,0,0,3
TAGTCTGCGGCACATT-1_V12D07-332_B1,1,1,0,0,2,4
TGGTCGATATACCTCT-1_V12D07-332_B1,3,0,0,0,0,3
TTCAGTTCAAGAGGAG-1_V12D07-332_B1,1,2,1,0,0,4
GTCTGTAGGTTGAACA-1_V12D07-332_B1,5,1,0,0,1,7
GAGAGTCTCGGGAGAG-1_V12D07-332_B1,2,0,2,0,0,4
TTGTTTGTATTACACG-1_V12D07-332_B1,2,2,1,0,0,5
GCACAGCACGGGCCGA-1_V12D07-332_B1,2,2,0,0,0,4
AAACAGTGTTCCTGGG-1_V12D07-332_B1,1,1,1,0,1,4
TGGAGAATAATCGTCC-1_V12D07-332_B1,0,0,1,0,0,1
CGCCGCGTTCTGAACG-1_V12D07-332_B1,3,0,1,0,0,4
CATGCGTTGAGAGGAG-1_V12D07-332_B1,2,0,1,0,0,3
TACGCTCCTAGAACTG-1_V12D07-332_B1,4,0,0,0,1,5
CCTTGTGAACGTGGTT-1_V12D07-332_B1,2,1,2,0,1,6
TTAAAGGCGATGCTCG-1_V12D07-332_B1,0,0,0,0,1,1
TAAAGTGCACGTCTCG-1_V12D07-332_B1,0,1,1,0,0,2
TGTCCGCAAACAATTC-1_V12D07-332_B1,0,0,1,0,0,1
AGGCCTATCATACCAA-1_V12D07-332_B1,1,1,1,1,0,4
ACTGGGATGCCAGTGC-1_V12D07-332_B1,0,1,0,0,0,1
CGATCCACCATTGTTG-1_V12D07-332_B1,0,1,0,1,0,2
GGGCATGCATGTCGAG-1_V12D07-332_B1,0,0,0,1,0,1
TCCAGGCAGGACGATC-1_V12D07-332_B1,1,0,0,0,0,1
CAATGACCCTTAATTT-1_V12D07-332_B1,0,1,0,2,0,3
ATCAAGATCCCAGGAC-1_V12D07-332_B1,0,1,0,1,0,2
CTCAGAGCTAATGTCG-1_V12D07-332_B1,0,0,0,1,0,1
CTGCGATTTCGAGATT-1_V12D07-332_B1,0,2,0,1,0,3
ATGGTATTGGGAACCG-1_V12D07-332_B1,3,2,0,1,0,6
TAGGTTCTGCTGAGAA-1_V12D07-332_B1,0,1,0,0,0,1
GCCTGTCCCGGTGCAT-1_V12D07-332_B1,0,0,0,0,0,0
GGCCTGCTCTGATGTT-1_V12D07-332_B1,0,0,0,0,0,0
TAGAGGGAGTTTATCT-1_V12D07-332_B1,1,0,0,0,0,1
CTCTACATCCTGCGTG-1_V12D07-332_B1,1,0,0,0,0,1
ACACATTTCCGTAGAC-1_V12D07-332_B1,1,0,0,0,0,1
TGGGTGTTAAGTAGAA-1_V12D07-332_B1,1,0,0,0,0,1
GAGCTCAACATGAGCG-1_V12D07-332_B1,0,1,0,0,1,2
GCACACAGCTATTACC-1_V12D07-332_B1,4,0,0,0,0,4
GCGACGGTAGTCTCCT-1_V12D07-332_B1,2,0,1,0,0,3
GTATCAAGGTACTTCC-1_V12D07-332_B1,3,0,0,0,0,3
GGAAAGGGAATTGAGC-1_V12D07-332_B1,0,1,0,0,1,2
TACACAGCCGTGGTGC-1_V12D07-332_B1,2,0,0,0,0,2
CGGTTGGGCAGGGTCC-1_V12D07-332_B1,2,0,0,0,0,2
GCACGCCGATTCCCGC-1_V12D07-332_B1,6,0,0,0,0,6
CGCTTTCCGCCAAGGT-1_V12D07-332_B1,2,0,0,0,0,2
TGCCCGATAGTTAGAA-1_V12D07-332_B1,2,1,0,0,0,3
TCAGAACGGCGGTAAT-1_V12D07-332_B1,2,0,0,0,0,2
CCACTCAGATCCGCAA-1_V12D07-332_B1,1,2,0,0,2,5
GAAGGGTCATTAAGAC-1_V12D07-332_B1,4,0,0,0,0,4
GCGGTCTTGCTTTCAC-1_V12D07-332_B1,0,0,0,0,0,0
GGAAGGACACCGTATA-1_V12D07-332_B1,2,1,0,0,0,3
CGCGGGAATTCCTTTC-1_V12D07-332_B1,3,1,0,0,0,4
TCTATCCGATTGCACA-1_V12D07-332_B1,0,0,0,0,0,0
TACTCGTTTGAATCAA-1_V12D07-332_B1,2,0,0,0,0,2
GTCTGCCGACTCGACG-1_V12D07-332_B1,3,0,0,1,0,4
TACGGGTAATAACATA-1_V12D07-332_B1,1,3,0,0,0,4
CCAGTTCGGTAACTCA-1_V12D07-332_B1,1,0,0,0,0,1
CGTGCACACCACTGTA-1_V12D07-332_B1,0,1,0,0,0,1
CTTCAGTTGGACAACG-1_V12D07-332_B1,0,2,0,0,0,2
TGATCTATCACACTCT-1_V12D07-332_B1,0,1,0,0,0,1
TAGCAGATACTTAGGG-1_V12D07-332_B1,2,1,0,0,0,3
CACCGGGCATCACAAG-1_V12D07-332_B1,1,0,0,0,0,1
AGTGGCCCGCAAATGG-1_V12D07-332_B1,0,0,0,0,0,0
CTCGCTAGGTAAGCGA-1_V12D07-332_B1,0,2,0,0,0,2
GATAGATAGTACAGTC-1_V12D07-332_B1,0,0,0,0,0,0
CGAGACTACTGCTGCT-1_V12D07-332_B1,0,0,0,0,0,0
ACATTTGAAACCTAAC-1_V12D07-332_B1,1,1,0,0,1,3
GACACAGCCGGGACTG-1_V12D07-332_B1,2,0,0,0,0,2
ACGGAACACGAGTGCC-1_V12D07-332_B1,0,0,1,0,0,1
ACGCCAGTGCGTTTGC-1_V12D07-332_B1,2,0,1,1,0,4
GCACCTAGGCGAGTCC-1_V12D07-332_B1,2,0,0,0,0,2
TCACTATCCCTTCGGT-1_V12D07-332_B1,3,0,1,0,0,4
TGAGTGTAACAACGGG-1_V12D07-332_B1,3,1,0,0,0,4
ATTGGTTGTGCATTAC-1_V12D07-332_B1,2,0,0,1,0,3
CTGGCGATTTACATGT-1_V12D07-332_B1,2,0,0,0,0,2
TCCACCAAGACATAGG-1_V12D07-332_B1,4,0,2,0,3,9
AACGTCGCTGCACTTC-1_V12D07-332_B1,3,0,1,0,0,4
GTCTCCCGAGTCCCGT-1_V12D07-332_B1,1,1,1,0,0,3
AGCCCGCACTACAATG-1_V12D07-332_B1,0,3,0,0,0,3
GGCACGCTGCTACAGT-1_V12D07-332_B1,2,2,1,0,0,5
GCTTGAGTGACCTCTG-1_V12D07-332_B1,1,0,0,0,0,1
ATAGCCATAACAGTCA-1_V12D07-332_B1,3,1,1,0,0,5
TAGGAGGCTCGAGAAC-1_V12D07-332_B1,2,2,0,0,0,4
GTCGGGTGAAGTACCG-1_V12D07-332_B1,3,0,0,1,1,5
CACCCGCGTTTGACAC-1_V12D07-332_B1,0,5,0,0,0,5
TCTCAGGCTACTCGCT-1_V12D07-332_B1,1,2,0,1,0,4
TAGATTCTCTAGCAAA-1_V12D07-332_B1,0,3,0,0,0,3
CCCATTATTGTATCCT-1_V12D07-332_B1,0,2,0,1,0,3
GTTAATAGCGTCATTA-1_V12D07-332_B1,1,1,0,0,0,2
TACTCATTGACGCATC-1_V12D07-332_B1,0,3,0,0,0,3
TAGTGACAAGCTCTAC-1_V12D07-332_B1,1,1,0,0,0,2
ATCGCCGTGGTTCATG-1_V12D07-332_B1,2,0,0,0,2,4
CTGCTCTCAACACACC-1_V12D07-332_B1,1,1,0,0,1,3
GCATGACACAAAGGAA-1_V12D07-332_B1,1,0,0,0,0,1
CAACGATCGATCCAAT-1_V12D07-332_B1,0,0,0,0,0,0
GGGATATTGATCGCCA-1_V12D07-332_B1,0,13,0,5,3,21
TAATGTCGGTTCATGG-1_V12D07-332_B1,0,4,0,11,1,16
CGATTTGTCATTAATG-1_V12D07-332_B1,0,0,0,8,0,8
TTAAGATACCCAGAGA-1_V12D07-332_B1,0,0,0,9,0,9
CGACCGTTGGTATTCG-1_V12D07-332_B1,0,3,0,1,0,4
ATGTCTTGTTTGACTC-1_V12D07-332_B1,0,12,0,2,2,16
TCCCAAACATCCTCTA-1_V12D07-332_B1,0,13,0,0,0,13
CAACGCGATGAGCCAA-1_V12D07-332_B1,3,0,0,0,0,3
GACACCCAAAGACGCG-1_V12D07-332_B1,0,0,0,0,0,0
ACGTTCACTATGCCGC-1_V12D07-332_B1,0,2,0,0,0,2
ATGGACTGCTTAGTTG-1_V12D07-332_B1,3,3,0,0,0,6
CCATGGCAAACGCTCA-1_V12D07-332_B1,2,0,0,1,1,4
TTGTCTCGGCAAGATG-1_V12D07-332_B1,4,1,0,0,0,5
TTCGAACGAAACATGC-1_V12D07-332_B1,1,0,0,0,2,3
GGAAAGTCTTGATTGT-1_V12D07-332_B1,1,2,0,0,0,3
ATCATAGATCGACGAG-1_V12D07-332_B1,5,0,0,0,0,5
GATTAGAAACAAGCGT-1_V12D07-332_B1,1,1,0,0,0,2
GCTGCGAAGAATTATT-1_V12D07-332_B1,2,1,0,0,0,3
TTCCAGTGGGTTTCGT-1_V12D07-332_B1,2,0,0,0,0,2
GCTCATTGATCATATC-1_V12D07-332_B1,3,0,0,0,0,3
ATACGAGGTTTGTAAG-1_V12D07-332_B1,2,0,0,0,0,2
GTCTATACACGCATGG-1_V12D07-332_B1,0,0,0,0,0,0
GATTTGCGCTAACACC-1_V12D07-332_B1,0,0,0,0,1,1
TGGTGCCCTGCCTTAC-1_V12D07-332_B1,3,0,3,0,1,7
TCGAATCGCAGGGTAG-1_V12D07-332_B1,1,0,1,0,0,2
GGTAGGCCAATATCAC-1_V12D07-332_B1,0,0,0,0,0,0
CGTAAATAACAAAGGG-1_V12D07-332_B1,0,1,0,1,0,2
GACTCTAGAGTTCCAA-1_V12D07-332_B1,0,0,0,1,0,1
ACTTGTTACCGGATCA-1_V12D07-332_B1,1,0,0,0,1,2
GGCATTGAACATCTCA-1_V12D07-332_B1,1,1,0,2,0,4
AACCCGCTGTATTCCA-1_V12D07-332_B1,0,3,0,0,1,4
TAACAGGTTCCCTTAG-1_V12D07-332_B1,0,1,0,0,0,1
GTTCTTGTAACTCAAT-1_V12D07-332_B1,0,1,0,0,1,2
GATTCTGTTAATGAGT-1_V12D07-332_B1,1,0,0,1,0,2
GGACACCTCGGTGTTG-1_V12D07-332_B1,1,1,0,0,1,3
CGATCGAGAAGCACCA-1_V12D07-332_B1,0,0,0,0,0,0
CTGCTCTGACGGCAAA-1_V12D07-332_B1,1,0,1,0,1,3
CCCAGGAAGAATTCGA-1_V12D07-332_B1,1,1,0,0,0,2
TGTCGTGGGTATAGGC-1_V12D07-332_B1,1,1,0,0,0,2
ATATGTCTAGAGCGTG-1_V12D07-332_B1,1,1,0,0,0,2
GCGGGCAGACGGGTGA-1_V12D07-332_B1,0,5,3,0,2,10
CGAAGATCAGTTTCAT-1_V12D07-332_B1,4,1,0,0,0,5
ACGCCACTCGAAACAG-1_V12D07-332_B1,0,1,0,0,0,1
CTTAGATGTTTCATCC-1_V12D07-332_B1,0,0,0,0,0,0
GCGAATGGACTAGCGA-1_V12D07-332_B1,0,0,1,0,0,1
TAAATTGTGGGTAAAG-1_V12D07-332_B1,1,0,0,0,0,1
ATTTATACTGGTAAAG-1_V12D07-332_B1,0,6,6,0,0,12
GCGTCGTAACATGGTC-1_V12D07-332_B1,3,0,0,0,0,3
CGGTATGGGCACTCTG-1_V12D07-332_B1,0,1,0,0,0,1
CTATCACAACGCTGGA-1_V12D07-332_B1,2,0,0,0,0,2
ACCACACGGTTGATGG-1_V12D07-332_B1,0,0,0,0,1,1
TCAGCGCACGCCGTTT-1_V12D07-332_B1,1,0,0,0,1,2
AATGTTAAGACCCTGA-1_V12D07-332_B1,1,0,0,0,0,1
CTTACATAGATTTCTT-1_V12D07-332_B1,2,0,0,0,0,2
AACATAGCGTGTATCG-1_V12D07-332_B1,0,0,0,0,0,0
AGCAGTCGAAGCATGC-1_V12D07-332_B1,2,0,0,0,1,3
GTACTACGGCCTCGTT-1_V12D07-332_B1,1,1,0,0,0,2
TTGGCCAAATTGTATC-1_V12D07-332_B1,1,0,0,0,0,1
TCAGAGGACGCGTTAG-1_V12D07-332_B1,0,1,0,0,1,2
AGTAATCTAAGGGTGG-1_V12D07-332_B1,2,0,0,0,0,2
AATTATACCCAGCAAG-1_V12D07-332_B1,1,0,0,0,0,1
CCCTACCCACACCCAG-1_V12D07-332_B1,3,1,0,0,0,4
CTCTGTCCATGCACCA-1_V12D07-332_B1,1,3,0,0,0,4
TCGCCTCCTTCGGCTC-1_V12D07-332_B1,0,1,0,0,0,1
CCTGATTCGCGAAGAA-1_V12D07-332_B1,0,0,0,0,0,0
GACTTCAACGCATCAA-1_V12D07-332_B1,2,0,0,0,0,2
GCTTCCCGTAAGCTCC-1_V12D07-332_B1,0,0,0,0,0,0
AGAACTGTACTTTGTA-1_V12D07-332_B1,4,1,0,0,0,5
CCTTAAGTACGCAATT-1_V12D07-332_B1,3,1,0,0,1,5
GGCCAATTGTATAGAC-1_V12D07-332_B1,4,0,0,0,0,4
AGAATACAGGCTATCC-1_V12D07-332_B1,2,1,0,0,0,3
AATACCTGATGTGAAC-1_V12D07-332_B1,1,0,0,0,0,1
TAGAGTGTTCCGGGTA-1_V12D07-332_B1,0,0,0,0,0,0
GCTTCCATGTAACCGC-1_V12D07-332_B1,2,0,0,0,0,2
GGTTCGCATTTGCCGT-1_V12D07-332_B1,0,2,0,1,0,3
TCAATCCGGGAAGTTT-1_V12D07-332_B1,0,0,0,0,0,0
CCGGAAGTGCAATATG-1_V12D07-332_B1,1,1,0,0,0,2
CTCATAAATGTGTATA-1_V12D07-332_B1,1,1,0,0,0,2
GACGGGCATCGAATTT-1_V12D07-332_B1,2,2,1,0,0,5
GCTAAGCCCAGTATGC-1_V12D07-332_B1,0,0,0,1,0,1
GCTATAAGGGCCAGGA-1_V12D07-332_B1,0,2,0,0,0,2
GCGGATTACTTGTTCT-1_V12D07-332_B1,1,1,0,0,0,2
TACAACAGCGCATACA-1_V12D07-332_B1,3,0,0,0,0,3
TCTAACCTAGCCTGCG-1_V12D07-332_B1,0,1,0,0,0,1
TCTACCCGCATCATTT-1_V12D07-332_B1,0,0,0,0,0,0
GTCTTACCACGCCAAG-1_V12D07-332_B1,0,2,0,0,0,2
AATAACGTCGCGCCCA-1_V12D07-332_B1,1,0,0,0,0,1
CGTTTCGGTTATATGC-1_V12D07-332_B1,1,1,0,0,0,2
TACGCTGCACGGTCGT-1_V12D07-332_B1,0,0,0,0,0,0
CGTTAAATACGACCAG-1_V12D07-332_B1,1,2,0,0,0,3
TCGACTGACGATGGCT-1_V12D07-332_B1,0,0,0,1,0,1
ACGCTACTGAATGGGC-1_V12D07-332_B1,2,0,0,0,0,2
AAGGGTTAGCCATGCG-1_V12D07-332_B1,3,1,0,0,0,4
ACGTTTCGGTGCACTT-1_V12D07-332_B1,0,4,0,0,0,4
TTAACCCGAGGCGTGT-1_V12D07-332_B1,2,4,0,0,1,7
GCCCGTCAAGCCCAAT-1_V12D07-332_B1,1,3,0,0,0,4
ATTCGTCCCGAGGTTA-1_V12D07-332_B1,0,0,0,0,0,0
TCAAATTATGTTCGAC-1_V12D07-332_B1,1,0,0,0,1,2
AACGTTCTACCATTGT-1_V12D07-332_B1,1,0,0,0,0,1
GTCATCCCAAACTCAC-1_V12D07-332_B1,0,0,0,0,0,0
CTCCTAGTAATCGTGA-1_V12D07-332_B1,1,2,0,7,4,14
CCCTCATCACAGAGTA-1_V12D07-332_B1,0,0,0,0,0,0
GGAAACAGAGCTTGGG-1_V12D07-332_B1,0,1,0,15,1,17
ACATCGCAATATTCGG-1_V12D07-332_B1,0,1,0,20,2,23
TTAGCCATAGGGCTCG-1_V12D07-332_B1,0,4,0,7,0,11
CGGATTCTGCCTTATG-1_V12D07-332_B1,0,7,0,6,0,13
GGATCTACCGTTCGTC-1_V12D07-332_B1,0,0,0,1,0,1
AGCTAAGCTCCGTCCG-1_V12D07-332_B1,0,7,1,0,0,8
CTAGCCCGGGAGACGA-1_V12D07-332_B1,0,7,0,4,0,11
CCCAGATTCCCGTGAC-1_V12D07-332_B1,0,0,0,0,0,0
GCCCGTTCACACAATT-1_V12D07-332_B1,0,3,0,4,0,7
ACAAACTCCATCAGAG-1_V12D07-332_B1,0,0,0,0,0,0
GGTTCCGTACGACTAA-1_V12D07-332_B1,0,0,0,0,0,0
TTGCGGAAAGCTGCCC-1_V12D07-332_B1,5,0,0,0,0,5
GGAACTCGTGAATACG-1_V12D07-332_B1,1,0,0,0,0,1
GGTTACCGCTCCCTAC-1_V12D07-332_B1,2,1,0,0,0,3
AGCGACTTTGAAGACA-1_V12D07-332_B1,2,1,0,0,0,3
CCGTTTCCTTTCCGTG-1_V12D07-332_B1,3,0,0,0,0,3
TGGATGGCATCTTGGA-1_V12D07-332_B1,3,0,0,0,0,3
CAAGTCGTTGAAATCT-1_V12D07-332_B1,5,0,0,0,0,5
TGCAAACGTACTAGTT-1_V12D07-332_B1,4,0,0,0,0,4
GGCTGTCCTACTGCGG-1_V12D07-332_B1,2,0,0,0,1,3
TACTGCATGATTAAAT-1_V12D07-332_B1,1,5,1,0,0,7
CGGACCTCTGTAGTTA-1_V12D07-332_B1,2,0,0,0,0,2
CCCTAGCTCTAAGGTC-1_V12D07-332_B1,3,1,0,0,0,4
GTAACAGGTTAACGGC-1_V12D07-332_B1,0,1,0,0,0,1
CCCGCAAATAATCATC-1_V12D07-332_B1,2,1,1,0,0,4
AATCCCGCTCAGAGCC-1_V12D07-332_B1,0,1,0,0,1,2
AACGTCATCCGGCTTG-1_V12D07-332_B1,0,1,0,3,0,4
CTCGTGGCACTGAAAG-1_V12D07-332_B1,1,1,0,0,0,2
CTTTATCCGACGCATG-1_V12D07-332_B1,2,1,0,2,1,6
AAATGACTGATCAAAC-1_V12D07-332_B1,1,0,1,1,0,3
TTCGTGCATGTTATAG-1_V12D07-332_B1,1,1,1,0,0,3
ATCAAAGAGCCGTGGT-1_V12D07-332_B1,0,1,0,0,0,1
ATGTCATAATAAACGA-1_V12D07-332_B1,1,1,0,0,0,2
CTTAATCGACTTAGTA-1_V12D07-332_B1,0,1,0,1,0,2
CTAAAGGATGAGATAC-1_V12D07-332_B1,0,2,0,0,0,2
GTGCTATCCAGCTGGA-1_V12D07-332_B1,1,2,0,0,0,3
GACAGAGGTCTTCAGT-1_V12D07-332_B1,0,0,1,2,0,3
TCGATTTACGAAACGA-1_V12D07-332_B1,0,0,0,0,0,0
AGGCTTAAGTTGCACA-1_V12D07-332_B1,1,0,0,0,0,1
TAGGATCTTAACCGCA-1_V12D07-332_B1,0,0,0,0,0,0
GACTTTCGAGCGGTTC-1_V12D07-332_B1,0,1,0,0,0,1
CCCTGGGAGGGATCCT-1_V12D07-332_B1,2,0,0,0,0,2
TAGTAGTTGCCGGACA-1_V12D07-332_B1,1,0,0,0,0,1
GCCCTAAGTGCAGGAT-1_V12D07-332_B1,0,2,0,0,0,2
ACTTGGGCTTTCGCCA-1_V12D07-332_B1,0,0,0,0,0,0
CATGATACGGTGAAAC-1_V12D07-332_B1,2,1,1,0,0,4
TCCTGCAGCCGCCAAT-1_V12D07-332_B1,0,0,0,0,0,0
GTCCGTTAGAGGGCCT-1_V12D07-332_B1,2,2,0,0,0,4
GCTTTATTAAGTTACC-1_V12D07-332_B1,0,0,0,0,0,0
AATCGAGGTCTCAAGG-1_V12D07-332_B1,0,0,0,0,0,0
GTGCTGTTAGAACATA-1_V12D07-332_B1,2,3,0,0,0,5
GGCTTCTCGTGGGTGG-1_V12D07-332_B1,1,1,0,0,0,2
CCTACAGTTGAGGGAG-1_V12D07-332_B1,0,0,0,0,0,0
TATCCCTCGATCTGCA-1_V12D07-332_B1,0,0,0,0,0,0
CCGGTATCTGGCGACT-1_V12D07-332_B1,1,0,0,0,0,1
CTCTAACACCGGCAGC-1_V12D07-332_B1,2,0,0,0,0,2
CTTCATCACCAGGGCT-1_V12D07-332_B1,2,3,0,0,0,5
GGCTGGCAATCCCACG-1_V12D07-332_B1,2,0,0,0,0,2
CAAACCATAAGCGTAT-1_V12D07-332_B1,2,1,0,0,0,3
CATGTGGGCTCATCAC-1_V12D07-332_B1,3,1,0,0,0,4
CCCGTGACAGTGCCTT-1_V12D07-332_B1,0,3,0,0,0,3
GATTATCTTGCATTAT-1_V12D07-332_B1,2,0,0,0,0,2
GAGTCCACCAGGTTTA-1_V12D07-332_B1,2,2,1,0,0,5
TGTACTATCGCTCGTT-1_V12D07-332_B1,1,1,0,0,0,2
TTAGCGAATAGATAGG-1_V12D07-332_B1,0,0,0,0,0,0
ACATACAATCAAGCGG-1_V12D07-332_B1,3,0,0,0,0,3
ATTCGTGTACCCATTC-1_V12D07-332_B1,0,1,0,0,0,1
GCTAGCAACGCACCTA-1_V12D07-332_B1,0,1,0,0,0,1
ACCTCAGCGAGGCGCA-1_V12D07-332_B1,0,0,0,0,0,0
TCCGGGCCACTAACGG-1_V12D07-332_B1,0,0,0,0,0,0
TCCCAATATCGACGAC-1_V12D07-332_B1,1,1,2,0,0,4
GGATTGAAGTAGCCTC-1_V12D07-332_B1,0,0,0,0,0,0
GGCGCACAGTTTACCT-1_V12D07-332_B1,0,0,0,0,0,0
CCCGGCACGTGTCAGG-1_V12D07-332_B1,2,1,0,0,1,4
AGTAAGGGACAGAATC-1_V12D07-332_B1,1,0,0,0,0,1
TTGCGCACAACCACGT-1_V12D07-332_B1,0,0,0,0,0,0
CCTGCTACAACCATAC-1_V12D07-332_B1,1,0,0,0,0,1
CTGGGCTACTGGAGAG-1_V12D07-332_B1,3,0,0,0,0,3
AGCTACGAATGGTGGT-1_V12D07-332_B1,0,3,0,0,0,3
ATTCGTTTATCGTATT-1_V12D07-332_B1,2,2,0,0,0,4
GGCATTCCCTCCCTCG-1_V12D07-332_B1,0,0,0,0,1,1
AGTTATTCAGACTGTG-1_V12D07-332_B1,1,4,1,0,0,6
CCACTTTCCTTCTAGG-1_V12D07-332_B1,3,0,0,0,0,3
CGCAGTTCTATCTTTC-1_V12D07-332_B1,0,0,0,0,0,0
AGGAGCGTTTATTATC-1_V12D07-332_B1,0,0,0,0,0,0
GACAGGTAATCCGTGT-1_V12D07-332_B1,0,0,0,0,0,0
TTCCCAAAGTACTGAT-1_V12D07-332_B1,2,1,0,0,0,3
CTGCAGGGTGACGCTC-1_V12D07-332_B1,1,0,0,0,0,1
TCATGGAGGCCTTTGT-1_V12D07-332_B1,0,0,0,0,0,0
ATGGCCCGAAAGGTTA-1_V12D07-332_B1,3,2,1,0,0,6
CGTAATATGGCCCTTG-1_V12D07-332_B1,4,0,0,0,0,4
AGAGTCTTAATGAAAG-1_V12D07-332_B1,1,0,1,0,0,2
GAACGTTTGTATCCAC-1_V12D07-332_B1,4,0,0,0,0,4
ATTGAATTCCCTGTAG-1_V12D07-332_B1,1,0,1,0,0,2
TACCTCACCAATTGTA-1_V12D07-332_B1,0,0,0,0,1,1
AGTCGAATTAGCGTAA-1_V12D07-332_B1,0,3,0,0,0,3
TTGAAGTGCATCTACA-1_V12D07-332_B1,1,0,0,0,0,1
