key,other,oligo,microglia,neuron,astrocyte,n_cells
GTTACGAAATCCACGC-1_V12D07-335_C1,0,0,0,0,0,0
GCGTCCAGCTCGTGGC-1_V12D07-335_C1,0,0,0,0,0,0
CCAAAGTCCCGCTAAC-1_V12D07-335_C1,0,0,0,0,0,0
GTTACGGCCCGACTGC-1_V12D07-335_C1,0,0,0,0,0,0
TAGTGAGAAGTGGTTG-1_V12D07-335_C1,1,0,0,0,0,1
AAACAATCTACTAGCA-1_V12D07-335_C1,0,0,0,0,0,0
ATAAACCATTGGACGG-1_V12D07-335_C1,0,0,0,0,0,0
TCTGTGGCTACATTTC-1_V12D07-335_C1,1,2,1,0,0,4
CACGACTAAAGTTCTG-1_V12D07-335_C1,1,2,0,0,0,3
AGAGGTATCTCGGTCC-1_V12D07-335_C1,2,0,0,0,0,2
GCCGGAAACACATCTT-1_V12D07-335_C1,0,0,0,0,0,0
ACCAGGAGTGTGATCT-1_V12D07-335_C1,0,0,0,0,0,0
AAGGAGAACTTATAAG-1_V12D07-335_C1,0,1,0,0,0,1
ACTGTTTAGTGTAGGC-1_V12D07-335_C1,0,2,0,0,0,2
GCGTGTATGTCGTATT-1_V12D07-335_C1,1,2,0,0,0,3
CAGCCCTCACAGGCAG-1_V12D07-335_C1,2,1,0,0,0,3
GAAGACTTCAATGCCG-1_V12D07-335_C1,1,2,0,0,0,3
ACCAAACTAGAAATCC-1_V12D07-335_C1,0,1,0,0,0,1
GACCAGGTCATTCATA-1_V12D07-335_C1,0,2,1,0,0,3
ACGCCCAGCTGTCGAT-1_V12D07-335_C1,1,1,0,0,0,2
CCTCGACCCACTGCCT-1_V12D07-335_C1,1,3,0,2,0,6
TCAGTTACGGAATGAT-1_V12D07-335_C1,1,1,0,0,0,2
TCGGCTAACTTCCCTT-1_V12D07-335_C1,0,1,0,0,0,1
ATATCGTGCCAGACCC-1_V12D07-335_C1,1,2,1,0,0,4
ACGCTTAGTGTCTCTC-1_V12D07-335_C1,1,7,0,0,0,8
TAGTGGAACTCATACA-1_V12D07-335_C1,1,0,1,0,0,2
GTTATTAAATACGACC-1_V12D07-335_C1,2,0,3,0,0,5
CCTGACGCAACCTTTA-1_V12D07-335_C1,0,4,0,0,0,4
AACTGGGTTCGAGCCG-1_V12D07-335_C1,2,3,0,1,0,6
CATGCACGTGTTACTG-1_V12D07-335_C1,0,4,0,0,0,4
CCTACGCGACCTTACA-1_V12D07-335_C1,1,2,0,0,0,3
GAGGTCTTAGTGGGTC-1_V12D07-335_C1,0,3,1,0,0,4
GTCACCTGTCTATGTC-1_V12D07-335_C1,0,2,1,0,0,3
CCTGTGCGGATTGTAA-1_V12D07-335_C1,0,4,0,0,0,4
GGAGGCGAAGAACCGC-1_V12D07-335_C1,0,3,0,0,0,3
GCTCCGGACGTTGATA-1_V12D07-335_C1,0,0,0,0,0,0
TGACCCAGCATTCCCG-1_V12D07-335_C1,2,2,0,0,0,4
TGTAATGCCTTCGGAC-1_V12D07-335_C1,0,2,0,0,0,2
TACGATCCAAGCCACT-1_V12D07-335_C1,0,5,0,0,1,6
AGATTCAAGCGGGTCG-1_V12D07-335_C1,1,3,0,0,0,4
GTAACATCAGCTCATC-1_V12D07-335_C1,0,5,0,0,0,5
GGGCCTATACAACCGG-1_V12D07-335_C1,0,1,0,0,0,1
AAACCACTACACAGAT-1_V12D07-335_C1,0,2,0,0,0,2
TTGAGGGTCGAACGCG-1_V12D07-335_C1,0,0,1,0,0,1
AGGGTGTGCTACACGC-1_V12D07-335_C1,0,1,0,0,0,1
AATGGCCGCCAATGCG-1_V12D07-335_C1,1,0,0,0,0,1
GGGTCACTGAGTAGTG-1_V12D07-335_C1,2,1,0,0,0,3
GATCTTAGTGAACGTG-1_V12D07-335_C1,0,2,1,0,0,3
CTAATGCGCCCAACAA-1_V12D07-335_C1,0,1,0,1,0,2
GCCACCCATTCCACTT-1_V12D07-335_C1,0,2,1,0,0,3
TACTCACAACGTAGTA-1_V12D07-335_C1,2,2,0,3,0,7
GTTCGGTGTGGATTTA-1_V12D07-335_C1,2,1,0,0,0,3
TCTTTCGGCGGGACAC-1_V12D07-335_C1,3,0,0,1,0,4
GGAGACATTCACGGGC-1_V12D07-335_C1,0,2,0,1,0,3
GGGATTATCTCACAAC-1_V12D07-335_C1,2,2,0,1,0,5
TAGAACGCCAGTAACG-1_V12D07-335_C1,2,0,0,0,2,4
ACGAGTCGCCGGCGTT-1_V12D07-335_C1,2,2,0,0,0,4
TGATGGGACTAAGTCA-1_V12D07-335_C1,0,1,0,1,0,2
TGCGAGAAACGTTACG-1_V12D07-335_C1,0,2,0,1,0,3
TCGCCTCGACCTGTTG-1_V12D07-335_C1,2,4,0,2,0,8
AACTCGATAAACACGT-1_V12D07-335_C1,1,2,0,0,0,3
AGGAAAGCCTCTGATG-1_V12D07-335_C1,0,2,0,1,0,3
GAAGGACTAAATTGAA-1_V12D07-335_C1,2,0,0,1,0,3
GTATCGGGACGAGCTG-1_V12D07-335_C1,0,1,0,2,0,3
CCTGTGCATAGGAGAC-1_V12D07-335_C1,0,1,0,1,0,2
CATACGGGTGCATGAT-1_V12D07-335_C1,2,2,0,0,0,4
CCACTAAACTGAATCG-1_V12D07-335_C1,3,5,0,0,0,8
AAATTGCGGCGGTTCT-1_V12D07-335_C1,3,6,0,0,0,9
AGTCCAGCGGGTACGT-1_V12D07-335_C1,2,0,0,1,0,3
CATTCAGGTCAGTGCG-1_V12D07-335_C1,1,0,0,0,0,1
CTAAAGTCCGAAGCTA-1_V12D07-335_C1,0,1,0,0,0,1
AATCAGACTGCAGGAC-1_V12D07-335_C1,1,4,0,0,0,5
AGTATCCATAATAACG-1_V12D07-335_C1,0,0,1,0,0,1
CTGGCTGCTAACGTAA-1_V12D07-335_C1,0,2,0,0,0,2
GTTCCAAGACAGCGAC-1_V12D07-335_C1,0,3,2,0,3,8
AAGACTAACCCGTTGT-1_V12D07-335_C1,1,2,0,0,0,3
GATTAATCCTGGCTCA-1_V12D07-335_C1,2,2,0,1,0,5
CGCGCAAGGAACTACA-1_V12D07-335_C1,0,5,0,0,0,5
CAGTAGCGAGGTAGTA-1_V12D07-335_C1,1,1,0,0,1,3
ACGGCGGGTTGCCCTG-1_V12D07-335_C1,3,1,0,0,0,4
CTAGGCGGCAGAGAAT-1_V12D07-335_C1,1,3,0,0,0,4
GTGCGCAGCTTGCTCC-1_V12D07-335_C1,1,2,0,0,1,4
TCACTATCGTGCAATC-1_V12D07-335_C1,1,2,0,0,0,3
TATGATTCTGCTTGGT-1_V12D07-335_C1,0,3,0,0,0,3
TAAGATTTAGCGGGAG-1_V12D07-335_C1,0,2,1,0,0,3
TTACGGTGTCACCGAG-1_V12D07-335_C1,0,3,0,0,0,3
CTACACTAGCTTGTTC-1_V12D07-335_C1,2,2,1,0,0,5
TGAGCAGTCGTGAAGT-1_V12D07-335_C1,0,1,0,0,0,1
CGCTGAGGACGTCCAA-1_V12D07-335_C1,0,4,1,0,0,5
GTGTATGACTTTAAAG-1_V12D07-335_C1,0,3,0,0,0,3
CTAAACGGGTGTAATC-1_V12D07-335_C1,1,4,0,1,0,6
TGTACTGTGCCAAAGT-1_V12D07-335_C1,2,1,0,0,0,3
GGCCACAAGCGATGGC-1_V12D07-335_C1,0,1,0,0,0,1
GTCAATTGTACTGAAG-1_V12D07-335_C1,0,1,0,0,0,1
AGGGACAGCACGGCGG-1_V12D07-335_C1,1,2,0,0,0,3
AGCTTATAGAGACCTG-1_V12D07-335_C1,0,3,1,0,0,4
AACTAGCGTATCGCAC-1_V12D07-335_C1,1,1,0,0,0,2
AACTTTAGCTGCTGAG-1_V12D07-335_C1,3,4,0,0,0,7
CCCAAGACAGAGTATG-1_V12D07-335_C1,0,5,0,0,0,5
GGCATCAACGAGCACG-1_V12D07-335_C1,1,0,0,0,0,1
ATGCATTCCGTGATGG-1_V12D07-335_C1,1,2,0,0,0,3
TTATAGATGCACATTA-1_V12D07-335_C1,1,2,1,0,0,4
GAACCATCTGGGAGAC-1_V12D07-335_C1,1,4,0,0,0,5
TGCTATACAAACGGAC-1_V12D07-335_C1,0,1,0,0,0,1
ACTTGCCATATTGTAC-1_V12D07-335_C1,1,3,3,0,0,7
TATTCCGGCAGTCCTA-1_V12D07-335_C1,1,3,1,0,0,5
GACGGACCGCGTTCCT-1_V12D07-335_C1,2,4,1,0,0,7
ATGTGTAGTTTAGTCA-1_V12D07-335_C1,1,3,0,0,0,4
ATACCAGCAAATTGCT-1_V12D07-335_C1,2,3,0,0,0,5
AAGTTTACTAATGGCA-1_V12D07-335_C1,0,5,0,1,0,6
CTCTCGATGTGCGCCT-1_V12D07-335_C1,0,3,2,0,0,5
GATTGACACTCTGCTC-1_V12D07-335_C1,2,4,1,0,0,7
TATCACAGCACGGGCA-1_V12D07-335_C1,3,0,0,2,0,5
ACCGTTCCCGCTCTGA-1_V12D07-335_C1,1,8,0,0,0,9
CCGCCACCACAATCCA-1_V12D07-335_C1,0,1,1,0,0,2
CATTCACTGACAGCTA-1_V12D07-335_C1,0,0,1,0,0,1
CGGCTGCAAGATTAAG-1_V12D07-335_C1,1,3,0,1,0,5
CATGAACCTCTTATCA-1_V12D07-335_C1,1,8,1,0,0,10
TTAATGCGAGGTAACT-1_V12D07-335_C1,1,4,0,0,0,5
AATAAGTCCTCGAGAC-1_V12D07-335_C1,0,2,0,0,0,2
ACCAGCCCGGTCTTTG-1_V12D07-335_C1,0,3,0,0,0,3
CTACGAACTAGGTCGA-1_V12D07-335_C1,0,6,0,0,0,6
ACATCTCAACGCGTAA-1_V12D07-335_C1,2,3,0,0,0,5
CACTACTCAGTTCTGT-1_V12D07-335_C1,0,0,0,0,0,0
CCGACTCGCATAGTCT-1_V12D07-335_C1,3,1,0,0,0,4
CATTTATCGTTCAAGA-1_V12D07-335_C1,0,2,2,0,0,4
CAAACGTGGTCTTGCG-1_V12D07-335_C1,0,5,0,0,0,5
TAGAAACCACTAAGTA-1_V12D07-335_C1,0,4,0,0,0,4
ACTGATTTAGTGATTC-1_V12D07-335_C1,0,7,0,0,0,7
TCGTATTTCGTCCGGA-1_V12D07-335_C1,2,5,0,0,0,7
CGGAAATTTCACATCC-1_V12D07-335_C1,0,3,0,0,0,3
ATCCACGCTAAATGTT-1_V12D07-335_C1,1,2,0,0,0,3
GTTCAATCTATGTCAA-1_V12D07-335_C1,0,2,1,0,0,3
ATAAAGGTCAAGTACG-1_V12D07-335_C1,6,4,2,0,0,12
CAACTCCAACGTTTAG-1_V12D07-335_C1,0,1,1,0,0,2
TAGGAACAGCCTCCAG-1_V12D07-335_C1,1,1,0,0,0,2
ATGGGAACGGAAGCGG-1_V12D07-335_C1,1,1,1,0,0,3
CACACGTTTCAATGGG-1_V12D07-335_C1,0,2,0,0,0,2
GGTGTTCTGTTTCTAC-1_V12D07-335_C1,0,1,1,0,0,2
AGTAACGTTCATCCTG-1_V12D07-335_C1,0,1,0,0,0,1
GTATAGTGGCCCATGT-1_V12D07-335_C1,0,1,1,0,0,2
TCTACACGTTCATGCA-1_V12D07-335_C1,3,0,0,1,0,4
AATCTGGGTAGACCCT-1_V12D07-335_C1,1,2,1,0,0,4
TCGGTTAGCCATGTAG-1_V12D07-335_C1,0,6,1,0,0,7
TGCCATGGCTTATAAG-1_V12D07-335_C1,0,2,0,0,0,2
TAAGTAAATGTGCCGC-1_V12D07-335_C1,6,4,4,0,0,14
GTGTCCGATAAGGCAT-1_V12D07-335_C1,0,3,0,0,0,3
TGGCACGAGCTCGAGT-1_V12D07-335_C1,1,2,0,0,0,3
ACCGGTCTGAGTACGG-1_V12D07-335_C1,1,4,1,0,0,6
GAACTTAGCGCCCGGT-1_V12D07-335_C1,1,3,0,0,0,4
AGTAGCTAGACGCCGA-1_V12D07-335_C1,1,2,1,0,0,4
ATAGGAATCTAAGCTT-1_V12D07-335_C1,1,2,0,0,0,3
CTTCCTGCATATTTAC-1_V12D07-335_C1,3,0,0,0,0,3
CAATATGTAGATTTAC-1_V12D07-335_C1,1,3,0,0,0,4
ACAAGGCCTACCAGCC-1_V12D07-335_C1,0,1,1,0,0,2
TTATAGTCCAAGGTGC-1_V12D07-335_C1,1,1,1,0,0,3
AAACGCCCGAGATCGG-1_V12D07-335_C1,0,5,0,0,0,5
CCTCGTTACGCCTGTT-1_V12D07-335_C1,1,4,0,0,0,5
GAACGGTGTAAAGCAG-1_V12D07-335_C1,0,1,0,0,0,1
ACGCATAAATGACATG-1_V12D07-335_C1,1,0,0,0,0,1
GGTTCGATGCTGAGTT-1_V12D07-335_C1,0,7,2,0,0,9
CTTTGGCAGACAGAGT-1_V12D07-335_C1,0,6,0,0,0,6
TTCGTGGGCTGGAAGC-1_V12D07-335_C1,3,0,1,0,0,4
CAAAGGTTAAATTCAG-1_V12D07-335_C1,1,4,0,0,0,5
GTTTGGCGTCAGGCAC-1_V12D07-335_C1,0,1,0,0,0,1
GCTTTCTATCTCAACT-1_V12D07-335_C1,1,0,0,0,1,2
TGCATCTCCGGATCTT-1_V12D07-335_C1,0,1,0,0,0,1
CTGAAACGGCCCTCAG-1_V12D07-335_C1,1,1,0,0,0,2
TAGCAGTAAATACGCG-1_V12D07-335_C1,1,1,0,0,0,2
CGGGCTACTTAAATTG-1_V12D07-335_C1,1,1,0,0,0,2
ATTATGCTCAGTATTG-1_V12D07-335_C1,1,4,1,0,1,7
TGATGCTCACGTAGTC-1_V12D07-335_C1,1,1,0,0,0,2
GTCTAAGATGCCCAGC-1_V12D07-335_C1,0,2,0,0,0,2
AACCCGATAGGGCTTC-1_V12D07-335_C1,1,3,0,0,0,4
CGCTATCGTGGCTTTA-1_V12D07-335_C1,1,3,0,0,0,4
CGTCTCTCGCCGAGGC-1_V12D07-335_C1,0,3,0,0,0,3
AGTGGGAGTATACACG-1_V12D07-335_C1,2,2,0,2,0,6
GGTCTTGGTGTTAACT-1_V12D07-335_C1,1,1,0,0,0,2
GGCTGGCAGCTTTATG-1_V12D07-335_C1,0,3,0,1,0,4
CGCCAATTATTGCGTT-1_V12D07-335_C1,4,2,0,1,0,7
GGTAACCGGCAAAGGT-1_V12D07-335_C1,2,9,2,0,0,13
TGGGACCATTGGGAGT-1_V12D07-335_C1,2,2,1,0,0,5
CTGCAGGTGCTCGGCC-1_V12D07-335_C1,2,1,1,0,0,4
CCGGTGCGAGTGATAG-1_V12D07-335_C1,2,3,0,0,0,5
GGGTACACTCTGGAGG-1_V12D07-335_C1,1,0,0,1,0,2
TAGCCAGAGGGTCCGG-1_V12D07-335_C1,1,0,0,1,0,2
CTTGTGAGGACAGCGG-1_V12D07-335_C1,1,1,0,2,0,4
GAAGGGCATAACCATG-1_V12D07-335_C1,1,2,0,2,0,5
CAACATGGCCTGATAA-1_V12D07-335_C1,0,2,0,0,0,2
CAATTTGACCGGGAAG-1_V12D07-335_C1,1,5,0,0,0,6
TCTGACTGTAATGGTT-1_V12D07-335_C1,3,1,0,0,0,4
TTCATAGCCTTGTAAC-1_V12D07-335_C1,2,1,1,0,0,4
TGGAAACGGAGTGAAC-1_V12D07-335_C1,2,3,0,0,0,5
ATCGCACGATTGTTCA-1_V12D07-335_C1,1,3,1,1,0,6
CGCCACCCGCATTAAC-1_V12D07-335_C1,0,3,0,0,1,4
TGGACCACGGCGTTGA-1_V12D07-335_C1,0,1,0,0,0,1
GTATATGTTACGGCGG-1_V12D07-335_C1,0,1,0,0,0,1
GTATTCTTACCGTGCT-1_V12D07-335_C1,3,4,0,0,0,7
TTCAGAGTAACCTGAC-1_V12D07-335_C1,1,7,1,0,0,9
GCGGTAACCCAAATGA-1_V12D07-335_C1,0,3,0,0,0,3
CTACGTGTTGCCACCA-1_V12D07-335_C1,1,3,0,0,0,4
CTAGATAAACTCCTCG-1_V12D07-335_C1,0,7,1,0,0,8
TCCATTAGTTGGATAG-1_V12D07-335_C1,0,6,0,1,0,7
CTGGCTCCTGCGGGAT-1_V12D07-335_C1,0,4,0,0,0,4
CAGTCTCTCGGCTAAT-1_V12D07-335_C1,0,1,0,0,0,1
GTATGACGTGGGAAAC-1_V12D07-335_C1,0,4,0,1,0,5
AGTCACTCCGCCTCAT-1_V12D07-335_C1,2,3,0,0,0,5
GCAGCGGTGGGCATTA-1_V12D07-335_C1,0,1,1,0,0,2
TATGGAGTTTCTCGTT-1_V12D07-335_C1,1,1,0,0,0,2
ACTCAACGAATGTATT-1_V12D07-335_C1,0,4,1,0,0,5
AACACGCGGCCGCGAA-1_V12D07-335_C1,0,5,0,0,0,5
CGATATTAGCCGCAGG-1_V12D07-335_C1,4,3,0,1,1,9
AGCGTCTGAACCCGCA-1_V12D07-335_C1,0,3,0,0,0,3
GATGTCCGGATCACAT-1_V12D07-335_C1,1,2,0,0,0,3
GGTCACGTTAGATTCA-1_V12D07-335_C1,0,4,0,0,0,4
TTAAGGATACGGAGGT-1_V12D07-335_C1,0,3,0,0,0,3
GTGCGGGACCATCGGC-1_V12D07-335_C1,0,2,0,0,0,2
CCATCTTGTTCACAAT-1_V12D07-335_C1,1,0,0,0,0,1
TCCGAGAAGGCTAAGC-1_V12D07-335_C1,0,1,0,0,0,1
TGGCGGTGTGCGATTG-1_V12D07-335_C1,0,0,0,0,0,0
ATCCTGCTGCAGATAG-1_V12D07-335_C1,0,3,0,0,0,3
TTATGCGTCCCGGTCC-1_V12D07-335_C1,1,3,1,1,0,6
CATAATGAGCGGGCGA-1_V12D07-335_C1,0,4,0,1,0,5
AGACATAGATCCTTCC-1_V12D07-335_C1,0,7,0,1,0,8
GGTGAAACCGGGAATG-1_V12D07-335_C1,2,1,0,0,0,3
AACTGGTGTGGGCCTT-1_V12D07-335_C1,0,3,1,0,0,4
GTAGCGCTGTTGTAGT-1_V12D07-335_C1,0,1,0,0,0,1
TTGTTTGTGTAAATTC-1_V12D07-335_C1,0,1,0,1,0,2
GGATCAAAGGACGAGG-1_V12D07-335_C1,0,2,0,0,0,2
CGTAGCGCCGACGTTG-1_V12D07-335_C1,0,3,0,0,0,3
CAAGTGAACTTTGGTT-1_V12D07-335_C1,1,4,3,2,0,10
GTAGACAACCGATGAA-1_V12D07-335_C1,0,2,0,2,0,4
CAATGGTCGGCCTGGG-1_V12D07-335_C1,1,2,0,0,0,3
ACAGATTAGGTTAGTG-1_V12D07-335_C1,0,4,0,2,0,6
GTTATCACCTTCTGAA-1_V12D07-335_C1,0,3,0,0,0,3
TGGTATCGGTCTGTAT-1_V12D07-335_C1,0,2,0,1,0,3
GGAATAACCTCAAGAA-1_V12D07-335_C1,2,3,0,1,0,6
ATTATCTCGACAGATC-1_V12D07-335_C1,0,1,0,1,0,2
CCGAGGGATGTTAGGC-1_V12D07-335_C1,1,5,1,0,0,7
TGAGATCAAATACTCA-1_V12D07-335_C1,0,2,0,0,0,2
AAACGAAGAACATACC-1_V12D07-335_C1,0,8,0,0,0,8
CTGGTCCTAACTTGGC-1_V12D07-335_C1,0,3,1,0,0,4
TGCACGAGTCGGCAGC-1_V12D07-335_C1,1,6,0,1,0,8
ATAGTCTTTGACGTGC-1_V12D07-335_C1,0,3,0,0,0,3
TGGAGCTAAAGTTCCC-1_V12D07-335_C1,1,7,1,0,0,9
GGGTGGTCCAGCCTGT-1_V12D07-335_C1,0,0,0,0,0,0
CATGCATGGAGACCCT-1_V12D07-335_C1,2,1,0,0,0,3
ACACGGCACTATGCAT-1_V12D07-335_C1,0,2,0,0,0,2
CCCTGGTATGGGCGGC-1_V12D07-335_C1,2,3,0,0,0,5
GGAGGATTGAAAGGAG-1_V12D07-335_C1,0,1,0,0,0,1
CCGCTGGTGCCATTCA-1_V12D07-335_C1,0,3,2,0,0,5
GTTAGAGTGTGCCGCT-1_V12D07-335_C1,0,1,0,0,0,1
TCGGAATGACCATCAA-1_V12D07-335_C1,0,0,0,0,0,0
TTCAATTAGCCATAAT-1_V12D07-335_C1,1,5,0,0,0,6
GATGTGTTGTCACAAG-1_V12D07-335_C1,0,2,2,0,0,4
TCTTTCTCTTAAGGAG-1_V12D07-335_C1,1,3,1,0,0,5
ACCCTTTAGTTCTCCA-1_V12D07-335_C1,1,3,0,0,0,4
ACCACAACTCAGAACA-1_V12D07-335_C1,2,2,0,0,0,4
TATGATAAATCTAACG-1_V12D07-335_C1,0,1,0,0,0,1
GATCCTCTTGCGCTTA-1_V12D07-335_C1,0,5,1,0,0,6
TTCTACCTTTATGTTG-1_V12D07-335_C1,1,3,0,0,0,4
GAAATACCTGCTGGCT-1_V12D07-335_C1,2,3,0,0,0,5
ATTCTGAGTATGAACT-1_V12D07-335_C1,0,1,0,0,0,1
GGATTAAGCTAAGGTC-1_V12D07-335_C1,0,4,1,0,0,5
AGTACGTGGCCTGTCT-1_V12D07-335_C1,0,8,0,0,0,8
TCAGGGTGCACGAAAC-1_V12D07-335_C1,1,3,2,0,0,6
AAATTTACCGAAATCC-1_V12D07-335_C1,0,2,1,0,0,3
TTGAGGCATTTAACTC-1_V12D07-335_C1,0,0,0,0,0,0
AACCAGTATCACTCTT-1_V12D07-335_C1,0,2,1,0,0,3
CACCGGAGATATCTCC-1_V12D07-335_C1,0,4,0,0,0,4
GACTGGGCGCCGCAAC-1_V12D07-335_C1,0,1,1,0,0,2
CACGTCTATGATGTGG-1_V12D07-335_C1,0,1,0,0,0,1
TTAAGACGAACGAACC-1_V12D07-335_C1,0,3,0,0,0,3
TGACCAGCTTCAAAGT-1_V12D07-335_C1,0,3,0,0,0,3
AGAGTTAGAGACCGAT-1_V12D07-335_C1,0,2,0,0,0,2
TTCGGACTGATGCCTT-1_V12D07-335_C1,0,1,1,0,0,2
CTCGAATGGAACGTAT-1_V12D07-335_C1,2,2,2,0,0,6
GGACGGCTTGCGCAAC-1_V12D07-335_C1,2,8,1,0,1,12
CTAAGTACAGGGCTAC-1_V12D07-335_C1,0,1,0,0,0,1
ACAAATTCAGATCTGA-1_V12D07-335_C1,0,0,0,0,0,0
CATGGAAATGGGACCA-1_V12D07-335_C1,2,3,1,0,0,6
GGTGGACCACGTGTTA-1_V12D07-335_C1,1,2,0,0,0,3
CACGACGTAATAGTAA-1_V12D07-335_C1,1,3,3,0,0,7
CGGGTTCGGCACGTAT-1_V12D07-335_C1,0,3,2,0,0,5
CTGGGCTATCCTTTGG-1_V12D07-335_C1,0,4,0,0,1,5
GTATTAGGGTTCGCGT-1_V12D07-335_C1,1,9,0,0,0,10
TCATTCGTATAATTTG-1_V12D07-335_C1,0,2,1,0,0,3
AATAGCAAGCCTCCTG-1_V12D07-335_C1,0,2,0,0,0,2
CATCTACCCGAGAACG-1_V12D07-335_C1,2,1,0,0,0,3
GCTTCAGTGGGATTAC-1_V12D07-335_C1,0,4,0,0,1,5
TCTGTGATGGAGGTTG-1_V12D07-335_C1,0,0,0,0,0,0
ATCCACTTTCAGACTA-1_V12D07-335_C1,0,1,1,0,0,2
ATGGTTACGAAACATG-1_V12D07-335_C1,0,2,0,0,0,2
GGCCCAATCTAGAGGG-1_V12D07-335_C1,1,0,0,0,0,1
GATGGTGAAATAACCC-1_V12D07-335_C1,1,3,2,0,0,6
AGAGGGACAATTGTCC-1_V12D07-335_C1,1,4,0,0,0,5
CGCGTACATTCTGGAA-1_V12D07-335_C1,2,2,0,0,0,4
CAAGAAACCCTAAACT-1_V12D07-335_C1,1,5,0,0,0,6
TTGGTGCGGTGTTGAA-1_V12D07-335_C1,0,1,0,0,0,1
GGTTCCCTAGTGTCTC-1_V12D07-335_C1,0,8,1,0,0,9
CGATAACCAATTTGAG-1_V12D07-335_C1,1,0,1,0,1,3
GCCCACTGGTCCACAA-1_V12D07-335_C1,0,5,1,0,0,6
GAGGGCCGGCAGAGTC-1_V12D07-335_C1,0,7,0,0,0,7
CGACACGGATGCCCAC-1_V12D07-335_C1,0,2,0,0,0,2
CTGTCTGTGGCTGGCT-1_V12D07-335_C1,1,5,1,0,0,7
ATATTATCCCGTATTT-1_V12D07-335_C1,2,0,0,0,0,2
GCGCTGGCGGAAAGTC-1_V12D07-335_C1,0,3,1,2,0,6
ATCTAACGTCCCTATG-1_V12D07-335_C1,0,0,0,0,0,0
GTCAGACAGCGTTGGA-1_V12D07-335_C1,2,2,1,0,0,5
GCCAGGCTTAGTGGTA-1_V12D07-335_C1,5,1,0,0,0,6
ATTCAAAGTACCTGTT-1_V12D07-335_C1,5,1,0,0,0,6
TGGACGTAGGCGAATC-1_V12D07-335_C1,4,3,1,1,0,9
ACACATTGACGCAACA-1_V12D07-335_C1,0,2,0,2,0,4
GATATCAGTATGTATC-1_V12D07-335_C1,2,2,0,0,0,4
TGGGCCTTGCCTGCAT-1_V12D07-335_C1,1,1,0,2,0,4
CAAAGTCAGGTTAGCT-1_V12D07-335_C1,1,1,0,1,0,3
GGATCCCTACCAGCTA-1_V12D07-335_C1,0,2,0,0,0,2
ATCGTCCAATCGAGTC-1_V12D07-335_C1,1,4,0,0,0,5
ACATGGCTCAATTTAG-1_V12D07-335_C1,1,3,2,1,0,7
AGGCCCAGTGACTGGT-1_V12D07-335_C1,1,1,0,0,0,2
GCTTCCAGCTTAGATT-1_V12D07-335_C1,1,3,0,0,0,4
TGCTTGAAACCATGCA-1_V12D07-335_C1,3,5,0,1,0,9
CAATATTGGACTAGTG-1_V12D07-335_C1,1,1,0,0,0,2
CGTGCTGGCCTAGTCG-1_V12D07-335_C1,1,2,0,0,0,3
CCTGCGATAGAACTGT-1_V12D07-335_C1,0,2,0,1,0,3
GGGTAATGCTGTGTTT-1_V12D07-335_C1,3,4,0,0,0,7
AACGCGAACGGCAACA-1_V12D07-335_C1,0,1,0,0,0,1
TGTCGGCATGGTGGAA-1_V12D07-335_C1,3,2,0,1,0,6
AGCGTACGAGAGCTAG-1_V12D07-335_C1,3,1,0,0,0,4
ATACTCTCGCCACTCT-1_V12D07-335_C1,1,3,1,0,0,5
AATCCATGCAAGGGTG-1_V12D07-335_C1,1,1,0,0,0,2
TTAAACAGAGTCCCGC-1_V12D07-335_C1,1,3,0,0,0,4
CCACAGCTGAAATCAT-1_V12D07-335_C1,1,2,0,0,0,3
CGGTTCCGGCTTCTTG-1_V12D07-335_C1,4,1,0,0,0,5
GACGTGAGACTCCATG-1_V12D07-335_C1,0,0,0,1,0,1
TCGTTGGCTCGTCAAT-1_V12D07-335_C1,0,1,0,0,0,1
GGTGAACGGGCTAGCC-1_V12D07-335_C1,4,4,0,0,0,8
GCACTGTGCAAATGTA-1_V12D07-335_C1,0,1,1,1,0,3
ACGAGAACCCATCACG-1_V12D07-335_C1,0,2,0,0,0,2
CCAGCTACGCCTCATA-1_V12D07-335_C1,2,2,0,0,0,4
TCCCGGTCAGGAATTT-1_V12D07-335_C1,1,4,0,1,0,6
TCGCATTCAATGACTT-1_V12D07-335_C1,0,1,0,0,0,1
CTGGTTCAACGCATCA-1_V12D07-335_C1,0,3,0,0,0,3
GGTGATTTCATCTTGT-1_V12D07-335_C1,0,0,0,0,0,0
CACCCTTTCCTCGCTC-1_V12D07-335_C1,0,3,0,0,0,3
CAACTTGTAGTGGGCA-1_V12D07-335_C1,1,2,0,0,0,3
AATATCAAGGTCGGAT-1_V12D07-335_C1,0,2,0,0,0,2
ACTCAGACCTGCTTCT-1_V12D07-335_C1,1,4,0,0,0,5
TTGGAGTCTCCCTTCT-1_V12D07-335_C1,2,1,0,0,0,3
GGATACTCATGAATTG-1_V12D07-335_C1,0,2,0,0,0,2
TGGGCACAAACAGAAC-1_V12D07-335_C1,0,5,0,0,0,5
GAGCCACGGTAGTAGG-1_V12D07-335_C1,2,0,0,0,0,2
TCGATAGGCTAGTCGC-1_V12D07-335_C1,0,0,0,0,0,0
TAACCGCCCGCAGTGC-1_V12D07-335_C1,2,2,0,1,0,5
GCCTATTTGCTACACA-1_V12D07-335_C1,0,1,0,0,0,1
TTGACGATTCAGCACG-1_V12D07-335_C1,5,2,0,0,0,7
TTAAACCGGTAGCGAC-1_V12D07-335_C1,2,2,0,0,0,4
ACCGAAAGGGCCCTGC-1_V12D07-335_C1,3,1,0,0,0,4
ACGTTCCGCGCTCCGT-1_V12D07-335_C1,2,0,0,0,0,2
ATACCAGGCTAATAGA-1_V12D07-335_C1,1,1,1,0,0,3
CGGCTTTGTATGATAA-1_V12D07-335_C1,2,1,1,0,0,4
CTTGACCCGAAAGATA-1_V12D07-335_C1,1,0,0,0,0,1
CGCAGAAACATTTGCG-1_V12D07-335_C1,0,0,0,0,0,0
GACCCGTCGCCGGCTA-1_V12D07-335_C1,0,6,0,0,0,6
AATCGGGACACTACGA-1_V12D07-335_C1,0,0,0,0,0,0
GTCACAAAGTTTCCAA-1_V12D07-335_C1,0,2,0,0,0,2
TATATTCGCGTCGATA-1_V12D07-335_C1,0,6,0,0,0,6
CCTCCCGACAATCCCT-1_V12D07-335_C1,1,1,1,0,0,3
CGACATGCGATCTTCT-1_V12D07-335_C1,0,3,1,0,0,4
AACACGACTGTACTGA-1_V12D07-335_C1,1,2,0,0,0,3
CCCAACCACACTAACA-1_V12D07-335_C1,3,4,0,1,0,8
CACCGCCGACCAGCGA-1_V12D07-335_C1,0,2,0,0,0,2
TGGTATCGCATCCCAA-1_V12D07-335_C1,0,3,0,0,0,3
CAGAGTGATTTAACGT-1_V12D07-335_C1,2,2,0,0,0,4
AACCCTGGTGGAACCA-1_V12D07-335_C1,0,2,0,0,0,2
GTCAGTTGTGCTCGTT-1_V12D07-335_C1,0,3,0,0,0,3
ATTGACGTAACTCGGT-1_V12D07-335_C1,0,1,0,0,0,1
GATGTCGGTCAACTGC-1_V12D07-335_C1,1,5,1,0,0,7
AGGGCAGCGGCGTGGT-1_V12D07-335_C1,1,4,0,1,0,6
ACATCGTTAACCTAGT-1_V12D07-335_C1,2,2,0,0,0,4
TCCATTGTGACCTCGT-1_V12D07-335_C1,0,4,0,0,0,4
TGTTTAATACTTCATC-1_V12D07-335_C1,0,3,2,0,0,5
TTGCTGGCCGGGCTTC-1_V12D07-335_C1,0,1,1,0,0,2
CATATTATTTGCCCTA-1_V12D07-335_C1,0,2,0,0,0,2
CTGCCTAGCCACCAAG-1_V12D07-335_C1,1,1,0,0,0,2
ACGAGATATTTGCTTA-1_V12D07-335_C1,0,2,3,0,0,5
GACTACAATTGCTCGT-1_V12D07-335_C1,0,1,0,0,0,1
AACGTGATGAAGGACA-1_V12D07-335_C1,0,6,0,0,0,6
ACTCTCTTATACACGA-1_V12D07-335_C1,0,0,1,0,0,1
CGCATCATGGCTTCAG-1_V12D07-335_C1,1,2,0,0,0,3
CGGCTCTTCGTCGAAC-1_V12D07-335_C1,0,1,1,0,0,2
ATTCTTCGTACTTATG-1_V12D07-335_C1,0,3,0,0,0,3
AGTGAGGGTTTCTGAC-1_V12D07-335_C1,0,3,0,0,0,3
GCCAGGCGTTCGCATG-1_V12D07-335_C1,1,0,0,0,0,1
GACTAACACAGCACCT-1_V12D07-335_C1,1,1,0,0,0,2
CAATGGAATCTACATA-1_V12D07-335_C1,0,3,0,0,0,3
GTGGTCAGCGAAGTAT-1_V12D07-335_C1,1,6,2,0,0,9
ATGGCTGGAAATGGCC-1_V12D07-335_C1,1,3,1,0,0,5
ATCAGGTCGCCATTGC-1_V12D07-335_C1,0,5,2,0,0,7
TATCACCATGTAAAGT-1_V12D07-335_C1,0,0,0,0,0,0
AGCGCTTATGGGCAAG-1_V12D07-335_C1,0,2,0,1,0,3
AAGCGGCGTCATGGGT-1_V12D07-335_C1,1,0,0,0,0,1
ACTAATACGTCAGGCG-1_V12D07-335_C1,0,1,0,0,0,1
GGCTGAGCATCGTAAG-1_V12D07-335_C1,1,5,0,0,0,6
CGGTTGGGTTCAAGTT-1_V12D07-335_C1,0,2,1,0,0,3
GACTGATTGGTCACAA-1_V12D07-335_C1,2,0,0,0,0,2
AGACGGGCCGATTTAA-1_V12D07-335_C1,0,4,0,0,0,4
ACCAGTGCCCGGTCAA-1_V12D07-335_C1,0,1,0,0,0,1
GTCCTTTAATGACTTC-1_V12D07-335_C1,1,0,0,0,0,1
CCTACAAGTCCGGAAT-1_V12D07-335_C1,1,6,0,0,0,7
GCCTGCTACACTGAGA-1_V12D07-335_C1,0,2,0,0,0,2
GACTCGGTCGGCGGAT-1_V12D07-335_C1,1,2,2,0,0,5
CTAGACATATATGTAG-1_V12D07-335_C1,0,1,0,0,0,1
TCGCCCAACTGACTCC-1_V12D07-335_C1,1,2,0,0,0,3
AAACTAACGTGGCGAC-1_V12D07-335_C1,0,0,1,0,0,1
AACTGAGGTCAGCGTC-1_V12D07-335_C1,1,0,0,0,0,1
ACAATGATTCTTCTAC-1_V12D07-335_C1,0,3,0,0,0,3
ATAAGTACCCGATTGT-1_V12D07-335_C1,0,1,0,0,0,1
ATTGGGAGTTCTGTAA-1_V12D07-335_C1,0,2,1,0,0,3
CGAACATAGTCAGAAA-1_V12D07-335_C1,0,3,0,0,1,4
TAGCTCAGATCCTAGT-1_V12D07-335_C1,1,3,1,0,0,5
GTGTCGTATTCACCTT-1_V12D07-335_C1,1,0,0,0,0,1
CTCACCGATCCAAACT-1_V12D07-335_C1,3,3,1,0,0,7
ATATGTGCACAAACCA-1_V12D07-335_C1,0,0,0,0,0,0
CAGTCCAACGCCTTCT-1_V12D07-335_C1,1,2,1,0,0,4
TCGTCCGGGTACACTC-1_V12D07-335_C1,0,3,1,0,0,4
GCAGAAACGTAATCCA-1_V12D07-335_C1,2,2,1,0,0,5
TTCGAGCCGGCGCTAC-1_V12D07-335_C1,0,1,1,0,0,2
GGAAGATAAGACTGTA-1_V12D07-335_C1,0,3,0,0,0,3
ATAAGCAAACACCGAG-1_V12D07-335_C1,0,8,0,0,0,8
GCATAAATTGAACGCC-1_V12D07-335_C1,3,1,0,0,0,4
CGCCGGTGTCGCAGTA-1_V12D07-335_C1,0,3,1,0,0,4
GACCTGGTCTGGGCGT-1_V12D07-335_C1,2,4,0,0,0,6
AGCCGCTTGATTAGCG-1_V12D07-335_C1,0,1,0,0,0,1
CCCGGCTAGGTGAGAA-1_V12D07-335_C1,1,1,0,0,0,2
CGAGCCGAGCACTCGA-1_V12D07-335_C1,0,0,0,0,0,0
TAGTGCTTGAATCCTT-1_V12D07-335_C1,1,1,0,1,0,3
CAACCGCACCTAGACA-1_V12D07-335_C1,1,3,1,0,0,5
ACCACTGTTCAAGAAG-1_V12D07-335_C1,0,0,1,0,0,1
AGATGCTATAACGAGC-1_V12D07-335_C1,1,5,0,1,0,7
AATTACTCGTACGCTC-1_V12D07-335_C1,0,0,0,1,0,1
CGTCAATCTTTAACAT-1_V12D07-335_C1,0,0,0,1,0,1
CCAAAGCAGTTGGTTG-1_V12D07-335_C1,2,1,0,2,0,5
CCATATTGGATCATGA-1_V12D07-335_C1,1,2,0,1,0,4
CGTACCGAAAGTCTAG-1_V12D07-335_C1,1,4,0,2,0,7
CTCGAGATCCAAAGCA-1_V12D07-335_C1,1,2,0,0,0,3
TGGATAGAGTAACAGA-1_V12D07-335_C1,0,2,0,0,0,2
TCACAGATCCTCAAAC-1_V12D07-335_C1,1,2,0,0,2,5
AGAGCTACGAAAGCAT-1_V12D07-335_C1,2,0,0,0,0,2
TGCGTGATTGGGTGTC-1_V12D07-335_C1,2,0,0,0,0,2
CACATGTTTGGACATG-1_V12D07-335_C1,1,1,0,0,0,2
TTCGCATCCGGAAGCA-1_V12D07-335_C1,2,0,0,0,0,2
CCCTAGTGTCAGGTGT-1_V12D07-335_C1,0,2,0,0,0,2
TTACCGCCTTAGGGAA-1_V12D07-335_C1,0,1,0,0,0,1
CCAGTCCATTATTCGA-1_V12D07-335_C1,2,2,0,1,0,5
CGTAAACGCTTGAGTG-1_V12D07-335_C1,2,5,0,0,0,7
ATTCCTTCCAGGCGGT-1_V12D07-335_C1,4,4,0,0,0,8
TTCCTTTCTGTGTTGC-1_V12D07-335_C1,0,3,0,0,0,3
AGTTGACATCGGCTGG-1_V12D07-335_C1,0,0,0,0,0,0
AACTCGATGGCGCAGT-1_V12D07-335_C1,1,3,1,0,0,5
GATAAGGCAGATGCAA-1_V12D07-335_C1,0,4,0,0,0,4
GGCTGGCTAGCTTAAA-1_V12D07-335_C1,0,0,0,0,0,0
CCTCATGCAGCTACGA-1_V12D07-335_C1,2,3,0,0,0,5
GACGCCTGTTGCAGGG-1_V12D07-335_C1,2,1,0,0,0,3
TAATTAGATGGATATG-1_V12D07-335_C1,0,2,0,0,0,2
GAGGGCATCGCGTATC-1_V12D07-335_C1,1,3,0,2,0,6
CTTGTGAGTCTTTGAC-1_V12D07-335_C1,1,1,0,0,0,2
TCAACACATTGGGTAA-1_V12D07-335_C1,2,0,0,0,0,2
ACTGTATACGCGAGCA-1_V12D07-335_C1,0,2,0,0,0,2
GTGAAACGTGCTCCAC-1_V12D07-335_C1,0,0,0,1,0,1
CGAGTGCTATAGTTCG-1_V12D07-335_C1,1,4,0,1,0,6
GTACTGCATGAAGCGT-1_V12D07-335_C1,3,4,0,0,0,7
GTAACTTGCGGCAGTC-1_V12D07-335_C1,1,1,0,0,0,2
GAATCGCCGGACACGG-1_V12D07-335_C1,1,1,0,0,0,2
GGGAGTAATGGCTGGC-1_V12D07-335_C1,0,0,0,0,0,0
CATGAACCGACATTTG-1_V12D07-335_C1,0,3,0,0,0,3
TCTGTCATACAAGAGC-1_V12D07-335_C1,1,0,0,0,0,1
GTCGTCAATTATAAGG-1_V12D07-335_C1,0,7,0,0,0,7
TAAAGAGCCCGAAACC-1_V12D07-335_C1,0,3,0,0,0,3
GTACTGAGGTCGTAAC-1_V12D07-335_C1,1,2,0,0,0,3
AAAGACCCAAGTCGCG-1_V12D07-335_C1,1,6,0,0,0,7
CGTCAGTGCGCACAAG-1_V12D07-335_C1,1,2,0,0,0,3
TGTATCCTTATTCCAT-1_V12D07-335_C1,0,1,1,1,0,3
ATTCTCGTCTCTTTAG-1_V12D07-335_C1,0,5,0,0,0,5
AAAGTCACTGATGTAA-1_V12D07-335_C1,3,0,0,0,0,3
TGTCTACAGTTTCTGT-1_V12D07-335_C1,0,0,0,0,0,0
TTAACGTCGCAAGACC-1_V12D07-335_C1,2,7,3,0,0,12
CTATGTCTATTGAAAC-1_V12D07-335_C1,1,2,0,0,0,3
TCGGGTGAAACTGCTA-1_V12D07-335_C1,0,1,0,1,0,2
TGTCCCGACATAGCAC-1_V12D07-335_C1,0,4,0,1,0,5
ACAGCATAGAGCCAGT-1_V12D07-335_C1,3,2,0,0,0,5
ATATTCCCACAGGTCA-1_V12D07-335_C1,0,2,0,0,0,2
TTGGATCGACTTCTGG-1_V12D07-335_C1,0,5,1,0,0,6
CACCATCGGAGGAGAC-1_V12D07-335_C1,1,4,0,0,0,5
TCGTTCGTTATTATGT-1_V12D07-335_C1,0,6,0,0,0,6
CTTAACTTCGAAGTAC-1_V12D07-335_C1,1,1,1,0,0,3
GCACAAGTGTCGGAAG-1_V12D07-335_C1,1,0,0,0,0,1
TACCAGCTAGGTTTAA-1_V12D07-335_C1,0,1,0,0,0,1
ACGTACAGATTTCTCT-1_V12D07-335_C1,1,4,0,1,0,6
AATTTGGTTCCAAAGA-1_V12D07-335_C1,1,3,2,1,0,7
GTAAGGATTTGTCGGA-1_V12D07-335_C1,0,4,0,0,0,4
CATCATCTACCCGGAC-1_V12D07-335_C1,0,3,1,0,0,4
ACGATGGATCCGATGC-1_V12D07-335_C1,0,1,0,0,0,1
CACTCAGCTCTTGAGG-1_V12D07-335_C1,0,4,0,0,0,4
TAGATCCGAAGTCGCA-1_V12D07-335_C1,0,3,0,0,0,3
TGAAACTTATGCAAGC-1_V12D07-335_C1,0,1,0,0,0,1
GCGATTCTGGAAGCAG-1_V12D07-335_C1,0,0,0,0,0,0
CAAACTATTGAGCTTC-1_V12D07-335_C1,1,2,0,0,0,3
TAGAATTAAGGGCAAC-1_V12D07-335_C1,2,0,0,0,0,2
CGAAACATAGATGGCA-1_V12D07-335_C1,1,1,0,0,0,2
GATGGTGCCCTAGGCA-1_V12D07-335_C1,0,1,2,0,0,3
CCCGCAGGGCCCAAAG-1_V12D07-335_C1,1,4,1,0,0,6
ACAGCGCACCCGCAGC-1_V12D07-335_C1,0,0,1,0,0,1
GGTAAATGTGCGTTAC-1_V12D07-335_C1,1,6,0,0,0,7
GTCCTTCTAGTGGGTT-1_V12D07-335_C1,0,2,0,0,0,2
GGAAGCTCGCTTACAG-1_V12D07-335_C1,1,6,0,0,0,7
CACCGATACACCGAGC-1_V12D07-335_C1,0,2,0,0,0,2
CAGCCGGGCCCTCTAT-1_V12D07-335_C1,2,0,0,0,0,2
CGGAGCTTATAACACC-1_V12D07-335_C1,1,0,0,0,0,1
ATTACAACTACCGGCC-1_V12D07-335_C1,0,2,1,0,0,3
TCCTCTGGCCCATTAG-1_V12D07-335_C1,0,1,0,0,0,1
CGGCACCGTTAGCGCC-1_V12D07-335_C1,0,1,0,0,0,1
TCGGTCCCTGACTCCA-1_V12D07-335_C1,0,4,0,0,0,4
TGGTTGGAGGATCCTG-1_V12D07-335_C1,0,0,0,0,0,0
CTGCGGTAGTCACGTG-1_V12D07-335_C1,0,1,1,0,0,2
GTGCCTCAGTGTACGG-1_V12D07-335_C1,0,9,0,0,0,9
ATCGTTCACTTTCGCC-1_V12D07-335_C1,0,2,2,0,0,4
ACTTACCGGGCGCGCA-1_V12D07-335_C1,1,5,4,0,0,10
CTAGACTGCATTTCGT-1_V12D07-335_C1,0,3,0,0,0,3
TTGCCGGTGATCCCTC-1_V12D07-335_C1,0,4,0,1,0,5
CTGTCACGCCAGGCGC-1_V12D07-335_C1,1,2,0,0,0,3
CGGTATAGGTATTAGC-1_V12D07-335_C1,3,1,1,0,0,5
CCAACGCTTGCCAGGG-1_V12D07-335_C1,0,0,0,0,0,0
CGTTGAGTAATTGCGT-1_V12D07-335_C1,0,0,0,0,0,0
TGTATTTACCTAATGC-1_V12D07-335_C1,2,2,1,0,0,5
TAAATGCCGTCTCATG-1_V12D07-335_C1,1,1,0,0,0,2
CGGTTTATGAAGGAAC-1_V12D07-335_C1,0,3,0,1,0,4
GCAAGATGTGTTCGCG-1_V12D07-335_C1,2,4,0,0,0,6
AAAGGTAAGCTGTACC-1_V12D07-335_C1,1,2,0,0,0,3
GTACGTCACGTATTAA-1_V12D07-335_C1,1,4,0,0,0,5
AGTACCTTCGAGTGCT-1_V12D07-335_C1,1,0,0,0,0,1
ATTGTGACTTCGCTGC-1_V12D07-335_C1,0,1,1,0,0,2
TGTATCAGACTGAAGC-1_V12D07-335_C1,0,2,0,0,0,2
GAGACCCTGCAACGCC-1_V12D07-335_C1,0,6,0,0,0,6
TGGGTGGGATGTCATT-1_V12D07-335_C1,0,3,0,0,0,3
GGCTAATGATTGAAAT-1_V12D07-335_C1,0,1,0,0,0,1
ATAACGTTACCTCCAC-1_V12D07-335_C1,1,1,0,0,0,2
TGCGAGATGGCGGCCA-1_V12D07-335_C1,3,3,0,0,0,6
CACACTTGTATTGCGA-1_V12D07-335_C1,0,1,0,0,0,1
GCTGGTGACTCGTAGT-1_V12D07-335_C1,2,4,2,0,0,8
CGACACCGCTTAAGGA-1_V12D07-335_C1,0,4,0,0,0,4
GTAACAACTGACCTTG-1_V12D07-335_C1,1,1,0,0,0,2
CAACTGAGGGTATGAC-1_V12D07-335_C1,1,1,2,0,1,5
CTAATTATGAAGCGTA-1_V12D07-335_C1,1,4,1,0,0,6
CCGATCTTAAGAGGCT-1_V12D07-335_C1,0,0,0,0,0,0
CGACTCGGTACACGGT-1_V12D07-335_C1,0,0,1,0,0,1
TGCTGCGTCAGAGTTA-1_V12D07-335_C1,0,4,1,0,0,5
AGAGTTGCAGGCCTCC-1_V12D07-335_C1,0,7,0,0,0,7
ACTGGCGAACCTGCGT-1_V12D07-335_C1,0,4,0,0,0,4
ACTAAGGACGCACACC-1_V12D07-335_C1,0,0,0,0,0,0
CGTCCAGATGGCTCCA-1_V12D07-335_C1,0,1,0,0,1,2
ACTATCGCCGGCTAAA-1_V12D07-335_C1,0,0,0,1,0,1
GATAGCGTACCACGCG-1_V12D07-335_C1,2,2,1,1,0,6
AGGACTTATAGGAGAA-1_V12D07-335_C1,0,3,0,1,0,4
TAGTCGGGATTCTTCG-1_V12D07-335_C1,1,2,0,0,0,3
ACCATTAAGGGTGTCA-1_V12D07-335_C1,5,0,0,1,0,6
TTAATGTGTTTGCAGG-1_V12D07-335_C1,1,1,0,0,0,2
TCCGCAGCCACCTAGC-1_V12D07-335_C1,0,0,0,0,0,0
GAGGAGATCCTCATGC-1_V12D07-335_C1,1,0,1,0,0,2
GGTCCTTCATACGACT-1_V12D07-335_C1,2,4,0,0,0,6
CCCTGTTGGCAAAGAC-1_V12D07-335_C1,1,2,0,1,0,4
GTGCCTAGCTATGCTT-1_V12D07-335_C1,0,1,1,0,0,2
GTCATCTCCTACAGCT-1_V12D07-335_C1,0,2,0,0,0,2
GCGAGAAACGGGAGTT-1_V12D07-335_C1,0,1,0,2,0,3
CGTCGCGGCGGGATTT-1_V12D07-335_C1,0,1,0,0,0,1
CATTGTGTGCTAGATC-1_V12D07-335_C1,0,3,0,0,1,4
CGCGGCAGTATTACGG-1_V12D07-335_C1,1,3,0,0,0,4
GAAATGGGATGTAAAC-1_V12D07-335_C1,2,2,0,0,0,4
CATTCCCTAAGTACAA-1_V12D07-335_C1,2,2,0,0,0,4
AGTTCTGCGTTGTATC-1_V12D07-335_C1,3,1,0,0,0,4
ACCCTATAGGACTGAG-1_V12D07-335_C1,2,1,0,0,0,3
TTAGATAGGTCGATAC-1_V12D07-335_C1,0,1,0,1,0,2
ATTGATAGCAACGAGA-1_V12D07-335_C1,3,2,0,0,0,5
TCTCGGCTCCAGGACT-1_V12D07-335_C1,1,4,0,0,0,5
CTTGAGGTTATCCCGA-1_V12D07-335_C1,0,0,0,0,0,0
AAGAAGGATCAGTTAG-1_V12D07-335_C1,0,2,0,0,0,2
GTACGACGGCGCTGCG-1_V12D07-335_C1,3,1,0,0,0,4
CTTATGTTGACTACCA-1_V12D07-335_C1,1,1,0,0,0,2
CGGCACTCAAGAAAGT-1_V12D07-335_C1,1,1,0,0,0,2
GTCAAAGTTTACATAG-1_V12D07-335_C1,1,2,0,0,2,5
CTCCTAAGTTATGTCT-1_V12D07-335_C1,1,3,0,0,0,4
ACTGTGCTAGTAGATC-1_V12D07-335_C1,1,1,0,1,0,3
GTTTGGCCGCTCAGCG-1_V12D07-335_C1,0,4,0,0,0,4
TTATCCAATCGAACTC-1_V12D07-335_C1,0,2,0,0,0,2
CCGTACCCAAGCGCCA-1_V12D07-335_C1,1,3,0,1,0,5
CATACAAAGCCGAACC-1_V12D07-335_C1,0,0,0,0,0,0
GGTCGGTAATTAGACA-1_V12D07-335_C1,2,2,0,0,0,4
AGCGGGAAGGGTCCAT-1_V12D07-335_C1,1,0,0,0,0,1
GCCCACCAAGGCTGTC-1_V12D07-335_C1,2,4,0,0,0,6
GTAGACGTCGTTACAT-1_V12D07-335_C1,0,2,0,0,0,2
GAGCATCATCCCTGGG-1_V12D07-335_C1,1,3,0,0,0,4
AGGTAACCTCCTATTC-1_V12D07-335_C1,1,1,2,0,0,4
GGTTTGAGTGCTGGAA-1_V12D07-335_C1,4,2,0,0,0,6
GCACTAGTCGCGCTAT-1_V12D07-335_C1,0,4,0,0,0,4
GGTAACTATGTATCTG-1_V12D07-335_C1,2,0,0,1,0,3
GCGGTCCCTAGACGCA-1_V12D07-335_C1,1,1,0,0,0,2
CGAGCGTTGATCAGCC-1_V12D07-335_C1,2,1,0,0,0,3
AATCCAAGGGCCTGAG-1_V12D07-335_C1,1,0,0,0,0,1
CCGTGCCCATGACGGC-1_V12D07-335_C1,2,0,0,0,0,2
GAAATTCACATCGCTG-1_V12D07-335_C1,0,1,0,1,0,2
CTCTGCGAAGCAAGCA-1_V12D07-335_C1,0,3,0,0,0,3
AGTAGGTAACATACAT-1_V12D07-335_C1,1,0,0,0,0,1
ATTGGGAATATCTTGG-1_V12D07-335_C1,1,5,0,0,0,6
TAGAGCTACGAAGAAC-1_V12D07-335_C1,1,3,0,0,0,4
TGCGGCATAGTTCAAC-1_V12D07-335_C1,2,3,0,1,0,6
CCGCCGGTCAACACAC-1_V12D07-335_C1,1,3,0,0,0,4
TCGTATAGTGCAATTA-1_V12D07-335_C1,2,2,0,0,0,4
TAGTTTATTCTTGCTT-1_V12D07-335_C1,2,2,0,0,0,4
GATATCTCATGCAATA-1_V12D07-335_C1,2,3,0,1,0,6
CGTTTAAGCGGAGCAC-1_V12D07-335_C1,0,0,0,0,0,0
CATGCTGGCTCCAATT-1_V12D07-335_C1,1,4,0,0,0,5
GAAACAGCCATGCAGT-1_V12D07-335_C1,1,1,0,0,0,2
AGTTTCGCAGGTCGGA-1_V12D07-335_C1,2,4,1,0,0,7
CTCATGGCTCACAATC-1_V12D07-335_C1,2,2,0,0,0,4
AACCGTTGTGTTTGCT-1_V12D07-335_C1,0,3,0,0,0,3
ACCCTTCATCTGCGAA-1_V12D07-335_C1,4,1,0,0,0,5
TGCGGTGAAATTTCAT-1_V12D07-335_C1,0,6,1,0,0,7
CAAATTGTCAGCAAGC-1_V12D07-335_C1,2,5,0,0,0,7
GAGGTACATCCATCTT-1_V12D07-335_C1,0,2,2,0,0,4
AAATGGCATGTCTTGT-1_V12D07-335_C1,0,3,0,0,0,3
TCATCCCAGAGGGTGG-1_V12D07-335_C1,0,4,1,0,0,5
CGTAGCGAATTGTCAG-1_V12D07-335_C1,0,3,0,0,0,3
CCTAGTTAGTCGCATG-1_V12D07-335_C1,3,4,0,0,0,7
GAAACTCTAATGAAGG-1_V12D07-335_C1,1,5,1,0,0,7
TTGTATCACACAGAAT-1_V12D07-335_C1,1,0,1,0,0,2
TTCAAGCCGAGCTGAG-1_V12D07-335_C1,0,3,2,0,0,5
AGGTACGATATTGCCA-1_V12D07-335_C1,0,2,0,0,0,2
TTAAGCCGACAACTTC-1_V12D07-335_C1,0,2,1,0,0,3
GTCTTAGTACAGCCGG-1_V12D07-335_C1,0,0,0,0,0,0
TGGGTAAGGTTCCCGC-1_V12D07-335_C1,0,3,1,0,0,4
CTACGCCATTTCCGAT-1_V12D07-335_C1,1,1,0,0,0,2
GACCGTCAGGTCGTGA-1_V12D07-335_C1,1,1,0,0,0,2
TAGTTAAGATAGGATA-1_V12D07-335_C1,1,6,1,0,0,8
GAATATTCGGAGTCCC-1_V12D07-335_C1,1,2,1,0,0,4
CAAACTACGATAGAGA-1_V12D07-335_C1,1,5,0,0,0,6
CAGGAAGACTTTATAT-1_V12D07-335_C1,1,2,1,0,0,4
TTCGTAATCCCAGCGG-1_V12D07-335_C1,2,3,0,0,0,5
GTGAGGAGCGGTTGAG-1_V12D07-335_C1,0,3,0,0,0,3
CAATCCCTATACCAGC-1_V12D07-335_C1,2,2,0,0,0,4
AGGGAAACGAGGTACT-1_V12D07-335_C1,0,1,0,0,0,1
TCCTGCCAACTGGAGA-1_V12D07-335_C1,3,0,1,0,0,4
AATTTGGGACATAGTA-1_V12D07-335_C1,1,4,0,0,0,5
AACTCCTAATCCCATG-1_V12D07-335_C1,1,3,0,0,0,4
GCTCATTACTGCATGT-1_V12D07-335_C1,2,6,3,0,0,11
TCTCGAACGAGGTCAC-1_V12D07-335_C1,0,2,0,0,0,2
TCACTACGACCAATGC-1_V12D07-335_C1,0,2,3,0,0,5
GTGATGCACAACATCT-1_V12D07-335_C1,0,0,0,0,0,0
CCGACGTAAACACAAC-1_V12D07-335_C1,6,1,1,0,0,8
TGGGATGCACTCATTC-1_V12D07-335_C1,1,4,0,0,0,5
TTCCATCATGCGGTGA-1_V12D07-335_C1,1,8,2,0,0,11
TGCACAGTGAAGTTAT-1_V12D07-335_C1,0,0,0,0,0,0
CTATTGTGTTTGGTCA-1_V12D07-335_C1,1,3,0,0,0,4
TGCGAGCCCTTCCGCG-1_V12D07-335_C1,0,4,0,0,1,5
TTGAAAGGTGTAAAGG-1_V12D07-335_C1,0,5,1,0,0,6
GGTGCAGAGCCTATCG-1_V12D07-335_C1,0,1,0,0,0,1
ACTATATGCTGTGTTC-1_V12D07-335_C1,0,5,0,0,0,5
TCCTGGCGCTGCCTGG-1_V12D07-335_C1,1,5,2,0,0,8
GAGCCGAGCGTTTATT-1_V12D07-335_C1,0,3,0,0,0,3
AGAATGCGGGTTCGGA-1_V12D07-335_C1,0,4,0,0,0,4
ATGCGACAATTGGTCC-1_V12D07-335_C1,1,2,0,0,0,3
TTCCGGCTCGACTTCT-1_V12D07-335_C1,1,0,0,0,0,1
TGATTATGGCACGCAG-1_V12D07-335_C1,2,1,0,0,0,3
GGTTTGACAAGAAGCT-1_V12D07-335_C1,2,2,0,0,0,4
GCAGCTATGGACAGGT-1_V12D07-335_C1,0,2,0,0,0,2
CACCATGATCGCAAAG-1_V12D07-335_C1,1,6,2,0,0,9
GTCGGAAGGATACCAG-1_V12D07-335_C1,0,3,0,0,0,3
GGCCCAGTTATCAGCA-1_V12D07-335_C1,0,2,0,0,0,2
GGGCCTATTTAAGTAT-1_V12D07-335_C1,0,1,1,0,0,2
GTTGTTACATTGCGCT-1_V12D07-335_C1,1,2,8,0,0,11
CAACTCCGTAACTTGC-1_V12D07-335_C1,1,4,1,0,0,6
GATCTTTGCTCAAAGA-1_V12D07-335_C1,0,0,2,0,0,2
TCGCTTAATTACGAAG-1_V12D07-335_C1,0,2,0,0,0,2
CGATCATTAGAGGCAC-1_V12D07-335_C1,0,5,0,0,0,5
TGTTCTCTACTCCCTA-1_V12D07-335_C1,1,4,0,0,0,5
GCTTAGGGAAGCGGTA-1_V12D07-335_C1,0,2,0,0,0,2
CAGGTTTAGTACTACA-1_V12D07-335_C1,0,2,0,0,0,2
AAGCGGAGTGCGCGCA-1_V12D07-335_C1,0,5,2,0,0,7
TCAGATGGAGACGTAG-1_V12D07-335_C1,0,1,1,0,0,2
TCGCACTAACGTTTGT-1_V12D07-335_C1,3,3,0,0,0,6
CACGTCGGGTTCTAGA-1_V12D07-335_C1,0,2,2,1,0,5
GGAGTACACATGAGCT-1_V12D07-335_C1,0,0,0,0,0,0
GTGTGTCGACGTCGCT-1_V12D07-335_C1,1,4,1,2,0,8
GAAGCTCTTTGCTTAG-1_V12D07-335_C1,2,1,0,0,0,3
ACACCGAGCGCTCTTT-1_V12D07-335_C1,1,0,0,0,0,1
CGTAATAATTACGAGT-1_V12D07-335_C1,2,2,0,0,0,4
CATCAACACCTACTAA-1_V12D07-335_C1,1,0,0,1,0,2
CCAAGTTTCTACAGAT-1_V12D07-335_C1,2,2,1,2,0,7
ACGGGTCATGTGACTT-1_V12D07-335_C1,1,3,0,1,0,5
AGTGTGCTAAGATCGC-1_V12D07-335_C1,3,1,0,1,0,5
GGCGGTTTGCCGGTGC-1_V12D07-335_C1,1,6,0,2,0,9
GTATAATCTCCCGGAT-1_V12D07-335_C1,0,3,0,1,0,4
TAGTCCGTATGCATAA-1_V12D07-335_C1,2,2,0,3,0,7
CACTTCGTCTTATCTC-1_V12D07-335_C1,0,2,0,1,0,3
CATCCGCAGGCCCGAA-1_V12D07-335_C1,3,1,0,0,0,4
CCCTGATGTAACTCGT-1_V12D07-335_C1,3,2,0,0,0,5
CCATAGTCAGTAACCC-1_V12D07-335_C1,0,1,0,0,0,1
CGGGCCATAGCCGCAC-1_V12D07-335_C1,0,4,0,0,0,4
CTCCGGCTTGTAGACA-1_V12D07-335_C1,2,3,0,0,0,5
AACTTGCGTTCTCGCG-1_V12D07-335_C1,0,1,0,0,0,1
AATGAGTTCGCATATG-1_V12D07-335_C1,2,0,0,0,0,2
CGAGGCCAGGCATTGG-1_V12D07-335_C1,2,4,0,0,0,6
TCTGCGTCCGGTTTCT-1_V12D07-335_C1,0,2,0,1,0,3
CAATCCTGCCGTGGAG-1_V12D07-335_C1,1,3,0,1,0,5
CTGAGCAAGTAACAAG-1_V12D07-335_C1,1,1,0,0,0,2
GGGTACCCACGGTCCT-1_V12D07-335_C1,0,3,0,0,0,3
ACGGAATTTAGCAAAT-1_V12D07-335_C1,1,2,0,1,0,4
GGGCGGTCCTATTGTC-1_V12D07-335_C1,3,0,0,0,0,3
ATGTTACGAGCAATAC-1_V12D07-335_C1,2,1,0,0,0,3
AACCATGGGATCGCTA-1_V12D07-335_C1,1,0,0,0,0,1
TCGCATCCCTAAGTGT-1_V12D07-335_C1,1,5,1,0,0,7
ACTTAGTACGACAAGA-1_V12D07-335_C1,0,0,0,0,0,0
GAGCTCTCGGACCTAA-1_V12D07-335_C1,0,2,0,0,0,2
TCTATTACGCTGGCGA-1_V12D07-335_C1,0,2,0,0,0,2
AGATACGACTTCATAT-1_V12D07-335_C1,0,3,1,0,0,4
CGCTATACCGCCCACT-1_V12D07-335_C1,0,7,0,1,0,8
CAGTGTCCGCAGAATG-1_V12D07-335_C1,0,5,0,0,0,5
CCATCCATACCAAGTC-1_V12D07-335_C1,3,2,0,0,0,5
AACCCAGAGACGGAGA-1_V12D07-335_C1,0,0,0,0,0,0
GAAGAACGGTGCAGGT-1_V12D07-335_C1,1,1,0,0,0,2
GATAAATCGGTGGATG-1_V12D07-335_C1,1,2,0,0,0,3
CAGCTCGTGCTTGTGT-1_V12D07-335_C1,2,1,0,0,0,3
GAGTACGGGTATACAA-1_V12D07-335_C1,0,1,0,0,0,1
CATCGCCCGCGGCCAA-1_V12D07-335_C1,0,2,0,0,0,2
TCTTACAGAGGTACCG-1_V12D07-335_C1,3,1,0,0,0,4
TGGAAGACGAACACCA-1_V12D07-335_C1,1,3,0,0,0,4
GTTGTCGTGTTAGTTG-1_V12D07-335_C1,5,4,0,0,0,9
CCAAGGAACAGAGAGG-1_V12D07-335_C1,2,3,0,0,0,5
CTGCACCTGGAACCGC-1_V12D07-335_C1,0,4,0,0,0,4
CGCTTTCATACCGGTG-1_V12D07-335_C1,0,0,0,0,0,0
GTTCTTCCCTCGATGT-1_V12D07-335_C1,1,1,0,0,0,2
ATTTAACTCGTATTAC-1_V12D07-335_C1,1,2,0,1,0,4
AACGATAGAAGGGCCG-1_V12D07-335_C1,0,4,0,1,0,5
TATCCTGCATGGGAAT-1_V12D07-335_C1,0,1,0,1,0,2
AGGCCCATTGTACAGG-1_V12D07-335_C1,4,2,0,1,0,7
CCGGCGCATATTGGAT-1_V12D07-335_C1,1,1,0,2,0,4
ATCTGTAATTGTACCC-1_V12D07-335_C1,0,0,1,1,0,2
GAGCGAGGGAGTACCG-1_V12D07-335_C1,1,0,0,0,0,1
TTATTAGGGAAGCATC-1_V12D07-335_C1,1,4,0,1,0,6
CTTCTTACGTCGTATA-1_V12D07-335_C1,0,2,1,0,0,3
GAAGTGCTGGATAGCT-1_V12D07-335_C1,2,5,0,1,0,8
GTGCAACAAATGTGGC-1_V12D07-335_C1,2,1,0,0,0,3
CATGCGTTAGACAGAA-1_V12D07-335_C1,0,2,0,1,0,3
ACACACTTTCTACACG-1_V12D07-335_C1,2,0,0,0,0,2
AGCCCTAAGCGAAGTT-1_V12D07-335_C1,0,1,1,0,0,2
ATTAATTCGGTCACTC-1_V12D07-335_C1,1,3,1,0,0,5
AACAGGAAATCGAATA-1_V12D07-335_C1,3,1,0,0,1,5
ACGTTTAGTTGTGATC-1_V12D07-335_C1,1,1,0,0,0,2
TCCTTCAGTGGTCGAA-1_V12D07-335_C1,2,1,0,1,0,4
CGAACGCCCAGTGCCG-1_V12D07-335_C1,1,0,0,0,0,1
CCTCGAAGTGGACGGG-1_V12D07-335_C1,1,0,0,0,0,1
CTCTGTTTGAGGATTC-1_V12D07-335_C1,1,0,0,0,0,1
TGGGCACGTTCTATGG-1_V12D07-335_C1,3,0,0,0,1,4
ACTATTCGTCCGTGGT-1_V12D07-335_C1,0,2,0,0,0,2
CCTCTGGCCTAGACGG-1_V12D07-335_C1,2,3,0,0,0,5
CCATAAACAACCCGAC-1_V12D07-335_C1,1,7,1,0,0,9
CATAGTACATTGAGAG-1_V12D07-335_C1,0,3,0,0,0,3
ATTTCATTATTTCGCG-1_V12D07-335_C1,0,3,0,0,0,3
CAACTATATCGAATGC-1_V12D07-335_C1,0,1,0,0,1,2
CTAGTATTCGGAATTA-1_V12D07-335_C1,0,2,0,0,0,2
GTGGAACCTACATGCG-1_V12D07-335_C1,0,4,0,0,0,4
CCTAAAGGCTGACGCT-1_V12D07-335_C1,1,2,0,0,0,3
CGTGACATTGGGTCGT-1_V12D07-335_C1,0,1,0,0,0,1
CCAATCGGTAGATCGA-1_V12D07-335_C1,0,1,0,0,0,1
ATTGTCGCAATACCTT-1_V12D07-335_C1,0,10,1,0,0,11
AAATTACACGACTCTG-1_V12D07-335_C1,0,3,0,0,0,3
CACTCCTCTCGGTCGG-1_V12D07-335_C1,0,2,1,0,0,3
AAATAACCATACGGGA-1_V12D07-335_C1,0,7,0,0,0,7
AGTTACTCTATCGTGG-1_V12D07-335_C1,1,0,0,0,0,1
CGTTAGCTCACAACTG-1_V12D07-335_C1,1,3,1,0,0,5
GAATGTATGGCAGGTC-1_V12D07-335_C1,2,2,0,0,0,4
GCAACCACCAGACCGG-1_V12D07-335_C1,2,1,0,0,0,3
TCACTCGTGCAACGGC-1_V12D07-335_C1,1,2,1,0,0,4
AAACAGAGCGACTCCT-1_V12D07-335_C1,1,0,1,0,0,2
CAGCCTCTCCTCAAGA-1_V12D07-335_C1,4,3,2,0,0,9
TTGCGTGAACGCTTAG-1_V12D07-335_C1,0,1,1,0,0,2
CCGCCTGCGAATTGGT-1_V12D07-335_C1,1,2,1,0,0,4
AGATGAGGGTTGCGAT-1_V12D07-335_C1,2,1,0,0,0,3
CGGTGGGCTCCAGCCT-1_V12D07-335_C1,0,1,0,0,0,1
GGCAGCGGTAATCCTA-1_V12D07-335_C1,0,2,1,0,0,3
GCTAGCAGGGAGTGGG-1_V12D07-335_C1,0,1,0,0,0,1
CTCAAGACATTAGCGC-1_V12D07-335_C1,2,4,4,0,0,10
CACGGCGCGCCAAAGG-1_V12D07-335_C1,2,5,2,0,0,9
TGCAATTTGGGCACGG-1_V12D07-335_C1,0,3,1,0,0,4
ATGCCAATCGCTCTGC-1_V12D07-335_C1,0,1,0,0,0,1
GCTGGACCCAAAGTGG-1_V12D07-335_C1,1,4,0,0,0,5
ATTCCTAAGACGTGGA-1_V12D07-335_C1,0,4,1,0,0,5
TCCGGAGGAAGGGCTG-1_V12D07-335_C1,1,0,0,0,1,2
TCGGTGACCGCTCCGG-1_V12D07-335_C1,1,1,1,0,0,3
TCCGAAGTAGTCACCA-1_V12D07-335_C1,1,3,1,0,0,5
CATGTAGGAGCGCCAA-1_V12D07-335_C1,0,6,2,0,0,8
CACAAGAAAGATATTA-1_V12D07-335_C1,1,3,2,0,0,6
AGGGTCAGTAACCCTA-1_V12D07-335_C1,1,2,1,0,0,4
TAAGCCCTTACGACCA-1_V12D07-335_C1,0,9,1,0,0,10
ATACCGTCATCCATAA-1_V12D07-335_C1,0,4,0,0,0,4
GGACGTCCATAGTTGG-1_V12D07-335_C1,0,7,2,0,1,10
CATCAAACTGGCGCCC-1_V12D07-335_C1,1,1,1,0,0,3
AAACGTGTTCGCCCTA-1_V12D07-335_C1,0,2,0,0,0,2
AAATTGGTGAGAAGCA-1_V12D07-335_C1,0,1,1,0,0,2
GGTCATTGTAGTCATA-1_V12D07-335_C1,1,2,0,0,0,3
TGCAGTGAGGCTCGGG-1_V12D07-335_C1,1,1,0,0,0,2
GAACATTAGTATGTTA-1_V12D07-335_C1,1,2,0,0,0,3
GGTTTGCGAACACGTA-1_V12D07-335_C1,0,2,0,0,0,2
ACACAAATATTCCTAG-1_V12D07-335_C1,1,5,0,0,0,6
TTGGGTTTATTCAGCG-1_V12D07-335_C1,0,2,0,0,0,2
ATTCGCAGAGGACACT-1_V12D07-335_C1,0,5,0,0,0,5
GATTTAGTGCGTACTG-1_V12D07-335_C1,2,6,0,0,0,8
TAGAAACACAATAGTG-1_V12D07-335_C1,2,2,0,0,0,4
CAGTAGATGATGTCCG-1_V12D07-335_C1,1,0,0,1,0,2
TCTTAACTCGGATGTA-1_V12D07-335_C1,1,1,0,0,0,2
TACATCTTGTTTCTTG-1_V12D07-335_C1,2,1,0,2,0,5
TTCATAGGGTGTCCAT-1_V12D07-335_C1,0,0,2,2,0,4
TGAAGTAGCTTACGGA-1_V12D07-335_C1,0,2,2,1,0,5
GCACAAGTGGATCATA-1_V12D07-335_C1,0,1,0,0,1,2
GGGCGAATTTCTCCAC-1_V12D07-335_C1,1,0,0,0,0,1
ATGTTCCTGCCCACCT-1_V12D07-335_C1,0,2,0,0,0,2
GCTCAACCTCTTAGAG-1_V12D07-335_C1,1,4,0,2,0,7
ATAGCTGCTCTTGTTA-1_V12D07-335_C1,1,0,0,0,0,1
CGTCAGCTATTTACTC-1_V12D07-335_C1,0,2,0,0,0,2
ATCTGATAGTGTCTTA-1_V12D07-335_C1,3,2,0,1,0,6
TGCACTATGTGAGTGC-1_V12D07-335_C1,1,0,0,0,0,1
CCGACAAACACATGAG-1_V12D07-335_C1,8,1,0,0,0,9
GCCTTGTATATGCAGT-1_V12D07-335_C1,2,3,0,1,0,6
ATAATACCGTTAGCCG-1_V12D07-335_C1,5,2,0,0,0,7
ACACTCCAATGTCACT-1_V12D07-335_C1,0,1,0,0,0,1
AGTTGCTGACTGATAT-1_V12D07-335_C1,0,3,0,0,0,3
GGCGCTCCTCATCAAT-1_V12D07-335_C1,1,7,1,0,0,9
TGCCTGACATCGGTCA-1_V12D07-335_C1,1,1,0,1,0,3
TTGGCCATCTTGCGCT-1_V12D07-335_C1,1,1,0,1,0,3
CAGTGGTTGCACATGA-1_V12D07-335_C1,0,0,0,0,0,0
AGAATTGTTTGACATA-1_V12D07-335_C1,1,0,0,1,0,2
AAATGCTCGTTACGTT-1_V12D07-335_C1,2,4,0,0,0,6
CACCTAATAGAGTCGT-1_V12D07-335_C1,1,3,0,0,0,4
CATTTCTAGCAGACTA-1_V12D07-335_C1,2,2,1,0,0,5
CCGAAAGTGGTGAGCA-1_V12D07-335_C1,1,1,0,0,0,2
AGTCAGCCACCGCCTG-1_V12D07-335_C1,0,0,0,1,0,1
TCATCACTCGAGCTCG-1_V12D07-335_C1,1,1,0,0,0,2
CTCAGGACTCACCTGT-1_V12D07-335_C1,1,1,0,0,0,2
CGGTGTACTTGATCCC-1_V12D07-335_C1,1,0,0,0,0,1
CCTACGGCTCAGTCGA-1_V12D07-335_C1,1,1,0,0,0,2
GTACTTGGGCACTTCT-1_V12D07-335_C1,2,0,2,0,0,4
TGATTTCCTCCTGACG-1_V12D07-335_C1,2,0,0,0,0,2
CCTCACCAATCTTGAC-1_V12D07-335_C1,3,1,0,0,0,4
GGTGAGATGCAGATAA-1_V12D07-335_C1,1,2,0,1,0,4
GCTAGTTTCATTGAGG-1_V12D07-335_C1,1,4,0,0,0,5
AGGACATCGCACGTCG-1_V12D07-335_C1,2,1,0,0,0,3
GTGGACGTGCTGAGAC-1_V12D07-335_C1,0,1,0,0,0,1
TAAGGAACTTGTGGGA-1_V12D07-335_C1,1,2,0,1,0,4
TCGCTGTGCGTAAATC-1_V12D07-335_C1,3,2,1,1,0,7
GCATCCCTAACTTTGA-1_V12D07-335_C1,0,3,0,0,0,3
CACCCACACGTCACCC-1_V12D07-335_C1,0,2,0,1,0,3
CCCTCATTCTGGAATT-1_V12D07-335_C1,1,3,0,0,0,4
AGGGCGTGATCGGCTA-1_V12D07-335_C1,0,1,1,0,0,2
GGTGCGGATAAGTGGC-1_V12D07-335_C1,3,1,0,0,0,4
TAATATTGAAATTCGC-1_V12D07-335_C1,0,1,0,0,0,1
CTTACACTGGGAAATA-1_V12D07-335_C1,0,2,0,0,0,2
ACCAAGAACGCGTGTC-1_V12D07-335_C1,0,3,0,0,0,3
GCCTTCAGCCCTACCG-1_V12D07-335_C1,3,0,0,0,0,3
GATGCTACAAGCGCCT-1_V12D07-335_C1,1,2,0,0,0,3
CCGGGACCCGCAGAGA-1_V12D07-335_C1,0,1,0,0,0,1
GTTCCAGTCTGACCAT-1_V12D07-335_C1,2,1,0,0,0,3
ATGATCGGGAATAGAC-1_V12D07-335_C1,1,0,0,0,0,1
TTGGATTGGGTACCAC-1_V12D07-335_C1,0,4,0,0,0,4
TACCTCACGCTTGTAC-1_V12D07-335_C1,1,1,0,0,0,2
CATGGCAGGAAGATCG-1_V12D07-335_C1,0,1,0,0,0,1
ATGACGCCGGCTCTAA-1_V12D07-335_C1,1,1,2,0,0,4
AGCGACATCCCATTCA-1_V12D07-335_C1,0,1,1,0,0,2
AGTAATGTCTTGCCGC-1_V12D07-335_C1,0,1,0,1,0,2
TTCTTAGTGGCTCAGA-1_V12D07-335_C1,1,0,0,0,0,1
CGTCTGGAAGGGCCCG-1_V12D07-335_C1,0,3,0,0,0,3
ACGTGCGCCTCGTGCA-1_V12D07-335_C1,1,3,3,1,0,8
AGAGCGGGCTAATCAT-1_V12D07-335_C1,3,3,1,0,0,7
GCGTCGAAATGTCGGT-1_V12D07-335_C1,1,1,0,0,0,2
AACTGATATTAGGCCT-1_V12D07-335_C1,0,7,0,0,0,7
CGAGCTGGGCTTTAGG-1_V12D07-335_C1,0,2,0,0,0,2
GGGTGTTTCAGCTATG-1_V12D07-335_C1,0,0,1,0,0,1
TTAATTTCAGACGCGG-1_V12D07-335_C1,0,6,0,0,0,6
ACTGCCGTCGTAACTC-1_V12D07-335_C1,1,0,0,0,0,1
GTGCACGAAAGTGACT-1_V12D07-335_C1,2,3,1,0,0,6
ATCTCCCTGCAATCTA-1_V12D07-335_C1,4,0,0,0,0,4
ACGCCAGATGATTTCT-1_V12D07-335_C1,0,5,0,0,0,5
AGCTATTTAATCCAAC-1_V12D07-335_C1,1,0,0,0,0,1
CCACGAGAAGAGAATC-1_V12D07-335_C1,1,3,0,0,0,4
GATTCCGCGTTTCCGT-1_V12D07-335_C1,0,1,0,0,1,2
GTCGGATGTAGCGCGC-1_V12D07-335_C1,0,1,0,0,0,1
TATTTATACCGAGTAG-1_V12D07-335_C1,1,2,0,0,6,9
GTAGGTGATCCGTGTA-1_V12D07-335_C1,0,3,1,0,1,5
AGTTAAGCGGTCCCGG-1_V12D07-335_C1,0,5,0,0,2,7
CTGGCGACATAAGTCC-1_V12D07-335_C1,0,0,0,5,2,7
TTGGCCTAGAATTTCG-1_V12D07-335_C1,0,0,0,4,0,4
GGCATATCGGTTCTGC-1_V12D07-335_C1,0,0,0,1,0,1
GGGCGTCCACTGGCTC-1_V12D07-335_C1,5,0,0,3,0,8
TTACCCATTGCCGGGT-1_V12D07-335_C1,0,0,0,0,0,0
TTAGACACGATCGTTG-1_V12D07-335_C1,2,2,0,0,0,4
GCGCTGATCCAGACTC-1_V12D07-335_C1,0,3,1,0,1,5
TTCGGCAACCCGCTGA-1_V12D07-335_C1,4,2,1,0,0,7
GATATTTCCTACATGG-1_V12D07-335_C1,1,4,0,0,3,8
CTGCGTTACGATATAA-1_V12D07-335_C1,1,3,1,0,0,5
TAATAAACAAGGAGAT-1_V12D07-335_C1,1,2,0,0,0,3
AACCTTTACGACGTCT-1_V12D07-335_C1,3,2,0,0,0,5
AGTCCCGCCTTTAATT-1_V12D07-335_C1,0,3,2,0,0,5
TGAGATTAGGCCCTAA-1_V12D07-335_C1,1,2,0,0,0,3
AGTGTATTGCGCATTG-1_V12D07-335_C1,0,4,0,0,0,4
GTTGGATTCAGTGGCT-1_V12D07-335_C1,0,0,0,0,0,0
TAAAGCTGCAATAGGG-1_V12D07-335_C1,0,3,0,0,0,3
AGTAGGAAGGAAGTTG-1_V12D07-335_C1,0,1,0,0,0,1
TATCACTTCGAGTAAC-1_V12D07-335_C1,0,3,0,0,0,3
TGATCTACGCTGATCT-1_V12D07-335_C1,1,3,0,0,0,4
GGATCATCCCGTACGC-1_V12D07-335_C1,0,0,0,0,0,0
TGACACTTCTCTTTGC-1_V12D07-335_C1,1,4,0,0,0,5
AGCCCTTCTAATCCGA-1_V12D07-335_C1,3,0,1,0,0,4
CACCGCGTCCACTCTA-1_V12D07-335_C1,0,2,0,0,0,2
TAATTGGAATCGGGAA-1_V12D07-335_C1,2,2,0,0,0,4
TCGTAAGCTCCGAGGA-1_V12D07-335_C1,0,1,1,0,1,3
TATATTACAAATGTCG-1_V12D07-335_C1,0,2,0,0,0,2
CGCGAGAGGGACTTGT-1_V12D07-335_C1,0,4,1,0,0,5
GGACCTACGGTAACGT-1_V12D07-335_C1,0,2,0,0,0,2
GAAATATGCTTGAATG-1_V12D07-335_C1,1,5,0,0,0,6
CCGTATTAGCGCAGTT-1_V12D07-335_C1,1,5,1,0,0,7
AGGCGTCTATGGACGG-1_V12D07-335_C1,0,1,0,0,0,1
AACATCGATACGTCTA-1_V12D07-335_C1,3,2,1,0,0,6
TGAATATGCTATAAAC-1_V12D07-335_C1,1,0,0,0,0,1
ACCAAACACCCAGCGA-1_V12D07-335_C1,0,1,1,0,0,2
TGGCTTGTACAAGCTT-1_V12D07-335_C1,0,4,0,0,0,4
GAATGAAGGTCTTCAG-1_V12D07-335_C1,0,0,1,0,0,1
AGATACCAGCACTTCA-1_V12D07-335_C1,0,0,0,0,0,0
GCGGTCCCGGTGAAGG-1_V12D07-335_C1,0,1,0,0,0,1
GAGGCATTTGCAGCAG-1_V12D07-335_C1,0,2,0,0,0,2
GGCAAGCCAGGGATAG-1_V12D07-335_C1,0,1,0,0,0,1
TCTACGGGCTCAGTTG-1_V12D07-335_C1,0,2,0,0,0,2
TCTGCGAATCGTTCGC-1_V12D07-335_C1,0,2,2,0,0,4
AGCTCGTTGATGGAAA-1_V12D07-335_C1,2,3,0,0,0,5
TGAATGAGATACAGCA-1_V12D07-335_C1,2,1,0,0,0,3
ACCCTTGCCTGGGTCG-1_V12D07-335_C1,1,2,1,0,0,4
GGCGAACCGTTCTGAT-1_V12D07-335_C1,1,2,0,0,0,3
GCGATGTCTGTGCTTG-1_V12D07-335_C1,2,0,0,3,0,5
ATTAACACCTGAGATA-1_V12D07-335_C1,2,0,0,0,0,2
GAAATCTGACCAAGTT-1_V12D07-335_C1,1,1,0,1,0,3
CCTGACAAACTCGCGC-1_V12D07-335_C1,2,2,1,1,0,6
ATGTCATTTCCCATTG-1_V12D07-335_C1,1,0,0,0,0,1
GCGGTGCGGAGCATCG-1_V12D07-335_C1,1,4,0,4,0,9
CGGAAAGCAAATGTGC-1_V12D07-335_C1,1,1,0,1,0,3
GCTGAGCAACGGTTCT-1_V12D07-335_C1,3,0,0,1,3,7
TCACTCTTCGTCTGTC-1_V12D07-335_C1,2,0,0,0,0,2
GATCTTCATTGTCCTC-1_V12D07-335_C1,1,2,0,0,0,3
ACTCGATGTATTTCAT-1_V12D07-335_C1,1,1,0,0,0,2
TGAAGAGCGGTCCTAG-1_V12D07-335_C1,3,3,0,1,0,7
TAAACGTCGTCAATGA-1_V12D07-335_C1,3,0,0,2,0,5
ACGTTATTGGTCACTC-1_V12D07-335_C1,0,2,0,1,0,3
ATAGCCTCAGTACCCA-1_V12D07-335_C1,3,2,0,1,0,6
CGGGAGTATACCGCCG-1_V12D07-335_C1,0,1,0,1,0,2
GTCCTACAGGCGGCTC-1_V12D07-335_C1,0,2,0,1,0,3
CGGATAAGCGGACATG-1_V12D07-335_C1,2,3,0,0,0,5
AACTTCTGCGTCTATC-1_V12D07-335_C1,4,1,0,0,0,5
GGGTTCAGACGAACAA-1_V12D07-335_C1,0,0,0,0,0,0
AGTCTGGACATCCTTG-1_V12D07-335_C1,5,0,0,0,0,5
TTGAACGAATCCTTTG-1_V12D07-335_C1,0,3,0,0,0,3
GAAATACTAAACGTTT-1_V12D07-335_C1,1,4,1,1,0,7
CCCGCGCAATGCACCC-1_V12D07-335_C1,0,0,0,0,0,0
TTCGGCTAGAGATGGT-1_V12D07-335_C1,3,3,0,1,0,7
GACACGAGTTAGAGGA-1_V12D07-335_C1,0,3,0,0,0,3
GAGGTCCCAAAGATCT-1_V12D07-335_C1,1,0,0,1,0,2
TAACTCCATGGAGGCT-1_V12D07-335_C1,1,0,0,0,0,1
CTTGTTTATGTAGCCA-1_V12D07-335_C1,0,4,0,0,0,4
GATGGCGCACACATTA-1_V12D07-335_C1,1,0,0,0,0,1
ATAATAGTGTAGGGAC-1_V12D07-335_C1,0,0,0,0,0,0
CGCTATTCAATGTATG-1_V12D07-335_C1,0,1,0,0,0,1
ATATTGCTGTCAAAGT-1_V12D07-335_C1,0,0,0,0,1,1
GGATTCAGTACGGTGG-1_V12D07-335_C1,0,3,0,0,0,3
TTCTTAGTGAACGGTG-1_V12D07-335_C1,0,1,0,1,0,2
AATGGTTCTCACAAGC-1_V12D07-335_C1,2,7,0,0,0,9
TATACACGCAAAGTAT-1_V12D07-335_C1,0,0,0,0,0,0
CTTCATAGCTCAAGAA-1_V12D07-335_C1,1,4,0,0,0,5
CAACGGTTCTTGATAC-1_V12D07-335_C1,1,2,0,0,0,3
ACACCCGAGAAATCCG-1_V12D07-335_C1,1,0,0,0,0,1
TCTATCATGCAGTTAC-1_V12D07-335_C1,0,3,1,0,0,4
CCCGCCATGCTCCCGT-1_V12D07-335_C1,1,1,0,0,0,2
CGCTTCCACTGAAATC-1_V12D07-335_C1,0,0,0,0,0,0
CACTGTCCAAGTGAGA-1_V12D07-335_C1,0,2,0,1,0,3
ATTACTAGCCTCTTGC-1_V12D07-335_C1,1,1,0,1,0,3
CATAGTAGCATAGTAG-1_V12D07-335_C1,2,1,0,0,0,3
CAACTCCTTGATCCCG-1_V12D07-335_C1,0,0,0,1,0,1
AAGTAGAAGACCGGGT-1_V12D07-335_C1,0,2,0,0,0,2
GCGGGAACCAGGCCCT-1_V12D07-335_C1,2,1,0,0,0,3
ATTAGATTGATAGCGG-1_V12D07-335_C1,1,2,0,0,0,3
CTCGGTCCGTAGCCTG-1_V12D07-335_C1,0,4,0,0,0,4
TGGCTTTGGGTAGACA-1_V12D07-335_C1,3,3,0,0,0,6
TATCCATATCATGCGA-1_V12D07-335_C1,1,1,0,1,0,3
GGAGTGCCGCCCTGGA-1_V12D07-335_C1,0,0,0,0,0,0
TGAGAATGCTTTACCG-1_V12D07-335_C1,3,2,0,0,0,5
TTAACCAACCCTCCCT-1_V12D07-335_C1,2,3,0,0,0,5
TGTTTCGGTACTTCTC-1_V12D07-335_C1,0,0,1,0,0,1
TTGCTGAAGGAACCAC-1_V12D07-335_C1,0,1,1,0,0,2
TATTTAGTCTAGATCG-1_V12D07-335_C1,0,1,0,1,0,2
CTCCGGCCTAATATGC-1_V12D07-335_C1,1,1,0,0,0,2
TTGTGGCCCTGACAGT-1_V12D07-335_C1,0,3,0,1,0,4
TCGCCGGTCGATCCGT-1_V12D07-335_C1,0,3,0,0,0,3
CCATAGGTTGGCGTGG-1_V12D07-335_C1,0,1,0,1,1,3
GAACGACCGAATGATA-1_V12D07-335_C1,1,1,0,0,0,2
TCCGATAATTGCCATA-1_V12D07-335_C1,0,0,0,0,0,0
CATTACGTCGGCCCGT-1_V12D07-335_C1,1,0,0,0,1,2
CAAGCACCAAATGCCT-1_V12D07-335_C1,1,2,0,1,2,6
TGCATGGATCGGATCT-1_V12D07-335_C1,2,8,0,0,0,10
GAAATCGCGCGCAACT-1_V12D07-335_C1,1,7,0,0,0,8
CTGAAAGAGATCCGAC-1_V12D07-335_C1,1,0,0,0,0,1
CACCTCGATGGTGGAC-1_V12D07-335_C1,1,0,0,0,2,3
ATTTGTTCCAGGGCTC-1_V12D07-335_C1,1,4,0,0,0,5
TGGGCCACAAGAGCGC-1_V12D07-335_C1,1,4,1,0,1,7
CCTTCTTGATCCAGTG-1_V12D07-335_C1,1,2,1,0,1,5
CCTCGCCAGCAAATTA-1_V12D07-335_C1,1,2,1,0,1,5
TTCATGGCGCAACAGG-1_V12D07-335_C1,0,3,4,0,0,7
TTAATCAGTACGTCAG-1_V12D07-335_C1,1,3,0,0,0,4
CCTATCTATATCGGAA-1_V12D07-335_C1,0,3,0,0,0,3
ATTATACTTTGCTCGT-1_V12D07-335_C1,1,3,1,0,0,5
ATGGATCCGGCGTCCG-1_V12D07-335_C1,1,6,1,0,1,9
CGCCCGCTTCCGTACA-1_V12D07-335_C1,0,4,0,0,0,4
GGATTCCGCTATACCC-1_V12D07-335_C1,1,2,1,0,0,4
CGGTCTATCAACCCGT-1_V12D07-335_C1,0,2,1,0,1,4
ATGCCGGTTGATGGGA-1_V12D07-335_C1,2,4,0,0,0,6
TCATGCAGGTTCTCAT-1_V12D07-335_C1,0,1,1,0,0,2
TGAGCTTTAATGACGC-1_V12D07-335_C1,0,1,0,0,0,1
TCCCTTAGATTACTCG-1_V12D07-335_C1,0,1,0,0,0,1
ATATCTCCCTCGTTAA-1_V12D07-335_C1,0,4,0,0,0,4
AGCTCTTCCCAGTGCA-1_V12D07-335_C1,0,3,0,0,0,3
TCGCTAAACCGCTATC-1_V12D07-335_C1,0,0,0,0,0,0
CACATTCTTTCGATGG-1_V12D07-335_C1,0,5,0,0,0,5
GATATGCGGTAGCCAA-1_V12D07-335_C1,0,6,0,0,0,6
CGTTTCACTTCGGGCG-1_V12D07-335_C1,1,3,1,0,0,5
CCAATTACGGGTCGAG-1_V12D07-335_C1,2,8,1,0,0,11
GCAGGTAGAGTATGGT-1_V12D07-335_C1,0,4,0,0,0,4
GTCGTATTGGCGTACA-1_V12D07-335_C1,1,2,0,0,0,3
GAAATTAGCACGGATA-1_V12D07-335_C1,0,4,0,0,0,4
AATGCACCAAGCAATG-1_V12D07-335_C1,1,6,0,0,0,7
AGGACGCTCGATGTTG-1_V12D07-335_C1,0,0,0,0,0,0
GGCTAAAGGGCGGGTC-1_V12D07-335_C1,1,1,1,0,0,3
CATCTATCCCGTGTCT-1_V12D07-335_C1,0,6,0,0,0,6
CAGTAACTATTTATTG-1_V12D07-335_C1,0,1,1,0,0,2
CATATACTACTGATAA-1_V12D07-335_C1,1,4,0,0,0,5
GCGTTCGGAGACCGGG-1_V12D07-335_C1,1,5,1,0,0,7
AAGTTCAGTCTGCGTA-1_V12D07-335_C1,1,3,0,0,0,4
CGAAGCTATAAATTCA-1_V12D07-335_C1,0,1,0,0,0,1
CGCGGTCACAAACCAA-1_V12D07-335_C1,2,4,1,0,0,7
GGGAATGAGCCCTCAC-1_V12D07-335_C1,1,3,0,0,0,4
ACGGAGCGCAAATTAC-1_V12D07-335_C1,0,2,1,0,0,3
CGTTCTTCGCACACCT-1_V12D07-335_C1,0,6,1,0,0,7
GAATAGCCCTGCGGTC-1_V12D07-335_C1,0,3,0,0,1,4
AATAGCTACCGCGTGC-1_V12D07-335_C1,0,4,1,0,0,5
CCGAGCTGTGCTTGTC-1_V12D07-335_C1,1,5,0,0,0,6
GATGACGATGATCGCG-1_V12D07-335_C1,1,3,1,0,1,6
GCCTATGCTGGGCCTT-1_V12D07-335_C1,1,1,0,0,0,2
TTACTGTCTAGAGCTC-1_V12D07-335_C1,0,2,1,0,1,4
AGCGGTTGCCGCTCTG-1_V12D07-335_C1,2,1,0,0,0,3
GCTTGCAGCACAATTG-1_V12D07-335_C1,0,2,2,0,0,4
CCGGAGGTCTTATGGT-1_V12D07-335_C1,0,1,0,0,0,1
ACAGTATACCGTGGGA-1_V12D07-335_C1,3,0,0,0,0,3
GGGATCCCAATACAAA-1_V12D07-335_C1,0,3,0,0,0,3
ATTACGACTCCACAGT-1_V12D07-335_C1,1,0,0,0,0,1
CTCACACGCAAGCCTA-1_V12D07-335_C1,2,0,1,0,0,3
CCAGATGTAAATGGGT-1_V12D07-335_C1,0,3,2,0,0,5
GAACTTGTGCACGGGA-1_V12D07-335_C1,3,5,0,0,0,8
AAGCCGCTTTACCTTG-1_V12D07-335_C1,1,0,1,0,0,2
TCCATTCCCACTAGAG-1_V12D07-335_C1,0,5,1,0,0,6
AGAGCGCTTGTAACGG-1_V12D07-335_C1,0,7,1,0,1,9
TGGGTTCCCGGACGGA-1_V12D07-335_C1,1,1,0,1,0,3
GCTGCGCCTCCCACGT-1_V12D07-335_C1,2,0,0,2,0,4
CTGTTGGCTCTTCTGA-1_V12D07-335_C1,3,0,0,1,0,4
TTGTTCTAGATACGCT-1_V12D07-335_C1,0,1,1,0,0,2
CCCTCAAGCTCTTAGT-1_V12D07-335_C1,2,0,0,2,0,4
TGGTCTAGCTTACATG-1_V12D07-335_C1,2,0,0,2,0,4
ATGCACCTTCCTTAAT-1_V12D07-335_C1,1,2,0,1,0,4
GGGATACGGTAATAAT-1_V12D07-335_C1,3,2,1,1,0,7
AGTTCACCGGTTGGAC-1_V12D07-335_C1,1,2,0,1,0,4
GACATACTGTCGCAGA-1_V12D07-335_C1,1,2,0,1,0,4
TGGACACCGTTGCTTG-1_V12D07-335_C1,5,3,0,0,0,8
TGCGATGCTAATGGCT-1_V12D07-335_C1,0,0,0,1,0,1
TTCTGTTTCCTGTCGC-1_V12D07-335_C1,0,0,0,0,0,0
CGTTGTAAACGTCAGG-1_V12D07-335_C1,0,0,0,0,0,0
GATCGGCGATAAGTCG-1_V12D07-335_C1,2,2,0,1,0,5
AGCCTTAAAGCGGAAG-1_V12D07-335_C1,0,1,0,2,0,3
TCCGTAACCACAATCC-1_V12D07-335_C1,0,3,0,0,0,3
GAATGCCGAAATGACC-1_V12D07-335_C1,3,1,1,1,7,13
TATACTCATGCGGCAA-1_V12D07-335_C1,0,0,1,0,0,1
TAGTGTCAGAAACGGC-1_V12D07-335_C1,0,0,0,0,1,1
CGTCATACCATATCCA-1_V12D07-335_C1,1,6,0,0,0,7
TAGTACCTTAGTGGTC-1_V12D07-335_C1,2,2,0,0,0,4
CTGGCGGGAATAAGTA-1_V12D07-335_C1,2,4,0,1,1,8
AGTGTGGTCTATTGTG-1_V12D07-335_C1,3,4,0,1,2,10
GCTATCGCGGCGCAAC-1_V12D07-335_C1,1,4,0,0,0,5
CAGTAATCCCTCCCAG-1_V12D07-335_C1,2,1,0,0,0,3
GTATTAAGGCGTCTAA-1_V12D07-335_C1,1,1,0,0,0,2
CTAATTTCAACAACAC-1_V12D07-335_C1,0,1,0,0,0,1
TTAGCAACATGGATGT-1_V12D07-335_C1,3,0,0,0,0,3
ATGCTCAGTGTTGCAT-1_V12D07-335_C1,3,2,0,1,0,6
GATGTTTGTGCGAGAT-1_V12D07-335_C1,0,1,0,1,0,2
CACTTCGCCACAGGCT-1_V12D07-335_C1,3,1,0,0,0,4
CTGTATGGTGTAGAAA-1_V12D07-335_C1,0,0,0,0,0,0
TACGTGCACTATGCTG-1_V12D07-335_C1,0,1,0,0,0,1
GTATCAGCTTGGGTTC-1_V12D07-335_C1,0,3,0,0,0,3
TAACAAAGGGAGAAGC-1_V12D07-335_C1,1,4,1,0,0,6
TTACATCGTGGCCTGG-1_V12D07-335_C1,0,1,0,0,0,1
TCTGAACCGGTCGGCT-1_V12D07-335_C1,0,0,0,0,0,0
GGCTCGTGCCACCAGC-1_V12D07-335_C1,0,4,0,0,0,4
TATAAGTGAGGATAGC-1_V12D07-335_C1,2,2,0,1,0,5
GCCCGCGCGTTTGACA-1_V12D07-335_C1,1,4,0,0,0,5
TGCTGGTTGGACAATT-1_V12D07-335_C1,1,2,0,0,0,3
GCCTAGCGATCTGACC-1_V12D07-335_C1,1,2,0,0,0,3
CCATGCTCTGCAGGAA-1_V12D07-335_C1,2,0,0,0,0,2
TATAAATCCACAAGCT-1_V12D07-335_C1,2,5,0,0,0,7
CGCTCGACATAATGAT-1_V12D07-335_C1,0,3,0,1,0,4
CCAATTGAATGTTAAT-1_V12D07-335_C1,2,3,0,0,0,5
GCTAATACCGAATGCC-1_V12D07-335_C1,0,0,0,1,0,1
TTCAACGACCCGACCG-1_V12D07-335_C1,0,3,0,0,0,3
TTCCTCGAGGGTGTCT-1_V12D07-335_C1,1,4,0,0,0,5
CAACGACCCGTTTACA-1_V12D07-335_C1,1,2,0,0,0,3
CTTGTACTTGTTGACT-1_V12D07-335_C1,0,4,0,0,0,4
TCTCTAATAGCTGGTA-1_V12D07-335_C1,0,1,0,0,0,1
ATTATGCCATAGGGAG-1_V12D07-335_C1,2,7,0,0,0,9
GACAACGCAGCTTACG-1_V12D07-335_C1,1,1,0,1,0,3
AGATGACTCGCCCACG-1_V12D07-335_C1,0,2,0,1,0,3
GTGCGGGTCTCCAAAT-1_V12D07-335_C1,1,3,0,1,1,6
GTACGAGATTGCGACA-1_V12D07-335_C1,0,1,0,0,0,1
GTATAGGACTCAGTAG-1_V12D07-335_C1,0,1,0,0,0,1
TTGCACGGAGCAGCAC-1_V12D07-335_C1,1,1,0,0,1,3
CACAGCTAGGGAGTGA-1_V12D07-335_C1,0,0,0,0,0,0
ATACTAGCATGACCCT-1_V12D07-335_C1,0,1,0,1,0,2
CCAAGACTTCTGCGAA-1_V12D07-335_C1,2,1,1,0,2,6
ACATAATAAGGCGGTG-1_V12D07-335_C1,0,0,0,0,0,0
TAATACACAGTAGTAT-1_V12D07-335_C1,2,3,0,2,0,7
TCTTGGTAACACCAAA-1_V12D07-335_C1,1,5,0,0,0,6
AACTGGGTCCCGACGT-1_V12D07-335_C1,0,3,0,0,0,3
ATCACTTCATCCTCGC-1_V12D07-335_C1,1,2,0,0,0,3
TGGAAGGATAAAGATG-1_V12D07-335_C1,0,2,0,0,0,2
CATGATGCACAATTCT-1_V12D07-335_C1,0,0,0,0,0,0
TGCCTGATCAAACGAT-1_V12D07-335_C1,2,0,0,0,0,2
ATAGGGATATCCTTGA-1_V12D07-335_C1,0,3,2,0,1,6
CACCTAATCAGTTTAC-1_V12D07-335_C1,0,1,0,0,0,1
TGTGACTACGCCAGTC-1_V12D07-335_C1,0,6,0,0,0,6
CCCGACCATAGTCCGC-1_V12D07-335_C1,1,2,0,0,0,3
CGCGCCCGACTTAATA-1_V12D07-335_C1,1,3,0,0,1,5
TGCCACCTGGCGAAAC-1_V12D07-335_C1,0,8,2,0,0,10
CTGCCAAGGTTGGAAG-1_V12D07-335_C1,0,3,0,0,1,4
TCTCCAACGTAGGTTA-1_V12D07-335_C1,0,5,0,0,0,5
TTCTTGGAGTAATGAG-1_V12D07-335_C1,0,5,1,0,1,7
GTCTCGATCTGCTTTC-1_V12D07-335_C1,0,3,0,0,1,4
TACTCTCCGAACAAAT-1_V12D07-335_C1,0,4,0,0,0,4
ATCACATTAGAATATC-1_V12D07-335_C1,0,0,1,0,0,1
TACGGGATGCTAGCAG-1_V12D07-335_C1,0,2,0,0,0,2
AGCTGAAGTAAACCAA-1_V12D07-335_C1,1,3,1,0,0,5
CATGGGTCGGGTGTGG-1_V12D07-335_C1,2,3,0,0,0,5
CACCCACGAGGCAATT-1_V12D07-335_C1,0,1,0,0,0,1
TGCCATTACTAAAGAA-1_V12D07-335_C1,1,3,0,0,0,4
CCGTTACGTTAGAACA-1_V12D07-335_C1,0,0,1,0,0,1
GCCAGGAGTAACCGAT-1_V12D07-335_C1,0,2,0,0,0,2
GGAAAGTGCCCATGCC-1_V12D07-335_C1,1,5,0,0,0,6
TCTTACCGGAACTCGT-1_V12D07-335_C1,0,2,0,0,0,2
TATGTCAAGACCGACT-1_V12D07-335_C1,0,2,0,0,0,2
CCTAACTAAGGCTCTA-1_V12D07-335_C1,0,7,0,0,0,7
GCGGTGAACTGCGCTC-1_V12D07-335_C1,2,1,0,0,1,4
CCTCGCGCGATATAGG-1_V12D07-335_C1,2,9,1,0,0,12
ATCGGCAAGCAGTCCA-1_V12D07-335_C1,0,1,0,0,0,1
AGATCGTGCATAAGAT-1_V12D07-335_C1,1,0,0,0,0,1
ATTCAGGACCTATTTC-1_V12D07-335_C1,0,1,0,0,0,1
AGCTAGAAGCAGAAGT-1_V12D07-335_C1,1,6,0,0,0,7
TTCGCTATCTGACGTG-1_V12D07-335_C1,1,3,2,0,0,6
TTCCGCAGAGAAATAT-1_V12D07-335_C1,0,2,0,0,1,3
CAGTACATTCTCTAAA-1_V12D07-335_C1,2,1,0,0,0,3
GTGAAGATTTCAAGTG-1_V12D07-335_C1,0,2,0,0,0,2
AACGCATGATCTGGGT-1_V12D07-335_C1,0,0,1,0,0,1
CCCAGAGGAGGGCGTA-1_V12D07-335_C1,0,3,1,0,0,4
GGAAACCTTGTTGAAT-1_V12D07-335_C1,0,0,0,0,0,0
GTGAAGCCGTATAGTC-1_V12D07-335_C1,1,2,0,0,0,3
GAGCTGTCGTCTCGGA-1_V12D07-335_C1,1,2,0,0,1,4
TGTCATTTGTTGGGAA-1_V12D07-335_C1,0,1,0,0,0,1
ACCAACACCACACACT-1_V12D07-335_C1,1,1,0,0,0,2
AAATGATTCGATCAGC-1_V12D07-335_C1,0,2,2,0,1,5
CTGCTTTATGTCCGCG-1_V12D07-335_C1,2,2,1,0,1,6
GCGAGAGGCCATGTAA-1_V12D07-335_C1,2,2,0,0,0,4
ATTGACCGGCGATGAC-1_V12D07-335_C1,1,4,0,0,0,5
ACCCTGGTAACGCCCT-1_V12D07-335_C1,0,2,2,0,0,4
GTTGGACCGCATCAGG-1_V12D07-335_C1,0,2,0,0,0,2
CGTTTACAAGGCAGCT-1_V12D07-335_C1,0,1,0,0,0,1
CGGTCCATGAGACTCC-1_V12D07-335_C1,2,3,0,0,0,5
GTTCGTCTGGGTCCCT-1_V12D07-335_C1,0,0,1,0,0,1
TGTACTACTCTCACGG-1_V12D07-335_C1,1,1,0,0,0,2
AGTGAAGATGGTGTCC-1_V12D07-335_C1,0,3,0,0,0,3
GAGGGCCATAATATTA-1_V12D07-335_C1,1,1,0,0,0,2
ACTCCCGTAGACTAGG-1_V12D07-335_C1,0,1,1,0,0,2
CGTCAAATGGTCGCAG-1_V12D07-335_C1,0,1,1,0,0,2
AAGTCTAGTAGCTGCC-1_V12D07-335_C1,1,1,0,0,0,2
AAGAAATCACCAGATT-1_V12D07-335_C1,0,1,0,0,1,2
GAGTGCACGGACAACA-1_V12D07-335_C1,0,3,0,0,0,3
GTTCAAATCAGATGTC-1_V12D07-335_C1,0,2,0,0,4,6
CATGGCTCCCTATGTC-1_V12D07-335_C1,3,3,0,1,1,8
GGCCACACGAAAGCCT-1_V12D07-335_C1,4,1,0,0,0,5
GAAGCCGGGTAAGCTC-1_V12D07-335_C1,2,2,0,1,0,5
TTGCGCTCTCTCGCTT-1_V12D07-335_C1,3,2,0,0,0,5
TACATGACCTTATCCG-1_V12D07-335_C1,2,2,0,1,0,5
GTCCTTCTACAACCCA-1_V12D07-335_C1,0,2,0,1,0,3
TATATGCTGGGTTGCC-1_V12D07-335_C1,4,0,0,0,0,4
GTTTATGGGATTTAGA-1_V12D07-335_C1,1,0,0,0,0,1
GGAACCCGAACAAGAA-1_V12D07-335_C1,1,2,0,0,0,3
AACGTTATCAGCACCT-1_V12D07-335_C1,1,1,0,1,0,3
CATCGTCCGGTTACTA-1_V12D07-335_C1,1,3,0,1,0,5
AGACAGCTCAGAATCC-1_V12D07-335_C1,1,3,0,1,0,5
GCAGATCCTCGCAAAT-1_V12D07-335_C1,6,3,0,0,0,9
GGGTCATGCGTACCAT-1_V12D07-335_C1,2,2,1,1,0,6
CTGGTCATTCCAATCC-1_V12D07-335_C1,3,2,0,0,0,5
TCAGGGCGCAAACTCG-1_V12D07-335_C1,0,1,0,1,0,2
GATGCCAGCAGAAGGC-1_V12D07-335_C1,1,2,1,0,0,4
GTTATTAACGTGGGAG-1_V12D07-335_C1,0,3,0,0,0,3
AATACAATGTTTCAGG-1_V12D07-335_C1,2,1,0,0,0,3
TTGCTGCACCTATCCA-1_V12D07-335_C1,1,0,0,0,0,1
CCAGAGACAAAGCCGG-1_V12D07-335_C1,2,0,0,0,0,2
CCGAAGTATATTGTTC-1_V12D07-335_C1,1,5,0,0,0,6
GCTAAACCTGAGGTGA-1_V12D07-335_C1,2,0,0,0,0,2
TCATACTTACAGATCC-1_V12D07-335_C1,1,2,1,0,0,4
CGAGCACTTCAAGTTT-1_V12D07-335_C1,0,2,0,0,0,2
TAGCAACCTGTCACAA-1_V12D07-335_C1,0,0,0,0,0,0
TGGGAAATGCCTTTCC-1_V12D07-335_C1,1,1,0,0,0,2
AGACCATGGGATACAA-1_V12D07-335_C1,1,0,1,0,0,2
TAAATGAATCCGTTTC-1_V12D07-335_C1,0,3,0,0,0,3
ACAACGGTCCCTGCGA-1_V12D07-335_C1,0,3,0,0,0,3
GTCACTCTCCAAATCT-1_V12D07-335_C1,0,2,0,0,0,2
TTCTACTTGCGAGGGC-1_V12D07-335_C1,1,2,0,0,0,3
CGCAATTACTTTCGGT-1_V12D07-335_C1,1,3,0,0,0,4
CTGTTCATCTCACGGG-1_V12D07-335_C1,0,1,0,0,0,1
TTCTTGTAACCTAATG-1_V12D07-335_C1,0,3,0,1,0,4
GCTTGATGATAATCAG-1_V12D07-335_C1,1,2,0,0,0,3
TTGGCTCGCATGAGAC-1_V12D07-335_C1,1,1,0,0,1,3
GCCCAGTTGGTATGCC-1_V12D07-335_C1,2,0,0,0,0,2
ATTCCTCCGCCAGTGC-1_V12D07-335_C1,2,0,0,0,0,2
TCGTCCGCTGGCGTCT-1_V12D07-335_C1,0,2,0,0,0,2
GGAGAAGTCATTGGCA-1_V12D07-335_C1,0,3,0,0,0,3
TTGTTAGCAAATTCGA-1_V12D07-335_C1,0,3,0,0,0,3
TCTAGCATCTTCGATG-1_V12D07-335_C1,3,2,1,0,0,6
TTCTAGGCCAATTGTG-1_V12D07-335_C1,1,0,0,0,0,1
TCACGGTCATCGCACA-1_V12D07-335_C1,0,4,0,0,0,4
ATGAAGCCAAGGAGCC-1_V12D07-335_C1,0,6,2,1,0,9
AATGACTGTCAGCCGG-1_V12D07-335_C1,0,1,0,0,0,1
CCAAACAGAACCCTCG-1_V12D07-335_C1,3,2,0,1,0,6
TATCGATGATTAAACG-1_V12D07-335_C1,0,2,0,0,0,2
GAACACACATCAACCA-1_V12D07-335_C1,0,0,0,0,0,0
CCCGTCAGCGTCTGAC-1_V12D07-335_C1,1,0,0,0,0,1
AGCATCGTCGATAATT-1_V12D07-335_C1,0,2,0,0,0,2
GACTAAGATCATGCAC-1_V12D07-335_C1,1,1,0,2,0,4
TAGGGTGTTTCAAGAG-1_V12D07-335_C1,1,2,0,0,0,3
TGGTTCGTAGCAAAGG-1_V12D07-335_C1,0,3,0,0,0,3
CTGTTCACTGCCTGTG-1_V12D07-335_C1,0,3,0,2,0,5
ATGTGCATCCGACGCA-1_V12D07-335_C1,0,5,0,1,0,6
TTGTCGTTCAGTTACC-1_V12D07-335_C1,0,0,0,0,0,0
CGGGATCAATGTAAGA-1_V12D07-335_C1,1,1,1,2,0,5
TTATCTGTATCATAAC-1_V12D07-335_C1,2,1,0,0,0,3
ATCGACTCTTTCCGTT-1_V12D07-335_C1,1,3,0,0,1,5
CTCATTTGATGGGCGG-1_V12D07-335_C1,0,5,0,0,0,5
GTAAGCGGGCAGTCAG-1_V12D07-335_C1,1,1,0,0,0,2
TCTATCGGTCGCAACA-1_V12D07-335_C1,1,1,0,0,0,2
AACGCGGTCTCCAGCC-1_V12D07-335_C1,1,2,0,0,0,3
ATTAATACTACGCGGG-1_V12D07-335_C1,0,1,1,0,1,3
CTTTAACTTTCAAAGG-1_V12D07-335_C1,0,2,0,0,0,2
CGTACCTGATAGGCCT-1_V12D07-335_C1,0,1,0,0,1,2
GAATGTTGGGTAATCT-1_V12D07-335_C1,2,1,0,0,0,3
TGCGGAGTAAAGGTGC-1_V12D07-335_C1,1,0,1,0,0,2
CCTGAATATTTACATA-1_V12D07-335_C1,1,4,0,0,0,5
TTGCTCCCATACCGGA-1_V12D07-335_C1,1,3,1,1,0,6
CCTCTAATCTGCCAAG-1_V12D07-335_C1,0,1,0,0,0,1
AGGTTGAGGCACGCTT-1_V12D07-335_C1,0,1,1,0,1,3
TCCCGTCAGTCCCGCA-1_V12D07-335_C1,0,0,0,0,0,0
TCCGATGACTGAGCTC-1_V12D07-335_C1,0,0,1,0,3,4
CAGCCTCCTGCAGAGG-1_V12D07-335_C1,0,2,0,0,0,2
CTTAGCCTTCCACATG-1_V12D07-335_C1,0,3,0,0,1,4
ATTAATGAACCAGTCG-1_V12D07-335_C1,0,0,0,0,0,0
ACGATACATAGAACTA-1_V12D07-335_C1,0,5,1,1,1,8
AGCCACTCCCGTGCTT-1_V12D07-335_C1,1,1,2,0,2,6
ATACGGGTTTCGATTG-1_V12D07-335_C1,0,0,0,0,0,0
CTGTCAAATGGCTCGG-1_V12D07-335_C1,0,1,1,0,0,2
GCTCGGAATTTAAAGC-1_V12D07-335_C1,0,7,1,0,0,8
TAGGCATGTTACGCCA-1_V12D07-335_C1,0,3,0,0,0,3
TGGCAACTCGCGCGCC-1_V12D07-335_C1,3,2,0,0,0,5
ATCAGTAGGCAGGGAT-1_V12D07-335_C1,0,3,0,0,0,3
TATCGATCTATGCATA-1_V12D07-335_C1,1,0,0,0,0,1
CGACTCAGGATGTTAT-1_V12D07-335_C1,1,5,0,0,0,6
GCCATATTGCACACAG-1_V12D07-335_C1,0,2,1,0,1,4
AATTCATAAGGGATCT-1_V12D07-335_C1,2,0,0,0,0,2
CGGTAGAGGTGCAGGT-1_V12D07-335_C1,0,3,1,0,0,4
AATGATGATACGCTAT-1_V12D07-335_C1,2,2,0,0,0,4
CTTGTGCTCACCGATT-1_V12D07-335_C1,0,0,0,0,0,0
TTCCAATCAGAGCTAG-1_V12D07-335_C1,1,3,1,0,0,5
CGATGGACCCTACGCC-1_V12D07-335_C1,10,1,2,0,0,13
GGTCGGATAAACGGCG-1_V12D07-335_C1,2,0,0,0,1,3
TTAGCTAATACGATCT-1_V12D07-335_C1,0,6,0,0,0,6
CTCGATATTTGCGAGC-1_V12D07-335_C1,0,4,1,0,0,5
ATTACTTACTGGGCAT-1_V12D07-335_C1,1,3,0,0,0,4
CTAGCCGATGTTATGA-1_V12D07-335_C1,2,3,2,0,0,7
TACTGCAATCAATTAC-1_V12D07-335_C1,0,3,0,0,0,3
TAGTCTGTGACGTTGC-1_V12D07-335_C1,0,3,0,0,0,3
CTCGTTTCTAATGTTT-1_V12D07-335_C1,0,1,0,0,0,1
TTCGTTCAACGAAGTT-1_V12D07-335_C1,1,2,2,0,0,5
CTGAATTTATTGCCAG-1_V12D07-335_C1,1,2,1,0,0,4
TGGAATATCCTTGACC-1_V12D07-335_C1,1,0,0,0,0,1
CAGATCATTTAAAGTC-1_V12D07-335_C1,0,2,0,0,0,2
CTCCTTTACGCAAGTC-1_V12D07-335_C1,0,2,1,0,0,3
TCCCAAACAGACAACG-1_V12D07-335_C1,0,0,0,0,2,2
ATCGCTGCGTGCAGCA-1_V12D07-335_C1,0,5,0,0,0,5
TTAGTTCAAGTGTTCG-1_V12D07-335_C1,0,6,1,0,0,7
AAACTCGTGATATAAG-1_V12D07-335_C1,0,1,0,0,0,1
TTAACGAACAAGCAGT-1_V12D07-335_C1,1,1,2,0,2,6
GTTATATCAGGAGCCA-1_V12D07-335_C1,0,4,1,0,1,6
CAAATTGGATTATGCC-1_V12D07-335_C1,0,6,1,0,0,7
CGAGGAGCTTCCATAT-1_V12D07-335_C1,1,3,0,0,0,4
GGAGACCAATGTGCTT-1_V12D07-335_C1,2,2,1,0,0,5
CATTGATGAACACGCC-1_V12D07-335_C1,0,4,0,0,0,4
GTCAATGCTATAATTT-1_V12D07-335_C1,0,3,0,0,0,3
ACCACCCTCTCTTCTA-1_V12D07-335_C1,0,0,2,0,0,2
TGGAGGGAAACACCTC-1_V12D07-335_C1,1,1,0,0,2,4
CACGGACGTGGATGGC-1_V12D07-335_C1,0,1,0,0,1,2
AACTTTCTCGATCATG-1_V12D07-335_C1,0,5,0,0,0,5
CGTATTGTTTCCTAAT-1_V12D07-335_C1,0,2,0,0,0,2
CCTACTGCGGCGGCCA-1_V12D07-335_C1,0,0,0,0,0,0
CTTAGGTCCCAATCGT-1_V12D07-335_C1,0,1,3,0,0,4
CGCAATCGATCATTAG-1_V12D07-335_C1,0,1,0,1,0,2
TGGTTATGCTTGCGGT-1_V12D07-335_C1,3,0,0,0,0,3
GGCTTGGCTCTCACCT-1_V12D07-335_C1,1,2,0,1,0,4
ATTGGTAGGATCCGCT-1_V12D07-335_C1,0,1,0,0,0,1
TCAGGGCGACTTCCTT-1_V12D07-335_C1,1,3,0,1,0,5
TCTGCAGATTCGAGTC-1_V12D07-335_C1,3,3,0,0,0,6
CTCTCGCTGTACTATG-1_V12D07-335_C1,0,1,0,0,0,1
AATAGTCGCGAGTCGG-1_V12D07-335_C1,0,0,1,1,0,2
AGTTACCCTTAAGACT-1_V12D07-335_C1,0,0,0,1,1,2
CTTAAATAAGACCCAT-1_V12D07-335_C1,2,5,1,0,0,8
GGTTGTGCTCTTGTCC-1_V12D07-335_C1,2,0,1,0,0,3
GTGAGTCTAAGACGGA-1_V12D07-335_C1,1,1,0,0,1,3
CGCGACACTGCGCAGC-1_V12D07-335_C1,1,4,0,1,0,6
GCTCGCGGTTCCGCTC-1_V12D07-335_C1,1,2,1,1,0,5
TTAACTCACGCGTGGA-1_V12D07-335_C1,3,1,0,2,0,6
GGAACGGCCTGCAGCC-1_V12D07-335_C1,2,1,0,1,0,4
GTAGAAACGGGTGGAG-1_V12D07-335_C1,4,1,0,0,0,5
TAATGAAAGACCCTTG-1_V12D07-335_C1,1,0,0,0,0,1
AGGCTTGCTAGACACC-1_V12D07-335_C1,2,2,0,0,0,4
TTGCGTAGTTTGAGGA-1_V12D07-335_C1,0,5,0,0,0,5
CGCCCTTGAAGGCTGA-1_V12D07-335_C1,3,4,0,0,0,7
CCCGGTGGAAGAACCT-1_V12D07-335_C1,1,0,1,0,3,5
TTAACACCTCGAACAT-1_V12D07-335_C1,1,2,1,0,0,4
GATTCCTATACGGCGC-1_V12D07-335_C1,0,0,0,0,0,0
TTACCCTAACAGTCCT-1_V12D07-335_C1,0,6,0,0,2,8
ACCCACCTACATGCTC-1_V12D07-335_C1,1,0,0,0,1,2
AAAGGGCAGCTTGAAT-1_V12D07-335_C1,2,1,0,0,0,3
CACACAGGGATAGATT-1_V12D07-335_C1,1,0,0,0,0,1
AGAGCGTACAAGCTCG-1_V12D07-335_C1,0,1,0,0,0,1
TCTTACGGCATCCGAC-1_V12D07-335_C1,0,1,0,0,0,1
GCCTATTCCGATATAG-1_V12D07-335_C1,0,5,0,0,0,5
GAAAGTGACTAACTGC-1_V12D07-335_C1,0,1,0,0,0,1
CCGGAATGGTTTCAGT-1_V12D07-335_C1,0,4,0,0,0,4
AGTATAATACTAGGCA-1_V12D07-335_C1,0,2,0,0,0,2
TAACTATCGAAGGTCC-1_V12D07-335_C1,2,0,0,0,0,2
ATGAGGAGTGTTAATC-1_V12D07-335_C1,0,2,0,0,0,2
TGTGTCGCGAGTTGCA-1_V12D07-335_C1,0,2,0,0,0,2
ATCCAACGCAGTCATA-1_V12D07-335_C1,1,1,0,0,0,2
AAGGCGCGTAAAGCTT-1_V12D07-335_C1,0,0,0,0,0,0
AGTCGGCCCAAACGAC-1_V12D07-335_C1,2,1,0,1,0,4
AACGTCAGACTAGTGG-1_V12D07-335_C1,1,0,0,1,0,2
ACTACCAGCTCTCTGG-1_V12D07-335_C1,1,5,0,1,0,7
GCAAGTGCACAGAGAA-1_V12D07-335_C1,1,2,0,0,0,3
ACACCTTAAGTAGGGC-1_V12D07-335_C1,0,1,0,0,0,1
TTCGACGGGAAGGGCG-1_V12D07-335_C1,0,3,0,1,0,4
TTCGCACTCGCGTGCT-1_V12D07-335_C1,3,1,0,0,0,4
TATTTGTTACCCTTTA-1_V12D07-335_C1,0,2,0,1,0,3
CGCTGTGACGCCGCAC-1_V12D07-335_C1,0,2,0,0,0,2
GTTGCACGGAGTTTCG-1_V12D07-335_C1,1,4,0,0,0,5
GTTTCCTGGAGGGTGA-1_V12D07-335_C1,0,0,0,0,0,0
ACACCCAGCATGCAGC-1_V12D07-335_C1,4,0,0,0,0,4
TCAACCATGTTCGGGC-1_V12D07-335_C1,1,4,0,0,0,5
TTACAACTACGCATCC-1_V12D07-335_C1,1,0,0,0,0,1
TCCGATGGTGCGACAT-1_V12D07-335_C1,0,0,0,1,0,1
GGGCGTACATTTATAT-1_V12D07-335_C1,1,1,1,0,1,4
AGCGACCAACGATATT-1_V12D07-335_C1,3,2,0,0,0,5
ACACAAAGACGGGTGG-1_V12D07-335_C1,1,4,0,1,2,8
ATCGCACGCCGGGAGA-1_V12D07-335_C1,0,6,0,1,1,8
GCTCTAAACCCTGACG-1_V12D07-335_C1,0,2,0,0,0,2
AATGCAACCGGGTACC-1_V12D07-335_C1,3,1,0,1,0,5
TCAAACAACCGCGTCG-1_V12D07-335_C1,2,1,0,0,0,3
TATGCTCCCTACTTAC-1_V12D07-335_C1,1,1,0,1,0,3
AAAGGGATGTAGCAAG-1_V12D07-335_C1,1,1,0,1,0,3
ACGATCATACATAGAG-1_V12D07-335_C1,1,0,0,0,0,1
TTGTTCAGTGTGCTAC-1_V12D07-335_C1,0,3,0,0,1,4
ATGCATGATCCAGGAT-1_V12D07-335_C1,0,0,0,0,0,0
AGTCTTCTCCTCAAAT-1_V12D07-335_C1,1,2,0,0,1,4
GATTCCCTTGTCGCAG-1_V12D07-335_C1,1,0,1,0,0,2
CTCGCACCTATATAGT-1_V12D07-335_C1,1,0,0,0,0,1
ACTCAATAAAGGCACG-1_V12D07-335_C1,1,0,0,2,0,3
AACCGAGCTTGGTCAT-1_V12D07-335_C1,0,1,0,0,0,1
TAAGGCAACATAAGAT-1_V12D07-335_C1,1,3,1,0,0,5
CACGCACAGCGCAGCT-1_V12D07-335_C1,0,2,0,0,1,3
GGTTTACAATCTCAAT-1_V12D07-335_C1,0,1,0,0,0,1
TGCAGGATCGGCAAAG-1_V12D07-335_C1,1,1,1,2,1,6
ATAACGGAGTCCAACG-1_V12D07-335_C1,1,3,0,0,0,4
AACGATATGTCAACTG-1_V12D07-335_C1,0,1,1,0,1,3
GACAACGACCATTGAA-1_V12D07-335_C1,1,4,0,0,0,5
TTGACCATGTTCTCCG-1_V12D07-335_C1,0,0,0,0,0,0
AGTACGGGCACCTGGC-1_V12D07-335_C1,2,1,0,0,0,3
CGCCATCCGATTATGA-1_V12D07-335_C1,0,4,0,0,0,4
AAGGTATCCTAATATA-1_V12D07-335_C1,1,6,0,2,0,9
TGTTGTCAAGAAGTCT-1_V12D07-335_C1,0,2,0,0,0,2
CAGTGAATAAATGACT-1_V12D07-335_C1,1,5,0,0,1,7
CACCTTGCGAAACTCG-1_V12D07-335_C1,1,3,0,0,0,4
CATTTAGCGGACCATG-1_V12D07-335_C1,1,2,0,0,0,3
CCAGTCTAGACGGCGC-1_V12D07-335_C1,1,3,0,0,0,4
TCGCTTTAAACGTTTG-1_V12D07-335_C1,0,2,0,0,0,2
GTGAAACGGCGCCACC-1_V12D07-335_C1,0,1,0,0,1,2
GGGCTCATCGAACCCA-1_V12D07-335_C1,0,1,0,0,0,1
TTGATGTGTAGTCCCG-1_V12D07-335_C1,0,3,2,0,1,6
CAGTAGCCCACGCGGT-1_V12D07-335_C1,0,5,0,0,0,5
AGCGCGGGTGCCAATG-1_V12D07-335_C1,1,0,0,0,0,1
TAATCGATCCGTACGT-1_V12D07-335_C1,0,2,0,0,0,2
AGTGGCGGCAATTTGA-1_V12D07-335_C1,1,2,0,0,0,3
CCTTTCAATGAAGAAA-1_V12D07-335_C1,1,2,0,0,0,3
CTCAGTCACGACAAAT-1_V12D07-335_C1,0,2,0,0,0,2
ATAGGCTAGCTTCGCA-1_V12D07-335_C1,0,2,0,0,0,2
CGGTTCAAGTAGGTGT-1_V12D07-335_C1,0,8,1,0,4,13
CAGTCGAGGATGCAAT-1_V12D07-335_C1,2,2,0,0,6,10
TATCACCCAACCGACC-1_V12D07-335_C1,0,0,0,0,0,0
AATGATGCGACTCCTG-1_V12D07-335_C1,2,5,0,0,0,7
TGGAACCACTGACACA-1_V12D07-335_C1,0,2,1,0,0,3
GCCAATAGGGCATCTC-1_V12D07-335_C1,1,0,1,0,0,2
TTCTTTGGTCGCGACG-1_V12D07-335_C1,0,5,1,0,1,7
ATTAGATTCCTCAGCA-1_V12D07-335_C1,1,2,0,0,0,3
CCGTGGAACGATCCAA-1_V12D07-335_C1,2,3,0,0,0,5
GGGTCGTGGCAAGTGT-1_V12D07-335_C1,0,2,2,0,0,4
TCGCTCGGCACCAGCG-1_V12D07-335_C1,0,1,1,0,0,2
ACGCAATCACTACAGC-1_V12D07-335_C1,0,3,0,0,1,4
CTCTAATGCATTGATC-1_V12D07-335_C1,0,1,0,0,0,1
GTCTCGACTAAGTTTG-1_V12D07-335_C1,0,1,0,0,1,2
TGGTTTAAACGTGGGT-1_V12D07-335_C1,0,3,0,0,2,5
CGCAGATCTTCACCCG-1_V12D07-335_C1,0,0,1,0,0,1
TCCAGATGTACGCCAA-1_V12D07-335_C1,0,2,1,0,0,3
CATTGCGGGTCAATTC-1_V12D07-335_C1,0,2,1,0,0,3
GACGTTCGTAAATACA-1_V12D07-335_C1,0,1,1,0,0,2
TACACCGTCGTTAGTC-1_V12D07-335_C1,0,2,0,0,0,2
ACGGGCGTATGCGACA-1_V12D07-335_C1,0,2,2,0,0,4
GAAGGCTACCATTGTT-1_V12D07-335_C1,0,3,0,0,0,3
TAAATCTTTACACCTC-1_V12D07-335_C1,0,0,0,0,0,0
AGTTTATGTAAAGACA-1_V12D07-335_C1,0,1,0,0,0,1
AGGAGACATCCACAGT-1_V12D07-335_C1,0,1,2,0,0,3
CAACCTGAACCTGCCA-1_V12D07-335_C1,0,0,0,0,0,0
AGTCCCTCGCAGAAAG-1_V12D07-335_C1,2,2,0,0,0,4
TGTATACGGATGATGA-1_V12D07-335_C1,1,1,2,0,0,4
TTGTGGTATAGGTATG-1_V12D07-335_C1,0,3,1,0,1,5
TCTGCACCATTAGTAA-1_V12D07-335_C1,0,3,1,0,0,4
AAATGTATCTTATCCC-1_V12D07-335_C1,0,1,0,0,1,2
ACTCTAAACCTGGGAT-1_V12D07-335_C1,1,0,0,0,0,1
GCTGGCAGGTGCCGTG-1_V12D07-335_C1,3,2,0,1,1,7
CTCATTCGTGAACATC-1_V12D07-335_C1,0,0,0,0,0,0
TCGCCGGATGGGCAAG-1_V12D07-335_C1,1,0,0,0,1,2
GGACTAAGTCAGGAGT-1_V12D07-335_C1,1,1,0,3,0,5
TATCAAAGGTCTGTAA-1_V12D07-335_C1,0,1,0,0,3,4
TTCAGTTTGTGGCAGC-1_V12D07-335_C1,2,1,1,0,0,4
TGTTCATAAATGTGCT-1_V12D07-335_C1,0,0,0,0,0,0
CTTAGCCCGGATAGTG-1_V12D07-335_C1,1,3,0,0,0,4
GATGCGAATGGTATTA-1_V12D07-335_C1,2,0,1,0,2,5
TCTAACTGTATGTAAA-1_V12D07-335_C1,0,2,0,0,2,4
TTAAACCTGGTTCCTT-1_V12D07-335_C1,0,0,0,0,0,0
GCTAAGTAAAGGCGAT-1_V12D07-335_C1,0,0,0,0,1,1
AGTTACCGCACATGGT-1_V12D07-335_C1,0,1,0,0,0,1
GACTGCGGCACGTGTA-1_V12D07-335_C1,0,0,0,0,0,0
TGGTGATCGTATTTGT-1_V12D07-335_C1,0,0,0,0,0,0
TTATCGCCTGCGAAGC-1_V12D07-335_C1,0,0,0,0,0,0
TGGAATTAGACGCTTT-1_V12D07-335_C1,0,0,0,0,0,0
TCGTCACACTGTTAGC-1_V12D07-335_C1,0,1,0,0,0,1
TTATGTTTGCGATAGA-1_V12D07-335_C1,0,0,0,0,0,0
GGTGCTGATCACAAAG-1_V12D07-335_C1,0,0,0,0,0,0
CATAGCCGCCCGGGAT-1_V12D07-335_C1,1,0,0,0,0,1
GGTTAGTTACGGCGCC-1_V12D07-335_C1,0,0,0,1,0,1
ATTCCCACATAAACAA-1_V12D07-335_C1,0,0,0,0,0,0
ATTCAGTAGCAGGGTC-1_V12D07-335_C1,0,0,0,0,0,0
CAGTTCCGCGGGTCGA-1_V12D07-335_C1,1,1,0,0,0,2
AAGAGATGAATCGGTA-1_V12D07-335_C1,1,0,0,0,0,1
CGCAATTCTACAATAA-1_V12D07-335_C1,0,0,0,0,0,0
TAACGCTTTGAGAGCG-1_V12D07-335_C1,0,0,0,0,0,0
AGGCTATGGTTAGCTT-1_V12D07-335_C1,0,0,0,0,0,0
GAGGAATGGAGAGGTT-1_V12D07-335_C1,1,0,0,0,0,1
TCCTCTACGAGATGGC-1_V12D07-335_C1,0,0,0,0,0,0
TTGATTATGCAGATGA-1_V12D07-335_C1,0,0,0,0,0,0
TCAGTACTGACCCGCG-1_V12D07-335_C1,0,0,0,0,0,0
TTATGACAAACTGGAT-1_V12D07-335_C1,2,0,0,0,0,2
GTAAGTAGGGTATACC-1_V12D07-335_C1,0,0,0,0,0,0
CGCAAACACGAGTTAC-1_V12D07-335_C1,0,0,0,0,0,0
TGGCCGTATATTGACC-1_V12D07-335_C1,0,0,0,0,0,0
ACTGTAGCACTTTGGA-1_V12D07-335_C1,0,0,0,0,0,0
GCTCTATGTTACGTGC-1_V12D07-335_C1,0,5,0,0,0,5
TGCGCGATTAACGGAG-1_V12D07-335_C1,1,0,0,0,0,1
GAATCGACATGGTCAC-1_V12D07-335_C1,3,0,1,0,1,5
GACTAAGTAGGCTCAC-1_V12D07-335_C1,1,2,0,0,0,3
ATCTTGACCTGCAACG-1_V12D07-335_C1,1,1,0,0,0,2
ATGCACTACCGCATTG-1_V12D07-335_C1,0,1,0,0,0,1
CAGATACTAACATAGT-1_V12D07-335_C1,1,1,0,0,0,2
GATCGACACTATCTGA-1_V12D07-335_C1,0,4,0,2,0,6
ATAGAGTACTGGGACA-1_V12D07-335_C1,2,1,0,0,0,3
CCTACTGCTTACACTT-1_V12D07-335_C1,0,0,0,0,0,0
CCTGCTATTTGAGAAG-1_V12D07-335_C1,1,2,0,1,0,4
CGCGTTCATGAAATAC-1_V12D07-335_C1,1,3,0,0,0,4
CATTATGCTTGTTGTG-1_V12D07-335_C1,0,1,0,1,0,2
CCAGGGACGTGGCCTC-1_V12D07-335_C1,2,0,0,0,0,2
TATGGATGTGCTACGC-1_V12D07-335_C1,0,2,0,1,0,3
GTACTAAGATTTGGAG-1_V12D07-335_C1,2,2,0,0,1,5
AGACCCGCCCTCCTCG-1_V12D07-335_C1,0,2,0,1,0,3
CGCATTAGCTAATAGG-1_V12D07-335_C1,0,1,0,1,0,2
GCTCTCGGGTACCGAA-1_V12D07-335_C1,0,0,0,0,0,0
CACCGCCAGAAGGTTT-1_V12D07-335_C1,0,3,0,0,0,3
TCCCAAAGACGAAGGA-1_V12D07-335_C1,2,3,1,0,0,6
ATGGATTGACCAAACG-1_V12D07-335_C1,1,0,0,0,0,1
GTCATGGACATGACTA-1_V12D07-335_C1,0,2,0,0,0,2
CTACTGCCACCTGACC-1_V12D07-335_C1,0,1,0,0,0,1
TTATATTTGGCAATCC-1_V12D07-335_C1,0,0,0,0,0,0
AGCACCAGTACTCACG-1_V12D07-335_C1,0,2,0,0,0,2
CATGGTCTAGATACCG-1_V12D07-335_C1,0,0,0,0,0,0
TCTACCGTCCACAAGC-1_V12D07-335_C1,0,0,0,0,0,0
CTAGTTGGGCCCGGTA-1_V12D07-335_C1,0,7,0,0,2,9
TCCCGCGTACTCCTGG-1_V12D07-335_C1,2,5,0,0,0,7
CAGAGCATGAGCTTGC-1_V12D07-335_C1,2,3,0,0,0,5
ACACGGGAACTTAGGG-1_V12D07-335_C1,1,3,0,0,5,9
GGCTCTGCTCCAACGC-1_V12D07-335_C1,0,1,1,1,1,4
AGAACGTGGTACATTC-1_V12D07-335_C1,1,1,1,0,1,4
CAATAAACCTTGGCCC-1_V12D07-335_C1,2,4,0,0,1,7
ACTTCGCCATACGCAC-1_V12D07-335_C1,0,1,0,0,1,2
ATCTGGTTAAGACTGT-1_V12D07-335_C1,0,5,0,0,0,5
TCGTAAGACGACATTG-1_V12D07-335_C1,0,3,0,1,1,5
GTGTACCTTGGCTACG-1_V12D07-335_C1,0,0,1,1,0,2
GCCCGTAATACCTTCT-1_V12D07-335_C1,0,3,0,0,0,3
CGGTCAAGTGGGAACC-1_V12D07-335_C1,1,2,0,0,0,3
TTGTAAGGCCAGTTGG-1_V12D07-335_C1,0,1,1,0,1,3
GGAGCACCAAGAACTA-1_V12D07-335_C1,0,4,1,0,0,5
TAATAGTGACGACCAG-1_V12D07-335_C1,0,1,0,0,0,1
CTAAATCCTATTCCGG-1_V12D07-335_C1,1,4,1,0,0,6
CGAGTTCTGTCCCACC-1_V12D07-335_C1,0,2,0,0,1,3
AGGCAGATGCGTAAAC-1_V12D07-335_C1,0,1,0,0,0,1
AAGGATGAGGGACCTC-1_V12D07-335_C1,0,1,0,0,0,1
AGAGAACCGTCTAGGA-1_V12D07-335_C1,0,3,1,0,2,6
GAGGGCGCAGCTCTGC-1_V12D07-335_C1,0,1,0,0,0,1
AAGATTGGCGGAACGT-1_V12D07-335_C1,0,2,1,0,0,3
CCAGTAGTCTGATCCA-1_V12D07-335_C1,2,3,0,0,0,5
AAGGGACAGATTCTGT-1_V12D07-335_C1,0,3,0,0,0,3
ATAGAGTTATCAACTT-1_V12D07-335_C1,0,4,0,0,3,7
AAATTACCTATCGATG-1_V12D07-335_C1,1,2,0,0,0,3
GATCCTAAATCGGGAC-1_V12D07-335_C1,1,1,1,0,0,3
TTACAGACCTAAATGA-1_V12D07-335_C1,0,1,1,0,0,2
CCTCACCTTAGCATCG-1_V12D07-335_C1,1,1,1,0,1,4
CATGCGACCAGTTTAA-1_V12D07-335_C1,0,3,0,0,0,3
AACATATCAACTGGTG-1_V12D07-335_C1,3,7,1,0,0,11
CTATAAGAGCCAATCG-1_V12D07-335_C1,1,0,1,0,0,2
AATATCGAGGGTTCTC-1_V12D07-335_C1,0,2,0,0,0,2
GTACTCCTGGGTATGC-1_V12D07-335_C1,0,1,0,0,0,1
ATAAGTAGGATTCAGA-1_V12D07-335_C1,0,1,0,0,0,1
AGGTCGCGGAGTTACT-1_V12D07-335_C1,0,2,1,0,0,3
CTAATTCTCAGATATT-1_V12D07-335_C1,0,1,1,0,1,3
GCCAACCATTTCCGGA-1_V12D07-335_C1,0,7,0,0,0,7
TGATCCCAGCATTAGT-1_V12D07-335_C1,0,4,1,0,0,5
CGTTGTAAGATTGATT-1_V12D07-335_C1,0,2,2,0,0,4
GAAACCATGGTGCGCT-1_V12D07-335_C1,0,0,1,0,0,1
AATCTATGCCGGAGCC-1_V12D07-335_C1,0,0,1,0,2,3
GACTCCCAGAATAAGG-1_V12D07-335_C1,0,2,0,0,0,2
TATGATCCGGCACGCC-1_V12D07-335_C1,0,2,0,0,4,6
CCGCTTGCTGACATGG-1_V12D07-335_C1,0,0,2,0,2,4
TGGTTAAGGGCGCTGG-1_V12D07-335_C1,0,0,0,0,0,0
TTGATAGTCAATACAT-1_V12D07-335_C1,0,8,0,0,0,8
GGTTTAATTGAGCAGG-1_V12D07-335_C1,1,3,1,0,1,6
CATTACATAGATTGTG-1_V12D07-335_C1,0,1,0,0,2,3
GGTACACCAGATTTAT-1_V12D07-335_C1,1,1,1,0,0,3
GGCCCGTATACCATGC-1_V12D07-335_C1,0,2,1,0,1,4
ATCTTTCGTATAACCA-1_V12D07-335_C1,0,3,0,0,0,3
GAGATGACAATCCTTA-1_V12D07-335_C1,0,4,3,0,0,7
AAAGCTTGCCTACATA-1_V12D07-335_C1,0,1,0,0,0,1
GAACGATAAGTTAAAG-1_V12D07-335_C1,0,1,1,0,2,4
TAATAGCTAAATGATG-1_V12D07-335_C1,0,3,3,0,0,6
TATGGCTAGGCTAATT-1_V12D07-335_C1,0,2,0,0,0,2
AGGAGAGTCTGGCTAC-1_V12D07-335_C1,0,2,0,0,1,3
TGCTCTGCCGGTTCAC-1_V12D07-335_C1,0,3,0,0,0,3
CCAATAGATTTCATCT-1_V12D07-335_C1,3,2,0,0,0,5
GGGCACGAATTGGCCG-1_V12D07-335_C1,2,1,1,0,0,4
TCGTTGACAGGGTCCC-1_V12D07-335_C1,2,0,0,0,0,2
ATCGTATTCCGAGAAC-1_V12D07-335_C1,3,0,0,1,0,4
GGGAATTCTGTCCAGT-1_V12D07-335_C1,1,0,0,1,0,2
ACGCGTTTCTTAAGAG-1_V12D07-335_C1,0,1,0,0,0,1
GAGAGCGCAGTCCCTG-1_V12D07-335_C1,1,1,0,1,0,3
GTCCTATTGTTGTGGT-1_V12D07-335_C1,2,0,0,0,0,2
CATCTGCAGGATCATT-1_V12D07-335_C1,3,2,0,0,0,5
GAGTCGACAGACCCTC-1_V12D07-335_C1,1,0,0,0,0,1
AAGTGCAAAGGTAGAC-1_V12D07-335_C1,0,0,0,0,0,0
AGGGTGGATAGTGCAT-1_V12D07-335_C1,0,0,0,0,0,0
TGATAGCGGGATTCTA-1_V12D07-335_C1,0,0,0,0,0,0
GTCAGTTTGGTAGTCG-1_V12D07-335_C1,1,0,0,0,0,1
GCATTCGAAATGAACA-1_V12D07-335_C1,0,0,0,0,0,0
AAAGACTGGGCGCTTT-1_V12D07-335_C1,0,0,0,0,0,0
TAACAATATTTGTTGC-1_V12D07-335_C1,0,0,0,0,0,0
CCAGCTTCCGCCCGCA-1_V12D07-335_C1,0,0,0,0,0,0
GATATGGATTACGCGG-1_V12D07-335_C1,0,0,0,0,0,0
AGAGCAGTTATGAGAC-1_V12D07-335_C1,0,0,0,0,0,0
TCACATCTTATCTGAT-1_V12D07-335_C1,0,1,0,0,0,1
TATGAAGACAGGTGCG-1_V12D07-335_C1,0,0,0,0,0,0
TACCTGCTGCACTGTG-1_V12D07-335_C1,0,0,0,0,0,0
TAGGTCCAAGTAAGGA-1_V12D07-335_C1,0,0,0,0,0,0
GAAACTCGTGCGATGC-1_V12D07-335_C1,0,0,0,0,0,0
AACAATTACTCTACGC-1_V12D07-335_C1,0,0,0,0,0,0
CCGCACGTGACCTCGG-1_V12D07-335_C1,1,0,0,0,0,1
AACTTGCCCGTATGCA-1_V12D07-335_C1,0,0,0,0,0,0
GGGTATGTATGCACTT-1_V12D07-335_C1,0,0,0,0,0,0
TTCGTACTCCAGAACG-1_V12D07-335_C1,2,0,0,0,0,2
GAATTTCTCGCTGCAG-1_V12D07-335_C1,1,0,0,0,0,1
AACAGGATGGGCCGCG-1_V12D07-335_C1,2,0,0,0,0,2
GACGTGTAGGGATTAT-1_V12D07-335_C1,0,0,0,0,0,0
TAGGTGAGCCCTACTC-1_V12D07-335_C1,0,0,0,0,0,0
CTAATTCGCACGCGCT-1_V12D07-335_C1,0,0,0,0,0,0
GAAGCTTGCTGACCGC-1_V12D07-335_C1,1,0,0,0,0,1
GGTTAGGCTTGGAGAA-1_V12D07-335_C1,0,0,0,0,0,0
ACAAGGACAAGAGGTT-1_V12D07-335_C1,1,0,0,0,0,1
AGGCCACCCGTTATGA-1_V12D07-335_C1,1,1,0,0,0,2
GTGGGCTTAGACACAC-1_V12D07-335_C1,0,0,0,0,0,0
CGTGTCCCATTCGCGA-1_V12D07-335_C1,0,0,0,1,0,1
TGGAGTGATGCGATGA-1_V12D07-335_C1,0,0,0,0,0,0
AACAACTGGTAGTTGC-1_V12D07-335_C1,0,0,0,0,0,0
CCTGGCTAGACCCGCC-1_V12D07-335_C1,1,0,0,0,0,1
CGCAATTAGGGTAATA-1_V12D07-335_C1,0,0,0,0,0,0
TCGAAATTTAGGACCA-1_V12D07-335_C1,1,2,0,0,0,3
AGACTAGCCTTCCAGA-1_V12D07-335_C1,1,1,0,0,0,2
TTGATCTAACTTTGTC-1_V12D07-335_C1,1,1,0,1,0,3
AAGGAGCGGTTGGTGC-1_V12D07-335_C1,0,0,0,1,0,1
ACTTGGGACCCGGTGG-1_V12D07-335_C1,1,2,0,0,0,3
TGATCTCCGGCGCCAG-1_V12D07-335_C1,0,2,0,0,0,2
CAGTTCAAATTGACAC-1_V12D07-335_C1,1,0,0,0,0,1
GTCCGGCTGAATTGCG-1_V12D07-335_C1,1,0,0,1,0,2
CTGGAAATGGATGCTT-1_V12D07-335_C1,0,1,1,0,0,2
TGATCGGTTTGACCCT-1_V12D07-335_C1,2,1,0,0,0,3
TAGAGTCTAAGCGAAC-1_V12D07-335_C1,0,2,0,0,0,2
GAGACTGATGGGTAGA-1_V12D07-335_C1,1,4,0,0,1,6
TAGCTAAGTCCGGGAG-1_V12D07-335_C1,1,2,0,0,0,3
GGGCGATATGTGTGAA-1_V12D07-335_C1,1,3,0,0,0,4
CTCGAGGTCGAACAGT-1_V12D07-335_C1,2,1,0,1,0,4
GATCCCTTTATACTGC-1_V12D07-335_C1,0,2,0,0,0,2
GTCATGCACCTCCGTT-1_V12D07-335_C1,2,0,0,0,1,3
ACTTTCCTATAGCTTC-1_V12D07-335_C1,0,1,0,0,0,1
TCGCTCGATATATTCC-1_V12D07-335_C1,1,0,0,0,0,1
ATAGGTTGGGCAGATG-1_V12D07-335_C1,0,0,0,0,0,0
CAATTAAGGGTGATGA-1_V12D07-335_C1,0,1,0,0,0,1
ACCGACTGAGTCCCAC-1_V12D07-335_C1,2,2,0,0,0,4
CCTGTCACCCGGGCTC-1_V12D07-335_C1,1,1,0,0,1,3
GATCGGTGGCCATAAC-1_V12D07-335_C1,2,2,0,0,0,4
CCTATGGGTTACCGTC-1_V12D07-335_C1,1,9,0,0,0,10
TTGGGACACTGCCCGC-1_V12D07-335_C1,0,1,0,0,1,2
CGAGGCTAAATATGGC-1_V12D07-335_C1,1,4,1,0,0,6
TCAGGGTGTAACGTAA-1_V12D07-335_C1,0,5,0,0,1,6
CGAGAGATGTGAACCT-1_V12D07-335_C1,0,5,0,0,0,5
TCGCTGGGCGGATTGT-1_V12D07-335_C1,1,0,0,0,1,2
AGATCTCAGGTGTGAT-1_V12D07-335_C1,0,0,0,1,0,1
TGGCCAAACTGAAGTA-1_V12D07-335_C1,0,1,1,0,2,4
GCTTCCGTCCCTAGAC-1_V12D07-335_C1,1,4,1,0,0,6
CAGCAGCCCGTTCCTT-1_V12D07-335_C1,1,0,1,0,1,3
TGTATAACAGATCCTG-1_V12D07-335_C1,1,0,0,0,4,5
CGCGGGAATTAGGCAG-1_V12D07-335_C1,1,3,0,0,0,4
TGCATGTGGTAATCTA-1_V12D07-335_C1,0,1,0,0,1,2
ACAATTTGAGCAGTGG-1_V12D07-335_C1,0,1,0,0,0,1
GAGCTAAGGGCATATC-1_V12D07-335_C1,0,3,0,0,3,6
CCAGATAGTTGAGTGA-1_V12D07-335_C1,0,3,1,0,0,4
CCACAATGTACGTCTT-1_V12D07-335_C1,0,3,0,0,0,3
CAATGGATCTCTACCA-1_V12D07-335_C1,0,3,2,0,0,5
TGTGGCAAAGCGTATG-1_V12D07-335_C1,0,2,0,1,2,5
TAAAGCGTTAGGAGAA-1_V12D07-335_C1,1,2,0,0,1,4
TCCGTTTAGCCTTGAA-1_V12D07-335_C1,0,1,1,0,0,2
CAGCTCGACAAGTTAA-1_V12D07-335_C1,0,1,1,0,0,2
GCCTATAGTGTCAGGG-1_V12D07-335_C1,0,1,1,0,0,2
ATAGACAACGGGACCT-1_V12D07-335_C1,0,1,0,0,0,1
CTACTATCTTTCAGAG-1_V12D07-335_C1,0,1,1,0,0,2
GCGCTGCTTTGCATTT-1_V12D07-335_C1,0,3,2,0,3,8
GCGCATCCAGTCAGCA-1_V12D07-335_C1,0,1,0,0,2,3
GACTCGCGGGAATGAC-1_V12D07-335_C1,0,3,1,0,0,4
CTGGTAACGAGCTCTT-1_V12D07-335_C1,0,0,1,0,0,1
TCCGGCCTAGCGTACA-1_V12D07-335_C1,1,3,0,0,0,4
TCTAGGTGGCGACGCT-1_V12D07-335_C1,0,1,0,0,0,1
ACGCTAGTGATACACT-1_V12D07-335_C1,0,1,0,0,0,1
ATCTGCACCTCTGCGA-1_V12D07-335_C1,1,2,0,0,1,4
CCTCACCTGAGGGAGC-1_V12D07-335_C1,0,3,0,0,0,3
AGTGAGCCTCGCCGCC-1_V12D07-335_C1,0,2,0,0,0,2
ACGAGTACGGATGCCC-1_V12D07-335_C1,0,4,0,0,1,5
GGTACCATTAAGACGG-1_V12D07-335_C1,0,2,0,0,2,4
TTCTGCTAGACTCCAA-1_V12D07-335_C1,0,3,0,0,1,4
TAACTATTACGCCAAA-1_V12D07-335_C1,0,1,0,0,2,3
GCATTCAAGGCAACGC-1_V12D07-335_C1,0,2,0,0,0,2
AGTACATCATTTATCA-1_V12D07-335_C1,0,4,0,0,1,5
GTCGTGTCTGGTCATC-1_V12D07-335_C1,0,0,1,0,0,1
AGTCTAAAGTATACTC-1_V12D07-335_C1,0,0,1,1,0,2
CGGCCCAACCTGTAGT-1_V12D07-335_C1,0,0,3,0,1,4
AGGGAGACATACTTCG-1_V12D07-335_C1,0,1,0,0,1,2
TCCCTAGATCAATAGG-1_V12D07-335_C1,0,3,0,0,2,5
TCCCGTCGCGTCATAG-1_V12D07-335_C1,0,3,1,0,0,4
CGCATCCATCAGCCAG-1_V12D07-335_C1,0,4,1,0,0,5
CTGCACCTAGTCCACA-1_V12D07-335_C1,0,4,0,0,0,4
CGAGGATCGGGAACGA-1_V12D07-335_C1,0,0,0,0,1,1
CAATGAGGTTCGACTA-1_V12D07-335_C1,0,0,4,0,0,4
TCTGACGGGCTAACCC-1_V12D07-335_C1,0,0,0,0,1,1
TTCTATGCCTTTCGCA-1_V12D07-335_C1,0,2,0,0,0,2
AGAGTATAGTGTTACG-1_V12D07-335_C1,0,2,0,0,0,2
CCATTGTTTCCTCCAT-1_V12D07-335_C1,0,2,0,0,0,2
CTCATCACTTAGTGAT-1_V12D07-335_C1,0,1,1,0,0,2
CCGAAGGGCGTACCGC-1_V12D07-335_C1,0,2,0,0,2,4
TCAAGCTGCCTTGAAA-1_V12D07-335_C1,0,0,2,0,0,2
CTCATTAACGTTGCCC-1_V12D07-335_C1,0,2,1,0,0,3
GTCTTCCTCACCTAAG-1_V12D07-335_C1,1,0,0,0,0,1
GGTGATGAAGGAAGTG-1_V12D07-335_C1,0,0,0,0,0,0
TCAATACAATTGCTGC-1_V12D07-335_C1,1,1,0,2,0,4
GCAACCCAAGTTGTTT-1_V12D07-335_C1,1,3,0,2,2,8
ATGAAGTGGACCCAGC-1_V12D07-335_C1,0,4,0,1,0,5
GAGAATCTCACGATCA-1_V12D07-335_C1,2,0,0,2,0,4
TATATCATTGATCAGT-1_V12D07-335_C1,1,3,1,0,1,6
AACTTTACGGGAGCTT-1_V12D07-335_C1,0,0,0,0,0,0
TTCTTGTGTCCATCAG-1_V12D07-335_C1,0,0,0,0,0,0
ACAATTTAGGAGGCTC-1_V12D07-335_C1,0,0,0,0,0,0
ATACTTGTTCTCGAGC-1_V12D07-335_C1,1,0,0,0,0,1
CACGGGATTGAGGGTT-1_V12D07-335_C1,1,0,0,0,0,1
GTTAATGTCTATCTTA-1_V12D07-335_C1,0,0,0,0,0,0
GCGTTATATTTGGAAC-1_V12D07-335_C1,0,0,0,0,0,0
CGTCAAGGCTATAAAT-1_V12D07-335_C1,1,0,0,0,0,1
TTAGCTCTGTAATCCG-1_V12D07-335_C1,0,0,0,0,0,0
AATGGTCCACCGTTCA-1_V12D07-335_C1,1,0,0,0,0,1
GTCATTGCATTGACCC-1_V12D07-335_C1,0,0,0,0,0,0
TGTCCGTGGCGCCTTT-1_V12D07-335_C1,2,0,0,0,0,2
TCAACTAACGTATAAC-1_V12D07-335_C1,0,0,0,0,0,0
TCCTCTCCAGTTGTCC-1_V12D07-335_C1,0,0,0,0,0,0
TGTGTTCGTATCCAAG-1_V12D07-335_C1,0,0,0,0,0,0
CCGCGTAGGTAAGGGC-1_V12D07-335_C1,1,0,0,0,0,1
CTGCGGGTGAAATGTT-1_V12D07-335_C1,0,0,0,0,0,0
TATCTACAGAGGTAAT-1_V12D07-335_C1,0,0,0,0,0,0
CTACTCTAGGCCCGGC-1_V12D07-335_C1,0,0,0,0,0,0
ACAAGCAGTGCCTAGC-1_V12D07-335_C1,0,0,0,0,0,0
TACAAGTCTCGTGCAT-1_V12D07-335_C1,1,0,0,0,0,1
TCGGAATGCGCTCTGA-1_V12D07-335_C1,0,0,0,0,0,0
TCGCGTCCAGAAGGTC-1_V12D07-335_C1,0,0,0,0,0,0
TATGGCCCGGCCTCGC-1_V12D07-335_C1,0,0,0,0,0,0
GCTGGCATATTCACCT-1_V12D07-335_C1,1,0,0,0,0,1
GTCAGAATAGTCTATG-1_V12D07-335_C1,0,0,0,0,0,0
GGCGTCCTATCCGCTG-1_V12D07-335_C1,0,0,0,0,0,0
CGGAGTTTGAGAGACA-1_V12D07-335_C1,0,0,0,0,0,0
AGCACTTAAGGACGCC-1_V12D07-335_C1,0,0,0,0,0,0
TCCACAATGGTTTACG-1_V12D07-335_C1,0,0,0,0,0,0
CCAACGATGCACTGAT-1_V12D07-335_C1,0,0,0,0,0,0
ATTTACAGTTTACTGG-1_V12D07-335_C1,0,0,0,0,0,0
CCCTGAAATGAGTTGA-1_V12D07-335_C1,0,0,0,0,0,0
CAAACGGTCGCACTTT-1_V12D07-335_C1,0,0,0,0,0,0
TGATTCGTCTATCACT-1_V12D07-335_C1,0,0,0,0,0,0
TCAGGTTCTTTGAGAA-1_V12D07-335_C1,0,0,0,0,0,0
CACGCAGCGAGGCTTT-1_V12D07-335_C1,1,0,0,0,0,1
TTAAGCGCCTGACCCA-1_V12D07-335_C1,1,0,0,0,0,1
CTTACACGGTATTCCA-1_V12D07-335_C1,1,0,0,0,0,1
AAGGCTGTGCTCATCG-1_V12D07-335_C1,0,0,0,0,0,0
GACCAGAGCCCTGTAG-1_V12D07-335_C1,1,0,0,0,0,1
TCCCAGGCTTAGCTAA-1_V12D07-335_C1,1,6,0,0,0,7
ATTGAAGATCTTAGTG-1_V12D07-335_C1,0,2,0,1,0,3
AGTTCCTACAGAATTA-1_V12D07-335_C1,3,6,0,1,0,10
GGGCTGGTTAGTCGCG-1_V12D07-335_C1,0,5,0,0,0,5
GAAATGGCGGTGTTAG-1_V12D07-335_C1,1,0,0,0,0,1
TACGAACACGACTTCA-1_V12D07-335_C1,0,3,0,6,0,9
ACCACAAGTTTCTATC-1_V12D07-335_C1,0,0,0,0,0,0
ATATTTAACCCTCAAG-1_V12D07-335_C1,0,3,1,0,0,4
GATCATTCCAAACATT-1_V12D07-335_C1,0,1,1,0,0,2
TCCAGGCGAGTACGGT-1_V12D07-335_C1,0,3,0,1,2,6
GTTTGACCAAATCCTA-1_V12D07-335_C1,1,3,0,0,0,4
CACAGCACCCACGGCA-1_V12D07-335_C1,0,2,0,0,0,2
TGCAAGAATGACGTAA-1_V12D07-335_C1,1,3,0,0,0,4
GCGAAGCCATACCCGT-1_V12D07-335_C1,2,2,0,0,0,4
TCCTTTCTTACGCTTA-1_V12D07-335_C1,2,1,0,0,1,4
GCTGCTCTCCGGACAC-1_V12D07-335_C1,0,2,0,0,0,2
ACTGTCTTCTTTAGAA-1_V12D07-335_C1,0,3,0,0,0,3
TCAAACTTAGATTGTT-1_V12D07-335_C1,0,1,0,0,0,1
CTATGTCACTAGCCCA-1_V12D07-335_C1,1,2,0,0,1,4
TGCGCAAAGCATTTGG-1_V12D07-335_C1,0,5,0,1,1,7
TTAATGTAGACCAGGT-1_V12D07-335_C1,0,4,0,0,0,4
GGCGGTAGGATCATTG-1_V12D07-335_C1,0,2,0,0,0,2
GGCAATAGTCAATGAG-1_V12D07-335_C1,0,7,4,0,1,12
ACACGAGACTCCTTCT-1_V12D07-335_C1,0,3,0,0,0,3
GACACAAGGGAAGAAA-1_V12D07-335_C1,0,1,0,0,0,1
TCAGCAAATGCATCTC-1_V12D07-335_C1,1,2,0,0,0,3
GAGATCTGTCACTCCG-1_V12D07-335_C1,0,5,0,0,0,5
ATGCCGGTCTTGCATA-1_V12D07-335_C1,0,1,0,0,0,1
TTGGGCGGCGGTTGCC-1_V12D07-335_C1,0,2,2,0,0,4
TTGTTGTGTGTCAAGA-1_V12D07-335_C1,1,2,0,1,0,4
ACTGTACGATACACAT-1_V12D07-335_C1,1,0,0,0,0,1
TCCACTTTATCTAGGT-1_V12D07-335_C1,2,2,0,0,0,4
GGTCTGAGAATCTGGA-1_V12D07-335_C1,0,5,0,0,1,6
TAGAAAGGTGGCGCTA-1_V12D07-335_C1,0,9,0,0,1,10
TATGTCTCATTGTGCC-1_V12D07-335_C1,0,2,0,0,0,2
GGATTTCACTTCTATA-1_V12D07-335_C1,1,0,1,0,2,4
TGAGTGGTCCGTGACG-1_V12D07-335_C1,0,8,0,0,0,8
CGCTTTCTTGCATTCG-1_V12D07-335_C1,0,0,0,0,1,1
ACCCAACGCCCGTGGC-1_V12D07-335_C1,0,2,1,0,0,3
GAACGTCTCATGGTCG-1_V12D07-335_C1,0,5,1,0,1,7
AGGGTTCCCTTTGGTT-1_V12D07-335_C1,0,2,0,0,0,2
GTAGCTTCCTCTTGTT-1_V12D07-335_C1,1,1,0,0,0,2
GCATGAGGGACGCGGC-1_V12D07-335_C1,0,4,0,0,1,5
CTACCCTAAGGTCATA-1_V12D07-335_C1,0,3,0,0,0,3
TCACCGCTCGGCACTC-1_V12D07-335_C1,0,0,0,0,4,4
GGCTCGCGTTGAGGTA-1_V12D07-335_C1,0,1,0,0,0,1
CTAACGAAACTTGCTG-1_V12D07-335_C1,0,3,0,0,2,5
TTAAACTCGAATTCAT-1_V12D07-335_C1,0,2,0,0,0,2
TACTTTACTGAGCCGG-1_V12D07-335_C1,0,1,0,0,0,1
GCTTGGATCGATTAGG-1_V12D07-335_C1,0,2,0,0,0,2
CGGTTATCCAACAGTG-1_V12D07-335_C1,0,1,0,0,1,2
CAGACCTGTAAGTGTT-1_V12D07-335_C1,0,3,0,0,0,3
GACGGTCAATAGAAGC-1_V12D07-335_C1,0,1,1,0,0,2
CTGACTGCGCAGCTCG-1_V12D07-335_C1,0,8,0,0,2,10
CCATACCTTTACTTGT-1_V12D07-335_C1,0,2,3,0,0,5
GTAATAAAGGGCTCCC-1_V12D07-335_C1,0,3,0,0,0,3
GTGAACTCCCATTCGA-1_V12D07-335_C1,1,3,1,0,1,6
GTGGTTACTTCTTTCG-1_V12D07-335_C1,0,2,1,0,0,3
TCAGAACCTCCACAGG-1_V12D07-335_C1,0,4,1,0,1,6
TCCCACTCTCTTCCGG-1_V12D07-335_C1,0,4,0,0,1,5
ATCTTGACTTGTCCAA-1_V12D07-335_C1,0,4,1,0,1,6
TCGGGAACGTGCCTAG-1_V12D07-335_C1,0,0,0,0,2,2
GTTAGCCGTAAATCAA-1_V12D07-335_C1,0,0,4,0,0,4
ATTTACTAAGTCCATT-1_V12D07-335_C1,0,2,1,0,1,4
GGGTGCATATGAAAGC-1_V12D07-335_C1,0,2,2,0,0,4
TCCGAATGGTCCTGAG-1_V12D07-335_C1,0,1,0,0,1,2
TGATGGCTGTTTCTGA-1_V12D07-335_C1,0,5,0,0,0,5
AAATAAGGTAGTGCCC-1_V12D07-335_C1,0,6,0,0,0,6
CCACTATCCGGGTCAC-1_V12D07-335_C1,0,3,0,0,0,3
ACACCACATAATTAGC-1_V12D07-335_C1,0,6,1,0,1,8
CGCGGTAAGTCTAGCT-1_V12D07-335_C1,0,0,0,0,1,1
GCGGGCATTACGATGC-1_V12D07-335_C1,2,1,0,0,0,3
AGGATTGCTTACGACA-1_V12D07-335_C1,1,1,0,0,0,2
CTCGGGATAACACCTA-1_V12D07-335_C1,0,3,0,0,0,3
GTCGTCTGGTTGGCTA-1_V12D07-335_C1,1,2,0,0,0,3
GCAATTAGTCGCACCG-1_V12D07-335_C1,0,3,0,0,0,3
GTGACCTAAAGAATAA-1_V12D07-335_C1,0,0,1,0,1,2
CTGAGCGAGACTTATT-1_V12D07-335_C1,0,1,0,0,1,2
CAAGACTCAGAAGCGC-1_V12D07-335_C1,1,3,0,0,0,4
ACTTCGCTAGCGAGTG-1_V12D07-335_C1,0,3,0,0,0,3
CCATACTCGCCTCTCC-1_V12D07-335_C1,0,0,0,0,0,0
ACGATACCTATCCTGA-1_V12D07-335_C1,0,2,0,0,2,4
CTCACCAGTACAAGTG-1_V12D07-335_C1,0,1,0,0,0,1
CGAAGACGGTGAGTGC-1_V12D07-335_C1,1,0,0,0,1,2
AAATTAATAAGCGCGA-1_V12D07-335_C1,0,2,1,0,4,7
GGGCCCTTATCTATAC-1_V12D07-335_C1,0,1,0,0,0,1
CTGCCCACGAAGCGTT-1_V12D07-335_C1,1,0,0,0,0,1
GGACAAGTTGCAGTGA-1_V12D07-335_C1,0,0,0,0,0,0
GTCCGAGAGCAATCAT-1_V12D07-335_C1,0,0,0,0,0,0
ATGGCAGCCGAGAAAC-1_V12D07-335_C1,0,0,0,0,0,0
CCTCGGATGCTACCTG-1_V12D07-335_C1,0,0,0,0,0,0
ATACGGTGAAGATGCA-1_V12D07-335_C1,0,0,0,0,0,0
ACATCAGCTGGGACGC-1_V12D07-335_C1,1,0,0,1,0,2
GGTTGTGTAGCCTGGC-1_V12D07-335_C1,0,0,0,0,0,0
CCTGCGTTCTACGCTT-1_V12D07-335_C1,0,0,0,0,0,0
GAACGTTAGGAAGACG-1_V12D07-335_C1,0,0,0,0,0,0
CTGATAGTGTATCTCA-1_V12D07-335_C1,0,0,0,0,0,0
TTCTGCGAGCGCCCTT-1_V12D07-335_C1,1,0,0,0,0,1
CTTTGGCGCTTTATAC-1_V12D07-335_C1,0,0,0,0,0,0
TCCGAACTTGGCTTAC-1_V12D07-335_C1,0,0,0,0,0,0
TAGATTCCTGGTTATT-1_V12D07-335_C1,0,0,0,0,0,0
CCGACAAAGGGAGTGC-1_V12D07-335_C1,0,0,0,0,0,0
CCATGGCCCTTGTACC-1_V12D07-335_C1,0,0,0,0,0,0
GAAATATCACCATCAG-1_V12D07-335_C1,1,0,0,0,0,1
ACGAAATGGGCGGCAC-1_V12D07-335_C1,1,0,0,0,0,1
GTGAGCGTGCTGCACT-1_V12D07-335_C1,0,0,0,0,0,0
CCGCGGGTACGAAGAA-1_V12D07-335_C1,1,0,0,0,0,1
TCCCTGGCTCGCTGGA-1_V12D07-335_C1,1,0,0,0,0,1
CAGCTTAGTAGGTAGC-1_V12D07-335_C1,0,0,0,0,0,0
CACGAAAGTTAGTCCC-1_V12D07-335_C1,0,0,0,0,0,0
ACCTAATCGACTTCCT-1_V12D07-335_C1,1,0,0,0,0,1
AAGTAGTGACGCGAGG-1_V12D07-335_C1,1,0,0,0,0,1
TCCGATTACATTGCCG-1_V12D07-335_C1,0,0,0,0,0,0
CCTCCGACAATTCAAG-1_V12D07-335_C1,0,0,0,0,0,0
GTTCACAGGAGTCTAG-1_V12D07-335_C1,1,0,0,0,0,1
CGAAGTTGCTCTGTGT-1_V12D07-335_C1,1,1,0,0,0,2
GTCGGATATCTCAGAC-1_V12D07-335_C1,0,0,0,0,0,0
CGCTCTCCGTAGATTA-1_V12D07-335_C1,1,0,0,0,0,1
CAAGCAACGTCGGAGT-1_V12D07-335_C1,0,0,0,0,0,0
CCATTCCCTGCCCACA-1_V12D07-335_C1,0,0,0,0,0,0
CTTTGGCTTTAGTAAA-1_V12D07-335_C1,0,0,0,0,0,0
GGCTATTAAGTTGTAT-1_V12D07-335_C1,0,0,0,0,0,0
CCATTAGCGATAATCC-1_V12D07-335_C1,0,0,0,0,0,0
TGTTCTTCCATTGACT-1_V12D07-335_C1,0,0,0,0,0,0
AGATAACTTCAGGGCC-1_V12D07-335_C1,1,0,0,0,0,1
ATAGACGAAGAGAAAG-1_V12D07-335_C1,0,0,0,0,0,0
GGCGGAGTAATATTAG-1_V12D07-335_C1,1,0,0,0,0,1
TGACCCACGTTAGACA-1_V12D07-335_C1,0,0,0,0,0,0
TCACAGGTTATTGGGC-1_V12D07-335_C1,1,1,0,0,0,2
TCACGCATTGTAGATC-1_V12D07-335_C1,2,2,0,0,1,5
TTGAAGAATTCCCAGG-1_V12D07-335_C1,3,1,0,0,0,4
AAATGGTCAATGTGCC-1_V12D07-335_C1,0,3,0,0,1,4
TAGTGCCCTCCAGAGT-1_V12D07-335_C1,5,2,0,0,0,7
GGTATTGCCGAGTTTA-1_V12D07-335_C1,1,4,0,0,0,5
CGTATTAAGAGATCTA-1_V12D07-335_C1,0,4,0,0,0,4
ACTGTCCAGGATTATA-1_V12D07-335_C1,3,5,0,0,2,10
CGGGCAGCTAAACCGC-1_V12D07-335_C1,0,1,1,0,0,2
TTGCTGATCATGTTCG-1_V12D07-335_C1,0,6,0,3,0,9
TATGGGTACGTATCGT-1_V12D07-335_C1,0,5,0,2,1,8
CAGCTCACTGAGACAT-1_V12D07-335_C1,0,0,0,2,0,2
GGGACTGCATAGATAG-1_V12D07-335_C1,0,2,0,0,0,2
ACGCATTCGTGAGTAC-1_V12D07-335_C1,4,0,0,1,0,5
CTCTGGACGCCTGGTG-1_V12D07-335_C1,0,7,0,0,2,9
AGGGTTTAGTTCGGGA-1_V12D07-335_C1,0,0,0,0,0,0
GGGAGAACTCACAGTA-1_V12D07-335_C1,1,1,0,0,0,2
ATCAATCTGGGCTGCA-1_V12D07-335_C1,0,2,0,0,0,2
TCTTCGATACCAATAA-1_V12D07-335_C1,0,0,0,0,0,0
ACGTAGATTGCTGATG-1_V12D07-335_C1,1,2,0,0,2,5
TCTTGATGCGTAGCGA-1_V12D07-335_C1,0,0,0,0,0,0
GGGCTGCCTAGGGCGA-1_V12D07-335_C1,0,2,0,1,1,4
CTCTCACAATCGATGA-1_V12D07-335_C1,0,1,0,0,2,3
CCAAGCGTAACTCGTA-1_V12D07-335_C1,0,2,0,0,0,2
ACAACAGCATGAGCTA-1_V12D07-335_C1,0,6,1,0,0,7
GTCCCAACGTAAAGTA-1_V12D07-335_C1,0,5,2,0,1,8
TCGGAGTACATGAGTA-1_V12D07-335_C1,0,0,0,0,0,0
GGGAGTTAATGAGGCG-1_V12D07-335_C1,0,1,0,0,2,3
CCGGGCGGTCTCGTCA-1_V12D07-335_C1,0,4,0,1,1,6
CCGTAAGTTGGTCCCA-1_V12D07-335_C1,0,3,0,2,0,5
GGAGGGCTTGGTTGGC-1_V12D07-335_C1,0,5,0,0,0,5
TCGGACGCCCAGCCCA-1_V12D07-335_C1,0,1,0,0,1,2
TCTGTGCCATCATAGT-1_V12D07-335_C1,0,4,0,0,0,4
GTACTGGAGTTAGACC-1_V12D07-335_C1,0,1,0,0,0,1
GGAATGCGCTAGCGTG-1_V12D07-335_C1,1,2,0,1,0,4
GTGTGAATAACTTAGG-1_V12D07-335_C1,0,2,3,0,0,5
GGTCGGCCAGGAGCTT-1_V12D07-335_C1,0,1,3,0,1,5
TAGCCGGCGGTCAGCG-1_V12D07-335_C1,0,5,0,0,1,6
CGGGTGTACCCATTTA-1_V12D07-335_C1,0,1,0,0,0,1
AGTGATTCAAGCAGGA-1_V12D07-335_C1,0,4,0,0,1,5
GTTGGATTGAGAACAC-1_V12D07-335_C1,0,1,0,0,0,1
CACACGCGCTGTCTTA-1_V12D07-335_C1,0,2,0,0,0,2
TAGACGCCCGTACCGG-1_V12D07-335_C1,0,3,0,0,0,3
GGTTTCAATCGGTCAG-1_V12D07-335_C1,0,2,0,0,0,2
AATCTGCGTTGGGACG-1_V12D07-335_C1,0,4,0,0,0,4
TTACGGATGGTTCGAG-1_V12D07-335_C1,1,2,2,0,1,6
CGGCAGGGTCGGGTTG-1_V12D07-335_C1,0,4,0,0,1,5
GCTTTCAGAGGAGGTG-1_V12D07-335_C1,0,1,0,0,0,1
TCTTCCCATGGGCACA-1_V12D07-335_C1,0,1,1,0,0,2
TACCGCGGACTTGCAG-1_V12D07-335_C1,1,2,0,0,1,4
AGAATTATGGATTCGA-1_V12D07-335_C1,0,2,2,0,0,4
ATTGATGAGTCCTAAC-1_V12D07-335_C1,0,6,1,0,1,8
TAGGTCGCCGGAACTG-1_V12D07-335_C1,1,1,1,0,0,3
TAACCTACCGTCCGAG-1_V12D07-335_C1,0,0,0,0,1,1
CTTAGTAGGCCTACAG-1_V12D07-335_C1,0,4,0,0,2,6
CTAGATGTGAGTGTAA-1_V12D07-335_C1,0,3,1,0,1,5
ACTCCCGAATTCGTTT-1_V12D07-335_C1,0,6,0,0,1,7
GTTCATCGTTTGGCTG-1_V12D07-335_C1,0,4,2,0,4,10
ACTTTACCCTCATGAA-1_V12D07-335_C1,0,0,3,0,1,4
GCGAGAGTTGCGTCCA-1_V12D07-335_C1,0,0,1,0,2,3
GTTCGGGCGTACCATT-1_V12D07-335_C1,0,4,0,0,0,4
CGACTTTGTATAGCCT-1_V12D07-335_C1,0,3,0,0,3,6
GCCATCGATGCTGCAT-1_V12D07-335_C1,0,3,1,0,1,5
GCATTTCCAAGGCTCC-1_V12D07-335_C1,0,4,0,0,2,6
ATGTAAGGCTGCTCTT-1_V12D07-335_C1,0,3,0,0,0,3
ACGTTCGCAATCAATT-1_V12D07-335_C1,0,4,0,0,0,4
GTGACGAGGGTGACCC-1_V12D07-335_C1,0,2,1,0,4,7
ATTATAGCTACTTTAC-1_V12D07-335_C1,0,3,1,0,0,4
CGTGTGTTAAACCCTG-1_V12D07-335_C1,0,2,0,0,0,2
TTGGTATGGCTTGTGT-1_V12D07-335_C1,0,2,1,0,1,4
CATTCCCATTCCGTCG-1_V12D07-335_C1,1,2,0,0,0,3
TGCCGAAAGCGTATTC-1_V12D07-335_C1,0,3,0,0,0,3
CAACACATCTCCTGCC-1_V12D07-335_C1,1,3,1,0,0,5
CTGCCTCATATGCAAC-1_V12D07-335_C1,0,1,0,0,0,1
TCCCGCCTATGTGCGT-1_V12D07-335_C1,0,4,0,0,0,4
GGTTACCCGACACTTT-1_V12D07-335_C1,0,1,0,0,1,2
CCAGCGGGATCACCAG-1_V12D07-335_C1,0,2,1,0,0,3
ATGTTTCGGCCCGGAG-1_V12D07-335_C1,1,2,0,0,0,3
GCGTCTAACCTCCTAA-1_V12D07-335_C1,0,1,0,0,0,1
ATCAGGTAGCTGACAG-1_V12D07-335_C1,1,1,1,0,0,3
GGTATGAAAGAACTGA-1_V12D07-335_C1,1,1,0,2,0,4
GTGGCCTAATATCATT-1_V12D07-335_C1,1,3,0,0,0,4
CCTGTGAAACCGTAAC-1_V12D07-335_C1,2,1,1,0,0,4
GGCAGAGAGATCGGGA-1_V12D07-335_C1,1,0,0,2,0,3
TAGCGTCGAATATTGA-1_V12D07-335_C1,1,1,0,0,0,2
CGCCGACTATTCGCTA-1_V12D07-335_C1,0,0,0,0,1,1
TCTGGCGCAAGCCGGG-1_V12D07-335_C1,1,0,0,0,0,1
AGTGGTTGCGTATAGG-1_V12D07-335_C1,2,1,0,0,0,3
ATCGGTTACCTAGTAA-1_V12D07-335_C1,0,0,0,0,0,0
CCTGCCCGTTGTCTAG-1_V12D07-335_C1,0,0,0,0,0,0
GCACACGCCCATGGTC-1_V12D07-335_C1,0,0,0,0,0,0
AGTACGGCCCGTATCG-1_V12D07-335_C1,0,0,0,0,0,0
TATCTAGCCTAAAGGA-1_V12D07-335_C1,0,0,0,0,0,0
CACTCGGTTAGGAGGA-1_V12D07-335_C1,0,0,0,0,0,0
ATGTTCGTCGACCCAC-1_V12D07-335_C1,1,0,0,0,0,1
TTCCTCTGCCCGAATA-1_V12D07-335_C1,0,0,0,0,0,0
TTACTATCGGCTTCTC-1_V12D07-335_C1,0,0,0,0,0,0
GCCGCATTAGTCCGGC-1_V12D07-335_C1,1,0,0,0,0,1
TAAGGGCTGGGAGAGG-1_V12D07-335_C1,0,0,0,0,0,0
TAAGCAGGCGACACGC-1_V12D07-335_C1,0,0,0,0,0,0
AGCACTACCGGCCTGT-1_V12D07-335_C1,1,0,0,0,0,1
GAAAGCCCTTTGGACC-1_V12D07-335_C1,0,0,0,0,0,0
GACCGACTGAAGCGTC-1_V12D07-335_C1,0,0,0,0,0,0
CGGTGAAGACTAAAGT-1_V12D07-335_C1,1,0,0,0,0,1
CCCTGCGCTACGCATA-1_V12D07-335_C1,0,0,0,0,0,0
TACTGGACAGCTCGGC-1_V12D07-335_C1,0,0,0,0,0,0
TTAGTAGGGCGGCGGG-1_V12D07-335_C1,0,0,0,0,0,0
GAGGCTATCAAAGTCG-1_V12D07-335_C1,0,0,0,0,0,0
TTACCATTGATTACCC-1_V12D07-335_C1,1,0,0,0,0,1
ATACCACGGGCAACTT-1_V12D07-335_C1,0,0,0,0,0,0
TGTCCTAAGTCACCGC-1_V12D07-335_C1,1,0,0,0,0,1
AGGTAGGTACAAAGCT-1_V12D07-335_C1,0,0,0,0,0,0
GGCATACAGGTAGCGG-1_V12D07-335_C1,0,0,0,1,0,1
TGTAGTGATCTATAAT-1_V12D07-335_C1,0,0,0,0,0,0
TCCCGGGTGTGCTGCT-1_V12D07-335_C1,0,0,0,0,0,0
TACGATGTTGATCATC-1_V12D07-335_C1,1,0,0,0,0,1
CCTCTCTCCCATCTAG-1_V12D07-335_C1,0,0,0,0,0,0
GCAGGACTATAGAATA-1_V12D07-335_C1,1,0,0,0,0,1
CTAGTGAAGGACAGGA-1_V12D07-335_C1,0,0,0,0,0,0
TACGAGAACTTCACGT-1_V12D07-335_C1,1,0,0,0,0,1
CGTTGTTTCAATTCCC-1_V12D07-335_C1,1,0,0,0,0,1
GCAAATATTACGCTTT-1_V12D07-335_C1,0,0,0,0,0,0
CCAATAGTGCCGTCGA-1_V12D07-335_C1,0,0,0,0,0,0
ATTGCTGCTCCTCCAT-1_V12D07-335_C1,1,0,0,0,0,1
GAGATCTGCTTGGCAT-1_V12D07-335_C1,0,0,0,0,0,0
GCCGAAATTCCTACGT-1_V12D07-335_C1,1,0,0,0,0,1
GGCACTCCACTGGGCA-1_V12D07-335_C1,0,0,0,0,0,0
GGGTCACCGTGACGGT-1_V12D07-335_C1,0,0,0,0,0,0
CACTTAATCAGACGGA-1_V12D07-335_C1,1,1,0,0,0,2
CGTTTCGCTCATTACA-1_V12D07-335_C1,1,0,0,0,0,1
ATAAAGGCTCGGTCGT-1_V12D07-335_C1,0,3,0,0,0,3
CACTAAAGTTGCCTAT-1_V12D07-335_C1,0,0,0,0,0,0
GTGCTCAAGTACTGTC-1_V12D07-335_C1,0,2,0,0,0,2
CCATGCCTGTTTAGTA-1_V12D07-335_C1,1,3,0,0,0,4
TCTAGTTATCAGAAGA-1_V12D07-335_C1,1,0,0,0,0,1
TTGTAATCCGTACTCG-1_V12D07-335_C1,1,2,0,0,0,3
TCCCAGCTTTAGTCTG-1_V12D07-335_C1,2,1,0,1,1,5
CTACGCACGGAGTACC-1_V12D07-335_C1,0,3,0,2,1,6
AAATTAACGGGTAGCT-1_V12D07-335_C1,1,0,0,0,0,1
CGGCCACGCACAAAGT-1_V12D07-335_C1,1,1,0,0,0,2
GAAGCGTGAGGAATTT-1_V12D07-335_C1,1,3,0,1,0,5
ATATCTTAGGGCCTTC-1_V12D07-335_C1,1,3,0,0,0,4
ACGCGGGCCAAGGACA-1_V12D07-335_C1,3,1,1,0,0,5
GCGAGTTCTGCAAAGA-1_V12D07-335_C1,1,8,0,2,0,11
TATTCGTGCCAGAATA-1_V12D07-335_C1,0,1,0,0,0,1
AGGGCTGCAGTTACAG-1_V12D07-335_C1,0,2,0,0,0,2
CTAGCATAGTATAATG-1_V12D07-335_C1,0,3,0,0,0,3
TAGGTTCGAGTTCGTC-1_V12D07-335_C1,0,0,0,0,1,1
GAATTATAGTGAAAGG-1_V12D07-335_C1,0,3,0,0,0,3
CTATCGGGTCTCAACA-1_V12D07-335_C1,0,4,0,0,0,4
GCGCTAATTGAATAGA-1_V12D07-335_C1,0,1,1,0,0,2
ATGCGACAGTCCCATT-1_V12D07-335_C1,0,0,0,0,0,0
GGTAGTGCTCGCACCA-1_V12D07-335_C1,0,2,1,0,0,3
AAGCTCGTGCCAAGTC-1_V12D07-335_C1,1,3,0,0,1,5
TATTCAATTCTAATCC-1_V12D07-335_C1,0,2,0,0,0,2
TTCAAAGTCTCTAGCC-1_V12D07-335_C1,0,1,0,0,0,1
TTGAATATGGACTTTC-1_V12D07-335_C1,0,6,0,0,0,6
AAGAGCTCTTTATCGG-1_V12D07-335_C1,0,1,0,0,0,1
TTACTCCGGCCGGGAA-1_V12D07-335_C1,0,3,0,0,1,4
AAACGAGACGGTTGAT-1_V12D07-335_C1,0,2,2,0,2,6
GCTAAGTAGTTTCTCT-1_V12D07-335_C1,0,5,1,1,0,7
ATAACGCCGGAGGGTC-1_V12D07-335_C1,0,1,0,0,0,1
GGATCCGGAATATACT-1_V12D07-335_C1,0,2,0,1,0,3
TGAAAGGACCTGACTC-1_V12D07-335_C1,0,0,0,0,0,0
TCCGCGGCAGCATCTG-1_V12D07-335_C1,0,4,0,0,0,4
TGCATATGTCTGTCAC-1_V12D07-335_C1,0,4,0,0,1,5
TGTAGGAGAAATTTCC-1_V12D07-335_C1,0,1,1,0,0,2
AGTGAGACTTCCAGTA-1_V12D07-335_C1,0,3,0,0,0,3
CCCAAACATGCTGCTC-1_V12D07-335_C1,0,6,1,0,3,10
GCTTATGAAGCAGGAA-1_V12D07-335_C1,0,3,0,0,2,5
TTCTAACCGAAGCTTA-1_V12D07-335_C1,1,2,0,1,0,4
GGATGTCCTTACCGCA-1_V12D07-335_C1,0,1,0,0,1,2
AGGGTGCTCTCGAGGG-1_V12D07-335_C1,1,2,0,0,0,3
AACTCTCAATAGAGCG-1_V12D07-335_C1,1,2,0,0,1,4
TCTGAATTCCGTACAA-1_V12D07-335_C1,0,0,0,0,1,1
GCGTGGTACTGGGTTA-1_V12D07-335_C1,0,2,0,0,1,3
CGTCGGATAGTGTTGA-1_V12D07-335_C1,0,3,0,0,0,3
ATATGTCTCCCTAGCC-1_V12D07-335_C1,2,0,0,0,1,3
TCTTTAAGACTATGAA-1_V12D07-335_C1,0,2,0,0,2,4
TCATTTAAGTCTCCGA-1_V12D07-335_C1,0,2,0,0,1,3
GATATTGAGATTGGCG-1_V12D07-335_C1,0,6,0,0,2,8
TGACATCGAGCGGACC-1_V12D07-335_C1,0,5,0,0,0,5
GCGTAAATGGCCATAA-1_V12D07-335_C1,0,4,0,0,0,4
ATTGTACAACTCGGCT-1_V12D07-335_C1,0,0,0,0,1,1
TACGCTATAGAAACCT-1_V12D07-335_C1,0,2,1,0,1,4
CACCCAAATCTTATGT-1_V12D07-335_C1,0,1,0,0,1,2
AGATGATGGAGTCTGG-1_V12D07-335_C1,0,1,0,0,5,6
CCACGGTGCCCGGTAG-1_V12D07-335_C1,0,0,0,0,1,1
TCAAGAAATACTAGCT-1_V12D07-335_C1,0,3,0,0,2,5
AGGTATAATTGATAGT-1_V12D07-335_C1,0,3,0,0,1,4
CAAGGTCCTATAGGCT-1_V12D07-335_C1,0,2,0,0,0,2
CCGGCACGACCGTTTC-1_V12D07-335_C1,0,1,0,0,0,1
ACCTCCGTTATTCACC-1_V12D07-335_C1,0,0,0,0,0,0
GCAGCCTATATCACAT-1_V12D07-335_C1,1,3,0,0,0,4
GGTATAGTGACACATA-1_V12D07-335_C1,1,1,0,0,0,2
AAATTCCAGGTCCAAA-1_V12D07-335_C1,0,2,0,0,0,2
TCTTTAGCAGGCGAAC-1_V12D07-335_C1,0,1,0,0,1,2
TATTGACATTTCTGCC-1_V12D07-335_C1,1,2,0,0,0,3
TCTGATCGGGTGCTAG-1_V12D07-335_C1,0,3,0,0,2,5
GGCCCGGAGCATGTCT-1_V12D07-335_C1,1,1,0,0,1,3
GGGCGCAGCGTTACTC-1_V12D07-335_C1,0,1,0,0,0,1
TTGGCGATCCGAATAT-1_V12D07-335_C1,0,0,0,0,0,0
CCACGTAAATTAGACT-1_V12D07-335_C1,0,7,0,0,2,9
TCTGATTGGAAATGGA-1_V12D07-335_C1,1,2,1,0,0,4
ATGGCGGAATAGTCGC-1_V12D07-335_C1,0,3,0,0,0,3
ATCGCTTTACGTCTCA-1_V12D07-335_C1,0,1,0,0,0,1
TACGTGCAAGGTTCCT-1_V12D07-335_C1,0,3,1,0,0,4
CAGGACAGCTGCCCTT-1_V12D07-335_C1,0,2,1,2,1,6
CAAACCAGGTCTGCAT-1_V12D07-335_C1,0,0,0,0,1,1
ACAAGCTATATGGAAG-1_V12D07-335_C1,3,0,0,1,0,4
TCGCCCACTGCGAGAG-1_V12D07-335_C1,0,0,0,1,0,1
AGCCGCAAATTCAAAT-1_V12D07-335_C1,1,2,0,0,0,3
TTAACGTTAAAGCCTG-1_V12D07-335_C1,0,0,0,0,0,0
CAGCGCCAACACGATA-1_V12D07-335_C1,2,1,1,0,0,4
ATCCAATGGTACCGAA-1_V12D07-335_C1,1,0,0,0,0,1
GTGCTGCAGATAAGGA-1_V12D07-335_C1,0,0,0,0,0,0
GGCCTTTGCAACTGGC-1_V12D07-335_C1,0,0,0,0,0,0
GTCGTACCTACGATTG-1_V12D07-335_C1,0,0,0,0,0,0
TAGAAATTCACGTATA-1_V12D07-335_C1,0,0,0,0,0,0
AGAATAAATCTTCAGG-1_V12D07-335_C1,0,0,0,0,0,0
CATTGCGAAATGGGCG-1_V12D07-335_C1,0,0,0,0,0,0
GTCTACTCAATTACAA-1_V12D07-335_C1,0,0,0,0,0,0
TGTAATGACCACAATA-1_V12D07-335_C1,0,0,0,0,0,0
AAAGTCGACCCTCAGT-1_V12D07-335_C1,0,0,0,0,0,0
TACTCGGCACGCCGGG-1_V12D07-335_C1,1,0,0,0,0,1
AGGTGTATCGCCATGA-1_V12D07-335_C1,0,0,0,0,0,0
TGTGCTTTACGTAAGA-1_V12D07-335_C1,0,0,0,0,0,0
AAACCTCATGAAGTTG-1_V12D07-335_C1,1,0,0,0,0,1
TATAGGGTACTCATGA-1_V12D07-335_C1,1,1,0,0,0,2
CCAGCTGATGGTACTT-1_V12D07-335_C1,0,0,0,0,0,0
AATATTGGAGTATTGA-1_V12D07-335_C1,0,0,0,0,0,0
GGCCCTCACCCACTTA-1_V12D07-335_C1,0,0,0,0,0,0
AACCAAGACTTCTCTG-1_V12D07-335_C1,0,0,0,0,0,0
TCGTATTACCCATTGC-1_V12D07-335_C1,0,0,0,0,0,0
ATTCGACGCCGGGCCT-1_V12D07-335_C1,0,0,0,0,0,0
GGCGCAGGACATCTTC-1_V12D07-335_C1,0,0,0,0,0,0
GTACTCCCTTATCGCT-1_V12D07-335_C1,0,0,0,0,0,0
TGGTCTGTTGGGCGTA-1_V12D07-335_C1,0,0,0,0,0,0
AATAACAACGCTCGGC-1_V12D07-335_C1,0,1,0,0,0,1
CATACCCGTACCCAGT-1_V12D07-335_C1,0,0,0,0,0,0
ACAATCCATTTAAACC-1_V12D07-335_C1,0,0,0,0,0,0
GTTACAATTGGTGACG-1_V12D07-335_C1,0,0,0,0,0,0
TTGCCCTGATCACGGG-1_V12D07-335_C1,0,0,0,0,0,0
CTAACCGCGCGCCCGT-1_V12D07-335_C1,0,0,0,0,0,0
CTAAAGAATGCCTACT-1_V12D07-335_C1,0,0,0,0,0,0
ACCCATCTTGAGGGTA-1_V12D07-335_C1,0,0,0,0,0,0
GATCTTTGCAGGGTAT-1_V12D07-335_C1,0,1,0,0,0,1
GGGTACTTCATGAACT-1_V12D07-335_C1,0,0,0,1,0,1
GCCGCTTGTGAGAAAC-1_V12D07-335_C1,1,0,0,0,0,1
CCTGTAAGACATGATA-1_V12D07-335_C1,0,0,0,1,0,1
CGACAGTTCGCGTTAT-1_V12D07-335_C1,0,0,0,0,0,0
ACGATGCATATGTTAT-1_V12D07-335_C1,0,1,0,0,0,1
TGTTCCGCTTCCATGA-1_V12D07-335_C1,0,0,0,0,0,0
GGATGACGCGAGTTTA-1_V12D07-335_C1,0,0,0,0,0,0
GAAGTTTCCACTCAAT-1_V12D07-335_C1,0,0,0,0,0,0
GCGAGGCCCGAGCAGA-1_V12D07-335_C1,1,0,0,0,0,1
CATACTATGTAATTGT-1_V12D07-335_C1,0,0,0,0,0,0
CCAATGTCACAGCAAG-1_V12D07-335_C1,0,0,1,0,0,1
GTTGGATTTGCGTTGG-1_V12D07-335_C1,0,0,0,0,0,0
GGGAGGATGCCCGAAA-1_V12D07-335_C1,1,5,0,0,0,6
GATCGCGGGCTCTCCA-1_V12D07-335_C1,0,1,0,0,0,1
GTTCGCCATAAGTGCC-1_V12D07-335_C1,1,0,0,0,0,1
AGATTATAGGACGTTT-1_V12D07-335_C1,0,0,0,1,0,1
TCGAGACCAACACCGT-1_V12D07-335_C1,0,3,0,2,0,5
TATGGGACCGAGCAGG-1_V12D07-335_C1,1,4,0,0,0,5
GATGCGTCCTGCATTC-1_V12D07-335_C1,0,2,0,2,0,4
TATGGTCTGAGTAACA-1_V12D07-335_C1,2,4,0,0,1,7
GCATAGAGCACTCAGG-1_V12D07-335_C1,1,3,0,0,0,4
CTTCATTGTCAGTGGA-1_V12D07-335_C1,0,1,1,0,0,2
GCAGATTAGGGATATC-1_V12D07-335_C1,0,1,0,1,0,2
CCTGTCGCCCGTAAAT-1_V12D07-335_C1,0,0,0,0,0,0
CAATTTCGTATAAGGG-1_V12D07-335_C1,2,2,0,0,0,4
GTACACTTACCTGAAG-1_V12D07-335_C1,1,1,0,1,1,4
CCAGCCTGGACCAATA-1_V12D07-335_C1,2,1,0,0,0,3
ATGGAGCAGGCCGTGA-1_V12D07-335_C1,0,3,0,0,0,3
GTCATTAGAGCGAACG-1_V12D07-335_C1,0,5,0,1,0,6
AAGACTGCAAGCTACT-1_V12D07-335_C1,0,1,1,0,0,2
CTAGTCACGTCTTAAG-1_V12D07-335_C1,1,2,0,0,0,3
ACTCTTGTATAGTAAC-1_V12D07-335_C1,1,4,0,0,0,5
ATTAGGCGATGCTTTC-1_V12D07-335_C1,0,1,1,0,0,2
TTCGGGACTAATCGCG-1_V12D07-335_C1,1,0,0,0,0,1
TGGACTGTTCGCTCAA-1_V12D07-335_C1,0,2,0,0,0,2
AACGTGCGAAAGTCTC-1_V12D07-335_C1,1,1,0,0,0,2
CCACCCAAGGAAAGTG-1_V12D07-335_C1,1,2,1,0,0,4
CCGCACAAAGACCAAC-1_V12D07-335_C1,0,3,0,0,0,3
GCGATTGTTAACGTTA-1_V12D07-335_C1,1,0,1,0,0,2
ACTCGTCAGTAATCCC-1_V12D07-335_C1,0,1,3,0,3,7
GGTGATAAGGAGCAGT-1_V12D07-335_C1,0,1,1,0,0,2
AAGAGGCATGGATCGC-1_V12D07-335_C1,0,0,0,0,2,2
CACGTTCGTGCTCTAG-1_V12D07-335_C1,0,3,0,0,0,3
CTATTTGGTTACGGAT-1_V12D07-335_C1,0,2,0,0,0,2
GTACAGAGGCAAGGGT-1_V12D07-335_C1,1,7,0,0,0,8
GGGCCGGCCGAAGTAC-1_V12D07-335_C1,0,3,0,0,0,3
CCTGAACGATATATTC-1_V12D07-335_C1,0,6,0,0,1,7
CCGGGCTGCTCCATAC-1_V12D07-335_C1,0,2,1,0,0,3
TACTTGTTAGTAGTCC-1_V12D07-335_C1,0,4,0,0,1,5
CCTAGGCGTAGCGATC-1_V12D07-335_C1,0,3,0,0,0,3
CTGGCGCACAGGTCTG-1_V12D07-335_C1,2,1,1,0,1,5
ACTTATACTTACCCGG-1_V12D07-335_C1,1,5,1,0,1,8
GAAGTCTCCCTAGCGA-1_V12D07-335_C1,0,2,0,1,2,5
ACCGATGGTAGCATCG-1_V12D07-335_C1,0,0,2,0,0,2
CGAGTTTATCGGACTG-1_V12D07-335_C1,0,0,0,0,2,2
CATAACGGACAGTCGT-1_V12D07-335_C1,0,3,1,0,0,4
TGACGATGCACTAGAA-1_V12D07-335_C1,0,3,0,0,0,3
TAGGGAGCTTGGGATG-1_V12D07-335_C1,0,3,0,0,0,3
AGGGTCGATGCGAACT-1_V12D07-335_C1,0,2,0,0,2,4
TATATCCCTGGGAGGA-1_V12D07-335_C1,0,3,0,0,3,6
CATCTTACACCACCTC-1_V12D07-335_C1,0,2,1,0,0,3
GTGCGACAGGGAGTGT-1_V12D07-335_C1,0,2,0,1,1,4
CCGATCTCAACCTTAT-1_V12D07-335_C1,0,2,0,0,1,3
ACGATCATCTTGTAAA-1_V12D07-335_C1,0,7,1,0,1,9
GAAAGAACAGCGTTAT-1_V12D07-335_C1,0,5,1,0,1,7
CTAGGTCTGAAGGAAT-1_V12D07-335_C1,0,0,1,0,5,6
ATATCAACCTACAGAG-1_V12D07-335_C1,0,0,0,1,1,2
AAATAGCTTAGACTTT-1_V12D07-335_C1,0,2,1,0,4,7
GCGACATGTAAACATC-1_V12D07-335_C1,0,1,1,0,0,2
ATAAGTAGGGCGACTC-1_V12D07-335_C1,0,1,0,0,1,2
GCGAGCGCATGCTCCC-1_V12D07-335_C1,0,4,1,0,0,5
AGGGACCGGCTGCGTT-1_V12D07-335_C1,1,4,0,0,0,5
CCTATGAAGTGGTGCC-1_V12D07-335_C1,0,0,0,0,1,1
GCTTACGTAGTTAGTA-1_V12D07-335_C1,0,0,1,0,0,1
CATACTTAGGCAATAC-1_V12D07-335_C1,0,2,0,0,0,2
CCTGTCCCTCACGTTA-1_V12D07-335_C1,0,0,0,0,0,0
CAATGTGCCAACCCTT-1_V12D07-335_C1,1,4,0,0,1,6
GTTAAGTTAGAGTGGG-1_V12D07-335_C1,0,5,0,0,0,5
CTGGGATACGCTACCC-1_V12D07-335_C1,0,2,0,0,0,2
AACCTGTCACGGAATT-1_V12D07-335_C1,0,4,0,1,0,5
ACTGCGGACACACCGT-1_V12D07-335_C1,0,1,0,0,2,3
CCGTGAGGCATTCATG-1_V12D07-335_C1,1,3,0,0,0,4
GCCCAGATGCTGGAGA-1_V12D07-335_C1,1,1,0,0,1,3
TCTGGCCGTTCAAGTT-1_V12D07-335_C1,0,4,0,0,0,4
ATACGAAGGCTTTCCA-1_V12D07-335_C1,0,2,0,0,0,2
GATCCGAATATAAGTG-1_V12D07-335_C1,2,1,0,1,0,4
GTGGAGCATGTCGGCC-1_V12D07-335_C1,0,3,2,0,1,6
ACTCTTCAGCTCCCGC-1_V12D07-335_C1,1,3,0,0,0,4
CCCGATAGCCTCGCCT-1_V12D07-335_C1,2,2,1,0,1,6
ACAGGTGTGTTGTTGC-1_V12D07-335_C1,0,0,0,0,0,0
TGAACTGCTATGACTT-1_V12D07-335_C1,4,2,0,0,0,6
TGACATATATGACGAT-1_V12D07-335_C1,0,0,0,0,0,0
AAGTCTTCTGTGGCCT-1_V12D07-335_C1,1,0,0,0,0,1
ACCAGACCATAACAAC-1_V12D07-335_C1,0,1,0,0,0,1
TGAGACGTACCTCTCA-1_V12D07-335_C1,0,1,0,0,0,1
GACCGTTACATGCGAC-1_V12D07-335_C1,0,4,2,0,4,10
GGTTCGGATTATACTA-1_V12D07-335_C1,3,0,0,0,0,3
CCTCCTGAGCCCACAT-1_V12D07-335_C1,0,0,0,0,0,0
CCGCGATTTGGTAGGT-1_V12D07-335_C1,0,0,0,0,0,0
AATCTCTACTGTGGTT-1_V12D07-335_C1,0,0,0,0,0,0
ACTTTGACTGCATCCT-1_V12D07-335_C1,0,1,0,0,0,1
CCCTGACTAACAAATT-1_V12D07-335_C1,0,0,0,0,0,0
ACGCTGTGAGGCGTAG-1_V12D07-335_C1,0,0,0,0,0,0
GCATACGAGGTCTTTA-1_V12D07-335_C1,0,0,0,0,0,0
TCGGGATTCAAACATA-1_V12D07-335_C1,1,0,0,0,0,1
GGGCCCTACGAAAGGG-1_V12D07-335_C1,0,0,0,0,0,0
CGCCAAGAAGCCGAGT-1_V12D07-335_C1,1,0,0,0,0,1
GGTACATCTGGGACGA-1_V12D07-335_C1,0,0,0,0,0,0
GGATGCTGGCGTTCCT-1_V12D07-335_C1,0,0,0,0,0,0
CCGATTCGAGGGACCC-1_V12D07-335_C1,0,0,0,0,0,0
CCACTGGTGGCTGGTT-1_V12D07-335_C1,0,0,0,0,0,0
GACAGGCACACACTAT-1_V12D07-335_C1,0,0,0,0,0,0
TCAACGCGACCGGCAG-1_V12D07-335_C1,0,0,0,0,0,0
CTACGACTAGCTATAA-1_V12D07-335_C1,0,0,0,0,0,0
CGGTTGACCTGGCATA-1_V12D07-335_C1,1,0,0,0,0,1
ATCCTGAATCGCTGCG-1_V12D07-335_C1,1,0,0,0,0,1
GTTTCATATCGTCGCT-1_V12D07-335_C1,1,0,0,0,0,1
ATAAATATTAGCAGCT-1_V12D07-335_C1,0,1,0,0,0,1
AAGAGGATGTACGCGA-1_V12D07-335_C1,0,0,0,0,0,0
TCCTGCGTTGATACTC-1_V12D07-335_C1,0,0,0,0,0,0
CGTGCATTGTCGACGC-1_V12D07-335_C1,0,0,0,0,0,0
CCGGGTTCGAGGTTAC-1_V12D07-335_C1,0,0,0,0,0,0
CCCAATTTCACAACTT-1_V12D07-335_C1,0,0,0,0,0,0
TGATTTATTAGCTGTG-1_V12D07-335_C1,0,0,0,0,0,0
TGGAAGAAGGGAACGT-1_V12D07-335_C1,0,0,0,0,0,0
GACGCTTGCTTCTAAA-1_V12D07-335_C1,0,0,0,0,0,0
GGGAACGGGAGGTTAG-1_V12D07-335_C1,1,0,0,1,0,2
GCGGCTCTGACGTACC-1_V12D07-335_C1,0,0,0,0,0,0
ACGTTAGATTTGCCCG-1_V12D07-335_C1,0,0,0,0,0,0
GAGAGGGCGCGAGGTT-1_V12D07-335_C1,0,0,0,0,0,0
GCGTCTCTGCATTGGG-1_V12D07-335_C1,0,0,0,0,0,0
GCAGCACACAGCCCAG-1_V12D07-335_C1,0,0,0,0,0,0
CAGGCCGTTTGGGTGT-1_V12D07-335_C1,1,0,0,0,0,1
AACTCAAGTTAATTGC-1_V12D07-335_C1,0,0,0,0,0,0
CTTCGTAGATAGGTGA-1_V12D07-335_C1,1,0,0,0,0,1
TGCAGAGTACCGAGCA-1_V12D07-335_C1,0,0,0,0,0,0
GAAGTGATTTATCGTG-1_V12D07-335_C1,0,2,0,0,0,2
CGCTACGGGACATTTA-1_V12D07-335_C1,0,1,0,0,0,1
CCACACTGAGATATTA-1_V12D07-335_C1,1,0,0,0,0,1
CGATCCGACCCAGTGC-1_V12D07-335_C1,0,1,0,1,0,2
CTGTACTTCTTAGCAT-1_V12D07-335_C1,2,1,0,0,0,3
ACTTATTAGGATCGGT-1_V12D07-335_C1,1,5,2,2,0,10
TAGTCCGCAGAGAATG-1_V12D07-335_C1,1,2,0,1,0,4
TTCACGAAAGGATCAC-1_V12D07-335_C1,1,2,0,1,0,4
TACATTTCTAACGTGC-1_V12D07-335_C1,0,1,0,1,0,2
ACCATATCCGCAATAA-1_V12D07-335_C1,0,3,0,0,1,4
CACTCAAGAGCTATGG-1_V12D07-335_C1,1,2,0,0,2,5
TGTACGAACAAATCCG-1_V12D07-335_C1,1,0,0,2,0,3
ATCATCCAATATTTGT-1_V12D07-335_C1,1,2,0,0,0,3
CGCTATTCTTAGGCTC-1_V12D07-335_C1,0,0,0,2,0,2
TGGCAGCAGTAATAGT-1_V12D07-335_C1,2,3,0,2,0,7
TCACGTGCCCGATTCA-1_V12D07-335_C1,0,0,0,0,0,0
CATACGGCGTCTGGGC-1_V12D07-335_C1,1,0,0,0,0,1
CACATGATTCAGCAAC-1_V12D07-335_C1,0,0,0,0,0,0
GCTAGTAGAGCTTGTA-1_V12D07-335_C1,0,1,0,0,0,1
TGCTGTTGAAGAACTC-1_V12D07-335_C1,2,2,0,1,0,5
CGGAGCATGGCGATCC-1_V12D07-335_C1,0,3,1,1,0,5
TAGCGTTGGGTCTTAC-1_V12D07-335_C1,1,1,0,0,0,2
GTAGCGGCTATACACT-1_V12D07-335_C1,0,2,0,0,0,2
TAACATACAATGTGGG-1_V12D07-335_C1,0,0,0,0,0,0
TCTTCGAATAGACGTT-1_V12D07-335_C1,0,0,0,1,1,2
GATCGTGACTGATATC-1_V12D07-335_C1,0,2,0,0,0,2
GATCCGGGAATTAACA-1_V12D07-335_C1,0,0,0,0,0,0
TTATATACGCTGTCAC-1_V12D07-335_C1,0,3,0,2,1,6
GTCGCGTAACCCGTTG-1_V12D07-335_C1,0,2,0,0,1,3
AGCTCTAGACGTTCCA-1_V12D07-335_C1,0,4,0,1,1,6
GTCAAGCGGACTCGGG-1_V12D07-335_C1,0,3,0,0,1,4
CGAGGGACTGCGGTCG-1_V12D07-335_C1,0,3,0,0,0,3
AATCGCCTCAGCGCCA-1_V12D07-335_C1,0,5,0,0,0,5
CTTGTTGCTGAGTCAA-1_V12D07-335_C1,0,2,0,0,4,6
GATATGAGACACTAAC-1_V12D07-335_C1,0,2,0,0,0,2
TTATGATCTTAACGAA-1_V12D07-335_C1,1,6,0,0,0,7
CGCCGCCCATGCCTGT-1_V12D07-335_C1,1,2,0,0,0,3
CTGGGATAAATAATGG-1_V12D07-335_C1,0,2,0,0,0,2
GTGCCCGTTCGGATTC-1_V12D07-335_C1,0,5,0,1,0,6
TTCAATACTCTGAATC-1_V12D07-335_C1,0,2,1,0,0,3
CGCACATGTCCACTAC-1_V12D07-335_C1,0,3,1,0,1,5
AGAAGAGCGCCGTTCC-1_V12D07-335_C1,0,1,0,0,2,3
GATAACTCGCACTGTG-1_V12D07-335_C1,0,3,0,1,3,7
AGTCGACGGTCTCAAG-1_V12D07-335_C1,1,2,0,0,0,3
GTGACCGCACACTACG-1_V12D07-335_C1,0,1,0,0,0,1
GTATGTGGGTCTAGTT-1_V12D07-335_C1,0,3,1,0,2,6
CTTGAGTTAGGGTAAT-1_V12D07-335_C1,0,1,0,0,0,1
TTAGCTGATTTGCCGT-1_V12D07-335_C1,0,1,0,1,0,2
GCTGTTGCTACCGAAC-1_V12D07-335_C1,0,4,1,0,0,5
TATTACCATCCTGCTT-1_V12D07-335_C1,0,4,1,0,0,5
TTGAATTCACGTGAGG-1_V12D07-335_C1,0,3,1,0,0,4
CCATCTCACCAGTGAA-1_V12D07-335_C1,0,3,1,0,0,4
CGCACGTGCGCTATCA-1_V12D07-335_C1,0,4,1,0,1,6
ACCCGGATGACGCATC-1_V12D07-335_C1,0,3,0,0,0,3
CGCTAGAGACCGCTGC-1_V12D07-335_C1,0,1,0,0,2,3
ATAGTTCCACCCACTC-1_V12D07-335_C1,0,1,1,0,1,3
GCAGACCCAGCACGTA-1_V12D07-335_C1,0,2,0,0,1,3
TAGACTACCTAGCGTT-1_V12D07-335_C1,0,2,0,0,0,2
GGTTCTACTCGTCTGA-1_V12D07-335_C1,0,4,1,0,1,6
GACTCACCCACGTGAG-1_V12D07-335_C1,0,2,0,0,2,4
AGCTCTTCGTAACCTT-1_V12D07-335_C1,1,1,0,0,0,2
ACTATCCAGGGCATGG-1_V12D07-335_C1,1,2,0,0,0,3
AAGGATCGATCGCTTG-1_V12D07-335_C1,1,4,1,0,1,7
ATATCGGTAGGGAGAT-1_V12D07-335_C1,0,2,1,0,1,4
TTCCAGACGAGATTTA-1_V12D07-335_C1,0,0,0,0,0,0
GACCGACGTGAAAGCA-1_V12D07-335_C1,0,1,0,0,1,2
CCTGGAAACGTTCTGC-1_V12D07-335_C1,2,3,0,0,2,7
CCGGTAATGGCTAGTC-1_V12D07-335_C1,0,3,0,0,0,3
GCCGTGGAAGAAATGT-1_V12D07-335_C1,1,1,0,0,0,2
GTCTTGAGGAGCAGTG-1_V12D07-335_C1,0,4,0,0,1,5
TCCCAAAGCCCTAAAT-1_V12D07-335_C1,1,2,0,0,0,3
TTGAGCGCCACGTGAT-1_V12D07-335_C1,0,0,1,0,0,1
TTGAGTCCCGCTGCTG-1_V12D07-335_C1,0,3,0,0,0,3
ATGGAACCTTTGCACA-1_V12D07-335_C1,0,2,0,0,0,2
GCTAGCACCTGGGCCA-1_V12D07-335_C1,2,1,1,0,0,4
CGCCGTCTACCCATCG-1_V12D07-335_C1,0,3,0,0,1,4
GATAGGTGTCCCGGGC-1_V12D07-335_C1,0,4,0,0,0,4
AGGTATGCGGACATTA-1_V12D07-335_C1,0,4,0,0,0,4
TTGGTTCGCTCAAAGG-1_V12D07-335_C1,0,2,1,0,0,3
TCTGGAGCGTAAGAGT-1_V12D07-335_C1,1,3,1,0,0,5
TGCCTAAATTTAATAG-1_V12D07-335_C1,2,4,0,0,0,6
TAATTTCCGTCCAGTA-1_V12D07-335_C1,0,1,0,0,0,1
TCCTTCAATCCCTACG-1_V12D07-335_C1,4,1,0,0,0,5
TACCTATCCCTAGAGG-1_V12D07-335_C1,2,3,0,0,0,5
GCATGGGTACTGACGC-1_V12D07-335_C1,0,1,0,0,0,1
GTCGGGAACATGGTAG-1_V12D07-335_C1,3,3,0,0,0,6
GCAAATGAGGACACTT-1_V12D07-335_C1,2,1,0,0,1,4
GAATGGGCTTATCGAC-1_V12D07-335_C1,2,1,0,0,0,3
TGGTCGTGCAAGGCAA-1_V12D07-335_C1,0,5,0,0,0,5
CACCACGCCACACAGA-1_V12D07-335_C1,2,0,0,0,0,2
GAACCTCGACCTACAC-1_V12D07-335_C1,1,1,0,0,0,2
CAATACGCTCTGAGGC-1_V12D07-335_C1,0,1,0,0,0,1
TGGTAAGCAGGATTGA-1_V12D07-335_C1,1,0,0,0,0,1
AGTGGCTCCGTCGGCC-1_V12D07-335_C1,1,0,0,0,0,1
GATCGGATAGAACCAT-1_V12D07-335_C1,2,0,0,0,0,2
GCTACAGTACGGACCG-1_V12D07-335_C1,0,0,0,0,0,0
TCTATTACTAGAGGAT-1_V12D07-335_C1,1,0,0,0,0,1
TTCAGGCGTCAAAGCC-1_V12D07-335_C1,0,0,0,0,0,0
AGACCGGGAAACCCTG-1_V12D07-335_C1,0,0,0,0,0,0
AGAGATCTCTAAAGCG-1_V12D07-335_C1,0,0,0,0,0,0
CCCTGCCCAATCCGCT-1_V12D07-335_C1,1,0,0,0,0,1
GTGGCGGTCCCAGCGT-1_V12D07-335_C1,1,0,0,0,0,1
GCATTGTAATTCATAT-1_V12D07-335_C1,1,0,0,0,0,1
CCGTTCCGAATCTCGG-1_V12D07-335_C1,0,0,0,0,0,0
AGCTTGATCTTAACTT-1_V12D07-335_C1,0,0,0,0,0,0
CCTGTACTCACGCCCA-1_V12D07-335_C1,0,0,0,0,0,0
AAGTGACGACCGAATT-1_V12D07-335_C1,0,0,0,0,0,0
CTCACTTGGCTGGTAA-1_V12D07-335_C1,0,1,0,0,0,1
CGCCTGGCCTACGTAA-1_V12D07-335_C1,1,0,0,0,0,1
CCCGTAAGTCTAGGCC-1_V12D07-335_C1,1,0,0,0,0,1
TTGGACATGTGGCTTA-1_V12D07-335_C1,0,0,0,0,0,0
ATTACGCGCTGGCAGG-1_V12D07-335_C1,0,0,0,0,0,0
ACGCGCTACACAGGGT-1_V12D07-335_C1,0,0,0,0,0,0
TACGTTTACCGGCAAT-1_V12D07-335_C1,0,0,0,0,0,0
CGAAACGCAATTCATG-1_V12D07-335_C1,0,0,0,0,0,0
TAGTCTAACAACGAGA-1_V12D07-335_C1,1,0,0,0,0,1
TTGCATGCTGATCACG-1_V12D07-335_C1,0,0,0,0,0,0
TCTGGGTAGCGCTCAT-1_V12D07-335_C1,0,0,0,0,0,0
ACATCGGTCAGCCGCG-1_V12D07-335_C1,0,0,0,0,0,0
AGATACCGGTGTTCAC-1_V12D07-335_C1,0,0,0,0,0,0
GATTACTGAATTTGGG-1_V12D07-335_C1,1,0,0,0,0,1
TCCAACTTTAAATTCT-1_V12D07-335_C1,0,0,0,0,0,0
TCCTAGCAAAGAAGCT-1_V12D07-335_C1,1,0,0,0,0,1
GTCTATCTGAGTTTCT-1_V12D07-335_C1,0,0,0,0,0,0
GATGTTCAATCCACGA-1_V12D07-335_C1,1,0,0,0,0,1
AGTTAAACACTTGCGA-1_V12D07-335_C1,0,0,0,0,0,0
AGCTCTTTACTCAGTT-1_V12D07-335_C1,1,0,0,0,0,1
ATCCAGGATTCGTGAA-1_V12D07-335_C1,1,0,0,0,0,1
AGTCAACACCACCATC-1_V12D07-335_C1,0,0,0,0,0,0
CGATACCTCGCGGACA-1_V12D07-335_C1,1,2,2,0,0,5
TACAACGCACAACTCA-1_V12D07-335_C1,1,2,0,0,1,4
AATTAAAGGTCGGCGT-1_V12D07-335_C1,0,1,0,0,0,1
TACGCAGTTCTTTCCT-1_V12D07-335_C1,0,7,0,2,0,9
GACCGTGCTGACGGTG-1_V12D07-335_C1,3,0,0,0,0,3
GGCAAATTACTTTACT-1_V12D07-335_C1,1,0,0,0,1,2
GGTACAAACATGCTAT-1_V12D07-335_C1,0,0,0,1,0,1
CGGGCCTTCTTTGTAA-1_V12D07-335_C1,1,3,2,0,0,6
CGTGAAGTTAATTCAC-1_V12D07-335_C1,0,3,0,0,2,5
ATAGTGAAGCGTTCTC-1_V12D07-335_C1,2,1,0,0,0,3
TACGCCATATTCTAAT-1_V12D07-335_C1,0,2,0,1,0,3
GCCGGGTTAGGGTCGC-1_V12D07-335_C1,3,1,0,0,0,4
TACATAGGCATACACC-1_V12D07-335_C1,2,4,0,2,0,8
GCCGATTGGCCAAGCT-1_V12D07-335_C1,0,3,0,0,1,4
CTGCCATGCATCACAT-1_V12D07-335_C1,2,2,1,0,1,6
TTATGAATGAAAGGGA-1_V12D07-335_C1,0,2,0,0,0,2
GCTGAGGCGTGAGTAT-1_V12D07-335_C1,2,1,0,0,0,3
GCGCCGTTCCACGATA-1_V12D07-335_C1,0,1,1,0,0,2
CGCATGGTGCGATGCT-1_V12D07-335_C1,0,1,0,0,1,2
AGGTTTCACACACCTT-1_V12D07-335_C1,0,3,0,1,0,4
CAAGGATCGCATGTTC-1_V12D07-335_C1,0,0,0,1,0,1
ACGTTAATGTCGAAGA-1_V12D07-335_C1,0,4,1,2,1,8
TCCAGAGCACCGGTTC-1_V12D07-335_C1,0,0,0,0,2,2
GATTCGACGGTTCACG-1_V12D07-335_C1,1,1,0,1,0,3
GTTTCTGCAGTCTCCC-1_V12D07-335_C1,1,1,0,0,1,3
GCTGCACGGTTTCTTA-1_V12D07-335_C1,0,1,0,1,0,2
CGTGCAGACTGGGACA-1_V12D07-335_C1,0,2,0,1,0,3
GTGTTACTATGCGTCC-1_V12D07-335_C1,0,3,0,0,0,3
TCCTCGGGCTGGGCTT-1_V12D07-335_C1,0,1,0,0,0,1
GTGAGGACACTTAAGG-1_V12D07-335_C1,0,0,0,0,0,0
ATACGCCGGCGAAACC-1_V12D07-335_C1,0,0,0,0,0,0
TCTGCCAGAAACTGCA-1_V12D07-335_C1,1,2,0,0,1,4
TTCTGCGGGTTAGCGG-1_V12D07-335_C1,0,1,0,0,0,1
CTCGGTACCACTGCTC-1_V12D07-335_C1,0,1,0,0,2,3
GTAAGTAACAGTCTGG-1_V12D07-335_C1,0,1,0,0,0,1
GTGCGTGTATATGAGC-1_V12D07-335_C1,0,5,1,0,1,7
ATTTGTCTTGGGAGCT-1_V12D07-335_C1,1,3,0,0,0,4
CCTCGGACCGGGATAG-1_V12D07-335_C1,0,3,0,1,1,5
TAGGTGCTCGCCTAGC-1_V12D07-335_C1,0,1,1,0,1,3
CTTTAGGAACACTGTT-1_V12D07-335_C1,0,4,0,0,1,5
TCGGGCCGTCGTGGTA-1_V12D07-335_C1,0,2,1,0,1,4
AGTGCTTGCACGAATA-1_V12D07-335_C1,0,5,0,2,0,7
TGCAGTTTCCTCCCAT-1_V12D07-335_C1,1,6,1,3,0,11
TGAGAGATTTACCACG-1_V12D07-335_C1,0,1,0,0,2,3
GAAACAGATGACCACC-1_V12D07-335_C1,0,1,0,0,0,1
AGCAACATATCTTATT-1_V12D07-335_C1,0,1,0,0,0,1
CAAGTGTGGTTGCAAA-1_V12D07-335_C1,0,3,0,0,1,4
GCCTCATCTGGAAATA-1_V12D07-335_C1,0,0,0,0,1,1
AACCCTACTGTCAATA-1_V12D07-335_C1,0,1,0,0,0,1
ACGTATTACTCCGATC-1_V12D07-335_C1,0,0,1,0,1,2
TCTGGGAACCTTTGAA-1_V12D07-335_C1,0,0,0,1,0,1
GCTCGCTCATGTCCAA-1_V12D07-335_C1,0,1,1,1,2,5
GCGCAAGAGCGCGCTG-1_V12D07-335_C1,0,2,1,0,3,6
TTGACGCTCCATGAGC-1_V12D07-335_C1,0,1,1,0,0,2
TATAGATGGTCGCAGT-1_V12D07-335_C1,0,2,0,0,1,3
TTACATGCCACAACTA-1_V12D07-335_C1,0,0,0,0,0,0
ACATGGCGCCAAAGTA-1_V12D07-335_C1,0,1,0,0,0,1
TATGGTTAGTGGGAGA-1_V12D07-335_C1,0,1,0,0,0,1
CATGACTTCGCTGAAT-1_V12D07-335_C1,4,0,0,0,2,6
ACCACCAATGTAACAA-1_V12D07-335_C1,0,0,0,0,0,0
TCTTAGAGCTCCAATT-1_V12D07-335_C1,1,4,0,0,0,5
CCACGAATTTAACCTC-1_V12D07-335_C1,1,1,0,0,0,2
TTCTTGCTAGCATCTC-1_V12D07-335_C1,0,3,0,0,0,3
ACACCTTACTACTTGC-1_V12D07-335_C1,1,4,0,0,0,5
AGTCGGTTGCGTGAGA-1_V12D07-335_C1,0,1,0,0,0,1
ACCTACAGTATGTGGT-1_V12D07-335_C1,0,5,0,0,0,5
GAGGATAAACAGTGCT-1_V12D07-335_C1,1,2,0,0,0,3
TTCCGGTATCTGTGTC-1_V12D07-335_C1,1,3,0,0,0,4
GGAGGCCGAAGTCGTC-1_V12D07-335_C1,0,2,0,0,0,2
TTCGCTAGGAAGTTGT-1_V12D07-335_C1,0,2,0,0,0,2
TAAAGACAACCCTTTA-1_V12D07-335_C1,1,2,1,0,0,4
GTTGCGCTAACATTAC-1_V12D07-335_C1,0,2,1,0,0,3
GCTGAACTCTCCAGGG-1_V12D07-335_C1,0,3,0,0,0,3
AGCCCTGTCGCACCGT-1_V12D07-335_C1,1,1,0,0,0,2
AGCGCTAGAGCGATGT-1_V12D07-335_C1,1,3,0,0,0,4
TGCGCCGTTAATAACG-1_V12D07-335_C1,2,1,1,1,0,5
TGACAACGCATGTCGC-1_V12D07-335_C1,0,1,0,0,0,1
CGTCTTGAGTGTGACG-1_V12D07-335_C1,0,1,0,1,0,2
GATAGGATTAATTACA-1_V12D07-335_C1,3,0,5,1,3,12
GATACCGTGTCGGAGT-1_V12D07-335_C1,2,4,0,0,0,6
TGTGTCGAAGTCGAGG-1_V12D07-335_C1,0,0,0,0,0,0
GGATCAGAGCCATCAG-1_V12D07-335_C1,1,0,0,0,0,1
GTCCCAATCATCCCGC-1_V12D07-335_C1,1,0,0,0,0,1
TGCCACACTAGAGGAA-1_V12D07-335_C1,0,2,0,0,0,2
TGAATTTCACTTGCCT-1_V12D07-335_C1,1,2,0,1,0,4
CTCAGATTGTGATAAG-1_V12D07-335_C1,0,1,0,0,0,1
CGGACGTTACTTGAAG-1_V12D07-335_C1,3,0,0,0,1,4
CCGCCTTGCGATGTCG-1_V12D07-335_C1,1,1,0,0,0,2
CCAGTCAAATCTCTTA-1_V12D07-335_C1,0,0,0,0,0,0
AAACAGCTTTCAGAAG-1_V12D07-335_C1,0,1,0,1,0,2
TAGCTGATGTGAAGCG-1_V12D07-335_C1,1,2,0,0,0,3
CTTATGCGCTCAGGGC-1_V12D07-335_C1,1,0,0,0,0,1
TGGCTCTTGTCGCGTA-1_V12D07-335_C1,1,1,0,0,0,2
TTGTGAGGCATGACGC-1_V12D07-335_C1,0,8,2,0,1,11
CATAAGCTCTCCGTCT-1_V12D07-335_C1,1,0,0,0,0,1
CCTTCTCAGCGTTCCT-1_V12D07-335_C1,0,0,0,0,0,0
TGCAGCTACGTACTTC-1_V12D07-335_C1,0,0,0,0,0,0
CTCTACACTGGCGATT-1_V12D07-335_C1,1,4,1,0,0,6
TGCAGATCGTCCTAGG-1_V12D07-335_C1,1,0,0,0,0,1
TGCCAAAGTCAGACTT-1_V12D07-335_C1,0,3,0,0,0,3
ACAATAGTCGTACGTT-1_V12D07-335_C1,1,0,0,0,0,1
CATGCCAACTCGCAAA-1_V12D07-335_C1,1,1,0,0,0,2
TGCAGAACTATATCGT-1_V12D07-335_C1,0,0,0,0,0,0
TCGTGTCACGCTGACA-1_V12D07-335_C1,0,1,0,0,0,1
TGATCAGGGAACTGCT-1_V12D07-335_C1,1,0,0,0,0,1
CTTGCAACCGCCTCCT-1_V12D07-335_C1,1,3,0,0,0,4
AGCCCATACATGTAAG-1_V12D07-335_C1,1,0,0,0,0,1
ATCCAATGGAGGGTCC-1_V12D07-335_C1,1,0,0,1,0,2
AAACCGGGTAGGTACC-1_V12D07-335_C1,1,0,0,0,0,1
GCAACCACGGCCGCGT-1_V12D07-335_C1,1,1,0,0,0,2
CGCTTATTCCCGGTCG-1_V12D07-335_C1,0,1,0,0,0,1
TTACTCTGGTACGTAC-1_V12D07-335_C1,0,0,0,0,0,0
GTGGTTTCCGCCTTTC-1_V12D07-335_C1,0,0,0,0,0,0
ATAGGCGGCTATAGAA-1_V12D07-335_C1,1,2,0,0,0,3
GTGCCATCACACGGTG-1_V12D07-335_C1,0,0,0,0,0,0
CCCAACATACGTCGCG-1_V12D07-335_C1,0,0,0,0,0,0
CGGTGCAGATAGAACG-1_V12D07-335_C1,1,0,0,0,0,1
GGGCGGGTTCCCTACG-1_V12D07-335_C1,0,1,0,0,0,1
TGAGCCATACAGTCTC-1_V12D07-335_C1,0,0,0,0,0,0
CTCCGCCCACATGAGG-1_V12D07-335_C1,0,0,0,0,0,0
GTTGAACCGGTTCCAT-1_V12D07-335_C1,0,0,0,0,0,0
TTGACTACCATATGGT-1_V12D07-335_C1,0,1,0,0,0,1
ACCATCGTATATGGTA-1_V12D07-335_C1,1,0,0,0,0,1
TGCGTAAGAACCTGAT-1_V12D07-335_C1,1,0,0,0,0,1
AGAAGGTTGCCGAATT-1_V12D07-335_C1,0,2,0,1,0,3
AGGACGACCCATTAGA-1_V12D07-335_C1,1,0,1,0,0,2
GGTGCTGGTACACATT-1_V12D07-335_C1,2,3,0,0,0,5
GCGCTATGCCGAGGCA-1_V12D07-335_C1,2,0,0,1,0,3
ACCCGGTTACACTTCC-1_V12D07-335_C1,1,4,2,2,0,9
TAACTCATCCGCGCGG-1_V12D07-335_C1,1,2,0,0,0,3
CACAATGAGCTGCTAT-1_V12D07-335_C1,0,1,0,0,0,1
GTTACTTTGGGCCTAG-1_V12D07-335_C1,2,4,0,1,0,7
GGGCCCGTCTTAAACA-1_V12D07-335_C1,7,0,2,0,0,9
GAAATTGTCTCTATAA-1_V12D07-335_C1,2,5,0,1,0,8
GGCGCATGAATTGATG-1_V12D07-335_C1,1,0,0,0,3,4
CATATAGGTACAGTCA-1_V12D07-335_C1,2,2,0,0,0,4
TCAACGAGGAGACAAA-1_V12D07-335_C1,1,0,0,0,0,1
TTGCACAATTCAGAAA-1_V12D07-335_C1,0,1,0,0,0,1
CATCGGACGGGTTAAT-1_V12D07-335_C1,2,1,0,0,0,3
ATTAAACATGCGGACC-1_V12D07-335_C1,0,3,0,0,1,4
TATCTACCACAGCGGG-1_V12D07-335_C1,1,2,0,0,1,4
CGAGACCCTAGAGTGT-1_V12D07-335_C1,0,4,0,1,0,5
ACATCGATCGTTTACC-1_V12D07-335_C1,1,0,0,0,0,1
ATCGACCCAATACAGA-1_V12D07-335_C1,1,1,0,0,0,2
GAATCTGAACATTCTC-1_V12D07-335_C1,1,0,0,0,4,5
AGTTCCTATTTATGTT-1_V12D07-335_C1,0,1,0,0,1,2
CAGTCTGTATACTGGG-1_V12D07-335_C1,0,2,1,1,0,4
GGAGACGACACCTTTG-1_V12D07-335_C1,0,2,0,1,0,3
CCTAAATTAACGGTTC-1_V12D07-335_C1,0,4,0,0,1,5
GCTACGACTTATTGGG-1_V12D07-335_C1,0,1,0,0,0,1
CTGTGCAGGGTAGGTC-1_V12D07-335_C1,0,2,0,2,0,4
ACGCCGCTAGACGACC-1_V12D07-335_C1,2,3,0,0,0,5
ACTTGACTCCCTCTTT-1_V12D07-335_C1,1,3,1,0,0,5
CGCCTCCCTCCTCTAT-1_V12D07-335_C1,0,0,0,0,0,0
CTAGATTTACGACGGC-1_V12D07-335_C1,2,1,0,0,0,3
GATGCTGTATTTCATC-1_V12D07-335_C1,0,0,1,0,1,2
TGCGTTTGTTGACACT-1_V12D07-335_C1,2,1,0,0,0,3
CGTGCCCTCCCGAAGA-1_V12D07-335_C1,1,3,0,1,1,6
ACTCTCTGACTTAGGT-1_V12D07-335_C1,0,1,0,0,0,1
CTGGGTAGGCAGTTAA-1_V12D07-335_C1,0,1,0,0,1,2
GTTTGGCCCAAGTTAT-1_V12D07-335_C1,0,2,0,0,1,3
GAATGTGGTCCGGATT-1_V12D07-335_C1,0,2,0,1,0,3
CCCAGTTAAGGCGCCG-1_V12D07-335_C1,1,2,0,0,2,5
CGGTACTAGAATCAAA-1_V12D07-335_C1,1,2,0,1,2,6
GCTTAATGTAACTAAC-1_V12D07-335_C1,0,0,0,0,0,0
AGGACAGTCGAATCCC-1_V12D07-335_C1,0,1,0,0,0,1
GACAGCCAGACCTGAC-1_V12D07-335_C1,0,2,0,0,1,3
GGCGAAATCTAACTTG-1_V12D07-335_C1,0,0,0,0,3,3
CTGGTAACACATAGAA-1_V12D07-335_C1,0,1,0,0,1,2
TAGCCATTTCAAAGTC-1_V12D07-335_C1,0,3,0,1,1,5
GGGATTTACCGCACCT-1_V12D07-335_C1,0,2,0,0,0,2
ATGCCATTTGCGACCA-1_V12D07-335_C1,0,1,0,0,0,1
GAATAGACGCGACCCA-1_V12D07-335_C1,0,1,0,0,0,1
TGTATGGCGCAGACAG-1_V12D07-335_C1,0,6,0,0,0,6
GGATGAAGATCGCTGA-1_V12D07-335_C1,0,3,0,0,0,3
CGACAATTTGATCTAA-1_V12D07-335_C1,0,0,0,0,1,1
AAAGTTGACTCCCGTA-1_V12D07-335_C1,0,2,0,0,1,3
CGCGGCTCAACTTGAA-1_V12D07-335_C1,0,2,0,0,2,4
CACGCGGAACTGTTGC-1_V12D07-335_C1,0,1,0,0,1,2
TCTTAGAGTGAACTCT-1_V12D07-335_C1,0,1,0,1,0,2
AGTCCATTGGCTGATG-1_V12D07-335_C1,0,3,0,0,2,5
TTAAGATAGGATTGAC-1_V12D07-335_C1,1,0,0,0,0,1
ACATCCTGGTAACTGT-1_V12D07-335_C1,1,4,0,1,0,6
CACCTTGGCGCCTTTG-1_V12D07-335_C1,0,2,0,0,1,3
GCTAGACCGTCTACTG-1_V12D07-335_C1,1,0,1,0,1,3
CGGCCCAGGTATATCC-1_V12D07-335_C1,1,2,1,1,0,5
GTCCATTACTGCTACG-1_V12D07-335_C1,0,3,0,0,0,3
GGGTTTAGGATAGGAT-1_V12D07-335_C1,0,1,0,0,0,1
TAATTAGGACATCCGT-1_V12D07-335_C1,0,2,0,0,0,2
GCTCCCAGTCGGTCCA-1_V12D07-335_C1,0,2,0,0,0,2
ATTCGTGCTATCTCTT-1_V12D07-335_C1,2,0,0,0,0,2
GTTAACTATGTTGTCA-1_V12D07-335_C1,0,0,0,0,2,2
GCTCCGCTCGCTTCAG-1_V12D07-335_C1,0,1,0,1,0,2
GCAACGGCTAGTTATG-1_V12D07-335_C1,0,0,0,0,0,0
AATCGCGCAGAGGACT-1_V12D07-335_C1,1,2,0,0,0,3
AGGTTACACCATGCCG-1_V12D07-335_C1,0,4,0,0,0,4
CGAGATTTCGCTCGGG-1_V12D07-335_C1,0,1,0,0,0,1
CGATAATACTCAGGTT-1_V12D07-335_C1,1,0,0,0,0,1
AAGGCAGGCTGTCTCC-1_V12D07-335_C1,0,1,0,1,0,2
GTAAGTCCACACTCTA-1_V12D07-335_C1,0,1,0,0,0,1
ATGAGGGCAGCGGCTA-1_V12D07-335_C1,0,1,0,0,0,1
GCCGCACTCCGTTTCA-1_V12D07-335_C1,3,2,2,1,0,8
GAGCACGGCGCCTCTT-1_V12D07-335_C1,5,3,1,0,0,9
ACAATTTGGCCATATT-1_V12D07-335_C1,0,1,1,0,0,2
CTGGTTCGCGAGCTAC-1_V12D07-335_C1,0,0,0,0,0,0
GACGGTCCTAGGGTGT-1_V12D07-335_C1,0,0,0,0,0,0
ACTCGCGATCTGACGC-1_V12D07-335_C1,0,3,0,0,0,3
GTGTACGAACCGTTCC-1_V12D07-335_C1,1,1,0,0,0,2
CTTTGACGTCGCTTCT-1_V12D07-335_C1,2,1,0,0,2,5
CGTTATCATACTTCCA-1_V12D07-335_C1,0,2,1,1,0,4
GCTATGCCAGCTTATG-1_V12D07-335_C1,1,1,0,0,0,2
CAGTCGGCCTAGATAT-1_V12D07-335_C1,0,1,0,0,0,1
CCCGTGAGGGCGGTGA-1_V12D07-335_C1,0,0,0,0,0,0
TCTCGTGTTACGAGGA-1_V12D07-335_C1,0,0,0,0,0,0
ACGTCTCGTTCCGGGA-1_V12D07-335_C1,0,1,0,2,0,3
CGAGAGCGCGTAGATA-1_V12D07-335_C1,0,0,0,0,0,0
GACAGATTTCTGGCTC-1_V12D07-335_C1,0,0,0,1,0,1
GGGCCTAAATGGGCTA-1_V12D07-335_C1,0,4,0,0,0,4
ACTTGTAGTCCCTTCA-1_V12D07-335_C1,2,0,0,0,0,2
CCCGAAGTTTCGCGAA-1_V12D07-335_C1,0,3,0,0,0,3
ACCATCCGCCAACTAG-1_V12D07-335_C1,0,3,0,1,0,4
TGCGAATATGGGATTT-1_V12D07-335_C1,0,3,0,2,0,5
TACATCCCTATCCCTG-1_V12D07-335_C1,2,4,1,1,0,8
GTGGGAAGACTGAATC-1_V12D07-335_C1,0,1,0,0,0,1
TCAACATCGACCGAGA-1_V12D07-335_C1,1,0,0,0,0,1
CTATGTGAGTCACGGC-1_V12D07-335_C1,2,3,0,0,0,5
CCGAACACTGGGCCTC-1_V12D07-335_C1,0,3,0,0,0,3
AAACTTGCAAACGTAT-1_V12D07-335_C1,1,0,0,0,0,1
AGGGCGAGCAGCTGAT-1_V12D07-335_C1,1,5,0,0,0,6
AACACGAGACGCGGCC-1_V12D07-335_C1,0,3,0,1,0,4
TGACGAATATTTCCCT-1_V12D07-335_C1,0,0,0,1,0,1
TCGGAGAGTATCGGGA-1_V12D07-335_C1,0,0,0,0,0,0
CAAATCTCTCACAAGG-1_V12D07-335_C1,0,4,0,0,0,4
AGGCCCTAGAACGCCA-1_V12D07-335_C1,1,2,0,0,0,3
TAGAGATCATGCAACT-1_V12D07-335_C1,0,1,0,0,0,1
TTGTTTCCATACAACT-1_V12D07-335_C1,1,1,0,0,0,2
GAGAGGTGCATTCTGG-1_V12D07-335_C1,3,0,0,0,0,3
GTGGACCAACCCGATT-1_V12D07-335_C1,2,1,0,0,0,3
CTGGGCCTGCTATATC-1_V12D07-335_C1,2,0,0,0,0,2
CATAGTCCACAAGAAC-1_V12D07-335_C1,1,2,0,1,0,4
TTGACATGAACGTGGA-1_V12D07-335_C1,1,0,0,0,0,1
GGTTACCACCCTCGGG-1_V12D07-335_C1,0,2,0,0,0,2
TACCGGTCGTTTCCAT-1_V12D07-335_C1,0,1,0,0,0,1
CGAGTACTAAAGAGGA-1_V12D07-335_C1,2,1,0,0,0,3
GCAAGAATTCCTTGGC-1_V12D07-335_C1,1,4,0,1,0,6
TCGCCGAAGTTGCGTC-1_V12D07-335_C1,1,3,0,0,0,4
TTGAGAGTACTGCTAA-1_V12D07-335_C1,2,5,0,0,0,7
GCCACAATTTAAGGAC-1_V12D07-335_C1,1,3,0,0,0,4
ATATTCAGTTAAACCT-1_V12D07-335_C1,5,2,0,0,0,7
TGAGTGCCTCTTAAAT-1_V12D07-335_C1,2,3,0,2,0,7
ATCAGACGGCACGCCG-1_V12D07-335_C1,1,1,1,0,0,3
GTGCGAAATCGAACAC-1_V12D07-335_C1,0,0,0,0,0,0
GTGCCGCTTCAAAGGT-1_V12D07-335_C1,2,5,2,1,0,10
GATACGATGGGAGTCA-1_V12D07-335_C1,1,1,0,1,0,3
GACACTGAGTTCAGTG-1_V12D07-335_C1,1,2,0,1,0,4
ATCCTGCGTGGAATGG-1_V12D07-335_C1,1,1,0,0,0,2
ATCCTACCTAAGCTCT-1_V12D07-335_C1,0,4,0,1,0,5
AGTGATATGAGTAGTT-1_V12D07-335_C1,2,1,0,1,0,4
ATGATGCAATGGTACA-1_V12D07-335_C1,0,0,0,3,1,4
GAAACCGAATTACCTT-1_V12D07-335_C1,3,2,0,0,0,5
AGTGACCTACTTTACG-1_V12D07-335_C1,1,2,0,0,0,3
CAAATGTCCTTCCGTG-1_V12D07-335_C1,1,0,0,0,0,1
TTACTGGGATATTTCA-1_V12D07-335_C1,1,1,0,1,1,4
CTTGCCCAGGCTCTAC-1_V12D07-335_C1,2,4,0,0,0,6
AAATCGTGTACCACAA-1_V12D07-335_C1,0,1,0,1,0,2
GTGATCATAGATCTGC-1_V12D07-335_C1,0,2,0,0,0,2
TGGCAGATTACGATCA-1_V12D07-335_C1,0,0,0,0,1,1
TCACCCTCTTAAGATT-1_V12D07-335_C1,1,1,0,0,0,2
CAGGATATATCGTTGT-1_V12D07-335_C1,2,2,0,0,0,4
CCTGACCACCGATGGT-1_V12D07-335_C1,1,0,0,0,0,1
CTAAAGGGAAATAGGA-1_V12D07-335_C1,2,1,0,0,0,3
CCGCTATCAGCACCAG-1_V12D07-335_C1,0,2,1,0,1,4
CTTTAGTGCTATTATT-1_V12D07-335_C1,0,0,0,1,0,1
CGGGAATTTATGTAAA-1_V12D07-335_C1,1,0,0,0,0,1
TACGACTGCCTCTTAG-1_V12D07-335_C1,2,1,0,0,0,3
AAACTGCTGGCTCCAA-1_V12D07-335_C1,0,2,0,0,0,2
GTACGTTTGCCCGTCA-1_V12D07-335_C1,1,2,0,0,0,3
GGCAAGGCGAAATAGC-1_V12D07-335_C1,0,0,0,0,2,2
GATCTTGGAGGGCATA-1_V12D07-335_C1,0,1,0,0,0,1
AGCGTGGTATTCTACT-1_V12D07-335_C1,0,2,1,1,1,5
CTAAGGGAATGATTGG-1_V12D07-335_C1,0,2,0,0,0,2
CATGGTAAGTAGCGTT-1_V12D07-335_C1,0,2,0,0,1,3
CGTTGAGCGACCGTCG-1_V12D07-335_C1,1,2,0,0,0,3
TGCCCGTACCGTTAAA-1_V12D07-335_C1,0,2,0,0,0,2
ACAAGGGCAGGCTCTG-1_V12D07-335_C1,0,1,0,0,0,1
GAGATCTTCCATGACA-1_V12D07-335_C1,0,2,0,0,2,4
AATGACGTAGGATGTC-1_V12D07-335_C1,0,1,0,0,0,1
GTGGTGGCCAAGTGAA-1_V12D07-335_C1,0,2,0,0,0,2
TCCCGTGTGCAATTTG-1_V12D07-335_C1,0,3,0,0,3,6
ACATCGTATGCAATGG-1_V12D07-335_C1,0,0,0,0,1,1
GCGAAACTTAACTGGA-1_V12D07-335_C1,0,2,0,0,2,4
AATTGAACGCTCTGGT-1_V12D07-335_C1,0,0,0,0,1,1
ACAAATGGTAGTGTTT-1_V12D07-335_C1,0,3,0,0,0,3
ATGGTCGCGTGGTTTC-1_V12D07-335_C1,0,3,0,0,0,3
TGTTATTGTATGTGGC-1_V12D07-335_C1,0,1,0,0,2,3
TTCCGGTTACCCACTT-1_V12D07-335_C1,0,0,0,0,1,1
GAGTGTGCGGTACCCA-1_V12D07-335_C1,0,1,1,0,0,2
CAAGATATTATAACGT-1_V12D07-335_C1,0,0,0,0,0,0
ACACACCAGGACCAGT-1_V12D07-335_C1,0,2,0,0,3,5
ATGGGCCTCGGCCTCT-1_V12D07-335_C1,0,1,0,0,0,1
AAGGTGATAAACCAGC-1_V12D07-335_C1,0,4,0,1,2,7
TCTTACTTATGCCTCT-1_V12D07-335_C1,0,0,1,0,3,4
AAAGTGTGATTTATCT-1_V12D07-335_C1,0,0,0,1,0,1
TGCTCCACAGTTCTTA-1_V12D07-335_C1,0,0,0,1,1,2
CTGGCTGATTCATCCT-1_V12D07-335_C1,0,1,0,0,2,3
TAAGGCTGAATCCCTC-1_V12D07-335_C1,0,2,0,0,0,2
TCTAGTGATATCGTGG-1_V12D07-335_C1,0,0,0,0,1,1
TCGAAGAACCGAGCAC-1_V12D07-335_C1,1,1,0,0,1,3
GACAAACATATGCAGG-1_V12D07-335_C1,1,2,0,0,2,5
AAGTCAATTGTCGTCA-1_V12D07-335_C1,0,3,0,0,0,3
AGTGAACAAACTTCTC-1_V12D07-335_C1,1,7,0,1,0,9
CATGATGGAAGTTAGC-1_V12D07-335_C1,2,1,0,0,0,3
AAGTGCCTTGACTGTA-1_V12D07-335_C1,0,1,0,0,1,2
ATCGCCAGTCAACATT-1_V12D07-335_C1,1,1,0,1,0,3
ACCGCGGTGGAAGTCG-1_V12D07-335_C1,1,1,0,1,0,3
TCTTCTATAACCCGCC-1_V12D07-335_C1,0,2,0,3,1,6
CACATTTCTTGTCAGA-1_V12D07-335_C1,0,0,0,0,1,1
TAGCGTCCCTCGATTG-1_V12D07-335_C1,2,2,0,1,1,6
GTTCGGATCGGGAACA-1_V12D07-335_C1,2,2,0,0,1,5
CAAACTCGCGACGCCG-1_V12D07-335_C1,1,0,0,1,0,2
GTCTTGTAGCTATTCA-1_V12D07-335_C1,0,2,0,0,0,2
TCTCGACGTATCGCCG-1_V12D07-335_C1,1,0,0,0,0,1
TTGCCAAGCAGAACCC-1_V12D07-335_C1,0,3,0,1,1,5
AAACCCGAACGAAATC-1_V12D07-335_C1,1,1,0,0,0,2
TTGAGCAGCCCACGGT-1_V12D07-335_C1,1,0,0,0,0,1
CGCCTTTAGCATGCTC-1_V12D07-335_C1,1,2,0,0,0,3
TGTGGCTCCCACCAAC-1_V12D07-335_C1,1,0,0,0,0,1
CCGCCGTTGAGGATAA-1_V12D07-335_C1,1,1,0,0,0,2
CAATACGAGAGTCTGA-1_V12D07-335_C1,0,3,0,1,0,4
CATCTAGTGAAGGGAA-1_V12D07-335_C1,0,0,0,0,0,0
GGTGGAGGTTGATACG-1_V12D07-335_C1,0,3,0,0,0,3
CCGCACACGAACGTGT-1_V12D07-335_C1,0,1,1,1,0,3
AGAACCCAGCGTGACA-1_V12D07-335_C1,1,4,2,0,0,7
GCGCTCGATCACCTGT-1_V12D07-335_C1,0,2,0,1,0,3
ATCATGGACTACCGAC-1_V12D07-335_C1,0,2,0,0,0,2
TACGCCGCCTCAGAAG-1_V12D07-335_C1,0,0,0,0,0,0
CGACCTACTAGACAAT-1_V12D07-335_C1,1,3,0,0,1,5
GAGTCTTGTAAAGGAC-1_V12D07-335_C1,2,0,0,0,0,2
AATATCCTAGCAAACT-1_V12D07-335_C1,0,0,0,0,0,0
CCCTAGGCAACAAGAG-1_V12D07-335_C1,1,0,0,0,0,1
ACAAAGAAGGTAGGCC-1_V12D07-335_C1,1,3,0,0,0,4
CCCTGGCTGTTCCTTC-1_V12D07-335_C1,0,0,0,1,0,1
TCGCCGCACCGCGTGA-1_V12D07-335_C1,0,0,0,0,0,0
TATAGCGCACGTTATC-1_V12D07-335_C1,0,1,0,0,0,1
TTATCTGACATTAGGA-1_V12D07-335_C1,0,0,0,0,1,1
AGTGGTGTTACCCGTG-1_V12D07-335_C1,1,1,0,1,0,3
GCCAAGAATACTTCTG-1_V12D07-335_C1,1,1,1,1,0,4
CCGGCGTGAGACTCTG-1_V12D07-335_C1,1,0,1,0,0,2
TTCCCGGCGCCAATAG-1_V12D07-335_C1,2,0,0,0,0,2
AAACAGGGTCTATATT-1_V12D07-335_C1,1,0,0,0,0,1
ACAGTAATACAACTTG-1_V12D07-335_C1,3,3,0,1,0,7
CGAACGGCCGGACAAC-1_V12D07-335_C1,0,1,0,0,0,1
GCAACACACTAGAACT-1_V12D07-335_C1,0,5,1,0,0,6
ACTCCCATTCCTAAAG-1_V12D07-335_C1,0,2,0,0,0,2
ACCTGCGTGTCATGTT-1_V12D07-335_C1,0,0,0,1,0,1
TACTTTCCGCACGCCA-1_V12D07-335_C1,3,1,0,0,0,4
AGGTCAGGTGAGAGTG-1_V12D07-335_C1,2,1,0,0,0,3
TCCTCCTAAGACATTC-1_V12D07-335_C1,2,0,0,0,0,2
ATGTGAAAGCCTAATG-1_V12D07-335_C1,1,1,0,0,1,3
AGTCGGCTCAACTTTA-1_V12D07-335_C1,0,1,0,0,0,1
CGATCTGTTGGAGGAC-1_V12D07-335_C1,0,2,0,0,0,2
ACGGGAGTGTCGGCCC-1_V12D07-335_C1,2,1,0,0,0,3
TTAACTTCAGGTAGGA-1_V12D07-335_C1,3,5,0,0,0,8
CCACGGAGCCATAAGA-1_V12D07-335_C1,1,3,0,0,0,4
CTTCTATGTTGAAGTA-1_V12D07-335_C1,1,3,0,0,0,4
CACCGTTGCGCGATAT-1_V12D07-335_C1,0,2,0,0,0,2
TCTAGCAATCTCCGCC-1_V12D07-335_C1,0,0,0,0,0,0
AGTTTGGCCAGACCTA-1_V12D07-335_C1,1,3,0,0,0,4
TTGTAAGGACCTAAGT-1_V12D07-335_C1,0,1,0,0,0,1
AAATTTGCGGGTGTGG-1_V12D07-335_C1,1,3,0,0,0,4
AAGTTCGGCCAACAGG-1_V12D07-335_C1,0,1,0,0,0,1
CCGCTTACCTCACTCT-1_V12D07-335_C1,0,0,0,0,0,0
ATCACGTGCTAATTAA-1_V12D07-335_C1,2,0,0,0,0,2
GGTGAAGTACAGGGAT-1_V12D07-335_C1,2,1,0,0,1,4
GCTGTATTACTGGCCC-1_V12D07-335_C1,0,0,0,0,0,0
AACGGCCATCTCCGGT-1_V12D07-335_C1,0,2,0,0,0,2
TAAGTAACATCTTGAC-1_V12D07-335_C1,0,0,0,1,0,1
TTCTTGAGCCGCGCTA-1_V12D07-335_C1,1,1,0,1,0,3
AGTGCGTAGCTCGTAA-1_V12D07-335_C1,0,0,0,0,0,0
GGGATGGTCGTAACCG-1_V12D07-335_C1,1,1,0,0,0,2
GTCTGGGCGGTCGAGA-1_V12D07-335_C1,0,2,1,1,0,4
CGGAACGTAAACATAG-1_V12D07-335_C1,0,1,0,0,0,1
TGCGACACCCTAGTGC-1_V12D07-335_C1,3,5,0,1,0,9
CAAACGAGTATCGCAG-1_V12D07-335_C1,0,0,0,0,0,0
TCAGTAGGGACTATAA-1_V12D07-335_C1,1,3,0,0,0,4
GCGGTTCCCTATCATG-1_V12D07-335_C1,0,2,0,0,0,2
GTGACTTCAGTAGTGC-1_V12D07-335_C1,5,0,0,1,0,6
CGTCACGTCCATTGGT-1_V12D07-335_C1,2,1,0,0,0,3
ATAAGTTACCGCGACG-1_V12D07-335_C1,0,3,0,1,0,4
CTGAATCCGAGACCTC-1_V12D07-335_C1,0,1,0,2,0,3
TACGACGCTTGCTGCG-1_V12D07-335_C1,1,2,0,1,0,4
GAATTCACCCGGGTGT-1_V12D07-335_C1,1,3,0,0,1,5
GGGTGACACCTTAACT-1_V12D07-335_C1,0,1,0,0,0,1
TGAGTAAATTAGCGTA-1_V12D07-335_C1,1,3,0,0,0,4
GAGTCCGCTTACCGGA-1_V12D07-335_C1,0,0,1,0,0,1
GGCGCGTTCGAGTTTA-1_V12D07-335_C1,2,1,0,0,0,3
ATTCATATACTGTCCA-1_V12D07-335_C1,0,0,1,0,0,1
ATAAACGGACCCGTAA-1_V12D07-335_C1,1,0,0,0,2,3
GTCGTACCATCTCGGG-1_V12D07-335_C1,0,0,0,1,0,1
ATAATAGCTGTTGAAT-1_V12D07-335_C1,2,1,0,0,3,6
TTCCGCGTGAGGCGAT-1_V12D07-335_C1,0,2,0,1,0,3
TACCGGCTCACTGCCC-1_V12D07-335_C1,1,3,0,0,0,4
GTATCTTTCATAACCA-1_V12D07-335_C1,2,5,0,0,0,7
GTTACCTACAACTTGC-1_V12D07-335_C1,1,4,0,0,1,6
TGACTATAATCCTTTC-1_V12D07-335_C1,0,0,0,1,1,2
AAATACCTATAAGCAT-1_V12D07-335_C1,0,0,0,0,0,0
TTATTAGAGCGTGTTC-1_V12D07-335_C1,0,2,1,0,4,7
ATGTGGACATCTTGAT-1_V12D07-335_C1,1,1,2,1,1,6
GTACGCTTCATTGCAC-1_V12D07-335_C1,0,1,0,0,0,1
CACATATTAGCAGGAT-1_V12D07-335_C1,0,0,0,1,1,2
CAAGAGGGCGGAGTAC-1_V12D07-335_C1,0,1,0,1,0,2
TCGCAAAGATGCATTT-1_V12D07-335_C1,0,1,0,0,0,1
GTCGTTATTCGCTTAT-1_V12D07-335_C1,0,0,0,0,0,0
TCGTGTACTATGGATG-1_V12D07-335_C1,1,1,0,0,0,2
GCGGAGAGGGAGAACG-1_V12D07-335_C1,0,1,1,2,1,5
TCACAGGGAATCGCAA-1_V12D07-335_C1,0,0,0,0,1,1
GACTGCACCAGCCCAG-1_V12D07-335_C1,0,2,0,2,2,6
TCCGCTGTCATCCCGG-1_V12D07-335_C1,0,3,1,2,0,6
AGATACTCAAGATCGA-1_V12D07-335_C1,0,2,1,0,2,5
ACTGAATGGCGAAAGT-1_V12D07-335_C1,0,0,0,0,0,0
TCCTACATCCACGGCC-1_V12D07-335_C1,0,2,0,0,0,2
TTCAGCCCTGGTCCAC-1_V12D07-335_C1,0,1,0,1,3,5
TTAGAGTTTAGAAGGA-1_V12D07-335_C1,0,1,0,0,1,2
GGTTAGCTATATGTCT-1_V12D07-335_C1,0,1,0,1,0,2
CTGGTTTCGAGCAAGA-1_V12D07-335_C1,0,0,1,0,2,3
TGGGCCCATACTAATT-1_V12D07-335_C1,0,0,1,1,0,2
ACTTATTTATGTGCCA-1_V12D07-335_C1,0,0,0,0,2,2
TTAGTTATTCGTGGCA-1_V12D07-335_C1,0,0,0,0,1,1
AACCGCTAAGGGATGC-1_V12D07-335_C1,0,2,0,1,1,4
ATACGTCCACTCCTGT-1_V12D07-335_C1,0,0,0,0,1,1
CGACACGCTCCGACAG-1_V12D07-335_C1,0,1,0,2,0,3
TCTGAACTCGTACCCG-1_V12D07-335_C1,0,0,0,0,0,0
AGGATATAGGGATTTA-1_V12D07-335_C1,0,1,1,0,0,2
GTGATCACTAACGCCT-1_V12D07-335_C1,0,4,1,0,1,6
ACCGGGCCTTTGTTGA-1_V12D07-335_C1,0,4,0,0,1,5
TTGACAGGAGCTCCCG-1_V12D07-335_C1,0,0,0,0,0,0
CTCTTCTATTGACTGG-1_V12D07-335_C1,0,1,0,0,1,2
CGTGGCCGAATATCTA-1_V12D07-335_C1,1,1,0,0,0,2
GGTTTAGCCTTTCTTG-1_V12D07-335_C1,0,0,1,0,0,1
TCAAGGTTACTACACC-1_V12D07-335_C1,0,1,0,0,1,2
TTGACTATTGTCCGGC-1_V12D07-335_C1,1,3,1,1,0,6
CGGGAATATAGTATAC-1_V12D07-335_C1,0,0,0,0,0,0
GCAACAGCAGTATGCG-1_V12D07-335_C1,0,0,0,0,0,0
ATCAAACACTGTTCCA-1_V12D07-335_C1,1,0,0,0,0,1
TGGGCAATAGTTGGGT-1_V12D07-335_C1,0,0,0,0,0,0
TGAATGTCAGCCGGCC-1_V12D07-335_C1,3,3,0,0,0,6
CGGCTCTAAAGCTGCA-1_V12D07-335_C1,0,1,0,0,0,1
GGACACAAGTTTACAC-1_V12D07-335_C1,2,1,0,1,0,4
CCGAGAAGTCGCATAA-1_V12D07-335_C1,0,2,0,1,1,4
AACTACCCGTTTGTCA-1_V12D07-335_C1,0,0,0,0,0,0
GCACAAACGAGGCGTG-1_V12D07-335_C1,2,4,0,1,0,7
CACACAGCTTGCGCTC-1_V12D07-335_C1,1,1,0,1,0,3
GTGCTTACATCAGCGC-1_V12D07-335_C1,0,3,0,0,0,3
GCAAACGTCGCCAGGT-1_V12D07-335_C1,0,0,1,0,0,1
GAATAGCATTTAGGGT-1_V12D07-335_C1,1,3,1,0,0,5
TACTGTTTCTCTGGTA-1_V12D07-335_C1,0,1,0,0,0,1
TCCTATCATAGGTAAC-1_V12D07-335_C1,1,2,0,0,1,4
TTCGGTGGAGACGCCC-1_V12D07-335_C1,0,1,1,2,0,4
TGTTGCCGTCGTCCCA-1_V12D07-335_C1,1,1,0,0,0,2
CCAACTTGATAGATCC-1_V12D07-335_C1,0,0,0,0,0,0
CAAAGGTCATCTGAAA-1_V12D07-335_C1,0,1,0,0,0,1
CTAGCTTAATGGTCCC-1_V12D07-335_C1,0,2,0,0,0,2
AGGCCACATTGGTTAC-1_V12D07-335_C1,0,4,0,0,0,4
TTAGGATGGGAGGGTA-1_V12D07-335_C1,0,1,0,0,0,1
TATGACCTTGCGCTGG-1_V12D07-335_C1,1,4,0,0,0,5
ATATACATGTATGGTA-1_V12D07-335_C1,0,0,0,0,0,0
TGTGTGACCATGAATC-1_V12D07-335_C1,2,0,0,0,1,3
CCCACTCCACGGTATC-1_V12D07-335_C1,1,0,1,0,0,2
GGGCAGACGTCACTGC-1_V12D07-335_C1,0,1,2,0,1,4
TCAAAGAGCTATCTGT-1_V12D07-335_C1,0,2,0,0,0,2
AGATGCATCCTGTGTC-1_V12D07-335_C1,2,2,0,1,0,5
GTGAAGTCACGACTCG-1_V12D07-335_C1,1,6,0,0,0,7
TGATTCAGGTCCCGCG-1_V12D07-335_C1,0,4,0,1,0,5
CGCCACAGGTCGCGAT-1_V12D07-335_C1,0,1,0,0,0,1
TTGAATCGTTGTATAA-1_V12D07-335_C1,0,1,0,1,1,3
TGGCCAATTTGGTACT-1_V12D07-335_C1,0,4,0,1,0,5
CGACCCTTAACGCCGG-1_V12D07-335_C1,1,0,0,0,0,1
TCGGCGTACTGCACAA-1_V12D07-335_C1,1,0,0,0,0,1
GAGTAAGGCCACGGGA-1_V12D07-335_C1,0,0,0,0,0,0
ATCAGCTCGTCCACTA-1_V12D07-335_C1,3,1,0,0,0,4
AGGATCACGCGATCTG-1_V12D07-335_C1,2,2,0,1,0,5
AAATGGCCCGTGCCCT-1_V12D07-335_C1,1,2,0,0,0,3
CAGTACCAGTTTACGT-1_V12D07-335_C1,1,1,0,0,0,2
GGTCGTAAGCTCGCAC-1_V12D07-335_C1,0,0,0,0,0,0
CGTTCATGGTGCGCGT-1_V12D07-335_C1,0,2,0,1,0,3
GACTACAAAGCGGTGG-1_V12D07-335_C1,1,0,1,0,0,2
CAGCTGGCGTAACCGT-1_V12D07-335_C1,1,3,0,0,0,4
ACTCGTAACCCGTCCT-1_V12D07-335_C1,1,2,0,0,0,3
CATATGTCAGGCTACG-1_V12D07-335_C1,1,0,0,0,0,1
GCCCGACTTCTTCCCG-1_V12D07-335_C1,2,2,1,0,0,5
CTGGCATCCGAATGAG-1_V12D07-335_C1,0,1,2,0,0,3
AAGTGCGTTAGAATCT-1_V12D07-335_C1,2,0,0,0,0,2
AGAAGTGATTCGTGAT-1_V12D07-335_C1,1,2,0,0,0,3
TACCTTAAGATTTCCC-1_V12D07-335_C1,1,2,0,1,0,4
AATGACAGCAATGTCT-1_V12D07-335_C1,2,0,0,0,0,2
TCAACGCAGGAAATAA-1_V12D07-335_C1,1,1,0,0,0,2
TATTCCTCCGCCCACT-1_V12D07-335_C1,2,0,0,0,0,2
ATCAAACGAAGGTTTG-1_V12D07-335_C1,0,1,1,0,0,2
TTGATTAGCTGTTTCT-1_V12D07-335_C1,3,4,1,0,0,8
CTGCTGAGGCCACGAA-1_V12D07-335_C1,0,1,0,0,0,1
CCGTGTTAAATTCCAT-1_V12D07-335_C1,0,0,0,0,0,0
CACGTCGGCAACCTCT-1_V12D07-335_C1,3,1,0,2,0,6
GTATTCTGAGAAACGA-1_V12D07-335_C1,1,1,0,0,0,2
CGGTGCGCGTTGGTCC-1_V12D07-335_C1,1,2,0,0,0,3
GTGATTCGCCGCTCAA-1_V12D07-335_C1,1,1,0,1,0,3
GCCCGCGCGTAAACGG-1_V12D07-335_C1,0,2,0,0,1,3
AACGTACTGTGGGTAC-1_V12D07-335_C1,1,3,0,0,0,4
GAGTATGCCCGCCTTG-1_V12D07-335_C1,0,0,0,0,0,0
TGATTCTGTCGCCGGT-1_V12D07-335_C1,0,5,1,0,0,6
GGGCGGCAAATGAATT-1_V12D07-335_C1,3,2,0,0,0,5
TTCCAATCTGGCTATC-1_V12D07-335_C1,0,1,1,0,0,2
GGAACCGTGTAAATTG-1_V12D07-335_C1,1,5,0,0,0,6
TTGGTCACACTCGTAA-1_V12D07-335_C1,1,3,0,0,1,5
CGAACCCGCATGCGTC-1_V12D07-335_C1,0,1,0,0,0,1
GGGCGTCACCACGTAA-1_V12D07-335_C1,1,1,0,0,0,2
TACCAGAAGTAGGTTC-1_V12D07-335_C1,1,2,1,0,0,4
TTGGATATCGTCTACG-1_V12D07-335_C1,2,2,0,0,0,4
TAGATATGGACTGGAA-1_V12D07-335_C1,1,0,0,0,1,2
GCGACGATAGTTGTAC-1_V12D07-335_C1,0,2,0,1,0,3
CTGGATTTACACTTGA-1_V12D07-335_C1,0,0,0,1,1,2
GTTATATTATCTCCCT-1_V12D07-335_C1,0,1,0,2,0,3
TATTCCACTCAGCTCG-1_V12D07-335_C1,2,3,0,0,1,6
CTGTTACCCAATCTAG-1_V12D07-335_C1,2,0,0,0,1,3
ACGCGAAGTCAGACGA-1_V12D07-335_C1,0,3,0,1,0,4
GATAGGTAACGTTGAC-1_V12D07-335_C1,1,7,0,0,1,9
TGTTCGTATTGCGGTG-1_V12D07-335_C1,0,4,1,0,1,6
GGTCAGTGGGTCCCAC-1_V12D07-335_C1,0,0,0,0,1,1
AATTCTAGAGTTAGGC-1_V12D07-335_C1,1,4,0,0,0,5
GTTTACGTTCCATCTG-1_V12D07-335_C1,0,2,0,0,1,3
AGACCCACCGCTGATC-1_V12D07-335_C1,2,3,0,1,0,6
TCTAGCATGCCCAGAA-1_V12D07-335_C1,0,2,0,1,0,3
CCCGCAGCGCGAACTA-1_V12D07-335_C1,1,3,0,0,0,4
CTCTATTTGGCTGCAG-1_V12D07-335_C1,0,2,0,0,0,2
TTCTGCCGCGCCTAGA-1_V12D07-335_C1,0,0,0,0,0,0
ACTCCCTAGAATAGTA-1_V12D07-335_C1,0,0,0,2,0,2
CCGAACCTTCCCGGCC-1_V12D07-335_C1,0,5,0,0,2,7
TCAGACGCTATAGAAG-1_V12D07-335_C1,0,0,0,0,2,2
CAGGCGCCATGCTAGG-1_V12D07-335_C1,1,1,0,0,0,2
CACTCGAGCTGAACAA-1_V12D07-335_C1,0,0,0,0,1,1
ACAAGGAAATCCGCCC-1_V12D07-335_C1,0,2,0,1,5,8
ACCACGTGCAGCTATA-1_V12D07-335_C1,0,0,0,0,0,0
ACGGCGACGATGGGAA-1_V12D07-335_C1,0,4,0,0,3,7
TTACTAAAGGACTTTA-1_V12D07-335_C1,0,0,0,0,0,0
GGCTGAAATAGCAAAG-1_V12D07-335_C1,0,0,0,0,1,1
TTAGACGAGTCACCTC-1_V12D07-335_C1,0,0,0,0,1,1
GTAGTCGCGGGAATCA-1_V12D07-335_C1,0,4,0,0,0,4
GCAAACCCTACATTAT-1_V12D07-335_C1,0,1,0,0,1,2
GTTAAAGTAGGACTGG-1_V12D07-335_C1,0,0,0,0,0,0
ACCCTCCCTTGCTATT-1_V12D07-335_C1,0,0,0,0,5,5
CATGTCTCATTTATGG-1_V12D07-335_C1,0,4,0,2,1,7
AATAGAATCTGTTTCA-1_V12D07-335_C1,0,0,0,0,0,0
TCTCATGAGATAGGGT-1_V12D07-335_C1,0,0,1,1,1,3
ATGACTATGCGACATT-1_V12D07-335_C1,0,0,0,0,0,0
CCTAACCCAAACAAGT-1_V12D07-335_C1,0,0,0,0,0,0
AGTCAAGATGACACTT-1_V12D07-335_C1,0,0,0,0,0,0
CGGGAGCTTCAGTGTA-1_V12D07-335_C1,0,1,0,1,0,2
CCACAGTACCCATCCT-1_V12D07-335_C1,0,1,0,1,0,2
GAGCGCGCACGAGTAG-1_V12D07-335_C1,0,2,0,1,0,3
ACCAGTGCGGGAGACG-1_V12D07-335_C1,1,1,0,0,0,2
TCCTTACGACGGTCCG-1_V12D07-335_C1,2,2,0,1,0,5
TAGTCGATCACGGGTT-1_V12D07-335_C1,1,1,0,0,0,2
AGACGAAGTGCCGGTC-1_V12D07-335_C1,0,0,0,0,0,0
CGCTGGTGACTACCCT-1_V12D07-335_C1,0,0,0,0,1,1
AGGCATTGTCGTAGGG-1_V12D07-335_C1,1,1,1,0,0,3
TGGTAGAATATATGGG-1_V12D07-335_C1,1,0,0,0,0,1
TTCTTATCCGCTGGGT-1_V12D07-335_C1,0,0,0,1,0,1
AGTTTGGCACGGGTTG-1_V12D07-335_C1,0,4,0,0,0,4
GCATCGGCCGTGTAGG-1_V12D07-335_C1,0,1,0,0,0,1
ATGCGAGTCCCACCAC-1_V12D07-335_C1,1,5,1,2,0,9
TCGGCGAACCCAAACC-1_V12D07-335_C1,0,0,0,1,0,1
AGAGTAAACTTCACTA-1_V12D07-335_C1,1,1,0,0,1,3
AAGCCGAAGCGGTTTA-1_V12D07-335_C1,0,0,0,0,0,0
CCCGAGTTTCTCCGTA-1_V12D07-335_C1,1,1,0,0,0,2
AATATCGAATCAATGC-1_V12D07-335_C1,0,0,0,0,0,0
GCGCCTCCCACTCCGA-1_V12D07-335_C1,1,4,1,1,0,7
CGTTAAACTAGTTAGG-1_V12D07-335_C1,2,0,0,0,0,2
TGAGTTAAAGACATTC-1_V12D07-335_C1,0,0,0,1,0,1
AACAGGTAGTATGGAT-1_V12D07-335_C1,1,2,0,0,0,3
GAACGCGGGTCACACG-1_V12D07-335_C1,0,2,0,0,0,2
TGTTTGAGATCGTCAG-1_V12D07-335_C1,2,0,0,0,0,2
ATCTCGTGAGCGAAAC-1_V12D07-335_C1,0,0,0,0,0,0
CTGAGAAAGTTCGGCG-1_V12D07-335_C1,0,1,0,0,0,1
ATTACCACACTGCCTG-1_V12D07-335_C1,3,0,0,1,0,4
CTGCTGTCTAACGAGC-1_V12D07-335_C1,1,0,0,0,0,1
CGTGGAAGCCTCGTAC-1_V12D07-335_C1,0,0,0,0,0,0
GGACTCACAAATTAGG-1_V12D07-335_C1,2,3,0,0,0,5
CTTTGCTGTCATGGAT-1_V12D07-335_C1,0,0,0,0,0,0
GGTGTTGGGCGTCTTA-1_V12D07-335_C1,0,0,0,0,0,0
TACCATGTATTGATTT-1_V12D07-335_C1,0,1,0,1,0,2
GGTCTCCAAGTAGTGC-1_V12D07-335_C1,1,1,0,0,0,2
ATCCTTCTGAAAGAAC-1_V12D07-335_C1,0,0,0,0,0,0
CCGGAAGTTATCAGTC-1_V12D07-335_C1,0,3,0,0,0,3
TTAGAGGGATATACAG-1_V12D07-335_C1,1,0,0,0,0,1
TTGTACACCTCGAACA-1_V12D07-335_C1,0,0,0,0,0,0
GTGGGTACTGAGCGTA-1_V12D07-335_C1,1,0,0,0,0,1
CTTAAGCAGCGAGCCG-1_V12D07-335_C1,0,3,0,0,0,3
GCATTGACTTGCGGAA-1_V12D07-335_C1,0,1,0,0,0,1
CCATAACCTGTGCAGT-1_V12D07-335_C1,1,0,0,1,0,2
GGGCTACTATTTCGTG-1_V12D07-335_C1,0,1,0,0,0,1
GGCGAGCGAAACGGCA-1_V12D07-335_C1,0,1,0,0,0,1
GGAGACCATCTACATA-1_V12D07-335_C1,1,1,0,1,0,3
AGACCAAACCACACCT-1_V12D07-335_C1,1,1,0,0,0,2
CGACGCATCCGTACCT-1_V12D07-335_C1,0,0,0,1,0,1
CCTAGGTAAAGGTAGC-1_V12D07-335_C1,0,1,0,0,0,1
AGCGGCGGTTAGCGGT-1_V12D07-335_C1,2,0,1,0,0,3
CTGGACGCAGTCCGGC-1_V12D07-335_C1,0,0,0,0,0,0
AGCCTAATACCCACGT-1_V12D07-335_C1,0,0,0,0,0,0
AATCTGGCTTTCTAGT-1_V12D07-335_C1,2,1,0,0,0,3
CACCCTTGGTGAGACC-1_V12D07-335_C1,0,0,0,0,0,0
GGATCTTGACTCAACC-1_V12D07-335_C1,1,0,0,0,0,1
ACGAGGATACCACTCT-1_V12D07-335_C1,0,4,0,1,0,5
GAGTTGATGGCAATTT-1_V12D07-335_C1,1,0,0,0,0,1
GTGGCAAACAGCGGCA-1_V12D07-335_C1,2,3,0,0,0,5
GATGTAACGAACCACC-1_V12D07-335_C1,2,4,0,0,0,6
AGCCGTGGCTAAATGT-1_V12D07-335_C1,0,2,0,1,0,3
CTCCCTCCTTTCGATC-1_V12D07-335_C1,0,0,0,0,0,0
TTGGAAGAATACAGTC-1_V12D07-335_C1,0,1,0,0,0,1
AGTTAAGTCAACCGCT-1_V12D07-335_C1,1,1,0,0,0,2
CTCATGGTAATTTGCG-1_V12D07-335_C1,0,0,0,0,0,0
AAAGTAGCATTGCTCA-1_V12D07-335_C1,2,3,0,0,0,5
TTGTGGTAGGAGGGAT-1_V12D07-335_C1,2,2,0,0,0,4
AGTCGTGGGCATTACG-1_V12D07-335_C1,1,1,0,0,0,2
ACCTAAGTACCTTTCA-1_V12D07-335_C1,0,2,0,0,0,2
GTAGAGGGAGACAAGT-1_V12D07-335_C1,5,0,0,0,0,5
GATCCTCGACACTGGC-1_V12D07-335_C1,0,1,0,0,0,1
CCTACATTCACAGACG-1_V12D07-335_C1,0,3,0,0,1,4
TTGACCGTGTTAATGA-1_V12D07-335_C1,1,0,0,0,0,1
TCTGTTACCCAGCATA-1_V12D07-335_C1,3,2,0,2,0,7
CTAACTGGTCCGGTTC-1_V12D07-335_C1,1,0,0,1,0,2
AGCGACAGGAACGGTC-1_V12D07-335_C1,0,2,0,0,0,2
TAATAGAACAGAGTTA-1_V12D07-335_C1,0,2,0,1,0,3
ACAGGTGGAGGTGAGG-1_V12D07-335_C1,0,1,0,1,0,2
TGCGAGAATATTACCC-1_V12D07-335_C1,0,0,0,0,0,0
TTGCGTCGGCCAACCG-1_V12D07-335_C1,0,2,0,0,0,2
AGGCTTCCCGAAGAAG-1_V12D07-335_C1,0,2,0,0,0,2
GCGGACCGCGTTGTGG-1_V12D07-335_C1,2,0,0,0,0,2
GTAATCTGATTCTTCG-1_V12D07-335_C1,1,0,1,0,0,2
CCGCGGAATGCGTCAC-1_V12D07-335_C1,2,3,0,0,0,5
TTCCACACAGATTTGA-1_V12D07-335_C1,0,3,0,1,0,4
CTTCTATTAATGCTAG-1_V12D07-335_C1,0,0,0,0,1,1
CATTTGAGTGGTACGT-1_V12D07-335_C1,0,2,0,2,0,4
TCACAGCAAACTCGAA-1_V12D07-335_C1,0,0,0,0,0,0
CAGACGAACCTGATAC-1_V12D07-335_C1,1,1,0,0,0,2
TAGCTAGAAGGCATGA-1_V12D07-335_C1,1,2,0,1,0,4
ATCCAGAGCAACAACC-1_V12D07-335_C1,1,1,0,0,0,2
TCCGGTTCGTCCGGTC-1_V12D07-335_C1,0,0,0,0,0,0
CGCGCATGTTTGATTG-1_V12D07-335_C1,0,2,0,0,1,3
TGGCGATCAAGTTATG-1_V12D07-335_C1,0,3,0,2,0,5
CCCTTTGACAGGTCTT-1_V12D07-335_C1,1,5,1,0,0,7
CAGAGACGGTCACCCA-1_V12D07-335_C1,0,1,0,0,0,1
TAGCTCGCCTGATAAC-1_V12D07-335_C1,0,1,0,0,0,1
TTGTGTTTCCCGAAAG-1_V12D07-335_C1,1,1,0,0,0,2
TATACACAGACGCCTT-1_V12D07-335_C1,0,4,0,0,0,4
ACATTAGTTTATATCC-1_V12D07-335_C1,1,3,0,0,0,4
CCATCGCAGTTAAACT-1_V12D07-335_C1,0,0,0,0,1,1
AATTAGCGCTGCAGCG-1_V12D07-335_C1,0,0,0,1,1,2
TCCGCTTATCCCATTA-1_V12D07-335_C1,0,2,1,3,0,6
GTTTGGGCTTGTGAGC-1_V12D07-335_C1,1,1,0,0,1,3
CTTGTCAACATTCGAG-1_V12D07-335_C1,0,2,0,0,1,3
GGACCAACAGGATAAC-1_V12D07-335_C1,2,1,0,0,0,3
AAGCTAGATCGAGTAA-1_V12D07-335_C1,1,5,1,0,0,7
TACCGTGCCTCGGACC-1_V12D07-335_C1,0,4,0,0,0,4
GTAGCCAAACATGGGA-1_V12D07-335_C1,0,2,0,1,1,4
TGCCAGTACGTGGAGA-1_V12D07-335_C1,0,2,0,0,1,3
ATAAGGTGGAGAACAT-1_V12D07-335_C1,0,1,0,0,5,6
CTTTAATATTGGTCGA-1_V12D07-335_C1,0,1,1,0,1,3
TGGTTCAACGGGTAAT-1_V12D07-335_C1,1,0,0,0,1,2
GCTGCTACTGCGTAGC-1_V12D07-335_C1,0,3,0,0,1,4
CTGCACAACTACATAT-1_V12D07-335_C1,0,4,0,0,0,4
ATATTCCACATAGTGA-1_V12D07-335_C1,0,1,0,2,1,4
TGGCAAACTAAATTAC-1_V12D07-335_C1,0,1,0,1,0,2
ACCGCAATAACTGCCT-1_V12D07-335_C1,0,1,0,0,1,2
TCGCACCAGGAGGCAG-1_V12D07-335_C1,0,1,0,0,1,2
ACTTCAGGCTGATCCC-1_V12D07-335_C1,0,0,0,0,0,0
ACAAATCGCACCGAAT-1_V12D07-335_C1,0,6,0,0,0,6
TCTGATGTATTCTGTC-1_V12D07-335_C1,0,0,0,0,2,2
CTTTACCGAATAGTAG-1_V12D07-335_C1,0,1,0,0,0,1
GCAGATCCATAAGACT-1_V12D07-335_C1,0,0,0,1,0,1
TTCCTCGGACTAACCA-1_V12D07-335_C1,0,0,0,0,2,2
TTATCCGGGATCTATA-1_V12D07-335_C1,0,0,0,0,1,1
CTGGAAGACACGGTGG-1_V12D07-335_C1,0,0,0,0,0,0
GTTCGTCTAAAGAACT-1_V12D07-335_C1,0,0,0,0,0,0
GTCTATTGGTTCCGGT-1_V12D07-335_C1,0,3,0,0,1,4
CTAGGCGCCCTATCAG-1_V12D07-335_C1,0,0,0,0,0,0
AACGGACGTACGTATA-1_V12D07-335_C1,0,0,0,0,0,0
AACACACGCTCGCCGC-1_V12D07-335_C1,1,0,0,0,0,1
GCTACTATAGTAGAGT-1_V12D07-335_C1,0,0,0,0,0,0
AGCATATCAATATGCT-1_V12D07-335_C1,1,0,0,1,0,2
CGAACAGTATGGGCGT-1_V12D07-335_C1,0,0,0,0,0,0
ACAATTGTGTCTCTTT-1_V12D07-335_C1,1,1,0,1,0,3
GATCGCTACCCGATTT-1_V12D07-335_C1,0,0,0,0,0,0
ATTGCGATCAGTAACT-1_V12D07-335_C1,0,0,0,0,0,0
CAGCAGTCCAGACTAT-1_V12D07-335_C1,0,2,0,0,0,2
AGAGGCTTCGGAAACC-1_V12D07-335_C1,0,0,0,0,0,0
AAACAAGTATCTCCCA-1_V12D07-335_C1,0,1,0,0,0,1
GGCAGCAAACCTATGC-1_V12D07-335_C1,2,0,0,0,0,2
ACTAGTTGCGATCGTC-1_V12D07-335_C1,0,0,1,0,0,1
TTGGACCATCTGGCAA-1_V12D07-335_C1,0,0,0,0,0,0
CCCTCCTCGCTCGTAT-1_V12D07-335_C1,0,1,0,1,0,2
GAGCGCAAATACTCCG-1_V12D07-335_C1,1,1,0,1,0,3
ATTACATGTCAGTCTT-1_V12D07-335_C1,2,0,0,0,0,2
TTGGGACGTAAGAGTT-1_V12D07-335_C1,1,1,0,0,0,2
CTTCGGCCAATTGTTT-1_V12D07-335_C1,1,4,0,0,0,5
AGACCGCTCCGCGGTT-1_V12D07-335_C1,0,1,0,0,0,1
GACCGCGTCTGACGTG-1_V12D07-335_C1,1,0,0,0,0,1
CCAAATAACAAGATTC-1_V12D07-335_C1,0,0,1,2,0,3
TCTTTAGAGTCTAACA-1_V12D07-335_C1,1,1,0,0,0,2
CTCCCAATGAGTCGCG-1_V12D07-335_C1,2,1,0,0,0,3
TAGTCTTTCCGAATTG-1_V12D07-335_C1,1,1,0,0,0,2
GAGTAAACCGGAAAGT-1_V12D07-335_C1,2,5,0,0,0,7
GATCTCGACGCTGTGG-1_V12D07-335_C1,0,0,0,0,0,0
CTGACATAGAAATAGA-1_V12D07-335_C1,0,2,0,1,0,3
TATACCGAGTGCCACA-1_V12D07-335_C1,3,0,0,0,0,3
TCCGAACGTTGCCGCT-1_V12D07-335_C1,3,0,0,2,0,5
GCAGAAGGTAATCTCC-1_V12D07-335_C1,1,0,0,0,0,1
GGTACTAAGTGCTTTG-1_V12D07-335_C1,1,1,0,1,0,3
CAGAATATTCGTTATC-1_V12D07-335_C1,1,0,0,0,0,1
TAATCAACCAAATGGG-1_V12D07-335_C1,0,1,0,0,0,1
TCTGCTTAGAACAAGC-1_V12D07-335_C1,1,1,0,0,0,2
AACTGAGTTATACTGA-1_V12D07-335_C1,0,1,1,0,0,2
CCTCAACGATCGCTGT-1_V12D07-335_C1,0,2,0,0,0,2
CGGTACGGCAAACCCA-1_V12D07-335_C1,0,1,0,0,1,2
CAGATGTTTGTCCCAA-1_V12D07-335_C1,1,2,0,1,0,4
GTTTGTTAGCCAAGTA-1_V12D07-335_C1,3,2,0,0,0,5
ACGTGACAAAGTAAGT-1_V12D07-335_C1,0,1,0,0,0,1
TTGTCACCGCGGTATC-1_V12D07-335_C1,0,1,0,0,0,1
GATCTAACCGTATTCA-1_V12D07-335_C1,0,0,0,0,0,0
ATGGAAATTTAAGGAG-1_V12D07-335_C1,0,0,0,0,0,0
ATTGATCACCACATTT-1_V12D07-335_C1,0,0,0,0,1,1
ACTGCTCGGAAGGATG-1_V12D07-335_C1,1,3,0,0,0,4
TCTAAAGAACAGTCTC-1_V12D07-335_C1,0,0,0,0,0,0
CTGGGTTGAGTTAAAG-1_V12D07-335_C1,0,0,0,0,0,0
CCCAGTAAACTTGGGA-1_V12D07-335_C1,1,0,0,0,0,1
AGATTCACAACCGATA-1_V12D07-335_C1,5,3,0,1,0,9
AGAAGGTACACTTCAC-1_V12D07-335_C1,0,0,0,2,0,2
GCAGGAACTTAGATCT-1_V12D07-335_C1,0,1,1,0,0,2
AATCTAGGTTTACTTG-1_V12D07-335_C1,0,0,0,0,0,0
CCCGGTGTATCGGAAT-1_V12D07-335_C1,1,1,0,0,0,2
TTATCCTCAAGGAATA-1_V12D07-335_C1,0,0,0,0,0,0
AGCATCATTTCGAAAG-1_V12D07-335_C1,0,0,0,0,0,0
CGCGAGTCTGCCGGGT-1_V12D07-335_C1,0,0,0,0,0,0
TGCGTCATGACTGAGC-1_V12D07-335_C1,0,1,0,1,0,2
GTATGAAATTTCACTC-1_V12D07-335_C1,1,1,0,0,0,2
TTGGTTGCGGTGCGCG-1_V12D07-335_C1,0,1,0,0,0,1
ACAGAACTGAGAACAA-1_V12D07-335_C1,2,0,0,0,0,2
CTACTATCATAGGTTT-1_V12D07-335_C1,1,0,0,0,0,1
CCTCTATCGATTAGCA-1_V12D07-335_C1,0,3,0,1,0,4
CCGTATCTCGTCGTAG-1_V12D07-335_C1,0,2,0,0,0,2
TCACGATGTCCGTGGA-1_V12D07-335_C1,0,1,0,0,0,1
TCAACAAAGATAATTC-1_V12D07-335_C1,0,0,0,1,0,1
ATGACGCGTTCTATCC-1_V12D07-335_C1,0,3,0,0,0,3
ATTTGCGCGAGTAGCT-1_V12D07-335_C1,3,2,0,0,1,6
TTCTTGGACGATCTGC-1_V12D07-335_C1,1,3,0,1,1,6
AGACGACGATGCCGCT-1_V12D07-335_C1,0,2,0,0,1,3
GGTCTCTGAATGGACT-1_V12D07-335_C1,2,0,0,0,0,2
GCTCAATCCGTTTATT-1_V12D07-335_C1,2,3,0,2,0,7
CCAGAAAGCAACTCAT-1_V12D07-335_C1,0,2,2,0,0,4
CACCGTTAGGGATCAC-1_V12D07-335_C1,2,2,1,1,0,6
AATAACACTAGAACAA-1_V12D07-335_C1,0,0,0,0,0,0
CACCCGGTTTGTGACT-1_V12D07-335_C1,1,1,0,0,0,2
CCACCAACTTTACTGT-1_V12D07-335_C1,0,0,0,0,0,0
AACTCTCAGTGTGCTC-1_V12D07-335_C1,1,6,2,0,0,9
AAACCGTTCGTCCAGG-1_V12D07-335_C1,0,4,0,0,0,4
CAGCGATTCCCTTCAA-1_V12D07-335_C1,0,4,0,0,0,4
GCTAGCTTGAATAGCT-1_V12D07-335_C1,0,3,0,0,1,4
TTGCGGCATCAGAAAG-1_V12D07-335_C1,2,5,0,0,0,7
AATAGAACAGAGTGGC-1_V12D07-335_C1,1,1,0,0,0,2
GCCATCGAGCTGCGTG-1_V12D07-335_C1,0,0,0,0,0,0
ACACTGATCAAGGTGT-1_V12D07-335_C1,1,0,0,0,0,1
ACCAACGCTTATTTAT-1_V12D07-335_C1,0,1,0,0,0,1
GACATCGATTTATAAC-1_V12D07-335_C1,1,0,1,0,0,2
CAGACACCGATCGCTG-1_V12D07-335_C1,0,0,0,0,0,0
CCAAGAAAGTGGGCGA-1_V12D07-335_C1,0,0,1,0,0,1
GGTAGACCGTTGGGCG-1_V12D07-335_C1,0,0,0,0,0,0
TCGTTAGGAGTCCCTA-1_V12D07-335_C1,2,0,0,0,0,2
ACGGCCAACATGGACT-1_V12D07-335_C1,3,1,0,0,1,5
GTGAGTGGTACAACGC-1_V12D07-335_C1,1,0,0,0,0,1
GAGACTTCGCGACCGA-1_V12D07-335_C1,0,2,0,0,0,2
GAAGTCAGTTGCACTA-1_V12D07-335_C1,0,2,0,1,0,3
GTTTGGTAGGGTCAAC-1_V12D07-335_C1,1,0,0,0,0,1
ACGGCACTTGCTTGGG-1_V12D07-335_C1,1,6,1,1,2,11
CCTCTGTACTATTCTA-1_V12D07-335_C1,2,2,0,1,0,5
CTATTCATGTGTCCCA-1_V12D07-335_C1,2,0,0,0,0,2
GCCCGATCTGTGGTCG-1_V12D07-335_C1,1,1,0,1,0,3
TTAGAAGAACATGACT-1_V12D07-335_C1,2,0,0,1,1,4
AGGATAAAGTCGGGAT-1_V12D07-335_C1,0,1,0,0,0,1
CGGCAAACATCGTGCG-1_V12D07-335_C1,2,0,0,0,0,2
CTAGTTACAACCCGGT-1_V12D07-335_C1,2,1,0,0,0,3
TTCGACAGAGCCCGTG-1_V12D07-335_C1,1,1,0,1,1,4
AAGCATACTCTCCTGA-1_V12D07-335_C1,0,1,0,1,4,6
GACGACGATCCGCGTT-1_V12D07-335_C1,0,1,0,0,0,1
GGTAGAAGACCGCCTG-1_V12D07-335_C1,0,4,2,2,2,10
GAGATGGGAGTCGACA-1_V12D07-335_C1,0,2,0,0,0,2
AACGATAATGCCGTAG-1_V12D07-335_C1,0,1,0,0,2,3
TGGTCCCACGCTACGG-1_V12D07-335_C1,0,2,0,0,1,3
CTGCTTGGCGATAGCT-1_V12D07-335_C1,0,0,0,0,3,3
ATCGGAGACAGACGGC-1_V12D07-335_C1,0,0,0,1,0,1
TAGCGTCCGGTGTGGT-1_V12D07-335_C1,0,0,0,0,0,0
GTTGAGTCCCGCCGGT-1_V12D07-335_C1,0,0,0,0,1,1
AAATAGGGTGCTATTG-1_V12D07-335_C1,0,0,0,1,3,4
AAGTGTTTGGAGACGG-1_V12D07-335_C1,0,0,0,0,2,2
AGCACTACCTCACCAG-1_V12D07-335_C1,0,1,0,0,2,3
TGCCTTGGCCAGGCAA-1_V12D07-335_C1,0,2,0,0,4,6
TCGTCTTAGGCGTTAA-1_V12D07-335_C1,0,1,0,1,1,3
TTCTGACCGGGCTCAA-1_V12D07-335_C1,0,1,0,1,1,3
CAGAACTTAGCCCTCT-1_V12D07-335_C1,0,0,0,1,2,3
AGCTCCTTCGCACATC-1_V12D07-335_C1,0,1,0,0,0,1
ACAGGCTTGCCCGACT-1_V12D07-335_C1,1,1,0,0,0,2
GCTATACGTCTCGGAC-1_V12D07-335_C1,1,3,1,0,0,5
GAGCCAGCTACCTGTG-1_V12D07-335_C1,0,0,0,0,0,0
TGCTAAGTGTCTATTT-1_V12D07-335_C1,0,2,0,0,0,2
GTCCTACGAATAGTCT-1_V12D07-335_C1,1,0,0,0,0,1
CAGTGTCGGCTGGCCC-1_V12D07-335_C1,2,0,0,0,0,2
CTATCGACGAAATACA-1_V12D07-335_C1,1,1,0,0,0,2
CATCATTACCCTGAGG-1_V12D07-335_C1,0,1,1,1,0,3
TAAGTTGCGACGTAGG-1_V12D07-335_C1,1,3,0,0,0,4
AGTGCACGCTTAAGAA-1_V12D07-335_C1,1,2,0,0,0,3
TGTGCCGGTGCCGGAA-1_V12D07-335_C1,0,0,0,0,0,0
AGGAGGCCTTCGCGCG-1_V12D07-335_C1,2,3,0,0,0,5
TCCGCGGCCCAATGAA-1_V12D07-335_C1,0,0,0,1,0,1
TCCGTTAAGCTAATAT-1_V12D07-335_C1,1,3,0,1,0,5
AAATCTAGCCCTGCTA-1_V12D07-335_C1,2,2,0,0,0,4
CGCAGGCGATCCAAAC-1_V12D07-335_C1,0,0,0,0,0,0
CCATATGGAAACTATA-1_V12D07-335_C1,1,0,0,0,0,1
CACCGTATCCCATCCG-1_V12D07-335_C1,1,0,0,0,0,1
GGTCAAGACTACTTCG-1_V12D07-335_C1,0,0,0,0,0,0
CCCGTTTCGCAGATGT-1_V12D07-335_C1,1,1,0,0,0,2
GTTATAATACGGTGAA-1_V12D07-335_C1,1,0,0,0,0,1
ACTTGTGGATGGAACG-1_V12D07-335_C1,1,0,0,0,1,2
GTTCGCTGAGACGTCT-1_V12D07-335_C1,0,0,0,0,0,0
GACACTGGAACCCGAT-1_V12D07-335_C1,1,1,0,4,0,6
CCCAGGTCTGAAGGCT-1_V12D07-335_C1,0,0,0,0,0,0
TCTCGAGGAGGTTCGC-1_V12D07-335_C1,0,1,0,0,0,1
ACTATCTGCCCGCGTA-1_V12D07-335_C1,1,2,0,1,0,4
CCTAAATTGTATCCTA-1_V12D07-335_C1,1,0,0,0,0,1
AGAAATTATGACTCGC-1_V12D07-335_C1,1,0,0,1,0,2
TCCAGCGCTATAAGCG-1_V12D07-335_C1,0,0,1,0,0,1
TCGTGTATTGGTCACG-1_V12D07-335_C1,0,0,0,0,0,0
CCACATACTGCACCCA-1_V12D07-335_C1,0,3,0,1,0,4
GTTGCGGACGGTCAGG-1_V12D07-335_C1,1,1,0,0,0,2
GTATTTAATGGCATAA-1_V12D07-335_C1,0,0,0,0,0,0
GTCGATAGGTGACTTT-1_V12D07-335_C1,0,1,0,0,0,1
AATAATCTTCGTATCG-1_V12D07-335_C1,1,1,0,0,0,2
ATTGTTCAACGATCCG-1_V12D07-335_C1,0,0,0,0,0,0
GTGCAGCGTAGAGTAG-1_V12D07-335_C1,0,1,1,0,0,2
TGTGGTAGGGTGCCTT-1_V12D07-335_C1,2,0,0,0,0,2
TGTGGACTATCTACGT-1_V12D07-335_C1,1,1,0,1,0,3
GGCGGGCTCTAAGAGT-1_V12D07-335_C1,2,2,0,0,0,4
TGTGCCAGAGGCAAAG-1_V12D07-335_C1,0,0,0,0,0,0
TGGCTTATGTATAATG-1_V12D07-335_C1,1,1,0,0,0,2
GCAAGCTGGAAACCGC-1_V12D07-335_C1,1,3,0,0,0,4
GATATCAAGCAGGAGC-1_V12D07-335_C1,0,1,0,0,0,1
CACCAATCATCCGTCT-1_V12D07-335_C1,0,2,0,0,1,3
CCACATGGCTCTTTAT-1_V12D07-335_C1,0,0,1,0,0,1
GTCCTACTCTACGGGC-1_V12D07-335_C1,1,1,0,0,0,2
CTCGAGACATACGATA-1_V12D07-335_C1,1,0,0,0,0,1
TATCAGTGGCGTAGTC-1_V12D07-335_C1,0,0,0,0,0,0
TGACAGGACAAGTCCA-1_V12D07-335_C1,2,1,0,1,0,4
TATTAACACCAAAGCA-1_V12D07-335_C1,0,1,0,1,0,2
TAGGCGATGAGGTCTC-1_V12D07-335_C1,2,1,0,0,0,3
CCGCCGGAACTTCTCG-1_V12D07-335_C1,4,0,0,0,0,4
GCCATTAGCCTCAAAC-1_V12D07-335_C1,0,0,1,0,0,1
GTTAGGCTACCCGTTT-1_V12D07-335_C1,0,1,0,1,0,2
GGGTATTCTAGCAAAC-1_V12D07-335_C1,2,3,0,1,1,7
GCCCTAGCCGTCGCGA-1_V12D07-335_C1,0,0,0,0,0,0
CAGATCCTGGTTTGAA-1_V12D07-335_C1,0,1,0,0,3,4
CTTCAGTGGTCGCCTA-1_V12D07-335_C1,0,4,0,0,0,4
GGGCAACCGCACGTGC-1_V12D07-335_C1,0,1,0,0,0,1
GACCCAATTATGATAC-1_V12D07-335_C1,1,1,0,0,0,2
GAAGCTCGGACCCGTC-1_V12D07-335_C1,0,0,0,0,0,0
CGTCGGGTCTAAGCGC-1_V12D07-335_C1,2,1,0,0,0,3
GAGGCCCGACTCCGCA-1_V12D07-335_C1,1,3,0,0,0,4
TTGCCATAGCCCGCTC-1_V12D07-335_C1,1,0,0,0,0,1
TAACATACACGCGATC-1_V12D07-335_C1,1,2,0,0,0,3
CCGACGGGCATGAGGT-1_V12D07-335_C1,1,1,0,0,0,2
AATGTGCCCGAGGTGT-1_V12D07-335_C1,0,0,1,0,0,1
AGCTGTAACCTCAATC-1_V12D07-335_C1,0,0,0,0,0,0
CGAGTGAAGGTACCAG-1_V12D07-335_C1,2,0,0,0,0,2
AGTCTCACAAGACTAC-1_V12D07-335_C1,1,2,0,0,0,3
AAATTGATAGTCCTTT-1_V12D07-335_C1,1,0,0,1,0,2
TAAGTCGCCGAGTATC-1_V12D07-335_C1,2,1,0,0,0,3
GCGGAGAAACTTCGCA-1_V12D07-335_C1,1,1,0,0,0,2
GGCAAAGGCGCCAATA-1_V12D07-335_C1,0,5,0,0,0,5
ATTTCCGGGTTCTGCG-1_V12D07-335_C1,1,3,0,1,0,5
TAAACCCAGGAGGGCA-1_V12D07-335_C1,2,0,1,0,0,3
TTCGGGCGCTAGTCTT-1_V12D07-335_C1,1,1,0,1,0,3
GTGGAGTCGGCGGTTG-1_V12D07-335_C1,1,1,0,0,0,2
GCACGCCTACTTAGAT-1_V12D07-335_C1,3,1,0,0,0,4
CAATATTCTTGACCTA-1_V12D07-335_C1,1,0,0,0,1,2
CGTTTGTGTAGAGGGT-1_V12D07-335_C1,0,1,0,0,0,1
CATAGCGTTGCCCACC-1_V12D07-335_C1,1,2,1,1,1,6
TGATACATTTAGCCGT-1_V12D07-335_C1,1,3,0,0,0,4
TTCCGGCCTTGAGGCT-1_V12D07-335_C1,0,6,0,0,1,7
CCTATACCGTCCTGTC-1_V12D07-335_C1,0,3,0,0,0,3
TCGTTGCTATCCGGTC-1_V12D07-335_C1,1,0,0,0,1,2
TGGCGACTGCTCCAAA-1_V12D07-335_C1,1,0,2,1,0,4
CAGAGGCGATGCATGA-1_V12D07-335_C1,1,0,0,0,0,1
TCACAGGAGAATAAGA-1_V12D07-335_C1,0,0,1,0,1,2
GGGTTAACATTTGAGT-1_V12D07-335_C1,3,0,0,1,6,10
GCGGGCGAGCCTTACC-1_V12D07-335_C1,0,0,0,0,0,0
TGCCAATGGGTACTCT-1_V12D07-335_C1,0,1,0,1,0,2
AGGGACTCTACGCGAC-1_V12D07-335_C1,0,0,0,0,0,0
GACGCCGTAAAGGCTA-1_V12D07-335_C1,1,2,0,0,0,3
AAAGGCTCTCGCGCCG-1_V12D07-335_C1,0,1,0,0,0,1
CTGGCTGGTTGTCAGT-1_V12D07-335_C1,2,0,0,0,0,2
ACATCCCGGCCATACG-1_V12D07-335_C1,0,0,0,0,0,0
CTCTTGTCCCGCTTGG-1_V12D07-335_C1,0,0,0,0,0,0
TACGCCTCCATTCCGA-1_V12D07-335_C1,1,0,0,0,0,1
CGGAGCAATTTAATCG-1_V12D07-335_C1,0,0,0,0,0,0
AACTAGGCTTGGGTGT-1_V12D07-335_C1,0,2,0,0,1,3
GCGTCGCCAGGGTGAT-1_V12D07-335_C1,0,0,0,0,0,0
GTTGGTCATGCTATCC-1_V12D07-335_C1,0,1,0,0,0,1
GCTGGCGGCGCATGCT-1_V12D07-335_C1,0,1,0,1,4,6
TGAGCGGAAAGTGTTC-1_V12D07-335_C1,0,0,0,0,1,1
CTTTCTGTGCGGGCTT-1_V12D07-335_C1,0,0,0,0,0,0
ATCTAATATCCTACGG-1_V12D07-335_C1,0,2,1,0,0,3
AACCTTTAAATACGGT-1_V12D07-335_C1,0,4,0,1,2,7
TTCACTCGAGCACCTA-1_V12D07-335_C1,0,3,0,1,1,5
CTGCACTCCAGTACAG-1_V12D07-335_C1,0,1,0,1,0,2
CCATTTCTACCTATTA-1_V12D07-335_C1,0,2,0,0,2,4
CAAGCGGCACATAATT-1_V12D07-335_C1,0,1,1,1,1,4
GTTAACATCACTTAAA-1_V12D07-335_C1,0,0,0,1,1,2
ATATAAATGTAGCTGC-1_V12D07-335_C1,0,0,0,0,0,0
GCCTCTATACATAGCA-1_V12D07-335_C1,0,0,0,1,1,2
GTGTCGTATAGCGTTC-1_V12D07-335_C1,0,0,0,0,0,0
ATACGTACTTAGCCAC-1_V12D07-335_C1,0,0,0,0,2,2
GCTATCATACTCATGG-1_V12D07-335_C1,0,3,0,0,0,3
TATCCAATTGGTTATC-1_V12D07-335_C1,0,2,0,0,1,3
TCTCCCTGGGCAGCGT-1_V12D07-335_C1,0,0,0,0,1,1
CCTATAATGAGTGCCC-1_V12D07-335_C1,0,3,0,0,1,4
CAATGCGAGAAGTATC-1_V12D07-335_C1,0,0,0,1,0,1
TACCAATAAAGTACCA-1_V12D07-335_C1,1,3,0,1,0,5
GCTAGGCACCACGGAG-1_V12D07-335_C1,0,1,0,0,0,1
GGTGGACTGCTCTGGC-1_V12D07-335_C1,1,1,0,0,0,2
TATTCCGAGCTGTTAT-1_V12D07-335_C1,1,1,0,1,0,3
TTGAGAAGTTTAGCAT-1_V12D07-335_C1,0,4,1,0,0,5
GTCCGGACCTGAAATT-1_V12D07-335_C1,4,1,1,0,0,6
CTGTGGTCGGGAGATA-1_V12D07-335_C1,1,2,0,0,0,3
CATGTAAGAGACATTT-1_V12D07-335_C1,0,1,1,0,0,2
CACGTTTCGTACACAC-1_V12D07-335_C1,1,1,0,1,0,3
CATCCTCTCAAAGATC-1_V12D07-335_C1,2,1,0,0,0,3
GATTAACCGAAAGCCC-1_V12D07-335_C1,0,1,1,0,0,2
AACGCTGTTGCTGAAA-1_V12D07-335_C1,1,3,0,1,0,5
TTCAGCTGGCGTGCCC-1_V12D07-335_C1,0,0,0,0,0,0
TAGAGGTTCTACTTGT-1_V12D07-335_C1,0,0,0,0,0,0
GTATCAAACGTTAGCT-1_V12D07-335_C1,0,0,1,0,0,1
AATCATGTAAAGACTC-1_V12D07-335_C1,1,3,0,0,0,4
AGTCACTAGCTCTCGA-1_V12D07-335_C1,0,0,0,0,0,0
GCGAAACGATCGGGAG-1_V12D07-335_C1,1,1,0,0,0,2
CATGGATTGTCTTCCG-1_V12D07-335_C1,2,0,0,0,2,4
ATTGGATTACAGCGTA-1_V12D07-335_C1,0,2,0,0,0,2
CACACACGCTAACGAG-1_V12D07-335_C1,0,2,0,0,1,3
CTATGGGAAGCGGAAT-1_V12D07-335_C1,2,0,0,0,0,2
TGCCTAATTGAAGATT-1_V12D07-335_C1,0,0,0,1,0,1
TGGCAATGGGACGGCG-1_V12D07-335_C1,2,1,0,1,0,4
ACCTCCGCCCTCGCTG-1_V12D07-335_C1,2,1,0,0,0,3
CGGCAATAAGATCGCC-1_V12D07-335_C1,2,1,0,0,1,4
CCTTGACCACTTTATT-1_V12D07-335_C1,0,0,0,0,0,0
TCATTTAGAAGTGTGA-1_V12D07-335_C1,0,1,1,0,0,2
CAGAATAACACACGGA-1_V12D07-335_C1,2,2,0,1,0,5
TCTGAGCAATTGACTG-1_V12D07-335_C1,0,1,0,1,0,2
CAACGTGGTGGAGTCT-1_V12D07-335_C1,2,1,0,1,0,4
CACAGTTCGCTTCCCA-1_V12D07-335_C1,2,0,0,0,0,2
TCTCTCGCCGCACATA-1_V12D07-335_C1,0,1,1,0,0,2
TGGGCAGGCCACCGCA-1_V12D07-335_C1,1,0,0,0,0,1
CTCCTGTTCAAGGCAG-1_V12D07-335_C1,1,4,0,1,0,6
TATTTGATTTGCACAG-1_V12D07-335_C1,1,1,0,0,0,2
GCCACTCCTTACGGTA-1_V12D07-335_C1,3,0,1,0,0,4
ACCGATATTTAATCAT-1_V12D07-335_C1,2,1,0,0,1,4
TTATTATCTGGAAGGC-1_V12D07-335_C1,2,1,0,0,0,3
TACATGCCGGAATTGT-1_V12D07-335_C1,1,1,0,1,0,3
GGCACTCAGCCGACCC-1_V12D07-335_C1,3,1,0,0,0,4
AAACCGGAAATGTTAA-1_V12D07-335_C1,2,0,0,0,0,2
AGACAGGCATCTCAGC-1_V12D07-335_C1,1,1,0,0,0,2
GTGGTGATGGTTTGTG-1_V12D07-335_C1,1,0,0,0,0,1
CCGATATGACGTAAGG-1_V12D07-335_C1,2,1,0,0,0,3
CATACACAAAGTCAGC-1_V12D07-335_C1,0,1,0,0,2,3
TGCCGTTCTTAATCGG-1_V12D07-335_C1,0,1,0,0,0,1
TCGAGTCTACGATTCG-1_V12D07-335_C1,1,0,0,0,0,1
ACTTCCAGTGGAAGCT-1_V12D07-335_C1,1,1,0,0,0,2
CAATTGGGCCGCACTC-1_V12D07-335_C1,1,3,0,0,0,4
AAATCGCGGAAGGAGT-1_V12D07-335_C1,0,2,0,0,0,2
ATATCAATTCCAGCCT-1_V12D07-335_C1,0,0,0,0,0,0
CTTTGTCGAATGCTCC-1_V12D07-335_C1,1,2,0,0,0,3
TGAGGCATGTACTGTG-1_V12D07-335_C1,1,0,0,1,0,2
TTCGCCGCTCGCGCTA-1_V12D07-335_C1,0,2,0,0,0,2
GACTCCTTCCAATTGA-1_V12D07-335_C1,1,0,0,0,2,3
ACCGAAGAGTCTGGTT-1_V12D07-335_C1,3,0,0,0,0,3
TGGCATGAAGTTTGGG-1_V12D07-335_C1,0,1,0,0,0,1
ACGAGGTTTACAACGT-1_V12D07-335_C1,2,0,0,0,0,2
AACCCATCCCATGATC-1_V12D07-335_C1,1,1,0,0,0,2
TCGACAACTGAACCCG-1_V12D07-335_C1,2,0,2,0,0,4
TATCTTGCAATACAAC-1_V12D07-335_C1,0,1,0,1,0,2
TATTATGTTTGCCTGC-1_V12D07-335_C1,1,2,0,0,0,3
GTCAAAGAAGTGGTGT-1_V12D07-335_C1,0,0,0,1,0,1
GGGACAGAGTTACTCC-1_V12D07-335_C1,2,1,1,0,1,5
AGCAACCGAAAGTAAT-1_V12D07-335_C1,0,2,0,0,0,2
CTCTCTAACTGCCTAG-1_V12D07-335_C1,1,1,0,0,1,3
ATACGGAACGTCGTTT-1_V12D07-335_C1,0,0,0,0,0,0
TCGGTCCCGACAATAG-1_V12D07-335_C1,0,2,0,1,1,4
CGCGCAAATGTCCAGA-1_V12D07-335_C1,1,0,0,0,0,1
TCTAATACTGCCTCAG-1_V12D07-335_C1,0,1,0,0,0,1
CTCGGTTGTCGGCCCT-1_V12D07-335_C1,1,0,0,0,0,1
GGTAACCGGGAGGATA-1_V12D07-335_C1,0,0,0,0,0,0
CAGGCGCACGGTGGTC-1_V12D07-335_C1,0,1,0,0,0,1
TCATCGATGGTCCCAA-1_V12D07-335_C1,1,1,0,1,0,3
CAAAGATTATTGGGCC-1_V12D07-335_C1,3,3,0,0,0,6
ACAATGAATACGGAGA-1_V12D07-335_C1,1,1,0,0,0,2
GCTCCTGACATACTGG-1_V12D07-335_C1,0,0,0,0,0,0
GATGACAAGTAGGGCA-1_V12D07-335_C1,0,0,0,0,0,0
TACGCCGAGGGTACCC-1_V12D07-335_C1,0,0,1,0,0,1
AAGCGTCCCTCATCGA-1_V12D07-335_C1,0,0,0,0,0,0
CACTCCTATGTAAGAT-1_V12D07-335_C1,0,0,0,0,0,0
TCGAGCCAGGCAGGCC-1_V12D07-335_C1,1,1,0,0,0,2
TCGTCAAGTACGCGCA-1_V12D07-335_C1,0,3,0,0,0,3
CCCGTAGCTGGGAAGA-1_V12D07-335_C1,1,2,0,0,0,3
ACCCTATGCCATATCG-1_V12D07-335_C1,0,0,0,0,0,0
GTGGTATAGTCTGCCG-1_V12D07-335_C1,0,1,0,0,0,1
CCGGTTTGTAATTGTG-1_V12D07-335_C1,1,0,0,0,0,1
GTCGCCGTTGTGTGTT-1_V12D07-335_C1,1,2,0,0,0,3
TACTGAACAGATTTAG-1_V12D07-335_C1,0,5,0,1,0,6
TATTAACCTGACCGCG-1_V12D07-335_C1,0,0,0,1,0,1
CTGTAGCCATCTCACT-1_V12D07-335_C1,1,0,0,0,0,1
TACTATGGTTCCTCAG-1_V12D07-335_C1,0,0,0,0,0,0
GAGTCAGACCAGAATC-1_V12D07-335_C1,1,1,0,0,0,2
TAAGGCATAACATCAA-1_V12D07-335_C1,0,0,1,0,3,4
CTTCCGCTCCGTGAAG-1_V12D07-335_C1,1,0,0,0,1,2
GGGCTATGATCGATGG-1_V12D07-335_C1,0,0,0,0,0,0
GGTCGGTCGTCCACAG-1_V12D07-335_C1,2,2,0,0,0,4
GGGACCCGTATATCTT-1_V12D07-335_C1,2,0,1,0,1,4
GAAAGCAGTGCACTTT-1_V12D07-335_C1,2,0,0,0,0,2
AGCGCATAATGAATCG-1_V12D07-335_C1,1,1,0,1,0,3
GCTGCTAAGTAGTCGA-1_V12D07-335_C1,1,3,0,0,0,4
AATAGTCCGTCCCGAC-1_V12D07-335_C1,1,0,0,0,0,1
AGCAGCCAGATGAATA-1_V12D07-335_C1,1,2,0,0,1,4
CCTCGCGCTGTGCGAT-1_V12D07-335_C1,1,1,0,0,1,3
TTGTGTATGCCACCAA-1_V12D07-335_C1,0,0,0,0,0,0
TGCTCGGCGAAACCCA-1_V12D07-335_C1,0,3,2,0,0,5
CGATTAAATATCTCCT-1_V12D07-335_C1,0,4,1,1,2,8
TGCCGTGGATCGTCCT-1_V12D07-335_C1,0,1,1,1,0,3
GTGGACGCATTTGTCC-1_V12D07-335_C1,0,0,0,0,1,1
ACCCGGAAACTCCCAG-1_V12D07-335_C1,0,0,0,0,0,0
CCGCATGTGGTACGAT-1_V12D07-335_C1,0,2,0,0,0,2
GCAAACCTTGGCCATA-1_V12D07-335_C1,0,1,0,0,1,2
ATTCACTGATGTTGGA-1_V12D07-335_C1,1,0,0,1,0,2
ACTCCCTAATGCTAAA-1_V12D07-335_C1,0,1,0,0,0,1
TCCTAAATTGGGAAGC-1_V12D07-335_C1,0,0,0,1,0,1
GAACAGATTACTAAAT-1_V12D07-335_C1,0,1,0,0,1,2
ATACAGGCCCTCCAAT-1_V12D07-335_C1,0,0,0,0,0,0
CGATTCGCCTGGCTGC-1_V12D07-335_C1,0,1,0,0,1,2
TCCGCCTGTCTACAAG-1_V12D07-335_C1,0,0,1,0,4,5
CACATCTCACCGACGA-1_V12D07-335_C1,0,0,0,0,2,2
CGTCGTCCTTCGCGAA-1_V12D07-335_C1,0,0,0,1,0,1
CGTTGAATACCGCGCT-1_V12D07-335_C1,0,2,1,0,2,5
ACCAATATGCAAGTTA-1_V12D07-335_C1,0,0,0,2,2,4
ACGGATGGTGCGGATA-1_V12D07-335_C1,1,2,0,0,0,3
CACCCTAACAAGATCT-1_V12D07-335_C1,0,7,0,1,1,9
AAGCTCTTTCATGGTG-1_V12D07-335_C1,0,0,0,0,0,0
CATGGGTATGCCTTAT-1_V12D07-335_C1,0,1,1,0,0,2
GCGCGTCATTGGTACA-1_V12D07-335_C1,0,1,0,0,0,1
TCTGAAGCACGTGGTC-1_V12D07-335_C1,0,0,1,0,0,1
AAGTTCACTCCAAGCT-1_V12D07-335_C1,0,0,0,0,1,1
TTGGACCTATAACAGT-1_V12D07-335_C1,0,2,0,0,2,4
ATCAGCCTCATGCTGC-1_V12D07-335_C1,1,1,0,0,0,2
AGTACTCTTATGCCCA-1_V12D07-335_C1,0,1,0,0,0,1
GCGCTTAAATAATTGG-1_V12D07-335_C1,0,1,0,0,0,1
TTGTGAACCTAATCCG-1_V12D07-335_C1,0,6,0,0,0,6
AGTCGTCGACCACCAA-1_V12D07-335_C1,0,2,0,0,0,2
TCCTTTAAATCCGCTT-1_V12D07-335_C1,0,3,0,0,0,3
ACTGAAACGCCGTTAG-1_V12D07-335_C1,2,2,0,1,0,5
GCACACACTGGTAGCC-1_V12D07-335_C1,1,0,0,0,0,1
TAAGGGCCTGTCCGAT-1_V12D07-335_C1,0,0,0,0,0,0
GCTAGAGTAGAGATGT-1_V12D07-335_C1,1,0,0,0,2,3
CACAGGGCCATATAGT-1_V12D07-335_C1,0,2,0,0,0,2
CCATGCCCTAGATTTC-1_V12D07-335_C1,0,0,0,0,0,0
TCGCGTAGCAGTGTCC-1_V12D07-335_C1,2,0,0,2,0,4
GACGAGGCTAATAAAC-1_V12D07-335_C1,0,3,0,0,0,3
CTACACTCGCAGATGG-1_V12D07-335_C1,2,0,0,2,0,4
ACGCATACGTTTACTA-1_V12D07-335_C1,1,0,0,0,0,1
GGAGCAACATTTCAAG-1_V12D07-335_C1,1,3,0,1,0,5
CGAGAGGGTAGCCGCG-1_V12D07-335_C1,0,2,0,0,0,2
TCGTGTTCGACCACAA-1_V12D07-335_C1,1,1,0,0,0,2
TCTACCCAATAGAGAG-1_V12D07-335_C1,0,2,0,0,0,2
ATAAACGTTGCACCAC-1_V12D07-335_C1,0,3,0,0,0,3
TCAACTGCAGAGTCAG-1_V12D07-335_C1,3,2,0,0,0,5
AGCTCCATATATGTTC-1_V12D07-335_C1,1,2,0,0,0,3
GTAACATCTAAGATAA-1_V12D07-335_C1,1,2,0,0,0,3
CCGACAATAGGCCGCC-1_V12D07-335_C1,0,0,0,0,0,0
ATGCTTAGGAGTTGAT-1_V12D07-335_C1,0,1,0,0,0,1
AACCCGAGCAGAATCG-1_V12D07-335_C1,2,3,1,0,0,6
CGGGTTTGTTAGGGCT-1_V12D07-335_C1,1,1,0,1,0,3
AGGCACGTGACTGTCC-1_V12D07-335_C1,3,2,0,1,0,6
GACAAGAGATGAGATT-1_V12D07-335_C1,2,1,0,1,0,4
AGCCCTTGGACATCCC-1_V12D07-335_C1,1,0,0,0,0,1
GCAGTTCGATCCGAGC-1_V12D07-335_C1,0,0,0,0,0,0
TCGAGGGCAACAGACG-1_V12D07-335_C1,0,6,0,0,0,6
ACTTTGTCGACGCACT-1_V12D07-335_C1,2,1,0,0,0,3
GAGTATCAAAGTTACA-1_V12D07-335_C1,1,0,0,0,0,1
CCAGGCTGGCGTCTGA-1_V12D07-335_C1,0,0,0,0,0,0
GGACTCTTCCGGTTGA-1_V12D07-335_C1,1,0,0,1,0,2
TCCCAGCACACGACAT-1_V12D07-335_C1,2,0,0,0,0,2
GCTCCATGAGTGCAGA-1_V12D07-335_C1,2,0,0,0,0,2
GCAGTGCGGGCGGATG-1_V12D07-335_C1,1,0,0,0,0,1
GCGTTCTGACTAAGCG-1_V12D07-335_C1,1,0,0,1,0,2
ATTTGGAGATTGCGGT-1_V12D07-335_C1,0,0,0,0,1,1
AAGGGTTTGATTTCAG-1_V12D07-335_C1,0,0,0,0,0,0
CCGGCCGCGAGCATAT-1_V12D07-335_C1,0,0,0,0,0,0
GAGTTCTGTGGGTGCT-1_V12D07-335_C1,0,3,1,0,0,4
AAACGAAGATGGAGTA-1_V12D07-335_C1,1,2,0,1,0,4
AATTACGAGACCCATC-1_V12D07-335_C1,2,6,0,1,0,9
CCTTTGAATTATGGCT-1_V12D07-335_C1,0,1,1,0,0,2
CATGGTATTAGTTTGT-1_V12D07-335_C1,0,1,0,0,0,1
AACGAAAGTCGTCCCA-1_V12D07-335_C1,2,2,0,1,0,5
ACATAAGTCGTGGTGA-1_V12D07-335_C1,0,1,0,0,1,2
GCACAACCTCGGGCGT-1_V12D07-335_C1,0,1,0,0,0,1
ATGCACGCGCTGTTCA-1_V12D07-335_C1,1,1,0,0,0,2
CGATGTTGTTATCTAC-1_V12D07-335_C1,2,2,0,0,0,4
GTCTCCTGCCAGTATG-1_V12D07-335_C1,2,2,0,0,0,4
GATGCCTTCTGCGGCA-1_V12D07-335_C1,0,0,0,0,0,0
ACCGGTCAGGTACACC-1_V12D07-335_C1,0,2,0,0,0,2
GTGGAGCGTTTACCGA-1_V12D07-335_C1,0,3,0,0,0,3
AGGCGGTTTGTCCCGC-1_V12D07-335_C1,0,3,1,0,0,4
TCCCTGGCGTATTAAC-1_V12D07-335_C1,0,1,0,0,0,1
AAACACCAATAACTGC-1_V12D07-335_C1,3,1,0,0,0,4
TGGACGCAATCCAGCC-1_V12D07-335_C1,3,0,0,0,0,3
GGAACCTTGACTCTGC-1_V12D07-335_C1,0,1,0,1,0,2
GTATCTCAGTCTTGAC-1_V12D07-335_C1,0,1,0,1,0,2
GCTGAATCTTCCAATC-1_V12D07-335_C1,0,3,1,0,0,4
AGATGCAAGACGTGCA-1_V12D07-335_C1,1,0,0,0,0,1
TTAAGGCCCGTACTTT-1_V12D07-335_C1,1,0,0,0,1,2
AGTATGCTGGAGACCA-1_V12D07-335_C1,2,1,0,0,0,3
GCGGCAAAGTATTGCC-1_V12D07-335_C1,0,1,0,0,0,1
GCGCAAATATATTCAA-1_V12D07-335_C1,0,0,0,0,1,1
GAAGAAACGATATTGT-1_V12D07-335_C1,2,0,0,1,0,3
GGACCTCTAGGCCGCC-1_V12D07-335_C1,0,0,0,0,0,0
AACAGCTGTGTGGCAA-1_V12D07-335_C1,1,0,0,1,0,2
TCGAATATCCCGCAGG-1_V12D07-335_C1,0,1,0,0,0,1
GCGACCCAACCATCTG-1_V12D07-335_C1,0,2,0,0,0,2
AGAGAAGGAGTACAAT-1_V12D07-335_C1,1,1,0,0,0,2
GGCTCCTCCACCTGTT-1_V12D07-335_C1,2,0,0,0,0,2
TCAGTGTATACGTCAT-1_V12D07-335_C1,1,3,0,0,0,4
ATTATTATGTCCGTCA-1_V12D07-335_C1,3,0,0,0,0,3
TTAGGTCATAACCGAC-1_V12D07-335_C1,0,0,0,0,0,0
AAGATGGCACCGGACC-1_V12D07-335_C1,0,0,0,0,0,0
CTACAAGAAATAACCC-1_V12D07-335_C1,0,5,1,0,0,6
ACTATTTCCGGGCCCA-1_V12D07-335_C1,0,2,0,0,1,3
TTGTTTCACATCCAGG-1_V12D07-335_C1,0,0,0,0,0,0
CGCTGTGTGGATGTTG-1_V12D07-335_C1,1,3,0,0,0,4
TCAACATAGCGCCCTA-1_V12D07-335_C1,3,0,0,1,0,4
GGCCGTTTGGGTTTCA-1_V12D07-335_C1,0,6,0,0,0,6
TACTCTTTCGTCTTCA-1_V12D07-335_C1,1,0,0,0,0,1
TTCGCGCGCCATACGA-1_V12D07-335_C1,2,2,0,0,1,5
CGGAAAGAATCAAACG-1_V12D07-335_C1,0,0,0,0,0,0
AGGCAGGGAGCGTACT-1_V12D07-335_C1,0,3,0,0,2,5
CCTTTAAGGGAGCACT-1_V12D07-335_C1,0,2,0,1,0,3
CGCCCAGCACGCCTAG-1_V12D07-335_C1,0,2,0,0,1,3
AGTATTTGGCACGACC-1_V12D07-335_C1,0,0,0,0,0,0
TATCCGCACCGTCGGG-1_V12D07-335_C1,0,0,1,0,0,1
ACCCGTGTCATCAGTA-1_V12D07-335_C1,1,1,0,0,0,2
CAACTGCTCATCCGAT-1_V12D07-335_C1,0,0,0,0,0,0
CCGGAGCGTACTTTCT-1_V12D07-335_C1,1,2,0,0,0,3
TACCGTAGGTTAACTA-1_V12D07-335_C1,0,0,0,0,0,0
TGAGGAGTGCCAGCTT-1_V12D07-335_C1,0,2,0,0,0,2
CCAGTCTTGTCATAGA-1_V12D07-335_C1,0,0,0,0,0,0
GGGCAGAGCAATCGTT-1_V12D07-335_C1,1,0,1,0,0,2
TACCAAATAGCCCAGA-1_V12D07-335_C1,0,0,0,0,0,0
TACCTACTCCCAGTAT-1_V12D07-335_C1,1,0,0,0,1,2
TGTGAGACTAGCCCAA-1_V12D07-335_C1,0,0,0,0,1,1
ATACCTAACCAAGAAA-1_V12D07-335_C1,0,0,0,0,1,1
GTCGGGAAGCAGAAAC-1_V12D07-335_C1,0,1,0,0,1,2
AATTAACGGATTTCCA-1_V12D07-335_C1,0,0,0,0,1,1
GAACCCTCTGTGTTCT-1_V12D07-335_C1,0,1,0,0,1,2
ATATAAAGCGCTCGTG-1_V12D07-335_C1,0,0,0,0,0,0
CCTGGTCGAATGTGGG-1_V12D07-335_C1,0,0,0,1,0,1
CTAGGTTCGGACGTGA-1_V12D07-335_C1,0,1,0,1,0,2
TCGGGAGACAGCGTAC-1_V12D07-335_C1,0,1,0,1,1,3
CATAAGAAGCTTGGCT-1_V12D07-335_C1,0,2,0,0,1,3
AAGCACCCTGCGTATC-1_V12D07-335_C1,0,1,0,0,1,2
AGTTTGCACCTGCCTC-1_V12D07-335_C1,0,2,2,0,1,5
GACTGCAAATCGAGCT-1_V12D07-335_C1,2,0,0,0,0,2
GTGTATATCAGCGGGC-1_V12D07-335_C1,0,0,0,0,1,1
CTTCAACTCCACTTGG-1_V12D07-335_C1,0,2,0,0,0,2
ACTTACGCATCCACGC-1_V12D07-335_C1,0,1,0,0,1,2
CATGAGATGCACTCTC-1_V12D07-335_C1,1,0,0,0,0,1
GAGCACCTGTGTCCAG-1_V12D07-335_C1,0,0,0,0,0,0
CGCGACCGCGACAGAT-1_V12D07-335_C1,0,0,0,1,0,1
GTCCCGCGACGTTATG-1_V12D07-335_C1,0,0,0,0,0,0
GCAGTGTGGCTATAGG-1_V12D07-335_C1,1,2,0,0,0,3
ATACTGCCTTACACCG-1_V12D07-335_C1,0,0,0,0,0,0
TACAGAAACGGTGGGC-1_V12D07-335_C1,1,1,0,0,0,2
GGCGCGGAGATCTTTC-1_V12D07-335_C1,2,1,0,0,0,3
CGTTAATGTCCCGACG-1_V12D07-335_C1,2,2,0,0,0,4
GCTAACTGAAGTCTGA-1_V12D07-335_C1,1,0,0,0,0,1
AGTGATAACCTGCGCG-1_V12D07-335_C1,1,0,1,0,1,3
TATGATCTTCTCTTTA-1_V12D07-335_C1,1,2,1,0,0,4
TGTACCTACACGAGGG-1_V12D07-335_C1,0,0,0,0,0,0
ATATCGTTCCTCGAAC-1_V12D07-335_C1,1,1,0,0,2,4
CGGCGCCATCAATCCC-1_V12D07-335_C1,2,3,0,0,0,5
CCTGTTTGAAGACACG-1_V12D07-335_C1,1,0,0,0,0,1
GCCACTCAGAGCGCGA-1_V12D07-335_C1,2,2,0,0,0,4
TCGGCTTGTATCGACG-1_V12D07-335_C1,3,2,0,0,0,5
TAGATGGTTCCTTACT-1_V12D07-335_C1,2,0,0,0,0,2
ATCGTTAGCTAGCGGA-1_V12D07-335_C1,0,2,0,0,0,2
ACAGCGACATTCTCAT-1_V12D07-335_C1,0,2,0,0,0,2
ATTCAACCATTTAAGG-1_V12D07-335_C1,1,0,0,2,0,3
CACTCTTCTGCTAGCC-1_V12D07-335_C1,0,1,0,0,0,1
CTAACTGATAATCGCC-1_V12D07-335_C1,1,1,0,0,0,2
TGATGTCAATTAAGTG-1_V12D07-335_C1,0,2,0,0,0,2
CGCCGTTCAGCATAGT-1_V12D07-335_C1,0,1,0,0,0,1
ATACTACCCGTACCAC-1_V12D07-335_C1,0,0,0,0,0,0
CCACTGTTTGGATTAA-1_V12D07-335_C1,1,1,0,0,0,2
CACTACGGGAGCTGCC-1_V12D07-335_C1,1,2,0,1,0,4
GACCAAACGTTGACTG-1_V12D07-335_C1,3,0,0,1,0,4
AAGAGGCCCTTTGGAA-1_V12D07-335_C1,2,2,0,0,0,4
ACACGTAGGCCACAAG-1_V12D07-335_C1,4,0,0,1,0,5
TACTCTTACTTTACTG-1_V12D07-335_C1,0,2,1,0,0,3
AGAGCCGCCGAGATTT-1_V12D07-335_C1,4,2,0,0,0,6
GGCCTGCTTCTCCCGA-1_V12D07-335_C1,6,1,0,0,1,8
TCAAGCGCGGACGGTA-1_V12D07-335_C1,1,1,0,0,0,2
ACACTGGGACAGTCGT-1_V12D07-335_C1,2,0,0,0,0,2
TGTGTAGTAGCACGTG-1_V12D07-335_C1,0,2,0,0,0,2
CTAGCCACAGGCGAGC-1_V12D07-335_C1,2,1,0,0,0,3
CTATCGCGTAGAGAAC-1_V12D07-335_C1,0,1,0,0,0,1
GTTCCCGTAAACATAT-1_V12D07-335_C1,2,3,0,0,0,5
TCTTTCCTTCGAGATA-1_V12D07-335_C1,0,0,0,0,0,0
ATATTGGAGAGGCCTT-1_V12D07-335_C1,1,0,0,0,0,1
AGGCGATAACTGGCGT-1_V12D07-335_C1,0,1,0,0,0,1
ACCCGGAGCACCACAA-1_V12D07-335_C1,1,4,0,1,1,7
TGAGCTCAACTGTATA-1_V12D07-335_C1,1,1,0,0,0,2
ACGACCCATGAGTTGC-1_V12D07-335_C1,1,2,0,0,0,3
CGGTCAGTCCATATTT-1_V12D07-335_C1,2,3,0,0,0,5
TCCGGCTGTCGGGTCG-1_V12D07-335_C1,1,1,0,0,0,2
ATTCCCGAAGGTACAG-1_V12D07-335_C1,1,3,0,1,0,5
CTAACAGCACAATAAC-1_V12D07-335_C1,3,0,0,0,0,3
TTGTGCGGAAGCGGAT-1_V12D07-335_C1,1,0,1,0,0,2
GGGCACTATTGACCAT-1_V12D07-335_C1,0,0,0,0,0,0
CCATAGAGGCTGCCAG-1_V12D07-335_C1,1,1,0,0,0,2
CCGAAGCATTGACCAA-1_V12D07-335_C1,2,0,0,0,0,2
TACTGAGGGAAGAAAG-1_V12D07-335_C1,1,1,0,0,0,2
TATGTAGAAACCCGGC-1_V12D07-335_C1,1,5,1,1,0,8
TGGTTAACTTACATTT-1_V12D07-335_C1,1,3,1,0,0,5
AGAACCCTCAATTGGG-1_V12D07-335_C1,1,0,0,1,0,2
CCTATATCGTGTCACG-1_V12D07-335_C1,0,2,0,0,0,2
ACGGCTGGATGTAGAA-1_V12D07-335_C1,0,2,0,0,0,2
CTCGCATTGCATAGCC-1_V12D07-335_C1,0,0,0,0,0,0
ACTTTGGTCGTGCTCC-1_V12D07-335_C1,0,1,0,0,0,1
GCTGGTTTAGGCCATA-1_V12D07-335_C1,3,1,0,0,0,4
TGTCGTTATCACATAT-1_V12D07-335_C1,2,0,0,0,0,2
ACACATGATCAAATCT-1_V12D07-335_C1,4,3,0,1,0,8
TATCCATCTCGGTTAG-1_V12D07-335_C1,0,3,0,0,0,3
CTCGTCGAGGGCTCAT-1_V12D07-335_C1,0,2,0,0,0,2
ATCAATGCCGTGGCTG-1_V12D07-335_C1,0,2,0,0,0,2
GAAACATAGGAAACAG-1_V12D07-335_C1,1,0,0,0,0,1
TAATAGGTCACCAGAA-1_V12D07-335_C1,0,0,0,0,0,0
CACCAGTCAGCATGCA-1_V12D07-335_C1,0,2,0,0,0,2
GAGCGCTGTTAGGTAA-1_V12D07-335_C1,1,3,0,1,0,5
CCCTATGTAGAGCAGA-1_V12D07-335_C1,2,1,0,0,0,3
GATCGCTATATCTCAG-1_V12D07-335_C1,0,1,0,0,1,2
AAGGGACTATGCATTC-1_V12D07-335_C1,0,0,0,0,0,0
CTCGGGTTCTCTGGCC-1_V12D07-335_C1,1,0,0,0,0,1
TATATATCGAGAAATG-1_V12D07-335_C1,2,0,0,0,0,2
ACCCGAGCGAAATTAC-1_V12D07-335_C1,2,2,0,0,0,4
TTGTTTCATTAGTCTA-1_V12D07-335_C1,1,6,0,0,0,7
ATGGGACCTGCTGAAC-1_V12D07-335_C1,2,1,0,0,0,3
TGCGACGGCCGAACGT-1_V12D07-335_C1,0,0,0,2,0,2
AGCTAACAAGCAATGT-1_V12D07-335_C1,0,6,0,1,0,7
CGTGTCTCGTTACGAC-1_V12D07-335_C1,0,0,0,0,0,0
CTAAATCCGGTGTACA-1_V12D07-335_C1,2,2,0,0,0,4
GAATAGTGCTCGATTA-1_V12D07-335_C1,1,0,0,0,0,1
AACAATACATTGTCGA-1_V12D07-335_C1,0,0,0,0,0,0
CACATCGTGCACGCGC-1_V12D07-335_C1,0,1,0,1,0,2
ACCGTGACCACGTGGG-1_V12D07-335_C1,0,2,0,0,0,2
CCCAATGAGATTTGCA-1_V12D07-335_C1,0,0,0,0,0,0
TCAGCAGTAGGCCCTG-1_V12D07-335_C1,0,7,0,0,0,7
CTACTCAAGGTATAGT-1_V12D07-335_C1,2,0,0,1,0,3
TAGTAGCTTATACCAG-1_V12D07-335_C1,1,0,0,0,0,1
ACGTTCGTTCAGGAAA-1_V12D07-335_C1,0,5,0,0,0,5
TTAGAATAAGGGTCGG-1_V12D07-335_C1,1,1,0,0,0,2
TTCTAGAAAGTCTTAT-1_V12D07-335_C1,3,0,0,0,0,3
CCTTCAGTTAAAGTGA-1_V12D07-335_C1,1,0,0,0,0,1
TAGCTAGTGATGATGG-1_V12D07-335_C1,1,1,0,0,1,3
AGCCCGGTAGCCTGTA-1_V12D07-335_C1,1,0,0,0,0,1
TACCTCAGTTGTCTGT-1_V12D07-335_C1,0,1,0,1,0,2
GACGGGTTGGCCCGTA-1_V12D07-335_C1,0,1,0,0,0,1
GAAACCTATACAAATG-1_V12D07-335_C1,1,3,0,0,1,5
TCCACCTCTAGCCTTT-1_V12D07-335_C1,1,1,0,0,0,2
AAGACCCAACTGAACA-1_V12D07-335_C1,0,0,1,0,0,1
CATACACGGTTCCCAC-1_V12D07-335_C1,0,1,0,0,0,1
ACTACGCGTTAGAATT-1_V12D07-335_C1,0,0,0,0,0,0
CTTGGCCAAGCTGGGA-1_V12D07-335_C1,0,3,0,0,0,3
TTACCCTAGGGATTGG-1_V12D07-335_C1,1,0,0,0,0,1
TTCGCACTGTACGACA-1_V12D07-335_C1,0,1,0,0,0,1
TAGGTGTTCCACAGAT-1_V12D07-335_C1,0,1,0,0,2,3
GAAGCCTGCACATTCC-1_V12D07-335_C1,0,0,0,2,1,3
GGCTTTCAATAAGGGT-1_V12D07-335_C1,0,1,0,0,6,7
TCCAGGGTATATACGA-1_V12D07-335_C1,0,0,0,0,0,0
CTCGCCGAATGTAGGG-1_V12D07-335_C1,0,2,0,0,2,4
AGGAAGCTGTCCGCCG-1_V12D07-335_C1,0,0,0,0,1,1
GTCTCAAGGCCCGGCT-1_V12D07-335_C1,0,0,0,0,1,1
ACCGACACATCTCCCA-1_V12D07-335_C1,0,0,0,0,0,0
TATACGCGTCATCACT-1_V12D07-335_C1,0,0,0,0,1,1
ATCTGGGCTGTTCTTG-1_V12D07-335_C1,0,0,0,0,0,0
TCAAATTTGAGACTCA-1_V12D07-335_C1,0,2,0,0,1,3
GTTAAGGGTGCGATGT-1_V12D07-335_C1,0,0,0,0,0,0
AGCAAAGGCCGCTAGT-1_V12D07-335_C1,0,0,0,1,0,1
TTATAGGTAATTGTCT-1_V12D07-335_C1,0,3,0,1,2,6
TTGTGCAGCCACGTCA-1_V12D07-335_C1,0,0,0,0,0,0
ACGGACTCTCAAAGCG-1_V12D07-335_C1,0,0,0,1,1,2
ATGCTCTGGCGCGGTA-1_V12D07-335_C1,0,0,0,0,0,0
ATAATCTTGGAGAACC-1_V12D07-335_C1,0,0,0,0,0,0
CTCATTGCTCTAACAA-1_V12D07-335_C1,0,1,1,1,0,3
TAGGTGACGATAACCT-1_V12D07-335_C1,0,1,0,1,0,2
CGGATCCTCAAGGACT-1_V12D07-335_C1,0,1,0,0,1,2
GGGCGTGGTTTCCCAG-1_V12D07-335_C1,0,0,0,0,0,0
TGGCTATGTGACATAC-1_V12D07-335_C1,1,1,1,0,0,3
CTTAGTGTAGTAGCAT-1_V12D07-335_C1,0,0,0,0,0,0
GGATTGCTGTGACTCC-1_V12D07-335_C1,0,1,0,0,0,1
ACTTCCATGCGGGACA-1_V12D07-335_C1,0,0,0,0,0,0
ACTCAAGTGCAAGGCT-1_V12D07-335_C1,1,0,0,0,0,1
ACAAGGATGCTTTAGG-1_V12D07-335_C1,2,1,0,0,0,3
TTGAACGACGTGCTGA-1_V12D07-335_C1,3,1,2,0,0,6
ATTCATCGTTGAGGCA-1_V12D07-335_C1,1,1,0,1,0,3
TGCAACCCATCTGCGG-1_V12D07-335_C1,2,2,0,0,0,4
AGTGCTAAACACAGCA-1_V12D07-335_C1,1,0,0,0,0,1
AACTCCAGAGCGTGTT-1_V12D07-335_C1,0,1,0,0,0,1
TCTCCACAAGTTGAAT-1_V12D07-335_C1,2,1,0,0,0,3
CTTTGCATCGCTCTTG-1_V12D07-335_C1,1,0,0,0,0,1
TCACAAACCGAGGTAC-1_V12D07-335_C1,1,0,0,2,0,3
CCGTAGGAAATCCCTG-1_V12D07-335_C1,0,0,1,1,0,2
AAACATTTCCCGGATT-1_V12D07-335_C1,0,3,0,1,0,4
GCCTCCGACAATTCAC-1_V12D07-335_C1,0,0,0,1,1,2
TCTGCATACCTTGCTT-1_V12D07-335_C1,2,3,0,0,0,5
ACCCATTTGTCCCTCT-1_V12D07-335_C1,1,2,0,0,0,3
CTGCAGAGAATCAGAG-1_V12D07-335_C1,3,4,0,0,0,7
GGAAACTAAATGGGCC-1_V12D07-335_C1,2,4,1,1,0,8
CAACCTACCGAGCAGT-1_V12D07-335_C1,0,3,0,0,0,3
CCGTAGGGTTGTTTAC-1_V12D07-335_C1,2,0,0,1,0,3
GGTTTGTGACCTGAGG-1_V12D07-335_C1,2,2,0,0,0,4
TAACCTAGGGAGTCCA-1_V12D07-335_C1,1,2,0,0,0,3
TTCCATCGACAGCGTG-1_V12D07-335_C1,1,0,0,1,0,2
ATCTCCCACGGAATAT-1_V12D07-335_C1,4,2,1,0,0,7
GTTTCAAACGAGTTGT-1_V12D07-335_C1,1,2,0,1,0,4
GGAACTTTGGCGATTA-1_V12D07-335_C1,1,2,1,0,0,4
CTGCAAGCACGTTCCG-1_V12D07-335_C1,3,1,0,0,0,4
CACAGTCCCGCTTCGC-1_V12D07-335_C1,1,0,0,0,0,1
TACGCTCGGTATTGGA-1_V12D07-335_C1,2,0,0,0,1,3
CTGGTAAAGTGTGGGC-1_V12D07-335_C1,0,1,0,0,1,2
CAACCAGTGGCCTACC-1_V12D07-335_C1,4,0,1,0,0,5
TCTTCGCGGTGAGAGG-1_V12D07-335_C1,4,3,0,0,0,7
TTCGGGTTGCCACGGG-1_V12D07-335_C1,2,0,0,0,0,2
ACCGATAGGCATAACC-1_V12D07-335_C1,2,0,0,0,0,2
CTTATAGATGGCTGTT-1_V12D07-335_C1,4,1,0,0,0,5
AGACGCCCACTTCGCC-1_V12D07-335_C1,2,0,0,0,0,2
AGGTCGCCTCCCAACA-1_V12D07-335_C1,0,0,0,0,0,0
CCTCACGTCAGCTAAT-1_V12D07-335_C1,3,0,0,1,0,4
CCACCTGTATGGAATA-1_V12D07-335_C1,0,0,0,0,0,0
GGACTCGAAGCTTTCA-1_V12D07-335_C1,3,0,0,0,0,3
AAGCCGGAGAGCAGGA-1_V12D07-335_C1,0,0,0,0,0,0
GCCTATCAGGTAAGAT-1_V12D07-335_C1,1,0,0,0,0,1
TCAGAGTGTGAGCATG-1_V12D07-335_C1,1,1,0,0,0,2
AAACATGGTGAGAGGA-1_V12D07-335_C1,1,2,1,0,0,4
ATCATTGTACCGCATT-1_V12D07-335_C1,2,0,0,1,1,4
TCAGCTTGAGCTTTCG-1_V12D07-335_C1,0,3,0,0,1,4
CCGCGCAAGATACCCA-1_V12D07-335_C1,2,0,0,2,0,4
CTATACTTAAAGCGAG-1_V12D07-335_C1,0,1,0,0,1,2
ACCGTCCACTGGGCCC-1_V12D07-335_C1,2,2,0,0,0,4
AAGACCAAATAACTCA-1_V12D07-335_C1,0,0,0,0,0,0
TGTTTCTGAAGCGTGC-1_V12D07-335_C1,0,2,0,1,0,3
TTCTCTTACAGGTGAT-1_V12D07-335_C1,3,0,0,0,0,3
AATTCATTGTCATGCA-1_V12D07-335_C1,3,2,0,0,0,5
GCCCGAGAGTCTAAAT-1_V12D07-335_C1,0,2,0,0,0,2
ATATAGAGTATTGGTC-1_V12D07-335_C1,0,4,0,2,0,6
TTGAAGGATGGGCGCC-1_V12D07-335_C1,2,1,0,1,0,4
TAGTACCACAACTTTC-1_V12D07-335_C1,1,0,0,0,0,1
ATCCCATCCACAGCGC-1_V12D07-335_C1,1,0,0,0,0,1
CTTAGGTATAGACCAG-1_V12D07-335_C1,0,0,0,1,1,2
TGACTCCGAATCATAC-1_V12D07-335_C1,1,0,0,0,0,1
ACTACATCCCGACAAG-1_V12D07-335_C1,0,4,0,1,0,5
TTGCCGCAGACCTACA-1_V12D07-335_C1,2,3,0,0,0,5
TAAGAGGGACAGGGAC-1_V12D07-335_C1,0,1,0,0,0,1
CGAATGAAGTCATTGC-1_V12D07-335_C1,0,2,0,0,0,2
AAGGGAACGACTGGCT-1_V12D07-335_C1,1,1,0,0,0,2
CGAATCTGCTCGACGC-1_V12D07-335_C1,1,2,0,0,1,4
ATCGTGGAAAGTCTGG-1_V12D07-335_C1,2,1,0,0,0,3
CCTATGGCTCCTAGTG-1_V12D07-335_C1,1,0,0,0,0,1
CGTCGCTTGGTTATAC-1_V12D07-335_C1,1,1,0,0,0,2
TGCTTAGAGAGAATGC-1_V12D07-335_C1,0,0,0,0,0,0
GATTGCTCCAGTTGCA-1_V12D07-335_C1,0,5,0,0,0,5
CGTGCTTCTACCTAAA-1_V12D07-335_C1,1,2,0,0,0,3
ACTCCAATATCATCAT-1_V12D07-335_C1,0,0,0,0,0,0
GCCGACCCACGACTGC-1_V12D07-335_C1,0,1,0,0,0,1
GAGGGTAGTAACAAAG-1_V12D07-335_C1,0,1,0,0,0,1
GGCCGAGACTCTGGTG-1_V12D07-335_C1,1,0,0,0,0,1
TATATAGGGCTTTACG-1_V12D07-335_C1,0,0,0,0,0,0
TGCCGGATGTACGAGC-1_V12D07-335_C1,2,1,0,1,0,4
AGGTAGATCGAGATAT-1_V12D07-335_C1,1,2,0,0,0,3
GATCAACATAAAGGGA-1_V12D07-335_C1,0,1,0,0,0,1
TAACAGCGTTTGTGCT-1_V12D07-335_C1,1,1,1,0,0,3
CTATAGGCGTTGATGT-1_V12D07-335_C1,0,2,0,1,0,3
GGTTTAATTACCATCG-1_V12D07-335_C1,0,0,0,2,0,2
CTCTTCTGGAAGTTAG-1_V12D07-335_C1,0,0,0,0,0,0
ATCTGACATGGAAGGA-1_V12D07-335_C1,0,0,0,0,0,0
TACGTACTAGTGCTGA-1_V12D07-335_C1,0,0,0,0,0,0
ATGACTATCAGCTGTG-1_V12D07-335_C1,2,0,0,0,0,2
CTTTGGGATTGTTGCA-1_V12D07-335_C1,0,1,0,0,0,1
AGACTGTTACCGGGTC-1_V12D07-335_C1,1,0,1,0,2,4
TCCTAACCGTCGGGCA-1_V12D07-335_C1,0,0,0,0,0,0
ACGCAAACTAATAGAT-1_V12D07-335_C1,1,0,0,0,0,1
AAGTGAGTCGGGTTTA-1_V12D07-335_C1,0,2,0,0,0,2
TAAAGCGGTATTTCCA-1_V12D07-335_C1,0,0,0,0,0,0
CTCCTCCAGCTCACAC-1_V12D07-335_C1,1,3,0,0,0,4
CGGTCCGTCGCAAGCC-1_V12D07-335_C1,1,1,0,0,0,2
CCTATATTTGTCCTGG-1_V12D07-335_C1,3,2,0,0,0,5
TCCAATAAAGGCTACC-1_V12D07-335_C1,2,0,0,0,0,2
AAAGGCTACGGACCAT-1_V12D07-335_C1,2,1,0,0,0,3
CGTGACCAGTCCTCTG-1_V12D07-335_C1,0,2,0,0,1,3
GATCTGCTATCTAAGG-1_V12D07-335_C1,0,1,1,0,0,2
CGAATGACGCATAATG-1_V12D07-335_C1,1,0,0,0,0,1
GCTCAATGTAATACCG-1_V12D07-335_C1,0,1,0,0,0,1
CTATGCCCGAATGCAA-1_V12D07-335_C1,0,1,0,1,1,3
CACAGGGCCGTTGTCA-1_V12D07-335_C1,0,0,0,0,2,2
TCAATACGCCGTCATG-1_V12D07-335_C1,0,0,1,0,1,2
AGCGGACACTTCGTAG-1_V12D07-335_C1,0,0,0,0,3,3
ATACGTTATGCACGGA-1_V12D07-335_C1,0,0,0,0,4,4
GAGTAGATACTAGTTG-1_V12D07-335_C1,0,0,0,0,1,1
CCAGCTCGAACGCATT-1_V12D07-335_C1,0,0,0,0,0,0
TGCTTCCCAAGCAGTA-1_V12D07-335_C1,0,0,0,0,1,1
GTAGACACGCCTGACT-1_V12D07-335_C1,0,0,3,0,0,3
CTCACATTTACTAAAT-1_V12D07-335_C1,0,1,1,0,1,3
GAATGCGAATCGGTTC-1_V12D07-335_C1,0,3,0,0,1,4
TAAGGCCCGTCACCCT-1_V12D07-335_C1,2,0,0,0,0,2
GAGTATGCGCGTGCAT-1_V12D07-335_C1,1,1,0,0,0,2
ATCCACATCGACAGAA-1_V12D07-335_C1,1,0,0,0,0,1
TAGACGAAACGCCAAT-1_V12D07-335_C1,3,3,0,0,0,6
CAGCAGTCTGTGCTGC-1_V12D07-335_C1,1,1,0,0,0,2
CTCACTGTGATACTTA-1_V12D07-335_C1,0,3,0,0,0,3
TTAATTGCTTTGGGTG-1_V12D07-335_C1,0,0,0,0,0,0
GTAGTCTACGATATTG-1_V12D07-335_C1,0,1,0,0,0,1
TTGCCGCTTTCTAGTA-1_V12D07-335_C1,0,0,0,0,0,0
GAACCTTTAACGATCC-1_V12D07-335_C1,1,1,0,0,0,2
TGGACCAATCTAAGAT-1_V12D07-335_C1,0,2,1,0,0,3
CTAGTAGAAAGGGATT-1_V12D07-335_C1,0,0,0,0,0,0
AACCTCGCTTTAGCCC-1_V12D07-335_C1,0,0,0,0,2,2
GAGTGTCAACCAGAAA-1_V12D07-335_C1,0,0,1,0,0,1
GTGATCCTTGTCATGA-1_V12D07-335_C1,1,0,0,0,0,1
CTCAACTAACCCGGAT-1_V12D07-335_C1,2,0,0,0,0,2
AGTGGCGTCTGAAGGT-1_V12D07-335_C1,1,0,0,0,0,1
GGGAAGGGCTTTCTCA-1_V12D07-335_C1,0,1,0,0,0,1
AGGCCTGAGAATCTCG-1_V12D07-335_C1,1,0,0,0,0,1
AGCCACAGGTTACCCG-1_V12D07-335_C1,1,4,1,0,0,6
TGCAATCTAACACGGT-1_V12D07-335_C1,1,1,0,0,0,2
GTTTGGGTTTCGCCCG-1_V12D07-335_C1,1,0,0,0,0,1
CCTATGTCCACTCCAC-1_V12D07-335_C1,1,0,0,0,0,1
CTGCCTTTCTAGTAAA-1_V12D07-335_C1,0,4,0,0,0,4
TTAGTAAACCTGCTCT-1_V12D07-335_C1,1,1,0,0,0,2
TTGTGGTGGTACTAAG-1_V12D07-335_C1,1,1,0,0,0,2
CCTCCTGTTGTGTCGT-1_V12D07-335_C1,1,0,0,0,0,1
ACAAAGCATGACCTAG-1_V12D07-335_C1,0,1,0,1,0,2
ATAGCAACTAGGGAAG-1_V12D07-335_C1,1,1,0,0,0,2
CCGCTCTTCCGAACTA-1_V12D07-335_C1,2,3,0,0,0,5
TAGAATAGCCGATGAA-1_V12D07-335_C1,0,1,0,0,0,1
GGTCTCCGTCCAGGTT-1_V12D07-335_C1,1,1,0,0,0,2
TAATTACGTCAGTAGA-1_V12D07-335_C1,1,0,0,1,0,2
TACGTAAAGCGGAGTG-1_V12D07-335_C1,0,0,0,1,0,1
GCTACAATCGAGGATA-1_V12D07-335_C1,0,1,0,1,0,2
TCAGCCAATCCGTAAA-1_V12D07-335_C1,0,1,0,0,0,1
ATCATAGCCCTATGTA-1_V12D07-335_C1,0,1,0,2,0,3
GAGGCCTGTTGATACA-1_V12D07-335_C1,1,1,0,0,0,2
ATATACGCTCGTGACG-1_V12D07-335_C1,0,1,0,0,1,2
CCCTTTAATGGAGTTC-1_V12D07-335_C1,0,1,0,0,0,1
TTACACGATCTGCGAC-1_V12D07-335_C1,4,0,0,1,0,5
TCGCATAAAGGGCGCA-1_V12D07-335_C1,1,1,0,0,0,2
TGTAGCCATCCCATTC-1_V12D07-335_C1,1,0,0,0,0,1
GGGTCTATCGCTTTCC-1_V12D07-335_C1,0,0,0,0,0,0
GGAGGGTCAAGTAAGA-1_V12D07-335_C1,3,0,1,0,0,4
TACGGCATGGACGCTA-1_V12D07-335_C1,5,2,2,1,1,11
CACGTCAATCAATGGA-1_V12D07-335_C1,4,1,0,0,0,5
CGCTTGGACGGATAGA-1_V12D07-335_C1,2,0,0,0,2,4
CGCGGTACGGTATACA-1_V12D07-335_C1,0,0,0,0,0,0
CCTACTCAACACGATT-1_V12D07-335_C1,1,0,0,0,0,1
CGTTTGGTGTTGTGGG-1_V12D07-335_C1,2,0,0,0,0,2
GTTGTTGCAAGATGGC-1_V12D07-335_C1,1,0,0,0,0,1
CATTCGTCGTAGCGGT-1_V12D07-335_C1,1,0,0,0,0,1
CAGCCTCGATAGCGGT-1_V12D07-335_C1,0,1,0,0,0,1
TCATAAGTCCAAGAAG-1_V12D07-335_C1,2,5,0,1,2,10
AAAGTGCCATCAATTA-1_V12D07-335_C1,0,0,0,0,0,0
GTTGCAGTCGACAACA-1_V12D07-335_C1,1,0,0,0,0,1
TAAATGGGCTACTGAG-1_V12D07-335_C1,0,1,0,0,0,1
GGACAAGCCATGATCG-1_V12D07-335_C1,1,0,0,0,0,1
TCCAATGCGTCGCCGC-1_V12D07-335_C1,0,1,0,0,0,1
AAAGAATGACCTTAGA-1_V12D07-335_C1,4,2,0,0,4,10
CCTATTATTCCGGCCG-1_V12D07-335_C1,0,0,0,0,0,0
CAGTAAGGGACGTCTC-1_V12D07-335_C1,1,2,0,0,0,3
GGGATGGACCCGCGTC-1_V12D07-335_C1,0,0,0,0,1,1
GACGCATACCCGTCGG-1_V12D07-335_C1,0,0,0,0,0,0
GGGCAGGATTTCTGTG-1_V12D07-335_C1,0,0,0,0,1,1
TATCTGAGCCGATATT-1_V12D07-335_C1,0,1,0,0,0,1
AATGTATGGCACTGTA-1_V12D07-335_C1,2,0,0,0,0,2
GCCTTTGTCAGTGGAC-1_V12D07-335_C1,0,0,0,0,0,0
AACCATAGGGTTGAAC-1_V12D07-335_C1,0,0,0,0,1,1
AAACTTAATTGCACGC-1_V12D07-335_C1,1,1,0,0,0,2
TAGGCGGCTGCAAAGA-1_V12D07-335_C1,0,3,0,0,1,4
TCCATCAATACTAATC-1_V12D07-335_C1,1,2,0,0,0,3
ACCTCGAACTTATGCT-1_V12D07-335_C1,1,2,0,0,0,3
ACAAACCATGCGTCCT-1_V12D07-335_C1,1,1,0,0,0,2
ACACCGGTCTGACCGC-1_V12D07-335_C1,0,0,0,0,0,0
ATGGCAGCATTACGAT-1_V12D07-335_C1,0,0,1,0,0,1
CTGGTGAATGGGCCTA-1_V12D07-335_C1,1,0,0,0,0,1
CACAGAGACGAGGACG-1_V12D07-335_C1,1,1,0,0,0,2
GCACAAACCCTAGATG-1_V12D07-335_C1,0,0,0,1,0,1
ACTATGTCCAGCTGCC-1_V12D07-335_C1,1,0,0,0,0,1
AAGCCGCCGTGAAATC-1_V12D07-335_C1,0,1,0,0,1,2
ATGGGTGTATACCTCC-1_V12D07-335_C1,0,0,0,0,0,0
TAAGCGCGAATCAAAT-1_V12D07-335_C1,0,0,0,0,0,0
AGCCCGGCATTAGAGG-1_V12D07-335_C1,0,1,0,0,0,1
GTGATCAAGCGTGCAC-1_V12D07-335_C1,1,0,0,0,0,1
CTGCCTTTAATACCTT-1_V12D07-335_C1,1,0,0,0,0,1
TACCTCCACACCAATG-1_V12D07-335_C1,0,1,0,0,1,2
GAGCATCAACAACTTG-1_V12D07-335_C1,2,0,0,0,0,2
CATACGAACTAGCTGG-1_V12D07-335_C1,1,1,0,0,1,3
GGGAACGGTTTCAGAT-1_V12D07-335_C1,0,2,0,0,0,2
AGGGTGCCGTTCTTTA-1_V12D07-335_C1,0,0,0,0,0,0
ACGACTGGTCATACTC-1_V12D07-335_C1,1,0,0,0,0,1
GGATCTTACTGCCCTT-1_V12D07-335_C1,0,1,0,0,0,1
TACTCCTCTAGTTGAC-1_V12D07-335_C1,1,0,0,2,0,3
GTAGCTCCGGGAGGCT-1_V12D07-335_C1,0,0,0,0,0,0
GGACTCGTGAGTGGTC-1_V12D07-335_C1,0,4,0,0,0,4
GTAGTTCGAAGGCGAA-1_V12D07-335_C1,2,0,0,1,0,3
CTCAAACCACTGCCCG-1_V12D07-335_C1,1,2,0,0,0,3
GAGGGAGTCAGATCGC-1_V12D07-335_C1,1,0,0,1,0,2
GCGTCCCTAAGACATA-1_V12D07-335_C1,2,1,0,0,0,3
TCTCTTACCGCGAACC-1_V12D07-335_C1,1,2,0,0,0,3
GGCTACTATACACTCC-1_V12D07-335_C1,0,0,0,1,1,2
CGTTGCCCGCGTGGGA-1_V12D07-335_C1,0,3,1,0,0,4
TATAGAGTCGCTTGAA-1_V12D07-335_C1,0,0,0,0,0,0
ATGTTGTAGTCTGTTT-1_V12D07-335_C1,2,1,0,0,0,3
AGTATACACAGCGACA-1_V12D07-335_C1,0,1,0,0,0,1
TGTGGTTGCTAAAGCT-1_V12D07-335_C1,2,0,0,0,0,2
TGATTCCCGGTTACCT-1_V12D07-335_C1,1,0,0,0,0,1
CACTGACGATTGTGGA-1_V12D07-335_C1,1,0,0,0,0,1
AACATTGTGACTCGAG-1_V12D07-335_C1,1,1,0,0,0,2
GTCCAATATTTAGCCT-1_V12D07-335_C1,2,0,0,0,0,2
GCTCTTTCCGCTAGTG-1_V12D07-335_C1,0,2,0,0,2,4
GGGTCAGGAGCTAGAT-1_V12D07-335_C1,1,2,2,1,3,9
AGGTGGTGACCTTCGC-1_V12D07-335_C1,0,4,0,0,2,6
CCCGGGTCGTTCAGGG-1_V12D07-335_C1,0,0,0,0,2,2
AGCCAAGCTTTGTGTC-1_V12D07-335_C1,0,0,0,0,0,0
TGTGGCGGGCTTCTGG-1_V12D07-335_C1,1,1,0,0,0,2
CGAGGGTATCCAGGTG-1_V12D07-335_C1,0,0,0,0,3,3
CGTTCAGACCCGCGAA-1_V12D07-335_C1,1,2,0,0,0,3
TCATATGAGCTTTGTT-1_V12D07-335_C1,0,0,0,1,1,2
AGTTGACGGTCCTTGC-1_V12D07-335_C1,0,1,0,0,2,3
ATAATTAGCTAAGTAG-1_V12D07-335_C1,0,0,0,1,2,3
GGTCTTGAGCGCTCTT-1_V12D07-335_C1,0,0,0,0,1,1
CGTTGTCGGCAATTGA-1_V12D07-335_C1,0,2,0,1,0,3
TCTTGCTCCCGATACT-1_V12D07-335_C1,2,3,0,2,1,8
AGCAGAAGGAGAAAGA-1_V12D07-335_C1,0,0,0,0,0,0
GAAGCCACTGATTATG-1_V12D07-335_C1,0,0,0,0,0,0
TGCTCTTGAGAGTTTG-1_V12D07-335_C1,0,1,0,0,0,1
GACATCCGTCGAACTG-1_V12D07-335_C1,1,0,0,0,0,1
AGATATAATACGACTA-1_V12D07-335_C1,0,0,0,0,0,0
TCGCTACTGGCTTTGA-1_V12D07-335_C1,0,0,0,0,0,0
GTGACAGCTTCCCACT-1_V12D07-335_C1,0,2,2,0,0,4
GTGACGCAGGTTTCAT-1_V12D07-335_C1,0,0,0,0,0,0
GGGAAGACGGTCTGTC-1_V12D07-335_C1,1,0,0,0,0,1
CGTCGCATGTGAGCCA-1_V12D07-335_C1,0,1,0,0,0,1
AGAAGGTTGTAGGTCG-1_V12D07-335_C1,0,0,0,2,0,2
GGCCGGCGTCTGCTAT-1_V12D07-335_C1,0,0,0,1,0,1
TTGACCAGGAACAACT-1_V12D07-335_C1,0,0,0,0,1,1
AGTCGTATAAAGCAGA-1_V12D07-335_C1,1,1,0,0,0,2
GGCGTAGGGAAAGCTG-1_V12D07-335_C1,0,1,0,1,1,3
AAACCTAAGCAGCCGG-1_V12D07-335_C1,0,0,0,0,0,0
ATTGCCTTTATGTTTG-1_V12D07-335_C1,0,0,0,0,0,0
CAGGCAGTCTTACCAG-1_V12D07-335_C1,0,1,0,1,0,2
AGCTAAGTACGCAGGC-1_V12D07-335_C1,2,1,0,1,0,4
AAATCCGATACACGCC-1_V12D07-335_C1,0,2,0,0,0,2
CGAGAGCTTTCACTAC-1_V12D07-335_C1,1,2,0,1,0,4
CGCCCAGCGTTTCACG-1_V12D07-335_C1,0,1,0,0,0,1
TTAAGTATTGTTATCC-1_V12D07-335_C1,2,2,0,1,0,5
AAACGGGCGTACGGGT-1_V12D07-335_C1,0,0,0,1,0,1
GTATCCTTTGGTAACC-1_V12D07-335_C1,0,1,0,0,0,1
CATAGTCAAATACATA-1_V12D07-335_C1,4,0,0,0,0,4
TCTATGCTATAACGAC-1_V12D07-335_C1,1,2,0,0,0,3
ACGTTCTGTACAAGTC-1_V12D07-335_C1,3,0,0,1,0,4
CGCGAAGTGGCATACT-1_V12D07-335_C1,1,1,0,0,0,2
ACCAACCGCACTCCAC-1_V12D07-335_C1,1,0,0,1,0,2
GTCATGCGCGAGGGCT-1_V12D07-335_C1,0,1,0,0,0,1
TAGGCTAAAGTGGCAC-1_V12D07-335_C1,0,2,0,0,0,2
TGGCTACACTCTACCT-1_V12D07-335_C1,1,0,0,0,0,1
TGTCCACGGCTCAACT-1_V12D07-335_C1,1,1,0,0,0,2
AATTGCAGCAATCGAC-1_V12D07-335_C1,1,2,0,0,0,3
GTCAACCAGGCCTATA-1_V12D07-335_C1,0,1,0,0,0,1
ATCTTATCGCACACCC-1_V12D07-335_C1,0,0,0,0,0,0
GTCTATTGCATGCTCG-1_V12D07-335_C1,3,2,1,0,0,6
GCACGTGGTTTACTTA-1_V12D07-335_C1,0,0,0,1,0,1
ATTCGCGCCTTGAGAG-1_V12D07-335_C1,4,0,0,0,0,4
AGCGATGCGCCTAATA-1_V12D07-335_C1,3,1,0,0,0,4
TCTATAGGTGGGTAAT-1_V12D07-335_C1,2,0,0,0,0,2
AGATACCAATAGAACC-1_V12D07-335_C1,1,3,0,2,0,6
CGTGTATGGGAGCTGA-1_V12D07-335_C1,0,1,0,0,0,1
ATGTACATGCGGTGAG-1_V12D07-335_C1,0,2,0,0,0,2
TTGGCTCAATATGTGT-1_V12D07-335_C1,0,0,0,0,0,0
GTTCGGAGCACTCAAC-1_V12D07-335_C1,0,1,0,0,0,1
TCCCTCTTCTCAAGGG-1_V12D07-335_C1,0,1,0,0,0,1
TTACGTATCTATGACA-1_V12D07-335_C1,1,0,0,0,0,1
CCCATATAGGTCGATT-1_V12D07-335_C1,2,0,1,0,0,3
GTCCACGTCGCATTCG-1_V12D07-335_C1,1,1,0,0,0,2
AATTGTGGTTGCCAAA-1_V12D07-335_C1,1,3,0,0,0,4
AGGAACGAACGACTTC-1_V12D07-335_C1,0,0,0,0,0,0
TAATTCCAATGCTTCA-1_V12D07-335_C1,1,2,0,0,1,4
AGGGCCCTAATGTTCT-1_V12D07-335_C1,2,0,0,0,0,2
AGGTGTTGCCGACCAC-1_V12D07-335_C1,0,0,0,0,0,0
CTGAGAGTAGAAATAC-1_V12D07-335_C1,1,2,0,0,0,3
TAGAAGAAGGGTTACA-1_V12D07-335_C1,1,0,0,0,0,1
GGTGACTGATAGAGAG-1_V12D07-335_C1,0,0,0,0,0,0
TACCCTCGGTAACCCT-1_V12D07-335_C1,0,1,0,0,0,1
TGTAAGACTGATAAGA-1_V12D07-335_C1,1,0,0,0,0,1
GTCACTCATGAGCGAT-1_V12D07-335_C1,1,2,0,0,0,3
CGGTTTACTGAACATT-1_V12D07-335_C1,0,3,0,0,1,4
GAGATCGATCTTACTC-1_V12D07-335_C1,0,0,2,0,0,2
TCTTTCATCCGTCCTT-1_V12D07-335_C1,3,1,0,0,0,4
TCGGATCTGGATGACC-1_V12D07-335_C1,0,0,0,1,0,1
GTCCTAGGATACCTTA-1_V12D07-335_C1,0,1,0,0,0,1
TGTACCCGACCCTAAT-1_V12D07-335_C1,1,0,0,0,0,1
AGGTTCTCCTTTCCGG-1_V12D07-335_C1,0,0,0,0,0,0
AATTGCGTGGATTACA-1_V12D07-335_C1,0,0,0,0,0,0
CGATAGCGATACAGTG-1_V12D07-335_C1,0,0,0,0,0,0
CGCCCTAATTGTTCAA-1_V12D07-335_C1,0,1,0,0,0,1
ATTATGAGACCCAATT-1_V12D07-335_C1,2,1,0,0,0,3
CCTCCTAGCTAGAGTC-1_V12D07-335_C1,1,0,0,0,2,3
CGAAGGGTTTCAGATT-1_V12D07-335_C1,0,3,0,0,0,3
CACAAGCTAAGAAAGG-1_V12D07-335_C1,0,0,0,0,1,1
CACCGGTAGAGACATT-1_V12D07-335_C1,2,2,0,2,0,6
ACTCATGGCAGCCTTC-1_V12D07-335_C1,1,0,0,0,1,2
CATCCAATATAGTTTG-1_V12D07-335_C1,1,2,1,0,0,4
CAGATATGAAGATGAC-1_V12D07-335_C1,1,1,0,0,0,2
GCAAAGGGCGTTAGCC-1_V12D07-335_C1,1,1,0,1,0,3
CTGTTGTTCAGTCGTA-1_V12D07-335_C1,2,1,0,0,0,3
AAAGGCCCTATAATAC-1_V12D07-335_C1,0,1,0,1,1,3
AACATTGAAGTTGATC-1_V12D07-335_C1,2,0,2,0,0,4
GCTAGCGATAGGTCTT-1_V12D07-335_C1,0,2,0,1,0,3
ATTGCCTATTAGACCG-1_V12D07-335_C1,1,0,0,0,0,1
GGGCGTTTACATTCAT-1_V12D07-335_C1,1,2,0,0,0,3
CCTCTACAAGGATTGG-1_V12D07-335_C1,0,0,0,0,0,0
AGTGACTGTGACACAA-1_V12D07-335_C1,0,1,0,0,0,1
AGCCCTCCCTGGTGGC-1_V12D07-335_C1,0,3,0,0,0,3
CGGTTGAGTATCCTTC-1_V12D07-335_C1,1,1,0,0,0,2
CATTATCCCATTAACG-1_V12D07-335_C1,1,2,0,0,0,3
AATGTGCTAATCTGAG-1_V12D07-335_C1,1,0,0,0,0,1
CTTAGTTGAGGAATCG-1_V12D07-335_C1,2,0,0,1,0,3
CTTCTGGGCGTACCTA-1_V12D07-335_C1,2,0,4,0,1,7
AGTCAAATGATGTGAT-1_V12D07-335_C1,0,2,0,0,0,2
TGAACAAGCAGGGACT-1_V12D07-335_C1,1,1,0,0,0,2
AATACCGGAGGGCTGT-1_V12D07-335_C1,0,0,0,0,0,0
GTTTGGTGATCGGTGC-1_V12D07-335_C1,1,2,0,0,0,3
GACTGCTGGTGAGAAA-1_V12D07-335_C1,2,0,0,0,0,2
CGATCCTCGCAACATA-1_V12D07-335_C1,0,0,0,0,0,0
CCAACCTTATGTAACT-1_V12D07-335_C1,0,2,0,0,0,2
CGTGGTACCCAAAGGC-1_V12D07-335_C1,1,0,0,1,0,2
AACCCGACAACCCGTG-1_V12D07-335_C1,0,2,0,0,0,2
TATGTAAAGTGCTTAA-1_V12D07-335_C1,0,0,0,0,0,0
GCAAGTGTAAAGCATG-1_V12D07-335_C1,1,0,0,0,1,2
GTAACTGCCCAAGGAG-1_V12D07-335_C1,0,3,0,1,0,4
GGTGCATAAATGATTA-1_V12D07-335_C1,0,1,0,0,0,1
TAGTCCCGGAGACCAC-1_V12D07-335_C1,0,0,0,0,0,0
CGGCCAGAGCGACCAT-1_V12D07-335_C1,3,0,0,0,0,3
TGAATGAGTGTTTCCC-1_V12D07-335_C1,2,1,0,0,0,3
TTCACTTCCTAGAACG-1_V12D07-335_C1,0,1,1,0,2,4
CGCTTAGTATTGATAC-1_V12D07-335_C1,0,1,0,0,0,1
AACGCGACCTTGGGCG-1_V12D07-335_C1,0,0,2,0,0,2
GTGCACCAGCTTCAAC-1_V12D07-335_C1,1,2,4,0,0,7
TTCTATTAAACGCAGC-1_V12D07-335_C1,2,2,2,0,1,7
TGGCAAGCACAAGTCG-1_V12D07-335_C1,2,0,0,0,0,2
ATCTGCTGTTATCGCC-1_V12D07-335_C1,0,1,1,0,1,3
AATTCCAAGCATGTAC-1_V12D07-335_C1,0,0,0,0,0,0
AAACGGTTGCGAACTG-1_V12D07-335_C1,0,1,0,0,5,6
GAAGGAGTCGAGTGCG-1_V12D07-335_C1,1,0,0,0,2,3
GGCAAGCCCATAGTGG-1_V12D07-335_C1,0,2,0,0,1,3
TGACCAAATCTTAAAC-1_V12D07-335_C1,1,0,0,0,0,1
TTCGGTACTGTAGAGG-1_V12D07-335_C1,1,1,0,0,0,2
ATGTACGATGACGTCG-1_V12D07-335_C1,1,2,1,0,0,4
ATCTAGCTTGTGAGGG-1_V12D07-335_C1,1,3,0,0,0,4
AGCGGGTCTGACACTC-1_V12D07-335_C1,2,1,0,0,0,3
GAGGTACGCGTGTCCC-1_V12D07-335_C1,1,0,0,0,0,1
GCACTGCCTACCTTTA-1_V12D07-335_C1,0,4,0,0,0,4
GGAGCGAGGCCTACTT-1_V12D07-335_C1,2,0,0,0,1,3
AAACTCGGTTCGCAAT-1_V12D07-335_C1,1,2,0,1,0,4
GGCGCTTCATTCCCTG-1_V12D07-335_C1,1,3,0,0,0,4
TGCTCGGTGGGTCACC-1_V12D07-335_C1,0,0,0,0,1,1
AAGCGCAGGGCTTTGA-1_V12D07-335_C1,0,2,0,0,0,2
GACCTTCCACGTCTAC-1_V12D07-335_C1,0,0,0,0,0,0
GTTAGCCCATGACATC-1_V12D07-335_C1,1,0,2,0,0,3
AATTCGATTCGAGGAT-1_V12D07-335_C1,0,2,0,1,1,4
AGTCTTTAAAGTGTCC-1_V12D07-335_C1,1,0,0,0,0,1
GACTAGGCCGTTAGGT-1_V12D07-335_C1,0,0,0,0,0,0
TCCAAGCCTAGACACA-1_V12D07-335_C1,0,0,2,0,0,2
GATTGGGAAAGGTTGT-1_V12D07-335_C1,1,0,0,0,0,1
GATGAGGAACCTTCGG-1_V12D07-335_C1,1,1,0,0,1,3
TGAATACCGACGCGTA-1_V12D07-335_C1,1,0,3,0,0,4
AATCGTGAGCCGAGCA-1_V12D07-335_C1,2,1,0,0,0,3
GCGAAGAATCTGACGG-1_V12D07-335_C1,1,0,0,0,0,1
GAACAACTGGGATGAA-1_V12D07-335_C1,0,1,0,0,0,1
TCGCCGACATATTCGC-1_V12D07-335_C1,0,0,0,0,0,0
CGTAGAGAGTAATTAT-1_V12D07-335_C1,1,2,0,2,0,5
CGATAGTCGTACTGCA-1_V12D07-335_C1,0,0,0,0,0,0
CGCATGCCGAATGCGT-1_V12D07-335_C1,1,1,0,0,0,2
CTCTAGCCCTCGGAAA-1_V12D07-335_C1,0,3,0,0,0,3
TCCAACTCAGCTATCT-1_V12D07-335_C1,1,3,0,0,0,4
GTCTAGTGAGCCGCTT-1_V12D07-335_C1,4,0,0,0,0,4
TACCGAATAATTGTAA-1_V12D07-335_C1,0,1,0,0,0,1
ATATAACACGGGCGCA-1_V12D07-335_C1,1,1,0,0,0,2
GCATGCTAATAACGAT-1_V12D07-335_C1,3,0,0,0,0,3
TCCGGGCTTGACGGGA-1_V12D07-335_C1,2,3,0,0,0,5
ATTATTCAGAGTCACT-1_V12D07-335_C1,0,1,0,0,1,2
TAGCAGTATGACTAAA-1_V12D07-335_C1,1,1,0,0,0,2
TATGAAGAATTAAGGT-1_V12D07-335_C1,0,0,1,0,0,1
CAAGGCCAGTGGTGCA-1_V12D07-335_C1,1,2,0,0,0,3
TGCGTACGGCTAATTG-1_V12D07-335_C1,2,0,1,0,0,3
CAGATAATGGGCGGGT-1_V12D07-335_C1,2,2,0,0,0,4
GAGAACGGTTCTGACT-1_V12D07-335_C1,0,0,0,0,0,0
CGCTTCGGTCTAAGAC-1_V12D07-335_C1,1,2,0,1,0,4
AGCATTACGAGGCAAG-1_V12D07-335_C1,1,0,0,0,1,2
AAGTTGTGATGTTATA-1_V12D07-335_C1,1,0,0,0,0,1
TTGCTCATAGTACGTG-1_V12D07-335_C1,0,0,0,0,0,0
TACTTAAACATGTACA-1_V12D07-335_C1,1,0,0,0,0,1
AGTGAGTCGAATTAAC-1_V12D07-335_C1,2,1,0,0,0,3
TAGGCCTATATAGTCT-1_V12D07-335_C1,0,2,0,1,0,3
ACTCGCCGTTCGATAA-1_V12D07-335_C1,1,0,0,0,0,1
GGTACGTTGCGGCCGG-1_V12D07-335_C1,0,2,0,1,0,3
TATTGCCGGGCTTGTA-1_V12D07-335_C1,1,1,0,0,0,2
GGTAAACTCTGCGCTG-1_V12D07-335_C1,3,0,0,0,0,3
TCCCTTGTCTGAAACT-1_V12D07-335_C1,2,1,0,0,0,3
CATGATCGCTTTGAGA-1_V12D07-335_C1,1,2,0,0,0,3
GGACGGGCGACCAACC-1_V12D07-335_C1,2,1,0,0,0,3
GAGAGGCCTATGTGTA-1_V12D07-335_C1,1,0,0,0,0,1
TCGTAACTCCCAAGAC-1_V12D07-335_C1,1,0,0,0,0,1
CGTATCTAGAACTAAG-1_V12D07-335_C1,1,1,0,0,0,2
GCACCTTCCCGAAGGT-1_V12D07-335_C1,2,0,0,0,0,2
TACCTCTTTACCATCC-1_V12D07-335_C1,3,0,0,0,0,3
TGACTCTAACTGGTAA-1_V12D07-335_C1,3,0,0,0,0,3
GAGAAACTGGATCCCA-1_V12D07-335_C1,3,2,0,0,0,5
ATCCGGACCAGCCTGA-1_V12D07-335_C1,2,0,0,0,0,2
TTATTTAGGTTCCTTA-1_V12D07-335_C1,3,2,0,0,0,5
CGAATTCCCGGTTCAA-1_V12D07-335_C1,1,0,0,0,0,1
TAGTTTGATCGGTCGC-1_V12D07-335_C1,0,0,0,0,0,0
AGTCGAAACGATTCAG-1_V12D07-335_C1,0,0,0,0,0,0
ACGTCGGGCAACTCGG-1_V12D07-335_C1,0,1,0,0,0,1
ACTTGCTCTATCTACC-1_V12D07-335_C1,1,3,0,1,0,5
ATTACGGGCTACGGTT-1_V12D07-335_C1,2,0,0,0,1,3
GCAAACGTAAGCGACC-1_V12D07-335_C1,0,1,0,0,0,1
TTCGGACTGGGCATGG-1_V12D07-335_C1,1,0,0,0,0,1
GGGCCATTCGTGCTGG-1_V12D07-335_C1,2,2,0,0,0,4
GAGTTGTCACCAGTCT-1_V12D07-335_C1,2,2,0,0,0,4
AGTAATTTGCAAGCGT-1_V12D07-335_C1,0,0,0,0,0,0
GTGGCCGGTTTCTCGG-1_V12D07-335_C1,0,2,0,0,0,2
ATCTTAGGGCATTAAT-1_V12D07-335_C1,0,0,0,0,0,0
CTACATATCGCGGGAC-1_V12D07-335_C1,1,1,0,0,0,2
ATGGTATTTACTGATT-1_V12D07-335_C1,1,5,1,0,2,9
CCGTCAACCTCTGGCG-1_V12D07-335_C1,0,1,0,0,0,1
GCTTCGACGTTCAATC-1_V12D07-335_C1,0,0,0,0,0,0
GACCGATTAAATATGT-1_V12D07-335_C1,1,1,0,0,1,3
GTCGAATTTGGGCGCT-1_V12D07-335_C1,1,0,1,0,0,2
TCACGGCCCAAGAGAG-1_V12D07-335_C1,1,1,0,1,0,3
CTACGATCCTATCCTA-1_V12D07-335_C1,0,3,1,0,0,4
TGCAGTGGTAGGGAAC-1_V12D07-335_C1,1,2,0,0,0,3
TTGCCTAATCCAAAGT-1_V12D07-335_C1,0,0,0,0,0,0
AGCGAGACGTGAAGGC-1_V12D07-335_C1,0,3,1,0,0,4
TTCTACCTCAATCGGT-1_V12D07-335_C1,0,2,0,0,0,2
TACGCTGCTGTGTTAA-1_V12D07-335_C1,1,2,0,0,0,3
TAGTCCTGCACTAAGC-1_V12D07-335_C1,1,1,0,0,0,2
AGCACACGTTTAGACT-1_V12D07-335_C1,1,1,0,0,1,3
GTTCGACAATTGTATA-1_V12D07-335_C1,1,1,0,2,0,4
CCATGTTCATCTATAT-1_V12D07-335_C1,1,2,0,0,1,4
CCCTCGATAATACACA-1_V12D07-335_C1,0,1,0,0,0,1
ACTGCCCGCCATTCTC-1_V12D07-335_C1,1,1,0,1,0,3
CTATATCCAGCCTGGC-1_V12D07-335_C1,3,1,0,0,0,4
CGCACGTCTGTTTATG-1_V12D07-335_C1,0,0,0,0,0,0
AATCAGGTTTCATTTA-1_V12D07-335_C1,1,1,0,1,0,3
AGAGAAACACCAGAAA-1_V12D07-335_C1,0,0,0,1,0,1
ACCCGATTGGTTCCGA-1_V12D07-335_C1,0,0,0,0,0,0
TACCAGGAATCCCGTC-1_V12D07-335_C1,1,4,0,0,1,6
AAGTGCTTCTCTATTG-1_V12D07-335_C1,1,1,0,0,0,2
TGCATGTGACCCATAG-1_V12D07-335_C1,0,2,0,0,0,2
TAGATTCAAAGTGCGG-1_V12D07-335_C1,0,0,0,0,0,0
AGGGTCAGAGCACTCG-1_V12D07-335_C1,0,0,0,0,1,1
GTGAGATAACCTTATA-1_V12D07-335_C1,1,1,0,0,1,3
GTGTCAGTGTACGTGG-1_V12D07-335_C1,1,0,0,0,2,3
CTGTAGTGAGGATCGA-1_V12D07-335_C1,0,0,0,0,0,0
GATAGTGCGAGTAAGT-1_V12D07-335_C1,1,0,0,0,1,2
AGGGTTCAGACGGTCC-1_V12D07-335_C1,0,2,0,0,0,2
GGACTCGACAGCGCAT-1_V12D07-335_C1,0,2,0,0,0,2
CACTCTCAAGCATCGA-1_V12D07-335_C1,1,0,0,0,1,2
GAGCGGAATGCGGTGT-1_V12D07-335_C1,0,1,0,0,1,2
CAGTTCGAGGACCCGA-1_V12D07-335_C1,0,2,0,0,1,3
CGTAACTTCGACACTT-1_V12D07-335_C1,0,0,0,0,1,1
TGATCACCACACTGAC-1_V12D07-335_C1,0,3,2,0,0,5
CATACTTCTTTCTCCG-1_V12D07-335_C1,0,0,0,0,1,1
CAAGTAAGTGATAGAC-1_V12D07-335_C1,1,3,0,0,0,4
AGCCCGCAACAAGCAG-1_V12D07-335_C1,1,3,0,0,2,6
GCTCCATGCAAAGCAA-1_V12D07-335_C1,0,0,0,0,1,1
TCGTACCGACGTCAAG-1_V12D07-335_C1,1,2,0,2,1,6
ATTATCGGAATGTACG-1_V12D07-335_C1,1,0,0,0,2,3
ACCTACTATAAATCTA-1_V12D07-335_C1,2,1,0,0,3,6
TATCCTATCAACTGGT-1_V12D07-335_C1,0,0,0,0,2,2
GCGCGGTCTAGTAACT-1_V12D07-335_C1,1,2,0,0,0,3
CCTTCGTATAGAATCC-1_V12D07-335_C1,2,3,0,0,0,5
TGGGCGATACAATAAG-1_V12D07-335_C1,2,0,1,0,0,3
TGACATGTAACGTGAC-1_V12D07-335_C1,1,1,0,1,1,4
TTGGGAAGACGAGCCG-1_V12D07-335_C1,1,1,2,0,0,4
GGTGTAAATCGATTGT-1_V12D07-335_C1,1,0,0,0,0,1
GAACTGTGGAGAGACA-1_V12D07-335_C1,1,0,0,0,0,1
TCCACATCGTATATTG-1_V12D07-335_C1,0,1,0,0,0,1
CCTATGGTCAAAGCTG-1_V12D07-335_C1,0,0,0,0,0,0
TCCTTGTCCTTTAATT-1_V12D07-335_C1,2,2,0,0,0,4
AAGTTTATGGGCCCAA-1_V12D07-335_C1,0,0,0,0,0,0
GTCCGGGTTCACATTA-1_V12D07-335_C1,2,2,0,0,0,4
ATGTAGCGCGCGTAGG-1_V12D07-335_C1,2,0,0,0,0,2
TACGGAAGCCAAACCA-1_V12D07-335_C1,1,1,0,0,0,2
GCCCTGAGGATGGGCT-1_V12D07-335_C1,2,0,0,0,0,2
CGGGCGATGGATCACG-1_V12D07-335_C1,1,0,0,0,0,1
TGCGGACTTGACTCCG-1_V12D07-335_C1,0,2,0,0,0,2
TAATACTAGAACAGAC-1_V12D07-335_C1,0,3,0,0,0,3
TCAAATTGTTGTGCCG-1_V12D07-335_C1,1,1,0,0,0,2
GGGCAGTCAACGCCAA-1_V12D07-335_C1,0,1,0,0,0,1
TCGCTGCCAATGCTGT-1_V12D07-335_C1,0,0,1,0,0,1
TACGTGGGCCCAGGGC-1_V12D07-335_C1,0,0,0,1,0,1
GCCTACGTTCTGTGCA-1_V12D07-335_C1,4,2,0,0,2,8
TTGCGTGTGTAGGCAT-1_V12D07-335_C1,1,1,0,0,0,2
TCCTAAAGATTCAGAC-1_V12D07-335_C1,0,0,0,1,0,1
TGGGTGCACAAGCCAT-1_V12D07-335_C1,0,0,0,1,0,1
GGGAGCGACCGTAGTG-1_V12D07-335_C1,0,0,0,0,0,0
CATAGAGGAGATACTA-1_V12D07-335_C1,1,1,0,1,0,3
CTTCGATTGCGCAAGC-1_V12D07-335_C1,1,1,0,0,0,2
GTGCCTGAGACCAAAC-1_V12D07-335_C1,0,3,0,0,0,3
TCATCCTCAGCTGCTT-1_V12D07-335_C1,2,0,0,0,0,2
TGCAACTACTGGTTGA-1_V12D07-335_C1,0,0,0,0,0,0
ATGTTGATTAGAGACT-1_V12D07-335_C1,0,0,0,0,0,0
GTTTCTAGAGGCGCGG-1_V12D07-335_C1,2,0,0,0,0,2
TACAAGGGCTTCTTTA-1_V12D07-335_C1,0,4,1,0,0,5
ACAGGCACGGATCCTT-1_V12D07-335_C1,0,1,0,0,2,3
CCCAAGTCATTACACT-1_V12D07-335_C1,1,1,0,0,0,2
ACTCTGACCTAATAGA-1_V12D07-335_C1,3,1,0,0,0,4
GGATGGCTTGAAGTAT-1_V12D07-335_C1,3,0,0,0,0,3
ACCCTCCCGTCAGGGC-1_V12D07-335_C1,0,1,0,0,0,1
AGCTTCTTCTCGAGCA-1_V12D07-335_C1,0,0,0,0,0,0
TTGCGCTTGATCAATA-1_V12D07-335_C1,2,0,1,1,0,4
TGGGTGTAATAGATTT-1_V12D07-335_C1,2,1,0,1,0,4
CATGGTTTATTAATCA-1_V12D07-335_C1,0,2,0,0,0,2
TTGCCTTCTCGCCGGG-1_V12D07-335_C1,1,3,0,0,1,5
TTAAAGTAAGTCGCCA-1_V12D07-335_C1,1,2,0,0,0,3
AGTTGGCAAGGCTAGA-1_V12D07-335_C1,1,1,0,0,0,2
CCGCACTTGCAATGAC-1_V12D07-335_C1,3,1,0,0,0,4
AATGTTGTCGTGAGAC-1_V12D07-335_C1,1,0,0,2,0,3
CCAAGGTTGCCCTTTC-1_V12D07-335_C1,1,3,0,0,0,4
TGTGACTAGAGTTTGC-1_V12D07-335_C1,3,4,0,0,0,7
TTGTGATCTGTTCAGT-1_V12D07-335_C1,0,2,0,0,0,2
GGAGTTGATTCTGTGT-1_V12D07-335_C1,0,0,0,0,0,0
GTAGTGAGCAACCTCA-1_V12D07-335_C1,1,1,0,0,0,2
AAGACATACGTGGTTT-1_V12D07-335_C1,2,3,1,0,0,6
CATCCCGAGATTCATA-1_V12D07-335_C1,0,2,0,0,0,2
GGCCGCAGGAACCGCA-1_V12D07-335_C1,3,0,0,0,0,3
CCAGAAACTGATGCGA-1_V12D07-335_C1,1,2,0,0,1,4
ACCCGTAGTCTAGTTG-1_V12D07-335_C1,2,0,0,0,0,2
AGGGTCTGGACGCAGT-1_V12D07-335_C1,0,1,0,0,2,3
TTGAAACCCTCATTCC-1_V12D07-335_C1,1,2,0,0,0,3
TCAATCCCGCGCCAAA-1_V12D07-335_C1,0,0,0,0,0,0
AGGACATCGGCACACT-1_V12D07-335_C1,0,0,0,0,0,0
GACAAGACGCCCGTGC-1_V12D07-335_C1,0,3,0,0,0,3
GAGTAAATTAAGAACC-1_V12D07-335_C1,1,1,0,0,0,2
TAAGTCGGTGAGCTAG-1_V12D07-335_C1,2,0,0,0,0,2
CTTACTGACTCCTCTG-1_V12D07-335_C1,0,0,0,0,0,0
TTAACTGATCGTTTGG-1_V12D07-335_C1,0,0,0,0,0,0
GGGCGATCCATAGGCC-1_V12D07-335_C1,0,2,0,0,0,2
CGTATTGTTTGGCGCC-1_V12D07-335_C1,1,2,0,0,1,4
CGCGTGGGCCTGTGTT-1_V12D07-335_C1,0,0,0,0,0,0
AAATCTGCCCGCGTCC-1_V12D07-335_C1,0,0,0,0,1,1
GCTGAAGGGTTCTTGG-1_V12D07-335_C1,1,2,0,0,0,3
TAATTGCGCTGATTAC-1_V12D07-335_C1,0,1,0,0,1,2
TCGCGCGTTTACATGA-1_V12D07-335_C1,1,1,0,0,0,2
TAACTGAAATACGCCT-1_V12D07-335_C1,0,3,0,0,0,3
CCTGTCGTGTATGAAG-1_V12D07-335_C1,1,0,0,0,0,1
CGGGAACGCCCTGCAT-1_V12D07-335_C1,0,1,0,0,0,1
AGTTGCGGTCCTCAAC-1_V12D07-335_C1,0,0,0,0,0,0
GGGTCCTTGGAAGAAG-1_V12D07-335_C1,0,0,0,0,0,0
CGGGAAGTACCGTGGC-1_V12D07-335_C1,0,1,0,0,0,1
ACGGTCACCGAGAACA-1_V12D07-335_C1,0,0,0,0,0,0
TAGACTCAGTTGGCCT-1_V12D07-335_C1,1,1,0,0,0,2
CCTTCCGCAACGCTGC-1_V12D07-335_C1,0,1,0,0,0,1
CAGTGTTAATCTCTCA-1_V12D07-335_C1,1,0,0,0,0,1
CAGGCCAGTACCACCT-1_V12D07-335_C1,0,0,0,0,2,2
GATCGCTGTGGTGCGT-1_V12D07-335_C1,1,0,1,0,0,2
GTATCTCGGGCGCTTT-1_V12D07-335_C1,0,0,1,0,1,2
CCGGGCTAAGAATTTC-1_V12D07-335_C1,0,1,0,0,0,1
CTTCACGCCCTGGTAC-1_V12D07-335_C1,0,0,0,0,0,0
CGGATGAATGCTGTGA-1_V12D07-335_C1,2,1,0,0,0,3
CTCTGCAGGCATTCTT-1_V12D07-335_C1,2,1,0,0,2,5
TCAAAGTCACGGCGTC-1_V12D07-335_C1,1,0,1,0,2,4
TGGGTTTCGGGCGTAC-1_V12D07-335_C1,3,1,0,0,0,4
TGCTATGGCAAAGGGA-1_V12D07-335_C1,2,0,0,0,0,2
TTCACGGTCGTCACGT-1_V12D07-335_C1,0,4,0,2,1,7
CGTAAAGCAAGAAATC-1_V12D07-335_C1,1,0,0,1,0,2
CTGATCCCTTTATGCA-1_V12D07-335_C1,3,1,0,1,0,5
GAGTATACCCTAATCA-1_V12D07-335_C1,0,0,0,0,0,0
CCACGGCAGGTGTAGG-1_V12D07-335_C1,2,1,0,0,0,3
ACGTACTTTGGCACGG-1_V12D07-335_C1,0,1,0,0,1,2
CCTGAGAATAAATGCA-1_V12D07-335_C1,0,1,0,0,0,1
TTGATGCCGCTCGTCG-1_V12D07-335_C1,0,0,0,1,0,1
GCCAGGAAAGAACACT-1_V12D07-335_C1,0,0,0,0,0,0
TCCGACCGCTAATCAA-1_V12D07-335_C1,0,0,0,0,0,0
TATATCAAAGTGATCT-1_V12D07-335_C1,0,0,0,0,2,2
CCTCGGTTTCCTTGCC-1_V12D07-335_C1,3,0,0,1,0,4
TAAATTTAGTAACACC-1_V12D07-335_C1,0,2,0,0,3,5
CTCGTTACGGCTACCA-1_V12D07-335_C1,1,0,0,0,1,2
GCCGTCGGTTTCGGGC-1_V12D07-335_C1,0,0,0,0,0,0
GTTCCGTCCGCCTGCA-1_V12D07-335_C1,1,0,0,0,0,1
CTAGGGATAGGGACAA-1_V12D07-335_C1,1,0,0,0,0,1
GTCCAGGCACGTGTGC-1_V12D07-335_C1,0,1,2,0,1,4
GAGGAATATCTCTTTG-1_V12D07-335_C1,0,0,0,0,0,0
CGTTCAAGGAAACGGA-1_V12D07-335_C1,1,0,1,0,0,2
GTGGGAACAAACCGGG-1_V12D07-335_C1,0,0,0,0,0,0
GGGCACGTAGTACTGT-1_V12D07-335_C1,0,0,0,0,0,0
ACTACAAAGAGAGGTG-1_V12D07-335_C1,0,2,0,0,1,3
GGTGTAGGTAAGTAAA-1_V12D07-335_C1,0,2,0,0,0,2
CCTGTTCAACCTCGGG-1_V12D07-335_C1,0,1,0,0,1,2
TGAGGTGTGTGGCGGA-1_V12D07-335_C1,2,0,4,0,11,17
ATTGTCTGTTTCATGT-1_V12D07-335_C1,0,0,1,0,4,5
GCCGGTCGTATCTCTC-1_V12D07-335_C1,0,0,0,0,2,2
ATATGGGATAGCAACT-1_V12D07-335_C1,0,0,0,0,2,2
GATAGAACCCGCTAGG-1_V12D07-335_C1,0,0,0,0,0,0
ATCCCATTTCCGTGGG-1_V12D07-335_C1,0,2,0,0,2,4
GATGCTACCTTCGATG-1_V12D07-335_C1,0,0,0,0,3,3
TGCAAAGTTCGTCTGT-1_V12D07-335_C1,0,4,0,0,0,4
GTTCAGTCGCCAAATG-1_V12D07-335_C1,0,4,0,1,0,5
GTCTCCGCCTCAATAC-1_V12D07-335_C1,0,2,0,0,0,2
AGTAGAAGGCGCCTCA-1_V12D07-335_C1,0,3,0,0,1,4
GTTGTAGATTTATGAG-1_V12D07-335_C1,0,1,0,0,2,3
CTATTTGCTTGGAGGA-1_V12D07-335_C1,2,2,0,0,0,4
AGCCATATAGTATGTG-1_V12D07-335_C1,0,4,0,0,1,5
TGTTCCGGCCTGAGCT-1_V12D07-335_C1,1,0,0,0,0,1
TGCCGTGGGACCCAAT-1_V12D07-335_C1,0,0,2,0,1,3
TTGCAAGAAGACTCCT-1_V12D07-335_C1,1,0,0,0,0,1
CCGCTCCAGGGCGATC-1_V12D07-335_C1,0,4,0,1,0,5
CAAACCCTCCGGCGGG-1_V12D07-335_C1,0,0,0,0,0,0
CGGACCTTTACGTCCC-1_V12D07-335_C1,1,0,0,0,2,3
ACGTAGGAGAGTCGCT-1_V12D07-335_C1,0,1,0,0,0,1
CTGCGACCTCGCCGAA-1_V12D07-335_C1,1,0,0,0,0,1
GGCCCAGCTGGTTTGC-1_V12D07-335_C1,3,0,0,0,0,3
GGATTAATCATGGACC-1_V12D07-335_C1,1,0,0,0,0,1
GAGATGGCTTTAATCA-1_V12D07-335_C1,1,0,0,0,0,1
AGTACAGAAGCTTATA-1_V12D07-335_C1,2,1,0,1,0,4
GCGGCTTTAGCAAGTT-1_V12D07-335_C1,1,2,0,0,1,4
ACCGAGTCTCCTTATT-1_V12D07-335_C1,0,1,0,1,0,2
GACCACACTTCCCTTT-1_V12D07-335_C1,2,0,0,0,0,2
TGTAGCCAATTCCGTT-1_V12D07-335_C1,2,1,0,0,0,3
CTCGTCTGTGCCTTCG-1_V12D07-335_C1,2,1,0,1,0,4
GGACTCTTTGACTAAG-1_V12D07-335_C1,1,0,0,0,0,1
TCATCGACGACCGTCG-1_V12D07-335_C1,0,0,0,0,0,0
TACTACGTGCAATGCG-1_V12D07-335_C1,0,0,0,0,0,0
CCCTACTTGAACAATG-1_V12D07-335_C1,2,0,0,1,0,3
GCAGCTGTCAACGCAT-1_V12D07-335_C1,0,0,0,0,0,0
ATCTACCATCTGCTCC-1_V12D07-335_C1,1,1,0,0,0,2
TCTCAAATCAATCGGG-1_V12D07-335_C1,1,2,0,1,0,4
ACTCCGGCCGACCACT-1_V12D07-335_C1,1,0,0,0,0,1
TACACCTCTTCGAATC-1_V12D07-335_C1,2,0,0,0,1,3
GTGGCTGTTTCTGTTC-1_V12D07-335_C1,1,0,0,0,0,1
ACGACTCTAGGGCCGA-1_V12D07-335_C1,1,0,0,0,0,1
TCGTTTACGCGACCCT-1_V12D07-335_C1,0,0,0,1,0,1
AGGATATCCGACTGCA-1_V12D07-335_C1,1,1,0,0,0,2
GACACTTCCAATTACC-1_V12D07-335_C1,0,0,0,0,0,0
ACGGTACAGTTCAATG-1_V12D07-335_C1,0,4,0,2,0,6
CTTGATGACCATCCAG-1_V12D07-335_C1,1,1,0,0,0,2
CTGGTAAAGACTTACA-1_V12D07-335_C1,1,0,1,0,0,2
CTTGCCCACCCACGCA-1_V12D07-335_C1,1,1,0,0,0,2
CATTACGCAGGAAGGG-1_V12D07-335_C1,3,1,0,0,0,4
GGACAACCATGAAGCC-1_V12D07-335_C1,0,3,0,0,0,3
GTTATCAAGCTATCGA-1_V12D07-335_C1,0,2,0,0,0,2
AGGTGCACGTCCACAT-1_V12D07-335_C1,1,2,0,0,1,4
AAAGAATGTGGACTAA-1_V12D07-335_C1,0,1,0,0,1,2
ACCAAGTCATCGGCAG-1_V12D07-335_C1,1,0,0,0,0,1
AGTAACTATAGCAGCC-1_V12D07-335_C1,0,1,0,0,0,1
GGGAAAGAATGCCAAC-1_V12D07-335_C1,0,1,0,0,0,1
AATCGGTATAGCCCTC-1_V12D07-335_C1,0,2,1,1,0,4
GGCACTGCGGTGGTTT-1_V12D07-335_C1,1,0,0,1,0,2
CGTCCTCATCGCGTGC-1_V12D07-335_C1,1,0,0,0,0,1
CTTAACTTACAGTATA-1_V12D07-335_C1,1,0,0,0,0,1
GTGAGTCGACTAATAG-1_V12D07-335_C1,1,1,1,0,0,3
TGTACTTCCGGGCATG-1_V12D07-335_C1,0,0,0,0,0,0
CACAAACCGCAGAACT-1_V12D07-335_C1,2,2,0,1,0,5
GCTTTACACAACTGGG-1_V12D07-335_C1,1,2,0,0,0,3
CACCGATGATGGGTAC-1_V12D07-335_C1,1,0,0,0,0,1
TCAATATACAGGAGGC-1_V12D07-335_C1,1,0,1,1,0,3
AACGACCTCCTAGCCG-1_V12D07-335_C1,1,2,0,0,0,3
GTTACCAAGGCGTACG-1_V12D07-335_C1,0,1,0,0,0,1
TAGCTCACTGTGTTTG-1_V12D07-335_C1,0,0,0,0,0,0
TCGGCAGGGTTAAGGG-1_V12D07-335_C1,0,1,0,0,0,1
TGTTAACAAAGTGACT-1_V12D07-335_C1,2,0,0,0,0,2
CAGAGCGATGGATGCT-1_V12D07-335_C1,1,1,0,0,0,2
CATAGTGGGCACGCCT-1_V12D07-335_C1,0,0,0,0,0,0
AAACGCTGGGCACGAC-1_V12D07-335_C1,1,0,0,0,0,1
TGTTCTCATACTATAG-1_V12D07-335_C1,1,0,0,0,0,1
TCCGCTGGGTCGATCG-1_V12D07-335_C1,2,0,0,0,0,2
TTAGCATCCCTCACGT-1_V12D07-335_C1,0,2,0,0,0,2
AGCCTTGTCACTGATA-1_V12D07-335_C1,0,0,0,0,0,0
GTTTCTTGTTAGAGCT-1_V12D07-335_C1,1,2,0,0,1,4
TCGGAGTCCTGGTTGC-1_V12D07-335_C1,1,0,0,0,1,2
ACGGGTTGTGACCTGT-1_V12D07-335_C1,0,0,0,0,0,0
TGACAGAAATCTTGCT-1_V12D07-335_C1,2,1,1,0,0,4
TAGCCATGATTGCCTA-1_V12D07-335_C1,1,0,0,0,0,1
CGAAGCCACAGCATGG-1_V12D07-335_C1,1,1,0,0,0,2
ACCCGTAGCAGAGAAT-1_V12D07-335_C1,0,0,1,0,0,1
AGCTTGATCAGGGTAG-1_V12D07-335_C1,1,3,0,0,1,5
CTATAAGTAGGGTTTG-1_V12D07-335_C1,1,0,0,0,0,1
TATAGTTAGGTGTACT-1_V12D07-335_C1,0,0,0,0,0,0
TACGCTGATAGTTGTA-1_V12D07-335_C1,0,0,0,0,0,0
TTCTCAATTGCTACAA-1_V12D07-335_C1,1,3,0,0,0,4
GTTGCCCTAACGGGTG-1_V12D07-335_C1,1,0,0,0,0,1
GACATTTCGCCCAGCC-1_V12D07-335_C1,0,0,0,0,0,0
GTAACTACGTAGACCT-1_V12D07-335_C1,1,0,0,0,1,2
CCAGTGTACAGACCGA-1_V12D07-335_C1,0,0,0,1,0,1
GCCCGATGCCCAGTTC-1_V12D07-335_C1,0,1,0,0,1,2
CGAACCTCTTTCCTAG-1_V12D07-335_C1,0,1,0,0,0,1
CATGCACATGAGAGGC-1_V12D07-335_C1,0,0,0,1,5,6
CCAAATCAAAGGGCAA-1_V12D07-335_C1,0,4,0,1,1,6
GTAGTTTAAGCACACG-1_V12D07-335_C1,0,0,0,0,2,2
TAAGTGAATAGTCTAC-1_V12D07-335_C1,0,1,0,0,0,1
GGTCCACGTCTATTTG-1_V12D07-335_C1,1,0,0,0,1,2
CCCTCAGATCGAGAAC-1_V12D07-335_C1,0,0,0,0,1,1
ACATTCGCGCGGAATA-1_V12D07-335_C1,0,0,0,1,0,1
CTATGAACACCTTGCC-1_V12D07-335_C1,0,0,0,0,1,1
CGAATGGTAGGTCGTC-1_V12D07-335_C1,0,0,0,0,2,2
TCGACATAGCGTAGCG-1_V12D07-335_C1,0,1,0,0,0,1
GACGTTGCTCGGCGGC-1_V12D07-335_C1,0,1,0,0,0,1
CTCGAGGCAAGTTTCA-1_V12D07-335_C1,0,0,0,0,2,2
GCTGGGAGCGCGTCAA-1_V12D07-335_C1,0,3,0,0,0,3
GACGATATCACTGGGT-1_V12D07-335_C1,2,2,1,0,0,5
CAGCTCTGGGCTCACT-1_V12D07-335_C1,0,0,0,0,1,1
TAGTCTGCGGCACATT-1_V12D07-335_C1,0,0,0,0,0,0
TGGTCGATATACCTCT-1_V12D07-335_C1,0,0,0,0,2,2
TTCAGTTCAAGAGGAG-1_V12D07-335_C1,2,1,0,0,0,3
GTCTGTAGGTTGAACA-1_V12D07-335_C1,0,1,0,0,0,1
GAGAGTCTCGGGAGAG-1_V12D07-335_C1,0,1,0,0,0,1
TTGTTTGTATTACACG-1_V12D07-335_C1,0,0,0,0,0,0
GCACAGCACGGGCCGA-1_V12D07-335_C1,1,0,0,1,1,3
AAACAGTGTTCCTGGG-1_V12D07-335_C1,1,0,0,0,1,2
TGGAGAATAATCGTCC-1_V12D07-335_C1,1,1,0,0,1,3
CGCCGCGTTCTGAACG-1_V12D07-335_C1,0,0,0,0,1,1
CATGCGTTGAGAGGAG-1_V12D07-335_C1,0,0,1,0,3,4
TACGCTCCTAGAACTG-1_V12D07-335_C1,0,0,0,0,0,0
CCTTGTGAACGTGGTT-1_V12D07-335_C1,0,0,0,0,1,1
TTAAAGGCGATGCTCG-1_V12D07-335_C1,0,1,0,0,1,2
TAAAGTGCACGTCTCG-1_V12D07-335_C1,0,1,0,0,2,3
TGTCCGCAAACAATTC-1_V12D07-335_C1,0,1,0,0,0,1
AGGCCTATCATACCAA-1_V12D07-335_C1,0,1,0,0,2,3
ACTGGGATGCCAGTGC-1_V12D07-335_C1,0,0,0,0,1,1
CGATCCACCATTGTTG-1_V12D07-335_C1,0,1,0,0,1,2
GGGCATGCATGTCGAG-1_V12D07-335_C1,0,1,0,0,4,5
TCCAGGCAGGACGATC-1_V12D07-335_C1,0,4,0,0,1,5
CAATGACCCTTAATTT-1_V12D07-335_C1,1,4,0,0,1,6
ATCAAGATCCCAGGAC-1_V12D07-335_C1,0,1,0,0,2,3
CTCAGAGCTAATGTCG-1_V12D07-335_C1,1,1,0,0,1,3
CTGCGATTTCGAGATT-1_V12D07-335_C1,0,4,0,0,1,5
ATGGTATTGGGAACCG-1_V12D07-335_C1,1,1,0,0,4,6
TAGGTTCTGCTGAGAA-1_V12D07-335_C1,0,0,0,0,1,1
GCCTGTCCCGGTGCAT-1_V12D07-335_C1,2,0,0,1,2,5
GGCCTGCTCTGATGTT-1_V12D07-335_C1,0,0,0,0,0,0
TAGAGGGAGTTTATCT-1_V12D07-335_C1,0,1,0,0,0,1
CTCTACATCCTGCGTG-1_V12D07-335_C1,0,0,1,0,0,1
ACACATTTCCGTAGAC-1_V12D07-335_C1,1,3,0,0,0,4
TGGGTGTTAAGTAGAA-1_V12D07-335_C1,0,0,0,1,2,3
GAGCTCAACATGAGCG-1_V12D07-335_C1,0,0,0,0,0,0
GCACACAGCTATTACC-1_V12D07-335_C1,0,2,0,0,1,3
GCGACGGTAGTCTCCT-1_V12D07-335_C1,0,0,0,0,1,1
GTATCAAGGTACTTCC-1_V12D07-335_C1,0,0,0,0,0,0
GGAAAGGGAATTGAGC-1_V12D07-335_C1,0,1,0,0,2,3
TACACAGCCGTGGTGC-1_V12D07-335_C1,1,0,0,0,0,1
CGGTTGGGCAGGGTCC-1_V12D07-335_C1,0,0,0,0,0,0
GCACGCCGATTCCCGC-1_V12D07-335_C1,0,0,0,0,0,0
CGCTTTCCGCCAAGGT-1_V12D07-335_C1,0,0,0,0,0,0
TGCCCGATAGTTAGAA-1_V12D07-335_C1,0,0,0,0,0,0
TCAGAACGGCGGTAAT-1_V12D07-335_C1,0,0,0,0,0,0
CCACTCAGATCCGCAA-1_V12D07-335_C1,0,0,0,0,0,0
GAAGGGTCATTAAGAC-1_V12D07-335_C1,0,0,0,0,0,0
GCGGTCTTGCTTTCAC-1_V12D07-335_C1,0,1,0,0,0,1
GGAAGGACACCGTATA-1_V12D07-335_C1,0,0,0,0,0,0
CGCGGGAATTCCTTTC-1_V12D07-335_C1,0,0,1,0,0,1
TCTATCCGATTGCACA-1_V12D07-335_C1,0,1,1,0,0,2
TACTCGTTTGAATCAA-1_V12D07-335_C1,0,0,0,0,0,0
GTCTGCCGACTCGACG-1_V12D07-335_C1,1,1,0,2,0,4
TACGGGTAATAACATA-1_V12D07-335_C1,1,1,0,0,0,2
CCAGTTCGGTAACTCA-1_V12D07-335_C1,1,3,0,2,0,6
CGTGCACACCACTGTA-1_V12D07-335_C1,2,1,0,0,0,3
CTTCAGTTGGACAACG-1_V12D07-335_C1,1,1,0,0,0,2
TGATCTATCACACTCT-1_V12D07-335_C1,2,0,0,0,0,2
TAGCAGATACTTAGGG-1_V12D07-335_C1,1,1,0,1,1,4
CACCGGGCATCACAAG-1_V12D07-335_C1,0,0,0,0,0,0
AGTGGCCCGCAAATGG-1_V12D07-335_C1,0,1,0,0,0,1
CTCGCTAGGTAAGCGA-1_V12D07-335_C1,0,1,0,0,1,2
GATAGATAGTACAGTC-1_V12D07-335_C1,2,1,0,1,0,4
CGAGACTACTGCTGCT-1_V12D07-335_C1,3,3,0,0,0,6
ACATTTGAAACCTAAC-1_V12D07-335_C1,2,1,0,0,0,3
GACACAGCCGGGACTG-1_V12D07-335_C1,0,4,0,0,0,4
ACGGAACACGAGTGCC-1_V12D07-335_C1,0,1,0,0,0,1
ACGCCAGTGCGTTTGC-1_V12D07-335_C1,1,2,1,0,0,4
GCACCTAGGCGAGTCC-1_V12D07-335_C1,2,0,0,0,0,2
TCACTATCCCTTCGGT-1_V12D07-335_C1,0,2,0,0,1,3
TGAGTGTAACAACGGG-1_V12D07-335_C1,0,4,0,0,2,6
ATTGGTTGTGCATTAC-1_V12D07-335_C1,0,0,0,0,0,0
CTGGCGATTTACATGT-1_V12D07-335_C1,2,0,0,0,0,2
TCCACCAAGACATAGG-1_V12D07-335_C1,0,4,0,0,0,4
AACGTCGCTGCACTTC-1_V12D07-335_C1,3,0,0,0,0,3
GTCTCCCGAGTCCCGT-1_V12D07-335_C1,1,3,0,0,0,4
AGCCCGCACTACAATG-1_V12D07-335_C1,0,0,0,1,0,1
GGCACGCTGCTACAGT-1_V12D07-335_C1,2,1,0,1,0,4
GCTTGAGTGACCTCTG-1_V12D07-335_C1,0,0,0,0,0,0
ATAGCCATAACAGTCA-1_V12D07-335_C1,0,0,0,0,0,0
TAGGAGGCTCGAGAAC-1_V12D07-335_C1,0,2,0,0,0,2
GTCGGGTGAAGTACCG-1_V12D07-335_C1,1,1,1,2,0,5
CACCCGCGTTTGACAC-1_V12D07-335_C1,0,1,0,0,0,1
TCTCAGGCTACTCGCT-1_V12D07-335_C1,1,0,0,0,0,1
TAGATTCTCTAGCAAA-1_V12D07-335_C1,2,1,0,0,0,3
CCCATTATTGTATCCT-1_V12D07-335_C1,0,1,0,0,0,1
GTTAATAGCGTCATTA-1_V12D07-335_C1,2,0,0,0,0,2
TACTCATTGACGCATC-1_V12D07-335_C1,2,0,0,0,0,2
TAGTGACAAGCTCTAC-1_V12D07-335_C1,2,0,0,1,1,4
ATCGCCGTGGTTCATG-1_V12D07-335_C1,2,0,0,0,0,2
CTGCTCTCAACACACC-1_V12D07-335_C1,0,0,0,0,0,0
GCATGACACAAAGGAA-1_V12D07-335_C1,0,0,0,0,0,0
CAACGATCGATCCAAT-1_V12D07-335_C1,0,1,0,0,0,1
ATACAGCGTCCACTGA-1_V12D07-335_C1,0,0,1,0,3,4
TCACGATTAATACGTT-1_V12D07-335_C1,0,0,0,0,2,2
CGTGAACTGACCCGAT-1_V12D07-335_C1,2,2,0,0,0,4
TCGATGTTACGGCCGT-1_V12D07-335_C1,0,0,0,0,1,1
GACCGGTGATACTCTC-1_V12D07-335_C1,0,0,1,0,2,3
TCTGTTTAGATTGTTC-1_V12D07-335_C1,1,0,0,0,0,1
GCTACTCGGACGCAGA-1_V12D07-335_C1,0,2,0,0,1,3
AAGAAAGTTTGATGGG-1_V12D07-335_C1,0,0,0,0,1,1
CGCCAGTAGTACCTTG-1_V12D07-335_C1,0,3,0,0,0,3
CTCCCTTGTATCAAGG-1_V12D07-335_C1,1,0,0,1,1,3
ACTTTATACACCACTT-1_V12D07-335_C1,1,0,0,0,0,1
AGATCTGGAGAGGATA-1_V12D07-335_C1,0,0,0,0,1,1
TCATCCATCTGATCAC-1_V12D07-335_C1,2,1,0,0,1,4
AGAACACGGCGATGGT-1_V12D07-335_C1,0,2,0,0,0,2
CCGCTCCGGATAAGCT-1_V12D07-335_C1,1,0,0,0,0,1
TGGTCGGGTACAGGGC-1_V12D07-335_C1,0,0,0,0,1,1
ACGGACGCAGCGACAA-1_V12D07-335_C1,2,1,0,0,3,6
ACATGCTTACGGCAGC-1_V12D07-335_C1,0,0,0,0,1,1
CAGGGAGATAGGCCAG-1_V12D07-335_C1,0,0,0,0,2,2
TCGCCACCCGGATTAC-1_V12D07-335_C1,0,1,0,0,1,2
TCTTGGTCAATGATAC-1_V12D07-335_C1,0,1,1,0,0,2
CATAGGGACACTTGTG-1_V12D07-335_C1,0,2,0,0,2,4
CACGAGCAAACCAGAC-1_V12D07-335_C1,0,0,0,0,1,1
GGGATATTGATCGCCA-1_V12D07-335_C1,0,0,0,1,1,2
TAATGTCGGTTCATGG-1_V12D07-335_C1,0,0,0,0,1,1
CGATTTGTCATTAATG-1_V12D07-335_C1,1,0,0,0,2,3
TTAAGATACCCAGAGA-1_V12D07-335_C1,0,1,0,0,1,2
CGACCGTTGGTATTCG-1_V12D07-335_C1,0,0,0,0,0,0
ACTACCATCCGAGGGC-1_V12D07-335_C1,1,0,1,0,1,3
TCTACGCACGATCTCC-1_V12D07-335_C1,2,1,0,0,1,4
AAGCCACTTGCAGGTA-1_V12D07-335_C1,2,4,0,1,4,11
ACGTTGTCGTTGAAAG-1_V12D07-335_C1,0,2,0,0,0,2
ACCGCTAGTCATTGGT-1_V12D07-335_C1,0,2,0,1,2,5
CATGAGTCCATCACGG-1_V12D07-335_C1,0,1,0,1,0,2
ATGTCTTGTTTGACTC-1_V12D07-335_C1,1,0,0,0,0,1
TCCCAAACATCCTCTA-1_V12D07-335_C1,0,1,0,0,0,1
CAACGCGATGAGCCAA-1_V12D07-335_C1,0,1,0,0,1,2
GACACCCAAAGACGCG-1_V12D07-335_C1,0,1,0,0,0,1
ACGTTCACTATGCCGC-1_V12D07-335_C1,0,3,0,0,1,4
ATGGACTGCTTAGTTG-1_V12D07-335_C1,1,1,0,0,0,2
CCATGGCAAACGCTCA-1_V12D07-335_C1,0,0,0,0,0,0
TTGTCTCGGCAAGATG-1_V12D07-335_C1,1,1,0,0,0,2
TTCGAACGAAACATGC-1_V12D07-335_C1,0,1,0,0,0,1
GGAAAGTCTTGATTGT-1_V12D07-335_C1,0,1,0,0,0,1
ATCATAGATCGACGAG-1_V12D07-335_C1,0,1,0,1,0,2
GATTAGAAACAAGCGT-1_V12D07-335_C1,0,0,0,0,1,1
GCTGCGAAGAATTATT-1_V12D07-335_C1,1,1,0,0,0,2
TTCCAGTGGGTTTCGT-1_V12D07-335_C1,1,0,0,0,0,1
GCTCATTGATCATATC-1_V12D07-335_C1,0,0,0,0,0,0
ATACGAGGTTTGTAAG-1_V12D07-335_C1,1,0,0,0,0,1
GTCTATACACGCATGG-1_V12D07-335_C1,1,1,0,1,1,4
GATTTGCGCTAACACC-1_V12D07-335_C1,0,1,0,0,1,2
TGGTGCCCTGCCTTAC-1_V12D07-335_C1,0,2,0,0,2,4
TCGAATCGCAGGGTAG-1_V12D07-335_C1,0,0,0,0,1,1
GGTAGGCCAATATCAC-1_V12D07-335_C1,0,3,0,0,0,3
CGTAAATAACAAAGGG-1_V12D07-335_C1,0,0,0,1,0,1
GACTCTAGAGTTCCAA-1_V12D07-335_C1,0,2,0,0,2,4
ACTTGTTACCGGATCA-1_V12D07-335_C1,0,1,0,0,0,1
GGCATTGAACATCTCA-1_V12D07-335_C1,0,0,0,0,0,0
AACCCGCTGTATTCCA-1_V12D07-335_C1,0,1,0,0,1,2
TAACAGGTTCCCTTAG-1_V12D07-335_C1,1,2,1,1,0,5
GTTCTTGTAACTCAAT-1_V12D07-335_C1,2,3,0,0,0,5
GATTCTGTTAATGAGT-1_V12D07-335_C1,2,1,0,0,0,3
GGACACCTCGGTGTTG-1_V12D07-335_C1,1,0,1,0,0,2
CGATCGAGAAGCACCA-1_V12D07-335_C1,0,0,0,0,0,0
CTGCTCTGACGGCAAA-1_V12D07-335_C1,0,2,1,0,0,3
CCCAGGAAGAATTCGA-1_V12D07-335_C1,0,0,0,0,0,0
TGTCGTGGGTATAGGC-1_V12D07-335_C1,2,1,0,0,1,4
ATATGTCTAGAGCGTG-1_V12D07-335_C1,1,1,1,0,0,3
GCGGGCAGACGGGTGA-1_V12D07-335_C1,1,1,1,1,0,4
CGAAGATCAGTTTCAT-1_V12D07-335_C1,0,0,0,0,1,1
ACGCCACTCGAAACAG-1_V12D07-335_C1,0,1,0,0,0,1
CTTAGATGTTTCATCC-1_V12D07-335_C1,0,0,0,0,1,1
GCGAATGGACTAGCGA-1_V12D07-335_C1,0,0,0,0,1,1
TAAATTGTGGGTAAAG-1_V12D07-335_C1,0,0,0,0,0,0
ATTTATACTGGTAAAG-1_V12D07-335_C1,0,0,0,0,1,1
GCGTCGTAACATGGTC-1_V12D07-335_C1,0,3,0,0,0,3
CGGTATGGGCACTCTG-1_V12D07-335_C1,0,1,0,0,1,2
CTATCACAACGCTGGA-1_V12D07-335_C1,0,0,0,1,0,1
ACCACACGGTTGATGG-1_V12D07-335_C1,0,0,0,0,0,0
TCAGCGCACGCCGTTT-1_V12D07-335_C1,2,0,0,0,0,2
AATGTTAAGACCCTGA-1_V12D07-335_C1,1,0,0,0,0,1
CTTACATAGATTTCTT-1_V12D07-335_C1,1,1,0,0,0,2
AACATAGCGTGTATCG-1_V12D07-335_C1,2,0,1,0,0,3
AGCAGTCGAAGCATGC-1_V12D07-335_C1,2,0,0,0,1,3
GTACTACGGCCTCGTT-1_V12D07-335_C1,1,0,0,1,0,2
TTGGCCAAATTGTATC-1_V12D07-335_C1,2,0,0,0,0,2
TCAGAGGACGCGTTAG-1_V12D07-335_C1,1,2,0,0,0,3
AGTAATCTAAGGGTGG-1_V12D07-335_C1,1,0,0,0,0,1
AATTATACCCAGCAAG-1_V12D07-335_C1,1,1,0,0,0,2
CCCTACCCACACCCAG-1_V12D07-335_C1,1,0,0,0,0,1
CTCTGTCCATGCACCA-1_V12D07-335_C1,1,4,0,1,0,6
TCGCCTCCTTCGGCTC-1_V12D07-335_C1,3,1,0,0,0,4
CCTGATTCGCGAAGAA-1_V12D07-335_C1,2,6,0,1,0,9
GACTTCAACGCATCAA-1_V12D07-335_C1,0,1,0,0,0,1
GCTTCCCGTAAGCTCC-1_V12D07-335_C1,2,0,0,0,0,2
AGAACTGTACTTTGTA-1_V12D07-335_C1,1,0,0,0,0,1
CCTTAAGTACGCAATT-1_V12D07-335_C1,1,2,0,0,0,3
GGCCAATTGTATAGAC-1_V12D07-335_C1,0,0,0,0,0,0
AGAATACAGGCTATCC-1_V12D07-335_C1,4,0,0,1,0,5
AATACCTGATGTGAAC-1_V12D07-335_C1,3,0,0,0,0,3
TAGAGTGTTCCGGGTA-1_V12D07-335_C1,1,0,0,2,0,3
GCTTCCATGTAACCGC-1_V12D07-335_C1,0,0,0,0,0,0
GGTTCGCATTTGCCGT-1_V12D07-335_C1,0,3,0,1,0,4
TCAATCCGGGAAGTTT-1_V12D07-335_C1,1,0,0,1,0,2
CCGGAAGTGCAATATG-1_V12D07-335_C1,2,3,0,0,1,6
CTCATAAATGTGTATA-1_V12D07-335_C1,1,0,0,0,1,2
GACGGGCATCGAATTT-1_V12D07-335_C1,0,0,0,0,0,0
GCTAAGCCCAGTATGC-1_V12D07-335_C1,1,0,0,0,0,1
GCTATAAGGGCCAGGA-1_V12D07-335_C1,0,3,0,0,0,3
GCGGATTACTTGTTCT-1_V12D07-335_C1,0,1,0,0,0,1
TACAACAGCGCATACA-1_V12D07-335_C1,2,0,0,0,0,2
TCTAACCTAGCCTGCG-1_V12D07-335_C1,1,0,0,0,0,1
TCTACCCGCATCATTT-1_V12D07-335_C1,0,1,0,0,0,1
GTCTTACCACGCCAAG-1_V12D07-335_C1,1,0,0,0,0,1
AATAACGTCGCGCCCA-1_V12D07-335_C1,3,2,0,0,0,5
CGTTTCGGTTATATGC-1_V12D07-335_C1,3,4,0,0,0,7
TACGCTGCACGGTCGT-1_V12D07-335_C1,0,0,0,0,0,0
CGTTAAATACGACCAG-1_V12D07-335_C1,1,2,0,0,0,3
TCGACTGACGATGGCT-1_V12D07-335_C1,2,0,0,0,0,2
ACGCTACTGAATGGGC-1_V12D07-335_C1,3,2,0,0,0,5
AAGGGTTAGCCATGCG-1_V12D07-335_C1,0,0,0,0,0,0
ACGTTTCGGTGCACTT-1_V12D07-335_C1,1,0,0,0,0,1
TTAACCCGAGGCGTGT-1_V12D07-335_C1,3,2,0,0,0,5
GCCCGTCAAGCCCAAT-1_V12D07-335_C1,2,0,0,0,0,2
ATTCGTCCCGAGGTTA-1_V12D07-335_C1,4,1,0,0,0,5
TCAAATTATGTTCGAC-1_V12D07-335_C1,0,0,0,0,0,0
AACGTTCTACCATTGT-1_V12D07-335_C1,1,1,0,1,0,3
CTGTCCTGCGCACTAC-1_V12D07-335_C1,0,0,0,0,1,1
GCCCAGCGACACAAAG-1_V12D07-335_C1,1,0,0,0,6,7
TATAGCTATTATCTCT-1_V12D07-335_C1,1,1,0,0,1,3
AAGCTATGGATTGACC-1_V12D07-335_C1,0,0,0,0,0,0
CCGAAACACGACCTCT-1_V12D07-335_C1,1,0,0,0,1,2
ATCAGAAGCTGGTTGC-1_V12D07-335_C1,0,1,0,0,3,4
TGAACCTGAATGTGAG-1_V12D07-335_C1,1,0,0,0,0,1
TCAGAGCATGTCAACG-1_V12D07-335_C1,2,1,0,0,0,3
ATACCCTCCCGGCCAA-1_V12D07-335_C1,0,0,0,0,0,0
GCCACCTTATTCGCGA-1_V12D07-335_C1,0,4,0,0,0,4
CAACGAGCTTATTATG-1_V12D07-335_C1,1,0,0,0,2,3
GATCCAACCTTTAAAC-1_V12D07-335_C1,1,0,0,0,1,2
TTGTGGAGACAGCCGG-1_V12D07-335_C1,0,2,0,0,1,3
AGATAATCACACCTAT-1_V12D07-335_C1,0,4,0,0,0,4
GGTTAGGGATGCTAAT-1_V12D07-335_C1,2,3,1,0,1,7
TCATGAAGCGCTGCAT-1_V12D07-335_C1,2,0,0,0,3,5
CCAGGCGAGATGGTCT-1_V12D07-335_C1,0,2,0,0,0,2
CGACTTGCCGGGAAAT-1_V12D07-335_C1,1,1,0,0,1,3
GTGCCAAACGTTTCGA-1_V12D07-335_C1,1,0,0,0,2,3
TGCTCAAAGGATGCAC-1_V12D07-335_C1,1,4,1,0,1,7
GCCTCAGGTACCGGTC-1_V12D07-335_C1,0,0,0,0,1,1
ACAAGTAATTGTAAGG-1_V12D07-335_C1,0,0,0,0,0,0
TTAGAGTATTGTCGAG-1_V12D07-335_C1,0,0,0,0,0,0
GTCATCCCAAACTCAC-1_V12D07-335_C1,0,0,0,0,0,0
CTCCTAGTAATCGTGA-1_V12D07-335_C1,0,2,0,0,0,2
CCCTCATCACAGAGTA-1_V12D07-335_C1,2,0,0,0,2,4
GGAAACAGAGCTTGGG-1_V12D07-335_C1,0,2,0,0,0,2
ACATCGCAATATTCGG-1_V12D07-335_C1,0,1,0,0,0,1
TTAGCCATAGGGCTCG-1_V12D07-335_C1,0,1,0,1,0,2
CGGATTCTGCCTTATG-1_V12D07-335_C1,0,0,0,0,0,0
TTGTTGGCAATGACTG-1_V12D07-335_C1,2,1,0,0,0,3
GGATCTACCGTTCGTC-1_V12D07-335_C1,1,0,0,0,1,2
GGTGGGATTAGGTCCC-1_V12D07-335_C1,2,0,1,0,1,4
AATAGGCACGACCCTT-1_V12D07-335_C1,0,3,0,0,2,5
GAGGTCCGTTCGCTGT-1_V12D07-335_C1,2,1,1,0,0,4
TGACAACTTAAAGGTG-1_V12D07-335_C1,0,0,0,0,1,1
AGCTAAGCTCCGTCCG-1_V12D07-335_C1,2,2,0,0,0,4
CTAGCCCGGGAGACGA-1_V12D07-335_C1,0,0,0,0,0,0
CCCAGATTCCCGTGAC-1_V12D07-335_C1,0,1,0,1,0,2
GCCCGTTCACACAATT-1_V12D07-335_C1,1,0,0,0,0,1
ACAAACTCCATCAGAG-1_V12D07-335_C1,1,0,0,0,0,1
GGTTCCGTACGACTAA-1_V12D07-335_C1,0,0,0,0,0,0
TTGCGGAAAGCTGCCC-1_V12D07-335_C1,0,0,0,0,1,1
GGAACTCGTGAATACG-1_V12D07-335_C1,0,1,0,1,4,6
GGTTACCGCTCCCTAC-1_V12D07-335_C1,0,2,0,2,0,4
AGCGACTTTGAAGACA-1_V12D07-335_C1,1,3,0,0,3,7
CCGTTTCCTTTCCGTG-1_V12D07-335_C1,0,2,0,1,0,3
TGGATGGCATCTTGGA-1_V12D07-335_C1,0,0,0,0,1,1
CAAGTCGTTGAAATCT-1_V12D07-335_C1,1,1,0,0,0,2
TGCAAACGTACTAGTT-1_V12D07-335_C1,0,0,0,0,0,0
GGCTGTCCTACTGCGG-1_V12D07-335_C1,1,0,0,0,1,2
TACTGCATGATTAAAT-1_V12D07-335_C1,1,0,0,0,0,1
CGGACCTCTGTAGTTA-1_V12D07-335_C1,0,1,0,0,1,2
CCCTAGCTCTAAGGTC-1_V12D07-335_C1,0,1,0,0,1,2
GTAACAGGTTAACGGC-1_V12D07-335_C1,0,3,0,0,1,4
CCCGCAAATAATCATC-1_V12D07-335_C1,0,0,0,0,0,0
AATCCCGCTCAGAGCC-1_V12D07-335_C1,1,1,0,0,2,4
AACGTCATCCGGCTTG-1_V12D07-335_C1,0,2,0,0,1,3
CTCGTGGCACTGAAAG-1_V12D07-335_C1,0,0,0,0,3,3
CTTTATCCGACGCATG-1_V12D07-335_C1,2,1,1,0,0,4
AAATGACTGATCAAAC-1_V12D07-335_C1,0,1,0,0,0,1
TTCGTGCATGTTATAG-1_V12D07-335_C1,1,0,0,0,0,1
ATCAAAGAGCCGTGGT-1_V12D07-335_C1,0,0,0,0,0,0
ATGTCATAATAAACGA-1_V12D07-335_C1,1,0,0,0,0,1
CTTAATCGACTTAGTA-1_V12D07-335_C1,2,0,1,0,1,4
CTAAAGGATGAGATAC-1_V12D07-335_C1,0,1,0,0,0,1
GTGCTATCCAGCTGGA-1_V12D07-335_C1,0,0,0,0,0,0
GACAGAGGTCTTCAGT-1_V12D07-335_C1,0,1,0,0,0,1
TCGATTTACGAAACGA-1_V12D07-335_C1,2,0,0,0,0,2
AGGCTTAAGTTGCACA-1_V12D07-335_C1,1,4,0,0,0,5
TAGGATCTTAACCGCA-1_V12D07-335_C1,0,1,0,0,0,1
GACTTTCGAGCGGTTC-1_V12D07-335_C1,1,2,0,0,0,3
CCCTGGGAGGGATCCT-1_V12D07-335_C1,0,0,0,0,1,1
TAGTAGTTGCCGGACA-1_V12D07-335_C1,1,0,0,0,1,2
GCCCTAAGTGCAGGAT-1_V12D07-335_C1,1,3,0,0,0,4
ACTTGGGCTTTCGCCA-1_V12D07-335_C1,1,3,0,0,0,4
CATGATACGGTGAAAC-1_V12D07-335_C1,0,0,0,0,0,0
TCCTGCAGCCGCCAAT-1_V12D07-335_C1,1,1,0,0,0,2
GTCCGTTAGAGGGCCT-1_V12D07-335_C1,0,4,0,0,1,5
GCTTTATTAAGTTACC-1_V12D07-335_C1,1,1,0,0,0,2
AATCGAGGTCTCAAGG-1_V12D07-335_C1,1,0,0,1,2,4
GTGCTGTTAGAACATA-1_V12D07-335_C1,4,0,0,0,1,5
GGCTTCTCGTGGGTGG-1_V12D07-335_C1,3,0,0,0,0,3
CCTACAGTTGAGGGAG-1_V12D07-335_C1,3,0,0,1,0,4
TATCCCTCGATCTGCA-1_V12D07-335_C1,1,1,0,0,0,2
CCGGTATCTGGCGACT-1_V12D07-335_C1,1,0,0,0,0,1
CTCTAACACCGGCAGC-1_V12D07-335_C1,2,2,0,0,0,4
CTTCATCACCAGGGCT-1_V12D07-335_C1,3,1,0,0,0,4
GGCTGGCAATCCCACG-1_V12D07-335_C1,1,0,0,0,0,1
CAAACCATAAGCGTAT-1_V12D07-335_C1,1,0,0,0,0,1
CATGTGGGCTCATCAC-1_V12D07-335_C1,2,0,0,0,0,2
CCCGTGACAGTGCCTT-1_V12D07-335_C1,2,1,0,0,0,3
GATTATCTTGCATTAT-1_V12D07-335_C1,3,1,2,0,0,6
GAGTCCACCAGGTTTA-1_V12D07-335_C1,1,1,0,0,0,2
TGTACTATCGCTCGTT-1_V12D07-335_C1,2,0,0,0,0,2
TTAGCGAATAGATAGG-1_V12D07-335_C1,0,0,0,0,0,0
ACATACAATCAAGCGG-1_V12D07-335_C1,1,1,0,0,0,2
ATTCGTGTACCCATTC-1_V12D07-335_C1,2,6,0,0,0,8
GCTAGCAACGCACCTA-1_V12D07-335_C1,0,0,1,0,0,1
ACCTCAGCGAGGCGCA-1_V12D07-335_C1,0,0,0,0,0,0
TCCGGGCCACTAACGG-1_V12D07-335_C1,3,1,0,0,1,5
TCCCAATATCGACGAC-1_V12D07-335_C1,3,2,0,0,1,6
GGATTGAAGTAGCCTC-1_V12D07-335_C1,1,0,0,0,0,1
GGCGCACAGTTTACCT-1_V12D07-335_C1,0,0,0,0,0,0
CCCGGCACGTGTCAGG-1_V12D07-335_C1,3,0,0,0,0,3
AGTAAGGGACAGAATC-1_V12D07-335_C1,2,0,0,0,0,2
TTGCGCACAACCACGT-1_V12D07-335_C1,0,2,0,0,2,4
CCTGCTACAACCATAC-1_V12D07-335_C1,1,2,0,2,0,5
CTGGGCTACTGGAGAG-1_V12D07-335_C1,0,0,0,0,0,0
AGCTACGAATGGTGGT-1_V12D07-335_C1,4,0,4,0,4,12
ATTCGTTTATCGTATT-1_V12D07-335_C1,0,2,0,0,0,2
GGCATTCCCTCCCTCG-1_V12D07-335_C1,3,2,1,0,0,6
AGTTATTCAGACTGTG-1_V12D07-335_C1,0,1,0,0,0,1
CCACTTTCCTTCTAGG-1_V12D07-335_C1,0,0,0,0,0,0
CGCAGTTCTATCTTTC-1_V12D07-335_C1,1,0,0,0,0,1
AGGAGCGTTTATTATC-1_V12D07-335_C1,1,0,0,0,0,1
GACAGGTAATCCGTGT-1_V12D07-335_C1,2,3,0,0,0,5
TTCCCAAAGTACTGAT-1_V12D07-335_C1,4,2,1,0,0,7
CTGCAGGGTGACGCTC-1_V12D07-335_C1,2,0,0,0,0,2
TCATGGAGGCCTTTGT-1_V12D07-335_C1,0,0,0,0,0,0
ATGGCCCGAAAGGTTA-1_V12D07-335_C1,0,1,0,0,0,1
CGTAATATGGCCCTTG-1_V12D07-335_C1,1,1,0,0,0,2
AGAGTCTTAATGAAAG-1_V12D07-335_C1,2,2,0,0,0,4
GAACGTTTGTATCCAC-1_V12D07-335_C1,2,1,0,0,0,3
ATTGAATTCCCTGTAG-1_V12D07-335_C1,3,2,0,0,0,5
TACCTCACCAATTGTA-1_V12D07-335_C1,3,0,0,0,0,3
AGTCGAATTAGCGTAA-1_V12D07-335_C1,1,0,0,1,0,2
TTGAAGTGCATCTACA-1_V12D07-335_C1,1,0,0,0,0,1
