key,oligo,other,microglia,neuron,astrocyte,n_cells
CTAATGCGCCCAACAA-1_V12D07-332_A1,1,0,0,0,0,1
GCCACCCATTCCACTT-1_V12D07-332_A1,2,1,1,0,0,4
GTTCGGTGTGGATTTA-1_V12D07-332_A1,1,1,1,0,0,3
GGAGACATTCACGGGC-1_V12D07-332_A1,3,0,0,0,0,3
TAGAACGCCAGTAACG-1_V12D07-332_A1,4,1,1,0,0,6
TGATGGGACTAAGTCA-1_V12D07-332_A1,3,0,0,0,0,3
TCGCCTCGACCTGTTG-1_V12D07-332_A1,5,1,0,1,0,7
AGGAAAGCCTCTGATG-1_V12D07-332_A1,5,1,1,0,0,7
GTATCGGGACGAGCTG-1_V12D07-332_A1,4,0,0,0,1,5
CATACGGGTGCATGAT-1_V12D07-332_A1,4,0,0,0,0,4
AAATTGCGGCGGTTCT-1_V12D07-332_A1,1,1,1,0,1,4
CATTCAGGTCAGTGCG-1_V12D07-332_A1,4,1,0,0,0,5
AATCAGACTGCAGGAC-1_V12D07-332_A1,2,2,0,0,0,4
CTGGCTGCTAACGTAA-1_V12D07-332_A1,0,2,2,0,0,4
AAGACTAACCCGTTGT-1_V12D07-332_A1,2,2,1,1,0,6
CGCGCAAGGAACTACA-1_V12D07-332_A1,0,2,0,0,0,2
ACGGCGGGTTGCCCTG-1_V12D07-332_A1,1,1,0,1,0,3
GTGCGCAGCTTGCTCC-1_V12D07-332_A1,1,2,1,0,0,4
TATGATTCTGCTTGGT-1_V12D07-332_A1,4,1,1,0,0,6
TTACGGTGTCACCGAG-1_V12D07-332_A1,0,1,1,0,0,2
TGAGCAGTCGTGAAGT-1_V12D07-332_A1,2,1,0,0,1,4
GTGTATGACTTTAAAG-1_V12D07-332_A1,0,0,0,0,0,0
TGTACTGTGCCAAAGT-1_V12D07-332_A1,1,1,0,0,0,2
GTCAATTGTACTGAAG-1_V12D07-332_A1,2,1,0,0,0,3
AGCTTATAGAGACCTG-1_V12D07-332_A1,0,2,0,0,1,3
AACTTTAGCTGCTGAG-1_V12D07-332_A1,1,1,0,0,0,2
GGCATCAACGAGCACG-1_V12D07-332_A1,1,2,0,0,0,3
TTATAGATGCACATTA-1_V12D07-332_A1,2,1,0,0,0,3
TGCTATACAAACGGAC-1_V12D07-332_A1,0,2,0,0,0,2
TATTCCGGCAGTCCTA-1_V12D07-332_A1,0,0,0,0,0,0
ATGTGTAGTTTAGTCA-1_V12D07-332_A1,1,2,1,1,0,5
AAGTTTACTAATGGCA-1_V12D07-332_A1,2,1,0,0,0,3
GATTGACACTCTGCTC-1_V12D07-332_A1,2,0,0,0,0,2
ACCGTTCCCGCTCTGA-1_V12D07-332_A1,1,0,0,0,0,1
CATTCACTGACAGCTA-1_V12D07-332_A1,0,1,0,0,0,1
CATGAACCTCTTATCA-1_V12D07-332_A1,0,0,0,1,0,1
AATAAGTCCTCGAGAC-1_V12D07-332_A1,2,2,0,1,0,5
CTACGAACTAGGTCGA-1_V12D07-332_A1,0,2,0,0,0,2
CACTACTCAGTTCTGT-1_V12D07-332_A1,0,1,0,0,0,1
CATTTATCGTTCAAGA-1_V12D07-332_A1,0,2,0,0,0,2
TAGAAACCACTAAGTA-1_V12D07-332_A1,0,1,0,0,0,1
TCGTATTTCGTCCGGA-1_V12D07-332_A1,0,0,1,0,0,1
ATCCACGCTAAATGTT-1_V12D07-332_A1,1,0,0,0,0,1
ATAAAGGTCAAGTACG-1_V12D07-332_A1,0,0,0,0,0,0
TAGGAACAGCCTCCAG-1_V12D07-332_A1,0,1,0,0,0,1
CACACGTTTCAATGGG-1_V12D07-332_A1,1,2,0,2,0,5
AGTAACGTTCATCCTG-1_V12D07-332_A1,0,0,0,0,0,0
TCTACACGTTCATGCA-1_V12D07-332_A1,1,0,0,0,0,1
TCGGTTAGCCATGTAG-1_V12D07-332_A1,0,1,0,1,0,2
TAAGTAAATGTGCCGC-1_V12D07-332_A1,1,5,0,0,0,6
TGGCACGAGCTCGAGT-1_V12D07-332_A1,2,0,0,0,0,2
GAACTTAGCGCCCGGT-1_V12D07-332_A1,0,0,0,0,0,0
ATAGGAATCTAAGCTT-1_V12D07-332_A1,0,1,1,0,0,2
CAATATGTAGATTTAC-1_V12D07-332_A1,0,0,0,0,0,0
TTATAGTCCAAGGTGC-1_V12D07-332_A1,0,2,0,2,0,4
CCTCGTTACGCCTGTT-1_V12D07-332_A1,0,0,0,1,0,1
ACGCATAAATGACATG-1_V12D07-332_A1,0,1,0,0,0,1
CTTTGGCAGACAGAGT-1_V12D07-332_A1,1,0,0,0,0,1
AGTGGGAGTATACACG-1_V12D07-332_A1,2,1,0,0,0,3
GGTCTTGGTGTTAACT-1_V12D07-332_A1,0,0,0,0,0,0
GGCTGGCAGCTTTATG-1_V12D07-332_A1,2,0,2,0,0,4
CGCCAATTATTGCGTT-1_V12D07-332_A1,1,2,2,0,0,5
GGTAACCGGCAAAGGT-1_V12D07-332_A1,1,2,0,0,0,3
TGGGACCATTGGGAGT-1_V12D07-332_A1,2,1,1,0,0,4
CTGCAGGTGCTCGGCC-1_V12D07-332_A1,4,1,0,0,0,5
CCGGTGCGAGTGATAG-1_V12D07-332_A1,3,0,1,0,0,4
GGGTACACTCTGGAGG-1_V12D07-332_A1,4,1,0,0,0,5
TAGCCAGAGGGTCCGG-1_V12D07-332_A1,2,2,0,0,0,4
CTTGTGAGGACAGCGG-1_V12D07-332_A1,2,0,0,0,0,2
GAAGGGCATAACCATG-1_V12D07-332_A1,2,1,1,0,0,4
CAACATGGCCTGATAA-1_V12D07-332_A1,5,1,0,0,0,6
CAATTTGACCGGGAAG-1_V12D07-332_A1,2,1,0,0,0,3
TCTGACTGTAATGGTT-1_V12D07-332_A1,2,0,0,0,0,2
TTCATAGCCTTGTAAC-1_V12D07-332_A1,4,0,0,0,0,4
TGGAAACGGAGTGAAC-1_V12D07-332_A1,2,3,0,0,0,5
ATCGCACGATTGTTCA-1_V12D07-332_A1,8,1,0,0,0,9
CGCCACCCGCATTAAC-1_V12D07-332_A1,2,2,1,0,0,5
TGGACCACGGCGTTGA-1_V12D07-332_A1,3,2,0,0,0,5
GTATATGTTACGGCGG-1_V12D07-332_A1,3,0,0,0,0,3
GTATTCTTACCGTGCT-1_V12D07-332_A1,4,1,0,0,0,5
TTCAGAGTAACCTGAC-1_V12D07-332_A1,1,0,0,0,0,1
GCGGTAACCCAAATGA-1_V12D07-332_A1,1,1,1,0,0,3
CTACGTGTTGCCACCA-1_V12D07-332_A1,0,4,2,0,0,6
CTAGATAAACTCCTCG-1_V12D07-332_A1,2,1,2,1,0,6
TCCATTAGTTGGATAG-1_V12D07-332_A1,5,0,0,0,0,5
CTGGCTCCTGCGGGAT-1_V12D07-332_A1,1,0,1,0,0,2
CAGTCTCTCGGCTAAT-1_V12D07-332_A1,5,0,0,0,0,5
GTATGACGTGGGAAAC-1_V12D07-332_A1,1,1,0,0,0,2
AGTCACTCCGCCTCAT-1_V12D07-332_A1,0,0,0,0,0,0
GCAGCGGTGGGCATTA-1_V12D07-332_A1,0,2,2,0,0,4
TATGGAGTTTCTCGTT-1_V12D07-332_A1,1,2,0,1,0,4
ACTCAACGAATGTATT-1_V12D07-332_A1,2,2,0,0,0,4
AACACGCGGCCGCGAA-1_V12D07-332_A1,3,0,0,1,0,4
CGATATTAGCCGCAGG-1_V12D07-332_A1,3,0,0,0,0,3
AGCGTCTGAACCCGCA-1_V12D07-332_A1,0,1,1,0,0,2
GATGTCCGGATCACAT-1_V12D07-332_A1,5,1,1,0,0,7
GGTCACGTTAGATTCA-1_V12D07-332_A1,2,0,0,0,0,2
TTAAGGATACGGAGGT-1_V12D07-332_A1,2,0,0,0,0,2
GTGCGGGACCATCGGC-1_V12D07-332_A1,2,0,1,0,0,3
CCATCTTGTTCACAAT-1_V12D07-332_A1,0,1,0,1,0,2
TCCGAGAAGGCTAAGC-1_V12D07-332_A1,2,1,1,0,0,4
TGGCGGTGTGCGATTG-1_V12D07-332_A1,2,1,0,0,0,3
ATCCTGCTGCAGATAG-1_V12D07-332_A1,3,3,0,0,0,6
TTATGCGTCCCGGTCC-1_V12D07-332_A1,1,0,0,0,0,1
CATAATGAGCGGGCGA-1_V12D07-332_A1,5,1,0,0,0,6
AGACATAGATCCTTCC-1_V12D07-332_A1,2,1,2,0,0,5
GGTGAAACCGGGAATG-1_V12D07-332_A1,2,0,0,0,0,2
AACTGGTGTGGGCCTT-1_V12D07-332_A1,3,1,0,0,0,4
GTAGCGCTGTTGTAGT-1_V12D07-332_A1,1,2,0,0,0,3
TTGTTTGTGTAAATTC-1_V12D07-332_A1,2,2,1,0,0,5
GGATCAAAGGACGAGG-1_V12D07-332_A1,2,1,0,0,0,3
CGTAGCGCCGACGTTG-1_V12D07-332_A1,1,1,1,0,0,3
CAAGTGAACTTTGGTT-1_V12D07-332_A1,2,3,0,0,0,5
GTAGACAACCGATGAA-1_V12D07-332_A1,2,0,1,0,0,3
CAATGGTCGGCCTGGG-1_V12D07-332_A1,0,1,2,0,0,3
ACAGATTAGGTTAGTG-1_V12D07-332_A1,1,0,0,0,0,1
GTTATCACCTTCTGAA-1_V12D07-332_A1,3,1,0,0,0,4
TGGTATCGGTCTGTAT-1_V12D07-332_A1,2,0,0,1,0,3
GGAATAACCTCAAGAA-1_V12D07-332_A1,1,0,0,0,0,1
ATTATCTCGACAGATC-1_V12D07-332_A1,1,1,1,0,0,3
CCGAGGGATGTTAGGC-1_V12D07-332_A1,1,3,0,0,0,4
TGAGATCAAATACTCA-1_V12D07-332_A1,2,0,0,0,0,2
AAACGAAGAACATACC-1_V12D07-332_A1,2,0,1,0,0,3
CTGGTCCTAACTTGGC-1_V12D07-332_A1,0,1,0,0,0,1
TGCACGAGTCGGCAGC-1_V12D07-332_A1,1,1,0,0,0,2
ATAGTCTTTGACGTGC-1_V12D07-332_A1,1,1,0,3,0,5
TGGAGCTAAAGTTCCC-1_V12D07-332_A1,1,3,1,0,0,5
GGGTGGTCCAGCCTGT-1_V12D07-332_A1,2,1,1,1,0,5
CATGCATGGAGACCCT-1_V12D07-332_A1,1,1,0,0,0,2
ACACGGCACTATGCAT-1_V12D07-332_A1,1,2,0,0,0,3
CCCTGGTATGGGCGGC-1_V12D07-332_A1,2,0,0,0,0,2
GGAGGATTGAAAGGAG-1_V12D07-332_A1,0,0,0,1,0,1
CCGCTGGTGCCATTCA-1_V12D07-332_A1,0,0,1,1,0,2
GTTAGAGTGTGCCGCT-1_V12D07-332_A1,3,0,1,0,0,4
TCGGAATGACCATCAA-1_V12D07-332_A1,0,1,0,0,0,1
TTCAATTAGCCATAAT-1_V12D07-332_A1,1,0,0,2,0,3
GATGTGTTGTCACAAG-1_V12D07-332_A1,1,1,2,0,0,4
TCTTTCTCTTAAGGAG-1_V12D07-332_A1,0,0,1,2,0,3
ACCCTTTAGTTCTCCA-1_V12D07-332_A1,2,1,3,1,0,7
ACCACAACTCAGAACA-1_V12D07-332_A1,1,1,0,0,0,2
TATGATAAATCTAACG-1_V12D07-332_A1,2,0,0,1,0,3
GATCCTCTTGCGCTTA-1_V12D07-332_A1,0,1,0,0,0,1
TTCTACCTTTATGTTG-1_V12D07-332_A1,0,1,1,0,0,2
GAAATACCTGCTGGCT-1_V12D07-332_A1,0,1,0,1,0,2
ATTCTGAGTATGAACT-1_V12D07-332_A1,0,0,1,0,0,1
GGATTAAGCTAAGGTC-1_V12D07-332_A1,1,0,0,0,0,1
AGTACGTGGCCTGTCT-1_V12D07-332_A1,1,0,1,1,0,3
TCAGGGTGCACGAAAC-1_V12D07-332_A1,1,0,1,0,0,2
AAATTTACCGAAATCC-1_V12D07-332_A1,1,0,1,1,0,3
TTGAGGCATTTAACTC-1_V12D07-332_A1,2,2,1,0,0,5
AACCAGTATCACTCTT-1_V12D07-332_A1,0,0,0,3,0,3
CACCGGAGATATCTCC-1_V12D07-332_A1,0,1,1,1,0,3
GACTGGGCGCCGCAAC-1_V12D07-332_A1,1,0,0,4,0,5
CACGTCTATGATGTGG-1_V12D07-332_A1,2,0,2,1,0,5
TTAAGACGAACGAACC-1_V12D07-332_A1,0,1,0,0,0,1
TGACCAGCTTCAAAGT-1_V12D07-332_A1,2,1,1,0,0,4
AGAGTTAGAGACCGAT-1_V12D07-332_A1,3,1,0,0,0,4
TTCGGACTGATGCCTT-1_V12D07-332_A1,0,1,0,0,0,1
CTCGAATGGAACGTAT-1_V12D07-332_A1,1,0,0,0,0,1
GGACGGCTTGCGCAAC-1_V12D07-332_A1,2,2,0,1,0,5
CTAAGTACAGGGCTAC-1_V12D07-332_A1,0,0,0,2,0,2
ACAAATTCAGATCTGA-1_V12D07-332_A1,4,1,0,0,0,5
CATGGAAATGGGACCA-1_V12D07-332_A1,0,5,1,0,0,6
GGTGGACCACGTGTTA-1_V12D07-332_A1,2,1,1,0,0,4
CACGACGTAATAGTAA-1_V12D07-332_A1,1,1,0,1,0,3
CGGGTTCGGCACGTAT-1_V12D07-332_A1,0,0,0,0,0,0
CTGGGCTATCCTTTGG-1_V12D07-332_A1,1,2,0,0,0,3
GTATTAGGGTTCGCGT-1_V12D07-332_A1,1,0,0,0,0,1
TCATTCGTATAATTTG-1_V12D07-332_A1,0,2,0,0,0,2
AATAGCAAGCCTCCTG-1_V12D07-332_A1,0,5,1,2,1,9
CATCTACCCGAGAACG-1_V12D07-332_A1,0,0,0,0,0,0
GCTTCAGTGGGATTAC-1_V12D07-332_A1,2,0,0,1,0,3
TCTGTGATGGAGGTTG-1_V12D07-332_A1,1,1,0,0,0,2
ATCCACTTTCAGACTA-1_V12D07-332_A1,2,2,1,1,0,6
ATGGTTACGAAACATG-1_V12D07-332_A1,2,0,1,1,0,4
GGCCCAATCTAGAGGG-1_V12D07-332_A1,1,1,0,1,0,3
GATGGTGAAATAACCC-1_V12D07-332_A1,1,1,1,4,0,7
AGAGGGACAATTGTCC-1_V12D07-332_A1,1,0,0,1,0,2
CGCGTACATTCTGGAA-1_V12D07-332_A1,0,1,1,0,0,2
CAAGAAACCCTAAACT-1_V12D07-332_A1,1,0,1,1,0,3
TTGGTGCGGTGTTGAA-1_V12D07-332_A1,2,0,0,2,0,4
GGTTCCCTAGTGTCTC-1_V12D07-332_A1,1,0,0,1,0,2
CGATAACCAATTTGAG-1_V12D07-332_A1,0,2,0,0,0,2
GCCCACTGGTCCACAA-1_V12D07-332_A1,0,0,1,5,0,6
GAGGGCCGGCAGAGTC-1_V12D07-332_A1,0,1,0,0,0,1
CGACACGGATGCCCAC-1_V12D07-332_A1,0,1,0,0,0,1
CTGTCTGTGGCTGGCT-1_V12D07-332_A1,2,3,0,0,0,5
ATATTATCCCGTATTT-1_V12D07-332_A1,2,1,0,0,0,3
GCGCTGGCGGAAAGTC-1_V12D07-332_A1,1,1,1,0,0,3
ATCTAACGTCCCTATG-1_V12D07-332_A1,1,0,0,0,0,1
GTCAGACAGCGTTGGA-1_V12D07-332_A1,0,0,1,0,0,1
GCCAGGCTTAGTGGTA-1_V12D07-332_A1,3,0,2,0,0,5
ATTCAAAGTACCTGTT-1_V12D07-332_A1,1,1,1,0,0,3
TGGACGTAGGCGAATC-1_V12D07-332_A1,1,1,0,0,0,2
ACACATTGACGCAACA-1_V12D07-332_A1,1,0,1,0,0,2
GATATCAGTATGTATC-1_V12D07-332_A1,0,4,4,0,0,8
TGGGCCTTGCCTGCAT-1_V12D07-332_A1,1,2,1,0,0,4
CAAAGTCAGGTTAGCT-1_V12D07-332_A1,1,1,2,0,0,4
GGATCCCTACCAGCTA-1_V12D07-332_A1,2,0,0,0,0,2
ATCGTCCAATCGAGTC-1_V12D07-332_A1,2,1,0,0,0,3
ACATGGCTCAATTTAG-1_V12D07-332_A1,1,1,1,0,0,3
AGGCCCAGTGACTGGT-1_V12D07-332_A1,5,0,1,0,0,6
GCTTCCAGCTTAGATT-1_V12D07-332_A1,1,2,2,0,0,5
TGCTTGAAACCATGCA-1_V12D07-332_A1,1,2,1,0,0,4
CAATATTGGACTAGTG-1_V12D07-332_A1,0,3,0,0,0,3
CGTGCTGGCCTAGTCG-1_V12D07-332_A1,0,0,0,0,0,0
CCTGCGATAGAACTGT-1_V12D07-332_A1,3,0,0,0,0,3
GGGTAATGCTGTGTTT-1_V12D07-332_A1,2,1,0,0,0,3
AACGCGAACGGCAACA-1_V12D07-332_A1,1,0,1,0,0,2
TGTCGGCATGGTGGAA-1_V12D07-332_A1,5,2,0,0,0,7
AGCGTACGAGAGCTAG-1_V12D07-332_A1,1,1,0,0,0,2
ATACTCTCGCCACTCT-1_V12D07-332_A1,2,1,0,0,0,3
AATCCATGCAAGGGTG-1_V12D07-332_A1,4,1,0,0,0,5
TTAAACAGAGTCCCGC-1_V12D07-332_A1,1,0,0,0,0,1
CCACAGCTGAAATCAT-1_V12D07-332_A1,3,0,1,0,0,4
CGGTTCCGGCTTCTTG-1_V12D07-332_A1,1,0,0,0,0,1
GACGTGAGACTCCATG-1_V12D07-332_A1,3,1,1,0,0,5
TCGTTGGCTCGTCAAT-1_V12D07-332_A1,0,1,1,0,0,2
GGTGAACGGGCTAGCC-1_V12D07-332_A1,2,0,1,0,0,3
GCACTGTGCAAATGTA-1_V12D07-332_A1,4,2,0,0,0,6
ACGAGAACCCATCACG-1_V12D07-332_A1,2,0,0,0,0,2
CCAGCTACGCCTCATA-1_V12D07-332_A1,1,3,1,0,0,5
TCCCGGTCAGGAATTT-1_V12D07-332_A1,4,0,0,0,0,4
TCGCATTCAATGACTT-1_V12D07-332_A1,3,0,0,1,0,4
CTGGTTCAACGCATCA-1_V12D07-332_A1,2,1,1,0,0,4
GGTGATTTCATCTTGT-1_V12D07-332_A1,2,0,0,0,0,2
CACCCTTTCCTCGCTC-1_V12D07-332_A1,1,0,0,0,0,1
CAACTTGTAGTGGGCA-1_V12D07-332_A1,2,0,0,0,0,2
AATATCAAGGTCGGAT-1_V12D07-332_A1,1,0,0,0,0,1
ACTCAGACCTGCTTCT-1_V12D07-332_A1,2,0,0,0,0,2
TTGGAGTCTCCCTTCT-1_V12D07-332_A1,4,0,0,0,0,4
GGATACTCATGAATTG-1_V12D07-332_A1,3,0,1,0,0,4
TGGGCACAAACAGAAC-1_V12D07-332_A1,4,0,1,0,0,5
GAGCCACGGTAGTAGG-1_V12D07-332_A1,1,0,0,0,0,1
TCGATAGGCTAGTCGC-1_V12D07-332_A1,1,2,0,0,0,3
TAACCGCCCGCAGTGC-1_V12D07-332_A1,2,0,0,0,0,2
GCCTATTTGCTACACA-1_V12D07-332_A1,0,0,0,0,0,0
TTGACGATTCAGCACG-1_V12D07-332_A1,1,3,0,1,0,5
TTAAACCGGTAGCGAC-1_V12D07-332_A1,0,0,0,0,0,0
ACCGAAAGGGCCCTGC-1_V12D07-332_A1,2,1,0,0,0,3
ACGTTCCGCGCTCCGT-1_V12D07-332_A1,2,0,1,0,0,3
ATACCAGGCTAATAGA-1_V12D07-332_A1,4,0,1,0,0,5
CGGCTTTGTATGATAA-1_V12D07-332_A1,1,0,1,0,0,2
CTTGACCCGAAAGATA-1_V12D07-332_A1,1,0,0,0,0,1
CGCAGAAACATTTGCG-1_V12D07-332_A1,4,0,1,0,0,5
GACCCGTCGCCGGCTA-1_V12D07-332_A1,2,1,0,0,0,3
AATCGGGACACTACGA-1_V12D07-332_A1,3,2,2,0,0,7
GTCACAAAGTTTCCAA-1_V12D07-332_A1,1,0,0,0,0,1
TATATTCGCGTCGATA-1_V12D07-332_A1,5,1,0,0,0,6
CCTCCCGACAATCCCT-1_V12D07-332_A1,2,1,1,0,0,4
CGACATGCGATCTTCT-1_V12D07-332_A1,3,0,1,0,0,4
AACACGACTGTACTGA-1_V12D07-332_A1,1,1,1,0,0,3
CCCAACCACACTAACA-1_V12D07-332_A1,1,1,0,0,0,2
CACCGCCGACCAGCGA-1_V12D07-332_A1,2,0,0,0,0,2
TGGTATCGCATCCCAA-1_V12D07-332_A1,1,2,0,0,0,3
CAGAGTGATTTAACGT-1_V12D07-332_A1,0,0,2,0,0,2
AACCCTGGTGGAACCA-1_V12D07-332_A1,0,1,0,1,0,2
GTCAGTTGTGCTCGTT-1_V12D07-332_A1,3,0,1,0,0,4
ATTGACGTAACTCGGT-1_V12D07-332_A1,0,1,0,0,0,1
GATGTCGGTCAACTGC-1_V12D07-332_A1,1,0,2,0,0,3
AGGGCAGCGGCGTGGT-1_V12D07-332_A1,1,1,0,1,0,3
ACATCGTTAACCTAGT-1_V12D07-332_A1,3,1,0,1,0,5
TCCATTGTGACCTCGT-1_V12D07-332_A1,5,3,1,1,0,10
TGTTTAATACTTCATC-1_V12D07-332_A1,1,0,0,3,0,4
TTGCTGGCCGGGCTTC-1_V12D07-332_A1,2,2,0,0,0,4
CATATTATTTGCCCTA-1_V12D07-332_A1,2,2,0,0,0,4
CTGCCTAGCCACCAAG-1_V12D07-332_A1,3,0,0,0,0,3
ACGAGATATTTGCTTA-1_V12D07-332_A1,0,1,0,0,0,1
GACTACAATTGCTCGT-1_V12D07-332_A1,2,0,0,1,0,3
AACGTGATGAAGGACA-1_V12D07-332_A1,1,0,0,0,0,1
ACTCTCTTATACACGA-1_V12D07-332_A1,2,0,1,0,0,3
CGCATCATGGCTTCAG-1_V12D07-332_A1,2,1,0,0,0,3
CGGCTCTTCGTCGAAC-1_V12D07-332_A1,3,4,1,0,0,8
ATTCTTCGTACTTATG-1_V12D07-332_A1,2,0,0,1,0,3
AGTGAGGGTTTCTGAC-1_V12D07-332_A1,1,1,1,1,0,4
GCCAGGCGTTCGCATG-1_V12D07-332_A1,0,0,1,0,0,1
GACTAACACAGCACCT-1_V12D07-332_A1,1,1,1,0,0,3
CAATGGAATCTACATA-1_V12D07-332_A1,1,1,1,0,0,3
GTGGTCAGCGAAGTAT-1_V12D07-332_A1,2,2,0,2,0,6
ATGGCTGGAAATGGCC-1_V12D07-332_A1,0,0,0,0,0,0
ATCAGGTCGCCATTGC-1_V12D07-332_A1,1,1,0,0,0,2
TATCACCATGTAAAGT-1_V12D07-332_A1,1,0,0,4,0,5
AGCGCTTATGGGCAAG-1_V12D07-332_A1,4,0,1,2,0,7
AAGCGGCGTCATGGGT-1_V12D07-332_A1,0,1,0,2,0,3
ACTAATACGTCAGGCG-1_V12D07-332_A1,1,0,0,0,0,1
GGCTGAGCATCGTAAG-1_V12D07-332_A1,1,0,1,0,0,2
CGGTTGGGTTCAAGTT-1_V12D07-332_A1,0,1,1,1,0,3
GACTGATTGGTCACAA-1_V12D07-332_A1,0,1,0,0,0,1
AGACGGGCCGATTTAA-1_V12D07-332_A1,0,0,0,0,0,0
ACCAGTGCCCGGTCAA-1_V12D07-332_A1,2,2,0,1,0,5
GTCCTTTAATGACTTC-1_V12D07-332_A1,2,0,0,0,0,2
CCTACAAGTCCGGAAT-1_V12D07-332_A1,4,2,0,0,0,6
GCCTGCTACACTGAGA-1_V12D07-332_A1,0,1,0,0,0,1
GACTCGGTCGGCGGAT-1_V12D07-332_A1,2,2,0,0,0,4
CTAGACATATATGTAG-1_V12D07-332_A1,1,0,0,1,0,2
TCGCCCAACTGACTCC-1_V12D07-332_A1,1,0,1,0,0,2
AAACTAACGTGGCGAC-1_V12D07-332_A1,2,1,0,0,0,3
AACTGAGGTCAGCGTC-1_V12D07-332_A1,1,2,1,2,0,6
ACAATGATTCTTCTAC-1_V12D07-332_A1,0,1,0,0,0,1
ATAAGTACCCGATTGT-1_V12D07-332_A1,0,4,0,0,0,4
ATTGGGAGTTCTGTAA-1_V12D07-332_A1,2,0,0,1,0,3
CGAACATAGTCAGAAA-1_V12D07-332_A1,0,1,0,0,0,1
TAGCTCAGATCCTAGT-1_V12D07-332_A1,1,2,0,1,0,4
GTGTCGTATTCACCTT-1_V12D07-332_A1,0,2,0,0,0,2
CTCACCGATCCAAACT-1_V12D07-332_A1,2,2,0,1,0,5
ATATGTGCACAAACCA-1_V12D07-332_A1,1,3,0,1,0,5
CAGTCCAACGCCTTCT-1_V12D07-332_A1,2,0,1,0,0,3
TCGTCCGGGTACACTC-1_V12D07-332_A1,2,0,0,6,0,8
GCAGAAACGTAATCCA-1_V12D07-332_A1,1,0,0,5,0,6
TTCGAGCCGGCGCTAC-1_V12D07-332_A1,0,1,0,3,0,4
GGAAGATAAGACTGTA-1_V12D07-332_A1,0,0,0,0,0,0
ATAAGCAAACACCGAG-1_V12D07-332_A1,0,1,0,0,0,1
GCATAAATTGAACGCC-1_V12D07-332_A1,0,1,0,2,0,3
CGCCGGTGTCGCAGTA-1_V12D07-332_A1,0,1,0,1,0,2
GACCTGGTCTGGGCGT-1_V12D07-332_A1,3,1,2,0,0,6
AGCCGCTTGATTAGCG-1_V12D07-332_A1,3,0,1,0,0,4
CCCGGCTAGGTGAGAA-1_V12D07-332_A1,3,1,0,0,0,4
CGAGCCGAGCACTCGA-1_V12D07-332_A1,3,2,0,0,0,5
TAGTGCTTGAATCCTT-1_V12D07-332_A1,6,0,0,0,0,6
CAACCGCACCTAGACA-1_V12D07-332_A1,1,1,0,0,0,2
ACCACTGTTCAAGAAG-1_V12D07-332_A1,5,0,0,0,0,5
AGATGCTATAACGAGC-1_V12D07-332_A1,3,1,1,0,0,5
AATTACTCGTACGCTC-1_V12D07-332_A1,1,1,0,0,0,2
CGTCAATCTTTAACAT-1_V12D07-332_A1,4,1,0,0,0,5
CCAAAGCAGTTGGTTG-1_V12D07-332_A1,3,0,2,0,0,5
CCATATTGGATCATGA-1_V12D07-332_A1,3,1,1,0,0,5
CGTACCGAAAGTCTAG-1_V12D07-332_A1,5,0,1,0,0,6
CTCGAGATCCAAAGCA-1_V12D07-332_A1,1,0,3,1,0,5
TGGATAGAGTAACAGA-1_V12D07-332_A1,3,2,0,0,0,5
TCACAGATCCTCAAAC-1_V12D07-332_A1,8,1,0,0,0,9
AGAGCTACGAAAGCAT-1_V12D07-332_A1,6,1,2,0,0,9
TGCGTGATTGGGTGTC-1_V12D07-332_A1,4,0,2,0,0,6
CACATGTTTGGACATG-1_V12D07-332_A1,2,0,2,0,0,4
TTCGCATCCGGAAGCA-1_V12D07-332_A1,2,1,1,0,0,4
CCCTAGTGTCAGGTGT-1_V12D07-332_A1,5,1,0,0,0,6
TTACCGCCTTAGGGAA-1_V12D07-332_A1,8,1,1,2,0,12
CCAGTCCATTATTCGA-1_V12D07-332_A1,2,3,0,0,0,5
CGTAAACGCTTGAGTG-1_V12D07-332_A1,5,1,2,1,0,9
ATTCCTTCCAGGCGGT-1_V12D07-332_A1,3,2,0,0,0,5
TTCCTTTCTGTGTTGC-1_V12D07-332_A1,3,1,1,0,0,5
AGTTGACATCGGCTGG-1_V12D07-332_A1,2,1,1,0,0,4
AACTCGATGGCGCAGT-1_V12D07-332_A1,3,0,1,0,0,4
GATAAGGCAGATGCAA-1_V12D07-332_A1,6,0,0,0,0,6
GGCTGGCTAGCTTAAA-1_V12D07-332_A1,2,0,0,0,0,2
CCTCATGCAGCTACGA-1_V12D07-332_A1,3,2,0,0,0,5
GACGCCTGTTGCAGGG-1_V12D07-332_A1,4,0,1,0,0,5
TAATTAGATGGATATG-1_V12D07-332_A1,3,0,0,0,0,3
GAGGGCATCGCGTATC-1_V12D07-332_A1,3,1,1,0,0,5
CTTGTGAGTCTTTGAC-1_V12D07-332_A1,0,2,2,0,0,4
TCAACACATTGGGTAA-1_V12D07-332_A1,1,1,0,0,0,2
ACTGTATACGCGAGCA-1_V12D07-332_A1,5,0,2,0,0,7
GTGAAACGTGCTCCAC-1_V12D07-332_A1,2,0,0,0,0,2
CGAGTGCTATAGTTCG-1_V12D07-332_A1,2,1,1,0,0,4
GTACTGCATGAAGCGT-1_V12D07-332_A1,2,0,0,0,0,2
GTAACTTGCGGCAGTC-1_V12D07-332_A1,1,0,0,1,0,2
GAATCGCCGGACACGG-1_V12D07-332_A1,3,1,0,0,0,4
GGGAGTAATGGCTGGC-1_V12D07-332_A1,3,1,1,0,0,5
CATGAACCGACATTTG-1_V12D07-332_A1,6,1,1,0,0,8
TCTGTCATACAAGAGC-1_V12D07-332_A1,1,0,1,0,0,2
GTCGTCAATTATAAGG-1_V12D07-332_A1,2,1,0,0,0,3
TAAAGAGCCCGAAACC-1_V12D07-332_A1,5,1,0,0,0,6
GTACTGAGGTCGTAAC-1_V12D07-332_A1,4,0,3,0,0,7
AAAGACCCAAGTCGCG-1_V12D07-332_A1,5,1,0,0,0,6
CGTCAGTGCGCACAAG-1_V12D07-332_A1,1,1,0,0,0,2
TGTATCCTTATTCCAT-1_V12D07-332_A1,3,0,1,0,0,4
ATTCTCGTCTCTTTAG-1_V12D07-332_A1,2,0,1,0,0,3
AAAGTCACTGATGTAA-1_V12D07-332_A1,4,0,1,0,0,5
TGTCTACAGTTTCTGT-1_V12D07-332_A1,3,0,0,0,0,3
TTAACGTCGCAAGACC-1_V12D07-332_A1,1,0,0,0,0,1
CTATGTCTATTGAAAC-1_V12D07-332_A1,5,0,0,0,0,5
TCGGGTGAAACTGCTA-1_V12D07-332_A1,4,0,0,0,0,4
TGTCCCGACATAGCAC-1_V12D07-332_A1,3,0,0,0,0,3
ACAGCATAGAGCCAGT-1_V12D07-332_A1,0,0,2,1,0,3
ATATTCCCACAGGTCA-1_V12D07-332_A1,3,4,0,0,0,7
TTGGATCGACTTCTGG-1_V12D07-332_A1,0,0,2,0,0,2
CACCATCGGAGGAGAC-1_V12D07-332_A1,3,0,1,1,0,5
TCGTTCGTTATTATGT-1_V12D07-332_A1,1,0,0,1,0,2
CTTAACTTCGAAGTAC-1_V12D07-332_A1,1,0,1,0,0,2
GCACAAGTGTCGGAAG-1_V12D07-332_A1,0,1,0,0,0,1
TACCAGCTAGGTTTAA-1_V12D07-332_A1,0,0,0,0,0,0
ACGTACAGATTTCTCT-1_V12D07-332_A1,3,1,0,0,0,4
AATTTGGTTCCAAAGA-1_V12D07-332_A1,1,2,0,1,0,4
GTAAGGATTTGTCGGA-1_V12D07-332_A1,0,1,0,0,0,1
CATCATCTACCCGGAC-1_V12D07-332_A1,1,0,1,0,0,2
ACGATGGATCCGATGC-1_V12D07-332_A1,0,4,1,0,0,5
CACTCAGCTCTTGAGG-1_V12D07-332_A1,1,1,1,0,0,3
TAGATCCGAAGTCGCA-1_V12D07-332_A1,1,0,0,1,0,2
TGAAACTTATGCAAGC-1_V12D07-332_A1,0,1,1,0,0,2
GCGATTCTGGAAGCAG-1_V12D07-332_A1,1,0,2,0,0,3
CAAACTATTGAGCTTC-1_V12D07-332_A1,0,0,1,0,0,1
TAGAATTAAGGGCAAC-1_V12D07-332_A1,0,2,0,0,0,2
CGAAACATAGATGGCA-1_V12D07-332_A1,1,1,0,1,0,3
GATGGTGCCCTAGGCA-1_V12D07-332_A1,2,1,1,2,0,6
CCCGCAGGGCCCAAAG-1_V12D07-332_A1,0,1,0,0,0,1
ACAGCGCACCCGCAGC-1_V12D07-332_A1,1,2,0,0,0,3
GGTAAATGTGCGTTAC-1_V12D07-332_A1,2,0,0,0,0,2
GTCCTTCTAGTGGGTT-1_V12D07-332_A1,2,2,0,1,0,5
GGAAGCTCGCTTACAG-1_V12D07-332_A1,0,1,0,0,0,1
CACCGATACACCGAGC-1_V12D07-332_A1,1,0,0,1,0,2
CAGCCGGGCCCTCTAT-1_V12D07-332_A1,1,1,0,0,0,2
CGGAGCTTATAACACC-1_V12D07-332_A1,3,1,1,0,0,5
ATTACAACTACCGGCC-1_V12D07-332_A1,1,1,0,1,0,3
TCCTCTGGCCCATTAG-1_V12D07-332_A1,0,0,0,0,0,0
CGGCACCGTTAGCGCC-1_V12D07-332_A1,4,1,0,0,0,5
TCGGTCCCTGACTCCA-1_V12D07-332_A1,0,1,0,0,0,1
TGGTTGGAGGATCCTG-1_V12D07-332_A1,0,0,0,0,0,0
CTGCGGTAGTCACGTG-1_V12D07-332_A1,4,0,0,2,0,6
GTGCCTCAGTGTACGG-1_V12D07-332_A1,0,0,1,0,0,1
ATCGTTCACTTTCGCC-1_V12D07-332_A1,0,1,0,1,0,2
ACTTACCGGGCGCGCA-1_V12D07-332_A1,0,0,1,0,0,1
CTAGACTGCATTTCGT-1_V12D07-332_A1,0,0,0,0,0,0
TTGCCGGTGATCCCTC-1_V12D07-332_A1,0,1,0,1,0,2
CTGTCACGCCAGGCGC-1_V12D07-332_A1,2,0,0,1,0,3
CGGTATAGGTATTAGC-1_V12D07-332_A1,1,2,0,1,0,4
CCAACGCTTGCCAGGG-1_V12D07-332_A1,1,0,1,2,0,4
CGTTGAGTAATTGCGT-1_V12D07-332_A1,0,1,0,2,0,3
TGTATTTACCTAATGC-1_V12D07-332_A1,0,1,0,1,0,2
TAAATGCCGTCTCATG-1_V12D07-332_A1,1,0,2,0,0,3
CGGTTTATGAAGGAAC-1_V12D07-332_A1,2,0,0,2,0,4
GCAAGATGTGTTCGCG-1_V12D07-332_A1,2,0,2,0,0,4
AAAGGTAAGCTGTACC-1_V12D07-332_A1,0,0,0,0,0,0
GTACGTCACGTATTAA-1_V12D07-332_A1,0,1,0,1,0,2
AGTACCTTCGAGTGCT-1_V12D07-332_A1,1,1,1,1,0,4
ATTGTGACTTCGCTGC-1_V12D07-332_A1,0,0,1,0,0,1
TGTATCAGACTGAAGC-1_V12D07-332_A1,1,0,1,0,0,2
GAGACCCTGCAACGCC-1_V12D07-332_A1,1,2,0,0,0,3
TGGGTGGGATGTCATT-1_V12D07-332_A1,0,0,1,1,0,2
GGCTAATGATTGAAAT-1_V12D07-332_A1,1,0,0,1,0,2
ATAACGTTACCTCCAC-1_V12D07-332_A1,1,0,0,2,0,3
TGCGAGATGGCGGCCA-1_V12D07-332_A1,0,1,0,0,0,1
CACACTTGTATTGCGA-1_V12D07-332_A1,0,1,0,0,0,1
GCTGGTGACTCGTAGT-1_V12D07-332_A1,2,0,0,1,0,3
CGACACCGCTTAAGGA-1_V12D07-332_A1,0,0,0,0,0,0
GTAACAACTGACCTTG-1_V12D07-332_A1,0,0,0,1,0,1
CAACTGAGGGTATGAC-1_V12D07-332_A1,2,0,0,2,0,4
CTAATTATGAAGCGTA-1_V12D07-332_A1,0,1,0,2,0,3
CCGATCTTAAGAGGCT-1_V12D07-332_A1,1,0,0,0,0,1
CGACTCGGTACACGGT-1_V12D07-332_A1,0,0,0,0,0,0
TGCTGCGTCAGAGTTA-1_V12D07-332_A1,0,0,1,0,0,1
AGAGTTGCAGGCCTCC-1_V12D07-332_A1,1,2,0,1,0,4
ACTGGCGAACCTGCGT-1_V12D07-332_A1,1,0,1,0,0,2
ACTAAGGACGCACACC-1_V12D07-332_A1,0,2,0,1,0,3
CGTCCAGATGGCTCCA-1_V12D07-332_A1,1,0,1,0,0,2
ACTATCGCCGGCTAAA-1_V12D07-332_A1,1,3,0,0,0,4
GATAGCGTACCACGCG-1_V12D07-332_A1,3,1,2,0,0,6
AGGACTTATAGGAGAA-1_V12D07-332_A1,5,1,0,0,0,6
TAGTCGGGATTCTTCG-1_V12D07-332_A1,2,2,2,0,0,6
ACCATTAAGGGTGTCA-1_V12D07-332_A1,2,0,1,0,0,3
TTAATGTGTTTGCAGG-1_V12D07-332_A1,2,1,1,0,0,4
TCCGCAGCCACCTAGC-1_V12D07-332_A1,5,0,1,0,0,6
GAGGAGATCCTCATGC-1_V12D07-332_A1,0,4,0,0,0,4
GGTCCTTCATACGACT-1_V12D07-332_A1,1,1,0,0,0,2
CCCTGTTGGCAAAGAC-1_V12D07-332_A1,1,3,1,0,0,5
GTCATCTCCTACAGCT-1_V12D07-332_A1,3,1,3,0,0,7
GCGAGAAACGGGAGTT-1_V12D07-332_A1,4,0,0,0,0,4
CGTCGCGGCGGGATTT-1_V12D07-332_A1,6,1,0,0,0,7
CATTGTGTGCTAGATC-1_V12D07-332_A1,1,0,2,0,0,3
CGCGGCAGTATTACGG-1_V12D07-332_A1,4,2,1,0,0,7
GAAATGGGATGTAAAC-1_V12D07-332_A1,1,1,0,0,0,2
CATTCCCTAAGTACAA-1_V12D07-332_A1,4,1,0,0,0,5
AGTTCTGCGTTGTATC-1_V12D07-332_A1,2,3,3,0,0,8
ACCCTATAGGACTGAG-1_V12D07-332_A1,3,2,0,0,0,5
TTAGATAGGTCGATAC-1_V12D07-332_A1,2,0,2,0,0,4
ATTGATAGCAACGAGA-1_V12D07-332_A1,2,2,1,0,0,5
TCTCGGCTCCAGGACT-1_V12D07-332_A1,7,2,0,0,0,9
CTTGAGGTTATCCCGA-1_V12D07-332_A1,4,2,4,0,0,10
AAGAAGGATCAGTTAG-1_V12D07-332_A1,5,0,0,1,0,6
GTACGACGGCGCTGCG-1_V12D07-332_A1,1,1,5,0,0,7
CTTATGTTGACTACCA-1_V12D07-332_A1,4,0,3,0,0,7
CGGCACTCAAGAAAGT-1_V12D07-332_A1,2,0,0,0,0,2
GTCAAAGTTTACATAG-1_V12D07-332_A1,1,0,1,0,0,2
CTCCTAAGTTATGTCT-1_V12D07-332_A1,3,3,1,0,0,7
ACTGTGCTAGTAGATC-1_V12D07-332_A1,3,2,0,0,0,5
GTTTGGCCGCTCAGCG-1_V12D07-332_A1,1,0,1,0,0,2
TTATCCAATCGAACTC-1_V12D07-332_A1,1,2,0,0,0,3
CCGTACCCAAGCGCCA-1_V12D07-332_A1,2,1,1,0,0,4
CATACAAAGCCGAACC-1_V12D07-332_A1,0,1,1,0,0,2
GGTCGGTAATTAGACA-1_V12D07-332_A1,3,0,0,0,0,3
AGCGGGAAGGGTCCAT-1_V12D07-332_A1,3,1,0,0,0,4
GCCCACCAAGGCTGTC-1_V12D07-332_A1,2,0,0,0,0,2
GTAGACGTCGTTACAT-1_V12D07-332_A1,4,0,3,0,0,7
GAGCATCATCCCTGGG-1_V12D07-332_A1,3,1,0,0,0,4
AGGTAACCTCCTATTC-1_V12D07-332_A1,3,2,0,0,0,5
GGTTTGAGTGCTGGAA-1_V12D07-332_A1,4,0,0,0,0,4
GCACTAGTCGCGCTAT-1_V12D07-332_A1,2,0,0,0,0,2
GGTAACTATGTATCTG-1_V12D07-332_A1,2,1,0,0,0,3
GCGGTCCCTAGACGCA-1_V12D07-332_A1,0,1,0,0,0,1
CGAGCGTTGATCAGCC-1_V12D07-332_A1,1,2,2,0,0,5
AATCCAAGGGCCTGAG-1_V12D07-332_A1,3,1,3,0,0,7
CCGTGCCCATGACGGC-1_V12D07-332_A1,2,0,0,0,0,2
GAAATTCACATCGCTG-1_V12D07-332_A1,4,0,0,0,0,4
CTCTGCGAAGCAAGCA-1_V12D07-332_A1,2,1,0,0,0,3
AGTAGGTAACATACAT-1_V12D07-332_A1,2,1,1,0,0,4
ATTGGGAATATCTTGG-1_V12D07-332_A1,4,0,1,0,0,5
TAGAGCTACGAAGAAC-1_V12D07-332_A1,0,2,0,0,0,2
TGCGGCATAGTTCAAC-1_V12D07-332_A1,4,0,0,0,0,4
CCGCCGGTCAACACAC-1_V12D07-332_A1,4,1,0,0,0,5
TCGTATAGTGCAATTA-1_V12D07-332_A1,2,1,1,0,0,4
TAGTTTATTCTTGCTT-1_V12D07-332_A1,2,1,1,0,0,4
GATATCTCATGCAATA-1_V12D07-332_A1,2,0,0,0,0,2
CGTTTAAGCGGAGCAC-1_V12D07-332_A1,2,0,0,0,0,2
CATGCTGGCTCCAATT-1_V12D07-332_A1,4,0,0,0,0,4
GAAACAGCCATGCAGT-1_V12D07-332_A1,1,0,2,0,0,3
AGTTTCGCAGGTCGGA-1_V12D07-332_A1,1,0,0,1,0,2
CTCATGGCTCACAATC-1_V12D07-332_A1,3,0,0,0,0,3
AACCGTTGTGTTTGCT-1_V12D07-332_A1,2,0,0,1,0,3
ACCCTTCATCTGCGAA-1_V12D07-332_A1,3,1,0,0,0,4
TGCGGTGAAATTTCAT-1_V12D07-332_A1,1,0,0,0,0,1
CAAATTGTCAGCAAGC-1_V12D07-332_A1,0,1,0,0,0,1
GAGGTACATCCATCTT-1_V12D07-332_A1,1,0,0,0,0,1
AAATGGCATGTCTTGT-1_V12D07-332_A1,4,1,0,0,0,5
TCATCCCAGAGGGTGG-1_V12D07-332_A1,2,2,2,0,0,6
CGTAGCGAATTGTCAG-1_V12D07-332_A1,1,0,0,0,0,1
CCTAGTTAGTCGCATG-1_V12D07-332_A1,0,0,1,0,0,1
GAAACTCTAATGAAGG-1_V12D07-332_A1,1,0,0,0,0,1
TTGTATCACACAGAAT-1_V12D07-332_A1,0,1,1,2,0,4
TTCAAGCCGAGCTGAG-1_V12D07-332_A1,5,1,0,0,0,6
AGGTACGATATTGCCA-1_V12D07-332_A1,0,0,0,1,0,1
TTAAGCCGACAACTTC-1_V12D07-332_A1,1,0,0,1,0,2
GTCTTAGTACAGCCGG-1_V12D07-332_A1,3,1,0,3,0,7
TGGGTAAGGTTCCCGC-1_V12D07-332_A1,1,0,0,1,0,2
CTACGCCATTTCCGAT-1_V12D07-332_A1,0,0,0,0,0,0
GACCGTCAGGTCGTGA-1_V12D07-332_A1,3,0,0,0,0,3
TAGTTAAGATAGGATA-1_V12D07-332_A1,0,0,0,1,0,1
GAATATTCGGAGTCCC-1_V12D07-332_A1,0,0,1,0,0,1
CAAACTACGATAGAGA-1_V12D07-332_A1,1,1,0,1,0,3
CAGGAAGACTTTATAT-1_V12D07-332_A1,1,0,1,1,0,3
TTCGTAATCCCAGCGG-1_V12D07-332_A1,0,3,1,0,0,4
GTGAGGAGCGGTTGAG-1_V12D07-332_A1,0,2,0,0,0,2
CAATCCCTATACCAGC-1_V12D07-332_A1,1,1,0,2,0,4
AGGGAAACGAGGTACT-1_V12D07-332_A1,0,1,0,0,0,1
TCCTGCCAACTGGAGA-1_V12D07-332_A1,1,0,0,1,0,2
AATTTGGGACATAGTA-1_V12D07-332_A1,2,1,0,0,0,3
AACTCCTAATCCCATG-1_V12D07-332_A1,1,1,0,1,0,3
GCTCATTACTGCATGT-1_V12D07-332_A1,2,0,0,1,0,3
TCTCGAACGAGGTCAC-1_V12D07-332_A1,0,0,2,1,0,3
TCACTACGACCAATGC-1_V12D07-332_A1,2,5,1,0,0,8
GTGATGCACAACATCT-1_V12D07-332_A1,0,0,0,0,0,0
CCGACGTAAACACAAC-1_V12D07-332_A1,1,1,0,3,0,5
TGGGATGCACTCATTC-1_V12D07-332_A1,1,1,0,0,0,2
TTCCATCATGCGGTGA-1_V12D07-332_A1,0,2,0,0,0,2
TGCACAGTGAAGTTAT-1_V12D07-332_A1,0,1,0,1,0,2
CTATTGTGTTTGGTCA-1_V12D07-332_A1,2,0,0,0,0,2
TGCGAGCCCTTCCGCG-1_V12D07-332_A1,0,0,2,0,0,2
TTGAAAGGTGTAAAGG-1_V12D07-332_A1,2,0,0,3,0,5
GGTGCAGAGCCTATCG-1_V12D07-332_A1,1,1,1,0,0,3
ACTATATGCTGTGTTC-1_V12D07-332_A1,2,1,1,1,0,5
TCCTGGCGCTGCCTGG-1_V12D07-332_A1,3,2,1,1,0,7
GAGCCGAGCGTTTATT-1_V12D07-332_A1,1,0,0,2,0,3
AGAATGCGGGTTCGGA-1_V12D07-332_A1,0,1,0,1,0,2
ATGCGACAATTGGTCC-1_V12D07-332_A1,0,3,0,0,0,3
TTCCGGCTCGACTTCT-1_V12D07-332_A1,1,2,0,3,0,6
TGATTATGGCACGCAG-1_V12D07-332_A1,2,1,0,1,0,4
GGTTTGACAAGAAGCT-1_V12D07-332_A1,1,0,1,0,0,2
GCAGCTATGGACAGGT-1_V12D07-332_A1,0,0,0,1,0,1
CACCATGATCGCAAAG-1_V12D07-332_A1,2,0,1,0,0,3
GTCGGAAGGATACCAG-1_V12D07-332_A1,1,1,0,1,0,3
GGCCCAGTTATCAGCA-1_V12D07-332_A1,2,0,0,0,0,2
GGGCCTATTTAAGTAT-1_V12D07-332_A1,0,0,0,0,0,0
GTTGTTACATTGCGCT-1_V12D07-332_A1,1,0,0,3,0,4
CAACTCCGTAACTTGC-1_V12D07-332_A1,0,3,0,0,0,3
GATCTTTGCTCAAAGA-1_V12D07-332_A1,1,0,0,0,0,1
TCGCTTAATTACGAAG-1_V12D07-332_A1,0,1,0,0,0,1
CGATCATTAGAGGCAC-1_V12D07-332_A1,1,0,0,0,0,1
TGTTCTCTACTCCCTA-1_V12D07-332_A1,1,1,0,1,0,3
GCTTAGGGAAGCGGTA-1_V12D07-332_A1,1,1,0,0,0,2
CAGGTTTAGTACTACA-1_V12D07-332_A1,0,0,0,0,0,0
AAGCGGAGTGCGCGCA-1_V12D07-332_A1,1,0,0,0,0,1
TCAGATGGAGACGTAG-1_V12D07-332_A1,1,0,0,1,0,2
TCGCACTAACGTTTGT-1_V12D07-332_A1,3,0,0,0,0,3
CACGTCGGGTTCTAGA-1_V12D07-332_A1,2,0,1,0,0,3
GGAGTACACATGAGCT-1_V12D07-332_A1,0,4,1,0,0,5
GTGTGTCGACGTCGCT-1_V12D07-332_A1,0,3,0,0,0,3
GAAGCTCTTTGCTTAG-1_V12D07-332_A1,7,0,0,0,0,7
ACACCGAGCGCTCTTT-1_V12D07-332_A1,1,0,0,0,0,1
CGTAATAATTACGAGT-1_V12D07-332_A1,5,0,1,0,0,6
CATCAACACCTACTAA-1_V12D07-332_A1,0,0,0,0,0,0
CCAAGTTTCTACAGAT-1_V12D07-332_A1,0,0,0,0,0,0
CACTTCGTCTTATCTC-1_V12D07-332_A1,1,0,0,0,0,1
CCCTGATGTAACTCGT-1_V12D07-332_A1,2,2,0,0,0,4
CCATAGTCAGTAACCC-1_V12D07-332_A1,6,1,2,0,0,9
CGGGCCATAGCCGCAC-1_V12D07-332_A1,2,3,0,0,0,5
CTCCGGCTTGTAGACA-1_V12D07-332_A1,3,2,2,0,0,7
AACTTGCGTTCTCGCG-1_V12D07-332_A1,4,0,2,0,0,6
AATGAGTTCGCATATG-1_V12D07-332_A1,1,2,0,0,0,3
CGAGGCCAGGCATTGG-1_V12D07-332_A1,3,1,1,0,0,5
TCTGCGTCCGGTTTCT-1_V12D07-332_A1,6,0,2,0,0,8
CAATCCTGCCGTGGAG-1_V12D07-332_A1,5,2,0,0,0,7
CTGAGCAAGTAACAAG-1_V12D07-332_A1,3,0,0,0,0,3
GGGTACCCACGGTCCT-1_V12D07-332_A1,5,1,0,0,0,6
ACGGAATTTAGCAAAT-1_V12D07-332_A1,1,0,1,0,0,2
GGGCGGTCCTATTGTC-1_V12D07-332_A1,2,1,0,0,0,3
ATGTTACGAGCAATAC-1_V12D07-332_A1,0,1,0,1,0,2
AACCATGGGATCGCTA-1_V12D07-332_A1,1,0,0,0,0,1
TCGCATCCCTAAGTGT-1_V12D07-332_A1,0,0,1,0,0,1
ACTTAGTACGACAAGA-1_V12D07-332_A1,1,1,1,0,0,3
GAGCTCTCGGACCTAA-1_V12D07-332_A1,2,1,0,0,0,3
TCTATTACGCTGGCGA-1_V12D07-332_A1,1,0,0,0,0,1
AGATACGACTTCATAT-1_V12D07-332_A1,1,3,0,0,0,4
CGCTATACCGCCCACT-1_V12D07-332_A1,0,1,1,0,0,2
CAGTGTCCGCAGAATG-1_V12D07-332_A1,1,1,0,0,0,2
CCATCCATACCAAGTC-1_V12D07-332_A1,2,1,1,0,0,4
AACCCAGAGACGGAGA-1_V12D07-332_A1,4,1,0,0,0,5
GAAGAACGGTGCAGGT-1_V12D07-332_A1,2,0,1,0,0,3
GATAAATCGGTGGATG-1_V12D07-332_A1,2,1,1,0,0,4
CAGCTCGTGCTTGTGT-1_V12D07-332_A1,2,1,1,0,0,4
GAGTACGGGTATACAA-1_V12D07-332_A1,2,0,0,0,0,2
CATCGCCCGCGGCCAA-1_V12D07-332_A1,1,2,2,0,0,5
TCTTACAGAGGTACCG-1_V12D07-332_A1,1,2,2,0,0,5
TGGAAGACGAACACCA-1_V12D07-332_A1,1,0,1,0,0,2
GTTGTCGTGTTAGTTG-1_V12D07-332_A1,2,1,1,0,0,4
CCAAGGAACAGAGAGG-1_V12D07-332_A1,1,2,0,0,0,3
CTGCACCTGGAACCGC-1_V12D07-332_A1,2,0,0,0,0,2
CGCTTTCATACCGGTG-1_V12D07-332_A1,2,0,0,0,0,2
GTTCTTCCCTCGATGT-1_V12D07-332_A1,6,0,0,0,0,6
ATTTAACTCGTATTAC-1_V12D07-332_A1,2,0,1,0,0,3
AACGATAGAAGGGCCG-1_V12D07-332_A1,0,1,0,1,0,2
TATCCTGCATGGGAAT-1_V12D07-332_A1,5,1,0,0,0,6
AGGCCCATTGTACAGG-1_V12D07-332_A1,5,0,0,0,0,5
CCGGCGCATATTGGAT-1_V12D07-332_A1,0,3,1,0,0,4
ATCTGTAATTGTACCC-1_V12D07-332_A1,0,1,1,0,0,2
GAGCGAGGGAGTACCG-1_V12D07-332_A1,0,1,0,0,0,1
TTATTAGGGAAGCATC-1_V12D07-332_A1,1,2,1,0,0,4
CTTCTTACGTCGTATA-1_V12D07-332_A1,2,0,0,0,0,2
GAAGTGCTGGATAGCT-1_V12D07-332_A1,4,1,0,0,0,5
GTGCAACAAATGTGGC-1_V12D07-332_A1,1,1,0,0,0,2
CATGCGTTAGACAGAA-1_V12D07-332_A1,0,1,0,0,0,1
ACACACTTTCTACACG-1_V12D07-332_A1,2,1,0,0,0,3
AGCCCTAAGCGAAGTT-1_V12D07-332_A1,2,0,0,0,0,2
ATTAATTCGGTCACTC-1_V12D07-332_A1,2,0,1,1,0,4
AACAGGAAATCGAATA-1_V12D07-332_A1,1,0,0,0,0,1
ACGTTTAGTTGTGATC-1_V12D07-332_A1,1,0,1,2,0,4
TCCTTCAGTGGTCGAA-1_V12D07-332_A1,0,0,0,0,0,0
CGAACGCCCAGTGCCG-1_V12D07-332_A1,0,0,1,0,0,1
CCTCGAAGTGGACGGG-1_V12D07-332_A1,1,0,0,0,0,1
CTCTGTTTGAGGATTC-1_V12D07-332_A1,1,1,0,0,0,2
TGGGCACGTTCTATGG-1_V12D07-332_A1,1,0,1,1,0,3
ACTATTCGTCCGTGGT-1_V12D07-332_A1,4,1,0,0,0,5
CCTCTGGCCTAGACGG-1_V12D07-332_A1,0,1,0,0,0,1
CCATAAACAACCCGAC-1_V12D07-332_A1,6,3,1,0,0,10
CATAGTACATTGAGAG-1_V12D07-332_A1,2,2,0,0,0,4
ATTTCATTATTTCGCG-1_V12D07-332_A1,3,0,0,3,0,6
CAACTATATCGAATGC-1_V12D07-332_A1,1,1,0,1,0,3
CTAGTATTCGGAATTA-1_V12D07-332_A1,1,1,1,4,0,7
GTGGAACCTACATGCG-1_V12D07-332_A1,1,1,1,1,0,4
CCTAAAGGCTGACGCT-1_V12D07-332_A1,1,0,1,2,0,4
CGTGACATTGGGTCGT-1_V12D07-332_A1,1,0,0,1,0,2
CCAATCGGTAGATCGA-1_V12D07-332_A1,1,1,0,0,0,2
ATTGTCGCAATACCTT-1_V12D07-332_A1,0,1,1,1,0,3
AAATTACACGACTCTG-1_V12D07-332_A1,3,0,1,0,0,4
CACTCCTCTCGGTCGG-1_V12D07-332_A1,1,0,0,0,0,1
AAATAACCATACGGGA-1_V12D07-332_A1,4,0,1,0,0,5
AGTTACTCTATCGTGG-1_V12D07-332_A1,1,1,0,0,0,2
CGTTAGCTCACAACTG-1_V12D07-332_A1,7,3,1,0,0,11
GAATGTATGGCAGGTC-1_V12D07-332_A1,4,0,0,2,0,6
GCAACCACCAGACCGG-1_V12D07-332_A1,3,0,0,1,0,4
TCACTCGTGCAACGGC-1_V12D07-332_A1,1,2,0,1,0,4
AAACAGAGCGACTCCT-1_V12D07-332_A1,1,1,0,1,0,3
CAGCCTCTCCTCAAGA-1_V12D07-332_A1,1,1,1,0,0,3
TTGCGTGAACGCTTAG-1_V12D07-332_A1,0,0,0,0,0,0
CCGCCTGCGAATTGGT-1_V12D07-332_A1,0,0,0,0,0,0
AGATGAGGGTTGCGAT-1_V12D07-332_A1,0,0,1,0,0,1
CGGTGGGCTCCAGCCT-1_V12D07-332_A1,0,2,0,1,0,3
GGCAGCGGTAATCCTA-1_V12D07-332_A1,0,0,1,0,0,1
GCTAGCAGGGAGTGGG-1_V12D07-332_A1,1,1,1,2,0,5
CTCAAGACATTAGCGC-1_V12D07-332_A1,1,1,0,0,0,2
CACGGCGCGCCAAAGG-1_V12D07-332_A1,0,0,0,0,0,0
TGCAATTTGGGCACGG-1_V12D07-332_A1,0,1,1,0,0,2
ATGCCAATCGCTCTGC-1_V12D07-332_A1,2,1,0,1,0,4
GCTGGACCCAAAGTGG-1_V12D07-332_A1,0,0,0,2,0,2
ATTCCTAAGACGTGGA-1_V12D07-332_A1,1,1,0,1,0,3
TCCGGAGGAAGGGCTG-1_V12D07-332_A1,1,2,0,1,0,4
TCGGTGACCGCTCCGG-1_V12D07-332_A1,1,2,1,1,0,5
TCCGAAGTAGTCACCA-1_V12D07-332_A1,1,0,0,1,0,2
CATGTAGGAGCGCCAA-1_V12D07-332_A1,0,1,0,0,0,1
CACAAGAAAGATATTA-1_V12D07-332_A1,0,0,1,0,0,1
AGGGTCAGTAACCCTA-1_V12D07-332_A1,2,0,0,1,0,3
TAAGCCCTTACGACCA-1_V12D07-332_A1,0,2,0,2,0,4
ATACCGTCATCCATAA-1_V12D07-332_A1,1,1,0,0,0,2
GGACGTCCATAGTTGG-1_V12D07-332_A1,0,1,0,2,0,3
CATCAAACTGGCGCCC-1_V12D07-332_A1,0,0,0,1,0,1
AAACGTGTTCGCCCTA-1_V12D07-332_A1,1,0,1,0,0,2
AAATTGGTGAGAAGCA-1_V12D07-332_A1,0,1,0,1,0,2
GGTCATTGTAGTCATA-1_V12D07-332_A1,0,1,0,1,0,2
TGCAGTGAGGCTCGGG-1_V12D07-332_A1,0,0,0,0,0,0
GAACATTAGTATGTTA-1_V12D07-332_A1,0,0,0,0,0,0
GGTTTGCGAACACGTA-1_V12D07-332_A1,1,0,1,0,0,2
ACACAAATATTCCTAG-1_V12D07-332_A1,1,2,0,1,0,4
TTGGGTTTATTCAGCG-1_V12D07-332_A1,1,1,1,2,0,5
ATTCGCAGAGGACACT-1_V12D07-332_A1,2,0,0,0,0,2
GATTTAGTGCGTACTG-1_V12D07-332_A1,0,0,0,1,0,1
TAGAAACACAATAGTG-1_V12D07-332_A1,3,1,0,0,0,4
CAGTAGATGATGTCCG-1_V12D07-332_A1,1,0,0,0,0,1
TCTTAACTCGGATGTA-1_V12D07-332_A1,3,0,0,0,0,3
TACATCTTGTTTCTTG-1_V12D07-332_A1,0,1,0,0,0,1
TTCATAGGGTGTCCAT-1_V12D07-332_A1,1,1,0,0,0,2
TGAAGTAGCTTACGGA-1_V12D07-332_A1,3,2,0,0,0,5
GCACAAGTGGATCATA-1_V12D07-332_A1,3,0,1,0,0,4
AGTCAGCCACCGCCTG-1_V12D07-332_A1,0,1,0,0,0,1
TCATCACTCGAGCTCG-1_V12D07-332_A1,4,0,0,0,0,4
CTCAGGACTCACCTGT-1_V12D07-332_A1,1,1,0,0,0,2
CGGTGTACTTGATCCC-1_V12D07-332_A1,1,0,0,0,0,1
CCTACGGCTCAGTCGA-1_V12D07-332_A1,2,3,0,0,0,5
GTACTTGGGCACTTCT-1_V12D07-332_A1,1,0,0,0,0,1
TGATTTCCTCCTGACG-1_V12D07-332_A1,5,0,1,0,0,6
CCTCACCAATCTTGAC-1_V12D07-332_A1,7,1,0,0,0,8
GGTGAGATGCAGATAA-1_V12D07-332_A1,0,2,0,0,0,2
GCTAGTTTCATTGAGG-1_V12D07-332_A1,2,0,1,0,0,3
AGGACATCGCACGTCG-1_V12D07-332_A1,3,1,0,1,0,5
GTGGACGTGCTGAGAC-1_V12D07-332_A1,3,1,1,0,0,5
TAAGGAACTTGTGGGA-1_V12D07-332_A1,3,1,0,0,0,4
TCGCTGTGCGTAAATC-1_V12D07-332_A1,5,0,0,0,0,5
GCATCCCTAACTTTGA-1_V12D07-332_A1,3,1,2,0,0,6
CACCCACACGTCACCC-1_V12D07-332_A1,0,0,0,0,0,0
CCCTCATTCTGGAATT-1_V12D07-332_A1,3,1,2,0,0,6
AGGGCGTGATCGGCTA-1_V12D07-332_A1,1,0,0,0,0,1
GGTGCGGATAAGTGGC-1_V12D07-332_A1,0,1,0,0,0,1
TAATATTGAAATTCGC-1_V12D07-332_A1,2,1,0,0,0,3
CTTACACTGGGAAATA-1_V12D07-332_A1,2,0,1,0,0,3
ACCAAGAACGCGTGTC-1_V12D07-332_A1,1,0,1,0,0,2
GCCTTCAGCCCTACCG-1_V12D07-332_A1,2,0,0,0,0,2
GATGCTACAAGCGCCT-1_V12D07-332_A1,3,3,0,0,0,6
CCGGGACCCGCAGAGA-1_V12D07-332_A1,1,0,1,0,0,2
GTTCCAGTCTGACCAT-1_V12D07-332_A1,1,0,1,0,0,2
ATGATCGGGAATAGAC-1_V12D07-332_A1,4,0,0,0,0,4
TTGGATTGGGTACCAC-1_V12D07-332_A1,4,2,0,0,0,6
TACCTCACGCTTGTAC-1_V12D07-332_A1,1,1,1,0,0,3
CATGGCAGGAAGATCG-1_V12D07-332_A1,0,1,0,0,0,1
ATGACGCCGGCTCTAA-1_V12D07-332_A1,0,0,0,0,0,0
AGCGACATCCCATTCA-1_V12D07-332_A1,6,1,0,0,0,7
AGTAATGTCTTGCCGC-1_V12D07-332_A1,1,1,0,0,0,2
TTCTTAGTGGCTCAGA-1_V12D07-332_A1,3,0,0,0,0,3
CGTCTGGAAGGGCCCG-1_V12D07-332_A1,5,0,0,0,0,5
ACGTGCGCCTCGTGCA-1_V12D07-332_A1,2,1,2,1,0,6
AGAGCGGGCTAATCAT-1_V12D07-332_A1,4,0,0,0,0,4
GCGTCGAAATGTCGGT-1_V12D07-332_A1,0,2,0,0,0,2
AACTGATATTAGGCCT-1_V12D07-332_A1,2,0,0,0,0,2
CGAGCTGGGCTTTAGG-1_V12D07-332_A1,2,1,1,0,0,4
GGGTGTTTCAGCTATG-1_V12D07-332_A1,5,1,1,0,0,7
TTAATTTCAGACGCGG-1_V12D07-332_A1,1,1,0,0,0,2
ACTGCCGTCGTAACTC-1_V12D07-332_A1,1,0,0,1,0,2
GTGCACGAAAGTGACT-1_V12D07-332_A1,0,1,0,0,0,1
ATCTCCCTGCAATCTA-1_V12D07-332_A1,0,0,2,0,0,2
ACGCCAGATGATTTCT-1_V12D07-332_A1,0,2,2,0,0,4
AGCTATTTAATCCAAC-1_V12D07-332_A1,0,1,0,1,0,2
CCACGAGAAGAGAATC-1_V12D07-332_A1,0,2,1,0,0,3
GATTCCGCGTTTCCGT-1_V12D07-332_A1,1,0,0,0,0,1
GTCGGATGTAGCGCGC-1_V12D07-332_A1,3,0,1,0,0,4
TATTTATACCGAGTAG-1_V12D07-332_A1,1,1,1,1,0,4
GTAGGTGATCCGTGTA-1_V12D07-332_A1,3,0,0,0,0,3
AGTTAAGCGGTCCCGG-1_V12D07-332_A1,1,0,0,0,0,1
CTGGCGACATAAGTCC-1_V12D07-332_A1,1,1,2,1,0,5
TTGGCCTAGAATTTCG-1_V12D07-332_A1,1,2,0,0,0,3
GGCATATCGGTTCTGC-1_V12D07-332_A1,4,0,0,2,0,6
GGGCGTCCACTGGCTC-1_V12D07-332_A1,2,3,0,0,0,5
TTACCCATTGCCGGGT-1_V12D07-332_A1,1,0,0,1,0,2
TTAGACACGATCGTTG-1_V12D07-332_A1,2,0,0,0,0,2
GCGCTGATCCAGACTC-1_V12D07-332_A1,3,0,0,0,0,3
TTCGGCAACCCGCTGA-1_V12D07-332_A1,4,2,0,0,0,6
GATATTTCCTACATGG-1_V12D07-332_A1,6,1,0,0,0,7
CTGCGTTACGATATAA-1_V12D07-332_A1,3,1,1,1,0,6
TAATAAACAAGGAGAT-1_V12D07-332_A1,3,2,1,0,0,6
AACCTTTACGACGTCT-1_V12D07-332_A1,1,0,1,0,0,2
AGTCCCGCCTTTAATT-1_V12D07-332_A1,0,0,0,0,0,0
TGAGATTAGGCCCTAA-1_V12D07-332_A1,2,2,0,0,0,4
AGTGTATTGCGCATTG-1_V12D07-332_A1,1,1,0,0,0,2
GTTGGATTCAGTGGCT-1_V12D07-332_A1,1,0,3,1,0,5
TAAAGCTGCAATAGGG-1_V12D07-332_A1,0,2,0,1,0,3
AGTAGGAAGGAAGTTG-1_V12D07-332_A1,2,2,0,1,0,5
TATCACTTCGAGTAAC-1_V12D07-332_A1,0,0,1,0,0,1
TGATCTACGCTGATCT-1_V12D07-332_A1,0,0,0,1,0,1
GGATCATCCCGTACGC-1_V12D07-332_A1,2,2,0,0,0,4
TGACACTTCTCTTTGC-1_V12D07-332_A1,0,2,0,1,0,3
AGCCCTTCTAATCCGA-1_V12D07-332_A1,4,0,0,1,0,5
CACCGCGTCCACTCTA-1_V12D07-332_A1,1,0,0,1,0,2
TAATTGGAATCGGGAA-1_V12D07-332_A1,0,1,1,1,0,3
TCGTAAGCTCCGAGGA-1_V12D07-332_A1,0,0,0,0,0,0
TATATTACAAATGTCG-1_V12D07-332_A1,0,0,0,0,0,0
CGCGAGAGGGACTTGT-1_V12D07-332_A1,1,0,1,0,0,2
GGACCTACGGTAACGT-1_V12D07-332_A1,2,0,1,1,0,4
GAAATATGCTTGAATG-1_V12D07-332_A1,1,0,0,3,0,4
CCGTATTAGCGCAGTT-1_V12D07-332_A1,1,0,0,0,0,1
AGGCGTCTATGGACGG-1_V12D07-332_A1,1,0,1,0,0,2
AACATCGATACGTCTA-1_V12D07-332_A1,1,2,2,1,0,6
TGAATATGCTATAAAC-1_V12D07-332_A1,0,0,1,0,0,1
ACCAAACACCCAGCGA-1_V12D07-332_A1,1,2,0,0,0,3
TGGCTTGTACAAGCTT-1_V12D07-332_A1,0,1,0,2,0,3
GAATGAAGGTCTTCAG-1_V12D07-332_A1,1,0,1,0,0,2
AGATACCAGCACTTCA-1_V12D07-332_A1,2,0,0,0,0,2
GCGGTCCCGGTGAAGG-1_V12D07-332_A1,1,1,0,1,0,3
GAGGCATTTGCAGCAG-1_V12D07-332_A1,1,0,0,2,0,3
GGCAAGCCAGGGATAG-1_V12D07-332_A1,1,1,0,1,0,3
TCTACGGGCTCAGTTG-1_V12D07-332_A1,1,0,1,0,0,2
TCTGCGAATCGTTCGC-1_V12D07-332_A1,1,0,0,0,0,1
AGCTCGTTGATGGAAA-1_V12D07-332_A1,0,1,1,1,0,3
TGAATGAGATACAGCA-1_V12D07-332_A1,1,1,0,1,0,3
ACCCTTGCCTGGGTCG-1_V12D07-332_A1,0,0,0,0,0,0
GGCGAACCGTTCTGAT-1_V12D07-332_A1,1,0,0,1,0,2
GCGATGTCTGTGCTTG-1_V12D07-332_A1,1,0,0,0,0,1
ATTAACACCTGAGATA-1_V12D07-332_A1,7,1,0,0,0,8
GAAATCTGACCAAGTT-1_V12D07-332_A1,3,1,0,0,0,4
CCTGACAAACTCGCGC-1_V12D07-332_A1,1,1,0,0,0,2
ATGTCATTTCCCATTG-1_V12D07-332_A1,5,0,1,0,0,6
TAACTCCATGGAGGCT-1_V12D07-332_A1,1,0,0,0,0,1
CTTGTTTATGTAGCCA-1_V12D07-332_A1,2,1,0,0,0,3
GATGGCGCACACATTA-1_V12D07-332_A1,0,0,0,0,0,0
ATAATAGTGTAGGGAC-1_V12D07-332_A1,2,1,0,0,0,3
CGCTATTCAATGTATG-1_V12D07-332_A1,3,2,0,0,0,5
ATATTGCTGTCAAAGT-1_V12D07-332_A1,2,0,0,0,0,2
GGATTCAGTACGGTGG-1_V12D07-332_A1,1,0,0,0,0,1
TTCTTAGTGAACGGTG-1_V12D07-332_A1,0,0,0,0,0,0
AATGGTTCTCACAAGC-1_V12D07-332_A1,1,1,1,0,0,3
TATACACGCAAAGTAT-1_V12D07-332_A1,1,0,0,0,0,1
CTTCATAGCTCAAGAA-1_V12D07-332_A1,2,2,1,0,0,5
CAACGGTTCTTGATAC-1_V12D07-332_A1,7,2,0,0,0,9
ACACCCGAGAAATCCG-1_V12D07-332_A1,3,0,1,0,0,4
TCTATCATGCAGTTAC-1_V12D07-332_A1,2,0,0,0,0,2
CCCGCCATGCTCCCGT-1_V12D07-332_A1,1,0,0,0,0,1
CGCTTCCACTGAAATC-1_V12D07-332_A1,3,0,1,0,0,4
CACTGTCCAAGTGAGA-1_V12D07-332_A1,0,2,0,0,0,2
ATTACTAGCCTCTTGC-1_V12D07-332_A1,2,0,0,0,0,2
CATAGTAGCATAGTAG-1_V12D07-332_A1,2,0,0,0,0,2
CAACTCCTTGATCCCG-1_V12D07-332_A1,2,1,0,0,0,3
AAGTAGAAGACCGGGT-1_V12D07-332_A1,1,0,1,0,0,2
GCGGGAACCAGGCCCT-1_V12D07-332_A1,0,2,1,0,0,3
ATTAGATTGATAGCGG-1_V12D07-332_A1,1,1,0,2,0,4
CTCGGTCCGTAGCCTG-1_V12D07-332_A1,0,0,1,0,0,1
TGGCTTTGGGTAGACA-1_V12D07-332_A1,3,0,1,0,0,4
TATCCATATCATGCGA-1_V12D07-332_A1,1,2,0,0,0,3
GGAGTGCCGCCCTGGA-1_V12D07-332_A1,1,0,0,1,0,2
TGAGAATGCTTTACCG-1_V12D07-332_A1,6,1,0,1,0,8
TTAACCAACCCTCCCT-1_V12D07-332_A1,4,0,0,0,0,4
TGTTTCGGTACTTCTC-1_V12D07-332_A1,0,1,1,0,0,2
TTGCTGAAGGAACCAC-1_V12D07-332_A1,5,2,0,0,0,7
TATTTAGTCTAGATCG-1_V12D07-332_A1,7,1,1,0,0,9
CTCCGGCCTAATATGC-1_V12D07-332_A1,2,0,0,0,0,2
TTGTGGCCCTGACAGT-1_V12D07-332_A1,2,1,2,0,0,5
TCGCCGGTCGATCCGT-1_V12D07-332_A1,3,1,0,0,0,4
CCATAGGTTGGCGTGG-1_V12D07-332_A1,1,1,0,0,0,2
GAACGACCGAATGATA-1_V12D07-332_A1,0,1,0,0,0,1
TCCGATAATTGCCATA-1_V12D07-332_A1,1,1,0,0,0,2
CATTACGTCGGCCCGT-1_V12D07-332_A1,5,1,1,0,0,7
CAAGCACCAAATGCCT-1_V12D07-332_A1,2,1,1,0,0,4
TGCATGGATCGGATCT-1_V12D07-332_A1,4,0,0,0,0,4
GAAATCGCGCGCAACT-1_V12D07-332_A1,0,0,0,0,0,0
CTGAAAGAGATCCGAC-1_V12D07-332_A1,1,1,0,0,0,2
CACCTCGATGGTGGAC-1_V12D07-332_A1,1,1,1,1,0,4
ATTTGTTCCAGGGCTC-1_V12D07-332_A1,2,1,0,0,0,3
TGGGCCACAAGAGCGC-1_V12D07-332_A1,1,1,1,0,0,3
CCTTCTTGATCCAGTG-1_V12D07-332_A1,1,0,1,0,0,2
CCTCGCCAGCAAATTA-1_V12D07-332_A1,0,1,1,0,0,2
TTCATGGCGCAACAGG-1_V12D07-332_A1,1,3,0,0,0,4
TTAATCAGTACGTCAG-1_V12D07-332_A1,3,1,3,1,0,8
CCTATCTATATCGGAA-1_V12D07-332_A1,0,0,0,0,0,0
ATTATACTTTGCTCGT-1_V12D07-332_A1,3,3,0,1,0,7
ATGGATCCGGCGTCCG-1_V12D07-332_A1,3,1,0,0,0,4
CGCCCGCTTCCGTACA-1_V12D07-332_A1,1,0,0,0,0,1
GGATTCCGCTATACCC-1_V12D07-332_A1,0,0,0,0,1,1
CGGTCTATCAACCCGT-1_V12D07-332_A1,2,0,0,0,0,2
ATGCCGGTTGATGGGA-1_V12D07-332_A1,1,0,0,0,0,1
TCATGCAGGTTCTCAT-1_V12D07-332_A1,2,0,0,1,0,3
TGAGCTTTAATGACGC-1_V12D07-332_A1,4,1,0,0,0,5
TCCCTTAGATTACTCG-1_V12D07-332_A1,1,1,0,0,0,2
ATATCTCCCTCGTTAA-1_V12D07-332_A1,1,0,1,1,0,3
AGCTCTTCCCAGTGCA-1_V12D07-332_A1,2,0,0,0,0,2
TCGCTAAACCGCTATC-1_V12D07-332_A1,2,2,0,0,0,4
CACATTCTTTCGATGG-1_V12D07-332_A1,2,2,0,0,0,4
GATATGCGGTAGCCAA-1_V12D07-332_A1,2,0,1,0,0,3
CGTTTCACTTCGGGCG-1_V12D07-332_A1,3,0,0,0,0,3
CCAATTACGGGTCGAG-1_V12D07-332_A1,0,0,0,1,0,1
GCAGGTAGAGTATGGT-1_V12D07-332_A1,0,2,0,0,0,2
GTCGTATTGGCGTACA-1_V12D07-332_A1,0,1,0,0,0,1
GAAATTAGCACGGATA-1_V12D07-332_A1,3,1,1,0,0,5
AATGCACCAAGCAATG-1_V12D07-332_A1,2,1,0,0,0,3
AGGACGCTCGATGTTG-1_V12D07-332_A1,1,0,1,0,0,2
GGCTAAAGGGCGGGTC-1_V12D07-332_A1,3,1,0,1,0,5
CATCTATCCCGTGTCT-1_V12D07-332_A1,1,0,2,1,0,4
CAGTAACTATTTATTG-1_V12D07-332_A1,0,0,0,1,0,1
CATATACTACTGATAA-1_V12D07-332_A1,2,1,0,0,0,3
GCGTTCGGAGACCGGG-1_V12D07-332_A1,1,1,1,1,0,4
AAGTTCAGTCTGCGTA-1_V12D07-332_A1,0,1,1,0,0,2
CGAAGCTATAAATTCA-1_V12D07-332_A1,0,0,1,0,0,1
CGCGGTCACAAACCAA-1_V12D07-332_A1,0,1,0,1,0,2
GGGAATGAGCCCTCAC-1_V12D07-332_A1,0,0,0,1,0,1
ACGGAGCGCAAATTAC-1_V12D07-332_A1,0,0,0,0,0,0
CGTTCTTCGCACACCT-1_V12D07-332_A1,0,1,1,1,0,3
GAATAGCCCTGCGGTC-1_V12D07-332_A1,1,0,1,2,0,4
AATAGCTACCGCGTGC-1_V12D07-332_A1,0,1,0,3,0,4
CCGAGCTGTGCTTGTC-1_V12D07-332_A1,0,1,0,0,0,1
GATGACGATGATCGCG-1_V12D07-332_A1,1,2,0,1,0,4
GCCTATGCTGGGCCTT-1_V12D07-332_A1,0,1,0,3,0,4
TTACTGTCTAGAGCTC-1_V12D07-332_A1,1,1,0,0,0,2
AGCGGTTGCCGCTCTG-1_V12D07-332_A1,1,0,0,1,0,2
GCTTGCAGCACAATTG-1_V12D07-332_A1,1,1,0,2,0,4
CCGGAGGTCTTATGGT-1_V12D07-332_A1,0,0,0,1,0,1
ACAGTATACCGTGGGA-1_V12D07-332_A1,0,0,0,1,0,1
GGGATCCCAATACAAA-1_V12D07-332_A1,1,0,0,3,0,4
ATTACGACTCCACAGT-1_V12D07-332_A1,1,1,1,2,0,5
CTCACACGCAAGCCTA-1_V12D07-332_A1,0,2,1,0,0,3
CCAGATGTAAATGGGT-1_V12D07-332_A1,2,2,0,1,0,5
GAACTTGTGCACGGGA-1_V12D07-332_A1,2,0,0,2,0,4
AAGCCGCTTTACCTTG-1_V12D07-332_A1,0,0,0,0,0,0
TCCATTCCCACTAGAG-1_V12D07-332_A1,3,0,1,0,0,4
AGAGCGCTTGTAACGG-1_V12D07-332_A1,0,0,1,0,0,1
TGGGTTCCCGGACGGA-1_V12D07-332_A1,2,0,0,0,0,2
GCTGCGCCTCCCACGT-1_V12D07-332_A1,4,1,1,0,0,6
CTGTTGGCTCTTCTGA-1_V12D07-332_A1,3,0,0,0,0,3
TTGTTCTAGATACGCT-1_V12D07-332_A1,0,1,1,0,0,2
CCCTCAAGCTCTTAGT-1_V12D07-332_A1,0,0,0,0,0,0
CAGTAATCCCTCCCAG-1_V12D07-332_A1,0,1,0,0,0,1
GTATTAAGGCGTCTAA-1_V12D07-332_A1,1,0,0,0,0,1
CTAATTTCAACAACAC-1_V12D07-332_A1,1,1,0,0,0,2
TTAGCAACATGGATGT-1_V12D07-332_A1,3,0,0,0,0,3
ATGCTCAGTGTTGCAT-1_V12D07-332_A1,3,1,2,0,0,6
GATGTTTGTGCGAGAT-1_V12D07-332_A1,5,1,0,0,0,6
CACTTCGCCACAGGCT-1_V12D07-332_A1,0,1,0,0,0,1
CTGTATGGTGTAGAAA-1_V12D07-332_A1,1,0,0,0,0,1
TACGTGCACTATGCTG-1_V12D07-332_A1,2,0,0,0,0,2
GTATCAGCTTGGGTTC-1_V12D07-332_A1,0,0,1,0,0,1
TAACAAAGGGAGAAGC-1_V12D07-332_A1,4,1,1,0,0,6
TTACATCGTGGCCTGG-1_V12D07-332_A1,2,1,1,0,0,4
TCTGAACCGGTCGGCT-1_V12D07-332_A1,2,2,0,0,0,4
GGCTCGTGCCACCAGC-1_V12D07-332_A1,2,0,2,0,0,4
TATAAGTGAGGATAGC-1_V12D07-332_A1,2,1,0,0,0,3
GCCCGCGCGTTTGACA-1_V12D07-332_A1,1,3,1,0,0,5
TGCTGGTTGGACAATT-1_V12D07-332_A1,0,0,0,0,0,0
GCCTAGCGATCTGACC-1_V12D07-332_A1,0,7,1,0,0,8
CCATGCTCTGCAGGAA-1_V12D07-332_A1,2,1,0,0,0,3
TATAAATCCACAAGCT-1_V12D07-332_A1,0,0,0,0,0,0
CGCTCGACATAATGAT-1_V12D07-332_A1,3,0,2,0,0,5
CCAATTGAATGTTAAT-1_V12D07-332_A1,4,1,0,0,0,5
GCTAATACCGAATGCC-1_V12D07-332_A1,4,1,0,0,0,5
TTCAACGACCCGACCG-1_V12D07-332_A1,1,1,0,0,0,2
TTCCTCGAGGGTGTCT-1_V12D07-332_A1,0,0,3,0,0,3
CAACGACCCGTTTACA-1_V12D07-332_A1,1,0,0,0,0,1
CTTGTACTTGTTGACT-1_V12D07-332_A1,1,0,0,0,0,1
TCTCTAATAGCTGGTA-1_V12D07-332_A1,2,0,3,0,0,5
ATTATGCCATAGGGAG-1_V12D07-332_A1,1,1,0,0,0,2
GACAACGCAGCTTACG-1_V12D07-332_A1,8,1,0,0,0,9
AGATGACTCGCCCACG-1_V12D07-332_A1,3,1,0,0,0,4
GTGCGGGTCTCCAAAT-1_V12D07-332_A1,1,0,0,1,0,2
GTACGAGATTGCGACA-1_V12D07-332_A1,5,1,0,0,0,6
GTATAGGACTCAGTAG-1_V12D07-332_A1,2,0,2,0,0,4
TTGCACGGAGCAGCAC-1_V12D07-332_A1,2,2,0,0,0,4
CACAGCTAGGGAGTGA-1_V12D07-332_A1,2,1,0,0,0,3
ATACTAGCATGACCCT-1_V12D07-332_A1,3,3,1,0,0,7
CCAAGACTTCTGCGAA-1_V12D07-332_A1,3,1,0,0,0,4
ACATAATAAGGCGGTG-1_V12D07-332_A1,0,0,1,0,0,1
TAATACACAGTAGTAT-1_V12D07-332_A1,3,0,0,0,0,3
TCTTGGTAACACCAAA-1_V12D07-332_A1,3,1,0,0,0,4
AACTGGGTCCCGACGT-1_V12D07-332_A1,3,4,2,0,0,9
ATCACTTCATCCTCGC-1_V12D07-332_A1,4,2,2,0,0,8
TGGAAGGATAAAGATG-1_V12D07-332_A1,2,2,0,0,0,4
CATGATGCACAATTCT-1_V12D07-332_A1,0,2,0,0,0,2
TGCCTGATCAAACGAT-1_V12D07-332_A1,1,1,0,0,0,2
ATAGGGATATCCTTGA-1_V12D07-332_A1,0,2,0,0,0,2
CACCTAATCAGTTTAC-1_V12D07-332_A1,0,1,2,0,0,3
TGTGACTACGCCAGTC-1_V12D07-332_A1,1,0,2,0,0,3
CCCGACCATAGTCCGC-1_V12D07-332_A1,1,1,0,0,0,2
CGCGCCCGACTTAATA-1_V12D07-332_A1,2,2,0,0,0,4
TGCCACCTGGCGAAAC-1_V12D07-332_A1,3,0,2,0,0,5
CTGCCAAGGTTGGAAG-1_V12D07-332_A1,2,0,0,0,0,2
TCTCCAACGTAGGTTA-1_V12D07-332_A1,5,0,2,0,0,7
TTCTTGGAGTAATGAG-1_V12D07-332_A1,2,0,0,0,0,2
GTCTCGATCTGCTTTC-1_V12D07-332_A1,2,1,0,1,0,4
TACTCTCCGAACAAAT-1_V12D07-332_A1,3,3,0,0,0,6
ATCACATTAGAATATC-1_V12D07-332_A1,0,1,0,1,0,2
TACGGGATGCTAGCAG-1_V12D07-332_A1,0,1,1,1,0,3
AGCTGAAGTAAACCAA-1_V12D07-332_A1,2,0,1,0,0,3
CATGGGTCGGGTGTGG-1_V12D07-332_A1,1,1,1,1,0,4
CACCCACGAGGCAATT-1_V12D07-332_A1,0,0,0,0,0,0
TGCCATTACTAAAGAA-1_V12D07-332_A1,0,0,1,0,0,1
CCGTTACGTTAGAACA-1_V12D07-332_A1,1,0,0,2,0,3
GCCAGGAGTAACCGAT-1_V12D07-332_A1,3,0,1,2,0,6
GGAAAGTGCCCATGCC-1_V12D07-332_A1,0,1,0,1,0,2
TCTTACCGGAACTCGT-1_V12D07-332_A1,0,2,0,0,0,2
TATGTCAAGACCGACT-1_V12D07-332_A1,1,1,1,0,0,3
CCTAACTAAGGCTCTA-1_V12D07-332_A1,0,2,1,1,0,4
GCGGTGAACTGCGCTC-1_V12D07-332_A1,3,0,0,1,0,4
CCTCGCGCGATATAGG-1_V12D07-332_A1,0,1,1,0,0,2
ATCGGCAAGCAGTCCA-1_V12D07-332_A1,0,2,0,0,0,2
AGATCGTGCATAAGAT-1_V12D07-332_A1,2,1,1,0,0,4
ATTCAGGACCTATTTC-1_V12D07-332_A1,4,2,0,0,0,6
AGCTAGAAGCAGAAGT-1_V12D07-332_A1,3,1,0,0,0,4
TTCGCTATCTGACGTG-1_V12D07-332_A1,2,1,0,1,0,4
TTCCGCAGAGAAATAT-1_V12D07-332_A1,3,1,1,0,0,5
CAGTACATTCTCTAAA-1_V12D07-332_A1,1,2,0,0,0,3
GTGAAGATTTCAAGTG-1_V12D07-332_A1,2,0,0,0,0,2
AACGCATGATCTGGGT-1_V12D07-332_A1,1,0,0,0,0,1
CCCAGAGGAGGGCGTA-1_V12D07-332_A1,5,0,0,1,0,6
GGAAACCTTGTTGAAT-1_V12D07-332_A1,1,0,0,0,0,1
GTGAAGCCGTATAGTC-1_V12D07-332_A1,4,1,0,1,0,6
GAGCTGTCGTCTCGGA-1_V12D07-332_A1,1,0,1,2,0,4
TGTCATTTGTTGGGAA-1_V12D07-332_A1,0,2,1,0,0,3
ACCAACACCACACACT-1_V12D07-332_A1,2,1,1,0,0,4
AAATGATTCGATCAGC-1_V12D07-332_A1,3,0,0,0,0,3
CTGCTTTATGTCCGCG-1_V12D07-332_A1,2,0,0,0,0,2
GCGAGAGGCCATGTAA-1_V12D07-332_A1,1,0,0,0,0,1
ATTGACCGGCGATGAC-1_V12D07-332_A1,0,0,1,2,0,3
ACCCTGGTAACGCCCT-1_V12D07-332_A1,0,0,0,2,0,2
GTTGGACCGCATCAGG-1_V12D07-332_A1,1,1,0,1,0,3
CGTTTACAAGGCAGCT-1_V12D07-332_A1,1,1,0,1,0,3
CGGTCCATGAGACTCC-1_V12D07-332_A1,1,1,0,1,0,3
GTTCGTCTGGGTCCCT-1_V12D07-332_A1,2,0,0,0,0,2
TGTACTACTCTCACGG-1_V12D07-332_A1,1,1,0,1,0,3
AGTGAAGATGGTGTCC-1_V12D07-332_A1,1,0,0,0,0,1
GAGGGCCATAATATTA-1_V12D07-332_A1,1,1,1,0,0,3
ACTCCCGTAGACTAGG-1_V12D07-332_A1,0,1,1,0,0,2
CGTCAAATGGTCGCAG-1_V12D07-332_A1,1,0,0,0,0,1
AAGTCTAGTAGCTGCC-1_V12D07-332_A1,1,1,0,1,0,3
AAGAAATCACCAGATT-1_V12D07-332_A1,0,0,0,2,0,2
GAGTGCACGGACAACA-1_V12D07-332_A1,1,1,0,0,0,2
GTTCAAATCAGATGTC-1_V12D07-332_A1,6,1,0,0,0,7
CATGGCTCCCTATGTC-1_V12D07-332_A1,2,0,1,0,0,3
GGCCACACGAAAGCCT-1_V12D07-332_A1,0,1,0,0,0,1
GAAGCCGGGTAAGCTC-1_V12D07-332_A1,3,1,0,0,0,4
TACATGACCTTATCCG-1_V12D07-332_A1,1,0,2,0,0,3
AATACAATGTTTCAGG-1_V12D07-332_A1,0,0,0,0,0,0
CCAGAGACAAAGCCGG-1_V12D07-332_A1,3,0,0,0,0,3
CCGAAGTATATTGTTC-1_V12D07-332_A1,1,0,0,0,0,1
GCTAAACCTGAGGTGA-1_V12D07-332_A1,4,0,0,0,0,4
TCATACTTACAGATCC-1_V12D07-332_A1,4,0,0,0,0,4
CGAGCACTTCAAGTTT-1_V12D07-332_A1,2,1,1,0,0,4
TAGCAACCTGTCACAA-1_V12D07-332_A1,5,1,0,0,0,6
TGGGAAATGCCTTTCC-1_V12D07-332_A1,2,0,1,1,0,4
AGACCATGGGATACAA-1_V12D07-332_A1,1,0,2,0,0,3
TAAATGAATCCGTTTC-1_V12D07-332_A1,3,0,0,0,0,3
ACAACGGTCCCTGCGA-1_V12D07-332_A1,1,0,1,0,0,2
GTCACTCTCCAAATCT-1_V12D07-332_A1,1,0,0,0,0,1
TTCTACTTGCGAGGGC-1_V12D07-332_A1,2,1,2,0,0,5
CGCAATTACTTTCGGT-1_V12D07-332_A1,3,0,0,1,0,4
CTGTTCATCTCACGGG-1_V12D07-332_A1,2,0,1,0,0,3
TTCTTGTAACCTAATG-1_V12D07-332_A1,2,1,1,0,0,4
GCTTGATGATAATCAG-1_V12D07-332_A1,3,0,0,2,0,5
TTGGCTCGCATGAGAC-1_V12D07-332_A1,3,0,0,0,0,3
GCCCAGTTGGTATGCC-1_V12D07-332_A1,2,0,2,0,0,4
ATTCCTCCGCCAGTGC-1_V12D07-332_A1,4,1,1,1,0,7
TCGTCCGCTGGCGTCT-1_V12D07-332_A1,3,0,0,0,0,3
GGAGAAGTCATTGGCA-1_V12D07-332_A1,2,2,1,1,0,6
TTGTTAGCAAATTCGA-1_V12D07-332_A1,2,0,1,0,0,3
TCTAGCATCTTCGATG-1_V12D07-332_A1,2,1,0,0,0,3
TTCTAGGCCAATTGTG-1_V12D07-332_A1,0,0,0,0,0,0
TCACGGTCATCGCACA-1_V12D07-332_A1,2,0,0,0,0,2
ATGAAGCCAAGGAGCC-1_V12D07-332_A1,1,1,1,1,0,4
AATGACTGTCAGCCGG-1_V12D07-332_A1,3,0,1,0,0,4
CCAAACAGAACCCTCG-1_V12D07-332_A1,2,0,1,0,0,3
TATCGATGATTAAACG-1_V12D07-332_A1,0,0,1,0,0,1
GAACACACATCAACCA-1_V12D07-332_A1,1,1,1,0,0,3
CCCGTCAGCGTCTGAC-1_V12D07-332_A1,2,0,1,0,0,3
AGCATCGTCGATAATT-1_V12D07-332_A1,1,1,1,0,0,3
GACTAAGATCATGCAC-1_V12D07-332_A1,5,0,2,0,0,7
TAGGGTGTTTCAAGAG-1_V12D07-332_A1,4,1,2,0,0,7
TGGTTCGTAGCAAAGG-1_V12D07-332_A1,2,2,1,2,0,7
CTGTTCACTGCCTGTG-1_V12D07-332_A1,1,0,1,0,0,2
ATGTGCATCCGACGCA-1_V12D07-332_A1,1,0,0,0,0,1
TTGTCGTTCAGTTACC-1_V12D07-332_A1,4,0,0,0,0,4
CGGGATCAATGTAAGA-1_V12D07-332_A1,2,1,0,0,0,3
TTATCTGTATCATAAC-1_V12D07-332_A1,2,0,0,0,0,2
ATCGACTCTTTCCGTT-1_V12D07-332_A1,2,1,2,0,0,5
CTCATTTGATGGGCGG-1_V12D07-332_A1,5,1,1,0,0,7
GTAAGCGGGCAGTCAG-1_V12D07-332_A1,0,2,0,0,0,2
TCTATCGGTCGCAACA-1_V12D07-332_A1,1,0,0,0,0,1
AACGCGGTCTCCAGCC-1_V12D07-332_A1,2,0,1,0,0,3
ATTAATACTACGCGGG-1_V12D07-332_A1,3,0,1,0,0,4
CTTTAACTTTCAAAGG-1_V12D07-332_A1,3,1,1,1,0,6
CGTACCTGATAGGCCT-1_V12D07-332_A1,3,0,1,0,0,4
GAATGTTGGGTAATCT-1_V12D07-332_A1,3,1,0,0,0,4
TGCGGAGTAAAGGTGC-1_V12D07-332_A1,0,0,1,0,0,1
CCTGAATATTTACATA-1_V12D07-332_A1,4,0,0,0,0,4
TTGCTCCCATACCGGA-1_V12D07-332_A1,4,0,0,0,0,4
CCTCTAATCTGCCAAG-1_V12D07-332_A1,0,1,0,0,0,1
AGGTTGAGGCACGCTT-1_V12D07-332_A1,1,1,0,0,0,2
TCCCGTCAGTCCCGCA-1_V12D07-332_A1,3,4,0,0,0,7
TCCGATGACTGAGCTC-1_V12D07-332_A1,2,0,0,0,0,2
CAGCCTCCTGCAGAGG-1_V12D07-332_A1,2,0,0,0,0,2
CTTAGCCTTCCACATG-1_V12D07-332_A1,0,1,1,0,0,2
ATTAATGAACCAGTCG-1_V12D07-332_A1,6,0,2,1,0,9
ACGATACATAGAACTA-1_V12D07-332_A1,0,2,0,0,0,2
AGCCACTCCCGTGCTT-1_V12D07-332_A1,2,2,0,0,0,4
ATACGGGTTTCGATTG-1_V12D07-332_A1,1,1,1,2,0,5
CTGTCAAATGGCTCGG-1_V12D07-332_A1,2,2,1,0,0,5
GCTCGGAATTTAAAGC-1_V12D07-332_A1,3,1,0,0,0,4
TAGGCATGTTACGCCA-1_V12D07-332_A1,1,1,0,0,0,2
TGGCAACTCGCGCGCC-1_V12D07-332_A1,0,0,0,0,0,0
ATCAGTAGGCAGGGAT-1_V12D07-332_A1,1,0,1,0,0,2
TATCGATCTATGCATA-1_V12D07-332_A1,1,0,0,0,0,1
CGACTCAGGATGTTAT-1_V12D07-332_A1,2,0,0,0,0,2
GCCATATTGCACACAG-1_V12D07-332_A1,2,0,0,2,0,4
AATTCATAAGGGATCT-1_V12D07-332_A1,1,0,0,1,0,2
CGGTAGAGGTGCAGGT-1_V12D07-332_A1,1,0,1,0,0,2
AATGATGATACGCTAT-1_V12D07-332_A1,2,2,0,0,0,4
CTTGTGCTCACCGATT-1_V12D07-332_A1,1,1,0,1,0,3
TTCCAATCAGAGCTAG-1_V12D07-332_A1,0,0,0,1,0,1
CGATGGACCCTACGCC-1_V12D07-332_A1,2,0,0,0,0,2
GGTCGGATAAACGGCG-1_V12D07-332_A1,0,0,1,0,0,1
TTAGCTAATACGATCT-1_V12D07-332_A1,2,2,1,0,0,5
CTCGATATTTGCGAGC-1_V12D07-332_A1,2,1,0,0,0,3
ATTACTTACTGGGCAT-1_V12D07-332_A1,0,1,0,0,0,1
CTAGCCGATGTTATGA-1_V12D07-332_A1,1,0,0,0,0,1
TACTGCAATCAATTAC-1_V12D07-332_A1,0,0,0,0,0,0
TAGTCTGTGACGTTGC-1_V12D07-332_A1,3,0,1,0,0,4
CTCGTTTCTAATGTTT-1_V12D07-332_A1,1,0,0,0,0,1
TTCGTTCAACGAAGTT-1_V12D07-332_A1,3,0,0,1,0,4
CTGAATTTATTGCCAG-1_V12D07-332_A1,1,0,1,1,0,3
TGGAATATCCTTGACC-1_V12D07-332_A1,2,0,0,0,0,2
CAGATCATTTAAAGTC-1_V12D07-332_A1,0,2,0,0,0,2
CTCCTTTACGCAAGTC-1_V12D07-332_A1,3,0,0,0,0,3
TCCCAAACAGACAACG-1_V12D07-332_A1,1,0,0,0,0,1
ATCGCTGCGTGCAGCA-1_V12D07-332_A1,0,0,0,1,0,1
TTAGTTCAAGTGTTCG-1_V12D07-332_A1,2,1,2,0,0,5
AAACTCGTGATATAAG-1_V12D07-332_A1,1,0,0,1,0,2
TTAACGAACAAGCAGT-1_V12D07-332_A1,0,1,0,0,0,1
GTTATATCAGGAGCCA-1_V12D07-332_A1,0,0,1,1,0,2
CAAATTGGATTATGCC-1_V12D07-332_A1,0,1,1,0,0,2
CGAGGAGCTTCCATAT-1_V12D07-332_A1,1,2,1,0,0,4
GGAGACCAATGTGCTT-1_V12D07-332_A1,1,0,0,0,0,1
CATTGATGAACACGCC-1_V12D07-332_A1,2,1,0,2,0,5
GTCAATGCTATAATTT-1_V12D07-332_A1,1,0,0,1,0,2
ACCACCCTCTCTTCTA-1_V12D07-332_A1,2,0,1,0,0,3
TGGAGGGAAACACCTC-1_V12D07-332_A1,0,1,0,0,0,1
CACGGACGTGGATGGC-1_V12D07-332_A1,1,0,0,1,0,2
AACTTTCTCGATCATG-1_V12D07-332_A1,1,3,1,0,0,5
CGTATTGTTTCCTAAT-1_V12D07-332_A1,0,0,0,0,0,0
CCTACTGCGGCGGCCA-1_V12D07-332_A1,1,0,0,0,0,1
CTTAGGTCCCAATCGT-1_V12D07-332_A1,0,1,0,0,0,1
CGCAATCGATCATTAG-1_V12D07-332_A1,1,0,1,0,0,2
TGGTTATGCTTGCGGT-1_V12D07-332_A1,5,1,1,0,0,7
GGCTTGGCTCTCACCT-1_V12D07-332_A1,3,1,1,0,0,5
ATTGGTAGGATCCGCT-1_V12D07-332_A1,4,1,0,0,0,5
TCAGGGCGACTTCCTT-1_V12D07-332_A1,4,0,0,0,0,4
TCTGCAGATTCGAGTC-1_V12D07-332_A1,5,0,1,1,0,7
CTCTCGCTGTACTATG-1_V12D07-332_A1,2,3,0,0,0,5
AATAGTCGCGAGTCGG-1_V12D07-332_A1,5,0,4,0,0,9
AGTTACCCTTAAGACT-1_V12D07-332_A1,0,0,0,0,0,0
CTTAAATAAGACCCAT-1_V12D07-332_A1,6,0,2,0,0,8
GGTTGTGCTCTTGTCC-1_V12D07-332_A1,2,1,0,0,0,3
GTGAGTCTAAGACGGA-1_V12D07-332_A1,4,1,4,0,0,9
CGCGACACTGCGCAGC-1_V12D07-332_A1,3,0,3,0,0,6
GCTCGCGGTTCCGCTC-1_V12D07-332_A1,4,1,3,0,0,8
TTAACTCACGCGTGGA-1_V12D07-332_A1,5,0,2,0,0,7
GGAACGGCCTGCAGCC-1_V12D07-332_A1,5,0,3,0,0,8
TAATGAAAGACCCTTG-1_V12D07-332_A1,2,1,0,0,0,3
AGGCTTGCTAGACACC-1_V12D07-332_A1,6,0,1,0,0,7
TTGCGTAGTTTGAGGA-1_V12D07-332_A1,2,1,1,0,0,4
CGCCCTTGAAGGCTGA-1_V12D07-332_A1,3,2,1,0,0,6
CCCGGTGGAAGAACCT-1_V12D07-332_A1,3,1,0,0,0,4
TTAACACCTCGAACAT-1_V12D07-332_A1,2,1,0,0,0,3
GATTCCTATACGGCGC-1_V12D07-332_A1,2,1,0,0,0,3
TTACCCTAACAGTCCT-1_V12D07-332_A1,3,1,1,0,0,5
ACCCACCTACATGCTC-1_V12D07-332_A1,3,1,0,0,0,4
AAAGGGCAGCTTGAAT-1_V12D07-332_A1,5,0,1,0,0,6
CACACAGGGATAGATT-1_V12D07-332_A1,1,0,1,0,0,2
AGAGCGTACAAGCTCG-1_V12D07-332_A1,2,0,2,0,0,4
TCTTACGGCATCCGAC-1_V12D07-332_A1,7,0,1,0,0,8
GCCTATTCCGATATAG-1_V12D07-332_A1,0,1,0,0,0,1
GAAAGTGACTAACTGC-1_V12D07-332_A1,6,0,0,0,0,6
CCGGAATGGTTTCAGT-1_V12D07-332_A1,5,0,0,0,0,5
AGTATAATACTAGGCA-1_V12D07-332_A1,2,1,0,0,0,3
TAACTATCGAAGGTCC-1_V12D07-332_A1,4,0,0,0,0,4
ATGAGGAGTGTTAATC-1_V12D07-332_A1,1,0,1,0,0,2
TGTGTCGCGAGTTGCA-1_V12D07-332_A1,3,0,0,0,0,3
ATCCAACGCAGTCATA-1_V12D07-332_A1,2,3,0,0,0,5
AAGGCGCGTAAAGCTT-1_V12D07-332_A1,4,1,1,0,0,6
AGTCGGCCCAAACGAC-1_V12D07-332_A1,1,0,0,0,0,1
AACGTCAGACTAGTGG-1_V12D07-332_A1,3,0,1,0,0,4
ACTACCAGCTCTCTGG-1_V12D07-332_A1,1,2,0,0,0,3
GCAAGTGCACAGAGAA-1_V12D07-332_A1,2,1,0,1,0,4
ACACCTTAAGTAGGGC-1_V12D07-332_A1,1,2,0,0,0,3
TTCGACGGGAAGGGCG-1_V12D07-332_A1,2,1,0,0,0,3
TTCGCACTCGCGTGCT-1_V12D07-332_A1,2,0,1,0,0,3
TATTTGTTACCCTTTA-1_V12D07-332_A1,6,0,1,0,0,7
CGCTGTGACGCCGCAC-1_V12D07-332_A1,3,0,0,0,0,3
GTTGCACGGAGTTTCG-1_V12D07-332_A1,2,0,1,0,0,3
GTTTCCTGGAGGGTGA-1_V12D07-332_A1,6,0,0,0,0,6
ACACCCAGCATGCAGC-1_V12D07-332_A1,1,1,0,0,0,2
TCAACCATGTTCGGGC-1_V12D07-332_A1,1,1,0,0,0,2
TTACAACTACGCATCC-1_V12D07-332_A1,2,0,2,1,0,5
TCCGATGGTGCGACAT-1_V12D07-332_A1,1,1,1,0,0,3
GGGCGTACATTTATAT-1_V12D07-332_A1,6,1,0,0,0,7
AGCGACCAACGATATT-1_V12D07-332_A1,3,1,1,0,0,5
ACACAAAGACGGGTGG-1_V12D07-332_A1,2,0,0,0,0,2
ATCGCACGCCGGGAGA-1_V12D07-332_A1,3,1,0,0,0,4
GCTCTAAACCCTGACG-1_V12D07-332_A1,3,0,0,0,0,3
AATGCAACCGGGTACC-1_V12D07-332_A1,1,0,1,0,0,2
TCAAACAACCGCGTCG-1_V12D07-332_A1,5,1,1,0,0,7
TATGCTCCCTACTTAC-1_V12D07-332_A1,1,1,2,0,0,4
AAAGGGATGTAGCAAG-1_V12D07-332_A1,1,1,1,0,0,3
ACGATCATACATAGAG-1_V12D07-332_A1,2,3,1,0,0,6
TTGTTCAGTGTGCTAC-1_V12D07-332_A1,1,1,1,0,0,3
ATGCATGATCCAGGAT-1_V12D07-332_A1,1,1,1,0,0,3
AGTCTTCTCCTCAAAT-1_V12D07-332_A1,2,0,1,0,0,3
GATTCCCTTGTCGCAG-1_V12D07-332_A1,0,1,0,0,0,1
CTCGCACCTATATAGT-1_V12D07-332_A1,2,1,0,0,0,3
ACTCAATAAAGGCACG-1_V12D07-332_A1,6,0,0,0,0,6
AACCGAGCTTGGTCAT-1_V12D07-332_A1,0,3,0,0,0,3
TAAGGCAACATAAGAT-1_V12D07-332_A1,1,0,0,0,0,1
CACGCACAGCGCAGCT-1_V12D07-332_A1,2,1,1,0,0,4
GGTTTACAATCTCAAT-1_V12D07-332_A1,1,1,0,0,0,2
TGCAGGATCGGCAAAG-1_V12D07-332_A1,1,0,2,0,0,3
ATAACGGAGTCCAACG-1_V12D07-332_A1,4,0,0,0,0,4
AACGATATGTCAACTG-1_V12D07-332_A1,2,0,1,0,0,3
GACAACGACCATTGAA-1_V12D07-332_A1,3,1,0,0,0,4
TTGACCATGTTCTCCG-1_V12D07-332_A1,0,2,1,0,0,3
AGTACGGGCACCTGGC-1_V12D07-332_A1,3,0,0,0,0,3
CGCCATCCGATTATGA-1_V12D07-332_A1,4,0,1,0,0,5
AAGGTATCCTAATATA-1_V12D07-332_A1,2,2,1,0,0,5
TGTTGTCAAGAAGTCT-1_V12D07-332_A1,2,0,4,0,0,6
CAGTGAATAAATGACT-1_V12D07-332_A1,1,0,1,0,0,2
CACCTTGCGAAACTCG-1_V12D07-332_A1,5,1,2,0,0,8
CATTTAGCGGACCATG-1_V12D07-332_A1,1,0,0,0,0,1
CCAGTCTAGACGGCGC-1_V12D07-332_A1,2,0,1,0,0,3
TCGCTTTAAACGTTTG-1_V12D07-332_A1,0,1,0,0,0,1
GTGAAACGGCGCCACC-1_V12D07-332_A1,0,0,0,0,0,0
GGGCTCATCGAACCCA-1_V12D07-332_A1,1,1,1,1,0,4
TTGATGTGTAGTCCCG-1_V12D07-332_A1,4,0,0,0,0,4
CAGTAGCCCACGCGGT-1_V12D07-332_A1,1,1,0,0,0,2
AGCGCGGGTGCCAATG-1_V12D07-332_A1,1,1,0,1,0,3
TAATCGATCCGTACGT-1_V12D07-332_A1,2,1,1,1,0,5
AGTGGCGGCAATTTGA-1_V12D07-332_A1,3,1,0,0,0,4
CCTTTCAATGAAGAAA-1_V12D07-332_A1,0,0,2,2,0,4
CTCAGTCACGACAAAT-1_V12D07-332_A1,2,0,0,1,0,3
ATAGGCTAGCTTCGCA-1_V12D07-332_A1,0,0,0,0,0,0
CGGTTCAAGTAGGTGT-1_V12D07-332_A1,6,0,1,1,0,8
CAGTCGAGGATGCAAT-1_V12D07-332_A1,1,0,0,1,0,2
TATCACCCAACCGACC-1_V12D07-332_A1,0,1,0,0,0,1
AATGATGCGACTCCTG-1_V12D07-332_A1,3,1,1,0,0,5
TGGAACCACTGACACA-1_V12D07-332_A1,0,0,0,0,0,0
GCCAATAGGGCATCTC-1_V12D07-332_A1,0,1,1,0,0,2
TTCTTTGGTCGCGACG-1_V12D07-332_A1,2,1,1,1,0,5
ATTAGATTCCTCAGCA-1_V12D07-332_A1,2,0,0,1,0,3
CCGTGGAACGATCCAA-1_V12D07-332_A1,0,0,0,1,0,1
GGGTCGTGGCAAGTGT-1_V12D07-332_A1,0,0,0,1,0,1
TCGCTCGGCACCAGCG-1_V12D07-332_A1,2,2,0,1,0,5
ACGCAATCACTACAGC-1_V12D07-332_A1,0,1,1,0,0,2
CTCTAATGCATTGATC-1_V12D07-332_A1,3,0,1,1,0,5
GTCTCGACTAAGTTTG-1_V12D07-332_A1,4,1,0,0,0,5
TGGTTTAAACGTGGGT-1_V12D07-332_A1,0,1,1,0,0,2
CGCAGATCTTCACCCG-1_V12D07-332_A1,1,1,1,0,0,3
TCCAGATGTACGCCAA-1_V12D07-332_A1,1,1,0,0,0,2
CATTGCGGGTCAATTC-1_V12D07-332_A1,2,1,1,0,0,4
GACGTTCGTAAATACA-1_V12D07-332_A1,1,2,0,0,0,3
TACACCGTCGTTAGTC-1_V12D07-332_A1,1,0,0,0,0,1
ACGGGCGTATGCGACA-1_V12D07-332_A1,1,1,1,0,0,3
GAAGGCTACCATTGTT-1_V12D07-332_A1,0,0,0,0,0,0
TAAATCTTTACACCTC-1_V12D07-332_A1,1,0,0,0,0,1
AGTTTATGTAAAGACA-1_V12D07-332_A1,2,1,0,0,0,3
AGGAGACATCCACAGT-1_V12D07-332_A1,1,0,1,0,0,2
CAACCTGAACCTGCCA-1_V12D07-332_A1,0,2,0,0,0,2
AGTCCCTCGCAGAAAG-1_V12D07-332_A1,1,2,0,0,0,3
TGTATACGGATGATGA-1_V12D07-332_A1,2,0,0,0,0,2
TTGTGGTATAGGTATG-1_V12D07-332_A1,1,1,1,0,0,3
TCTGCACCATTAGTAA-1_V12D07-332_A1,0,1,0,0,0,1
AAATGTATCTTATCCC-1_V12D07-332_A1,2,1,0,0,0,3
ACTCTAAACCTGGGAT-1_V12D07-332_A1,2,0,0,0,0,2
GCTGGCAGGTGCCGTG-1_V12D07-332_A1,1,2,2,0,0,5
CTCATTCGTGAACATC-1_V12D07-332_A1,1,1,2,0,0,4
TCGCCGGATGGGCAAG-1_V12D07-332_A1,4,1,2,0,0,7
GGACTAAGTCAGGAGT-1_V12D07-332_A1,1,0,1,0,0,2
TATCAAAGGTCTGTAA-1_V12D07-332_A1,8,1,3,0,0,12
TTCAGTTTGTGGCAGC-1_V12D07-332_A1,6,2,0,0,0,8
TGTTCATAAATGTGCT-1_V12D07-332_A1,3,2,2,0,0,7
CTTAGCCCGGATAGTG-1_V12D07-332_A1,3,0,2,0,0,5
GATGCGAATGGTATTA-1_V12D07-332_A1,7,0,3,1,0,11
TCTAACTGTATGTAAA-1_V12D07-332_A1,11,0,1,0,0,12
TTAAACCTGGTTCCTT-1_V12D07-332_A1,3,3,3,0,0,9
GCTAAGTAAAGGCGAT-1_V12D07-332_A1,5,0,1,1,1,8
AGTTACCGCACATGGT-1_V12D07-332_A1,3,1,1,0,0,5
GACTGCGGCACGTGTA-1_V12D07-332_A1,3,1,1,0,0,5
TGGTGATCGTATTTGT-1_V12D07-332_A1,2,0,1,0,0,3
TTATCGCCTGCGAAGC-1_V12D07-332_A1,2,0,0,0,0,2
TGGAATTAGACGCTTT-1_V12D07-332_A1,3,1,1,0,0,5
TCGTCACACTGTTAGC-1_V12D07-332_A1,1,0,3,0,0,4
TTATGTTTGCGATAGA-1_V12D07-332_A1,2,0,0,0,0,2
GGTGCTGATCACAAAG-1_V12D07-332_A1,2,0,0,0,0,2
CATAGCCGCCCGGGAT-1_V12D07-332_A1,0,0,0,0,0,0
GGTTAGTTACGGCGCC-1_V12D07-332_A1,0,3,0,0,0,3
ATTCCCACATAAACAA-1_V12D07-332_A1,2,0,1,0,0,3
ATTCAGTAGCAGGGTC-1_V12D07-332_A1,5,0,1,0,0,6
CAGTTCCGCGGGTCGA-1_V12D07-332_A1,1,0,0,0,0,1
AAGAGATGAATCGGTA-1_V12D07-332_A1,1,1,0,0,0,2
CGCAATTCTACAATAA-1_V12D07-332_A1,3,3,0,0,0,6
TAACGCTTTGAGAGCG-1_V12D07-332_A1,1,3,1,0,0,5
AGGCTATGGTTAGCTT-1_V12D07-332_A1,3,0,0,0,0,3
GAGGAATGGAGAGGTT-1_V12D07-332_A1,2,0,0,0,0,2
TCCTCTACGAGATGGC-1_V12D07-332_A1,3,1,2,0,0,6
TTGATTATGCAGATGA-1_V12D07-332_A1,3,0,0,0,0,3
TCAGTACTGACCCGCG-1_V12D07-332_A1,5,1,0,0,0,6
TTATGACAAACTGGAT-1_V12D07-332_A1,5,1,1,0,0,7
GTAAGTAGGGTATACC-1_V12D07-332_A1,4,0,0,0,0,4
CGCAAACACGAGTTAC-1_V12D07-332_A1,2,0,1,0,0,3
TGGCCGTATATTGACC-1_V12D07-332_A1,1,3,1,0,0,5
ACTGTAGCACTTTGGA-1_V12D07-332_A1,4,1,0,0,0,5
GCTCTATGTTACGTGC-1_V12D07-332_A1,0,2,1,0,0,3
TGCGCGATTAACGGAG-1_V12D07-332_A1,4,0,0,0,0,4
GAATCGACATGGTCAC-1_V12D07-332_A1,5,3,1,0,0,9
GACTAAGTAGGCTCAC-1_V12D07-332_A1,2,1,0,0,0,3
ATCTTGACCTGCAACG-1_V12D07-332_A1,3,0,0,0,0,3
ATGCACTACCGCATTG-1_V12D07-332_A1,3,1,0,0,0,4
CAGATACTAACATAGT-1_V12D07-332_A1,3,0,0,0,0,3
GATCGACACTATCTGA-1_V12D07-332_A1,3,0,0,0,0,3
ATAGAGTACTGGGACA-1_V12D07-332_A1,7,1,0,0,0,8
CCTACTGCTTACACTT-1_V12D07-332_A1,1,0,2,0,0,3
CCTGCTATTTGAGAAG-1_V12D07-332_A1,2,1,1,0,0,4
CGCGTTCATGAAATAC-1_V12D07-332_A1,3,1,0,0,0,4
CATTATGCTTGTTGTG-1_V12D07-332_A1,2,1,0,0,0,3
CCAGGGACGTGGCCTC-1_V12D07-332_A1,2,1,0,0,0,3
TATGGATGTGCTACGC-1_V12D07-332_A1,3,1,1,0,0,5
GTACTAAGATTTGGAG-1_V12D07-332_A1,0,1,0,1,0,2
AGACCCGCCCTCCTCG-1_V12D07-332_A1,3,1,0,0,0,4
CGCATTAGCTAATAGG-1_V12D07-332_A1,3,0,0,0,0,3
GCTCTCGGGTACCGAA-1_V12D07-332_A1,2,1,0,0,0,3
CACCGCCAGAAGGTTT-1_V12D07-332_A1,5,1,1,1,0,8
TCCCAAAGACGAAGGA-1_V12D07-332_A1,1,0,1,0,0,2
ATGGATTGACCAAACG-1_V12D07-332_A1,3,0,0,1,0,4
GTCATGGACATGACTA-1_V12D07-332_A1,3,0,0,0,0,3
CTACTGCCACCTGACC-1_V12D07-332_A1,0,1,1,0,0,2
TTATATTTGGCAATCC-1_V12D07-332_A1,1,1,0,0,0,2
AGCACCAGTACTCACG-1_V12D07-332_A1,0,4,0,0,0,4
CATGGTCTAGATACCG-1_V12D07-332_A1,5,2,0,0,0,7
TCTACCGTCCACAAGC-1_V12D07-332_A1,0,1,0,0,0,1
CTAGTTGGGCCCGGTA-1_V12D07-332_A1,7,0,0,1,0,8
TCCCGCGTACTCCTGG-1_V12D07-332_A1,5,1,0,0,0,6
CAGAGCATGAGCTTGC-1_V12D07-332_A1,4,1,1,0,0,6
ACACGGGAACTTAGGG-1_V12D07-332_A1,5,0,0,0,0,5
GGCTCTGCTCCAACGC-1_V12D07-332_A1,3,1,0,0,0,4
AGAACGTGGTACATTC-1_V12D07-332_A1,1,0,0,0,0,1
CAATAAACCTTGGCCC-1_V12D07-332_A1,1,0,0,0,0,1
ACTTCGCCATACGCAC-1_V12D07-332_A1,1,1,0,0,0,2
ATCTGGTTAAGACTGT-1_V12D07-332_A1,3,0,0,0,0,3
TCGTAAGACGACATTG-1_V12D07-332_A1,3,0,0,0,0,3
GTGTACCTTGGCTACG-1_V12D07-332_A1,4,2,0,2,0,8
GCCCGTAATACCTTCT-1_V12D07-332_A1,0,1,0,1,0,2
CGGTCAAGTGGGAACC-1_V12D07-332_A1,1,1,0,0,0,2
TTGTAAGGCCAGTTGG-1_V12D07-332_A1,2,1,0,0,0,3
GGAGCACCAAGAACTA-1_V12D07-332_A1,0,1,1,0,0,2
TAATAGTGACGACCAG-1_V12D07-332_A1,1,1,1,0,0,3
CTAAATCCTATTCCGG-1_V12D07-332_A1,2,1,1,0,0,4
CGAGTTCTGTCCCACC-1_V12D07-332_A1,2,0,0,0,0,2
AGGCAGATGCGTAAAC-1_V12D07-332_A1,2,0,0,1,0,3
AAGGATGAGGGACCTC-1_V12D07-332_A1,3,2,0,0,0,5
AGAGAACCGTCTAGGA-1_V12D07-332_A1,0,1,0,0,0,1
GAGGGCGCAGCTCTGC-1_V12D07-332_A1,3,1,2,0,0,6
AAGATTGGCGGAACGT-1_V12D07-332_A1,4,1,0,0,0,5
CCAGTAGTCTGATCCA-1_V12D07-332_A1,3,0,1,0,0,4
AAGGGACAGATTCTGT-1_V12D07-332_A1,4,1,1,0,0,6
ATAGAGTTATCAACTT-1_V12D07-332_A1,2,0,0,0,0,2
AAATTACCTATCGATG-1_V12D07-332_A1,4,0,0,0,0,4
GATCCTAAATCGGGAC-1_V12D07-332_A1,1,1,1,0,0,3
TTACAGACCTAAATGA-1_V12D07-332_A1,2,0,5,1,0,8
CCTCACCTTAGCATCG-1_V12D07-332_A1,2,1,0,0,0,3
CATGCGACCAGTTTAA-1_V12D07-332_A1,3,0,1,0,0,4
AACATATCAACTGGTG-1_V12D07-332_A1,6,1,0,1,0,8
CTATAAGAGCCAATCG-1_V12D07-332_A1,1,0,0,1,0,2
AATATCGAGGGTTCTC-1_V12D07-332_A1,3,0,0,0,0,3
GTACTCCTGGGTATGC-1_V12D07-332_A1,0,1,0,1,0,2
ATAAGTAGGATTCAGA-1_V12D07-332_A1,1,1,0,2,0,4
AGGTCGCGGAGTTACT-1_V12D07-332_A1,5,1,0,0,0,6
CTAATTCTCAGATATT-1_V12D07-332_A1,1,0,0,1,0,2
GCCAACCATTTCCGGA-1_V12D07-332_A1,3,1,0,0,0,4
TGATCCCAGCATTAGT-1_V12D07-332_A1,0,0,0,0,0,0
CGTTGTAAGATTGATT-1_V12D07-332_A1,0,2,0,1,0,3
GAAACCATGGTGCGCT-1_V12D07-332_A1,5,0,0,1,0,6
AATCTATGCCGGAGCC-1_V12D07-332_A1,0,2,1,2,0,5
GACTCCCAGAATAAGG-1_V12D07-332_A1,1,1,1,0,0,3
TATGATCCGGCACGCC-1_V12D07-332_A1,3,1,1,0,0,5
CCGCTTGCTGACATGG-1_V12D07-332_A1,3,0,0,0,0,3
TGGTTAAGGGCGCTGG-1_V12D07-332_A1,4,0,0,0,0,4
TTGATAGTCAATACAT-1_V12D07-332_A1,0,0,0,0,0,0
GGTTTAATTGAGCAGG-1_V12D07-332_A1,4,2,0,0,0,6
CATTACATAGATTGTG-1_V12D07-332_A1,0,0,1,1,0,2
GGTACACCAGATTTAT-1_V12D07-332_A1,5,0,2,0,0,7
GGCCCGTATACCATGC-1_V12D07-332_A1,2,0,0,0,0,2
ATCTTTCGTATAACCA-1_V12D07-332_A1,1,0,0,0,0,1
GAGATGACAATCCTTA-1_V12D07-332_A1,1,0,0,2,0,3
AAAGCTTGCCTACATA-1_V12D07-332_A1,2,0,0,1,0,3
GAACGATAAGTTAAAG-1_V12D07-332_A1,0,0,1,0,0,1
TAATAGCTAAATGATG-1_V12D07-332_A1,2,1,1,0,0,4
TATGGCTAGGCTAATT-1_V12D07-332_A1,3,2,0,0,0,5
AGGAGAGTCTGGCTAC-1_V12D07-332_A1,1,0,0,0,0,1
TGCTCTGCCGGTTCAC-1_V12D07-332_A1,0,1,0,0,0,1
CCAATAGATTTCATCT-1_V12D07-332_A1,3,0,0,0,0,3
GGGCACGAATTGGCCG-1_V12D07-332_A1,2,1,0,0,0,3
TCGTTGACAGGGTCCC-1_V12D07-332_A1,2,0,1,0,0,3
ATCGTATTCCGAGAAC-1_V12D07-332_A1,3,1,0,0,0,4
GGGAATTCTGTCCAGT-1_V12D07-332_A1,5,0,2,0,0,7
ACGCGTTTCTTAAGAG-1_V12D07-332_A1,7,0,2,0,0,9
GAGAGCGCAGTCCCTG-1_V12D07-332_A1,3,2,5,0,0,10
GTCCTATTGTTGTGGT-1_V12D07-332_A1,7,0,0,0,0,7
CATCTGCAGGATCATT-1_V12D07-332_A1,2,1,1,0,0,4
GAGTCGACAGACCCTC-1_V12D07-332_A1,1,0,0,0,0,1
AAGTGCAAAGGTAGAC-1_V12D07-332_A1,0,0,1,0,0,1
AGGGTGGATAGTGCAT-1_V12D07-332_A1,1,2,1,0,0,4
TGATAGCGGGATTCTA-1_V12D07-332_A1,1,3,0,0,0,4
GTCAGTTTGGTAGTCG-1_V12D07-332_A1,2,1,1,0,0,4
GCATTCGAAATGAACA-1_V12D07-332_A1,2,1,0,0,0,3
AAAGACTGGGCGCTTT-1_V12D07-332_A1,2,1,0,0,0,3
TAACAATATTTGTTGC-1_V12D07-332_A1,1,0,1,0,0,2
CCAGCTTCCGCCCGCA-1_V12D07-332_A1,4,1,1,0,0,6
GATATGGATTACGCGG-1_V12D07-332_A1,5,0,0,0,0,5
AGAGCAGTTATGAGAC-1_V12D07-332_A1,3,0,0,0,0,3
TCACATCTTATCTGAT-1_V12D07-332_A1,0,2,1,0,0,3
TATGAAGACAGGTGCG-1_V12D07-332_A1,4,0,0,0,0,4
TACCTGCTGCACTGTG-1_V12D07-332_A1,1,0,1,0,0,2
TAGGTCCAAGTAAGGA-1_V12D07-332_A1,1,0,1,0,0,2
GAAACTCGTGCGATGC-1_V12D07-332_A1,2,0,0,0,0,2
AACAATTACTCTACGC-1_V12D07-332_A1,0,0,0,0,0,0
CCGCACGTGACCTCGG-1_V12D07-332_A1,2,1,0,0,0,3
AACTTGCCCGTATGCA-1_V12D07-332_A1,2,0,0,0,0,2
GGGTATGTATGCACTT-1_V12D07-332_A1,2,2,0,0,0,4
TTCGTACTCCAGAACG-1_V12D07-332_A1,3,0,2,0,0,5
GAATTTCTCGCTGCAG-1_V12D07-332_A1,0,2,1,0,0,3
AACAGGATGGGCCGCG-1_V12D07-332_A1,1,0,0,0,0,1
GACGTGTAGGGATTAT-1_V12D07-332_A1,0,4,3,0,0,7
TAGGTGAGCCCTACTC-1_V12D07-332_A1,1,3,0,0,0,4
CTAATTCGCACGCGCT-1_V12D07-332_A1,3,3,0,1,0,7
GAAGCTTGCTGACCGC-1_V12D07-332_A1,0,2,0,0,0,2
GGTTAGGCTTGGAGAA-1_V12D07-332_A1,3,0,0,0,0,3
ACAAGGACAAGAGGTT-1_V12D07-332_A1,3,2,1,0,0,6
AGGCCACCCGTTATGA-1_V12D07-332_A1,2,0,0,0,0,2
GTGGGCTTAGACACAC-1_V12D07-332_A1,2,1,1,0,0,4
CGTGTCCCATTCGCGA-1_V12D07-332_A1,1,1,2,0,0,4
TGGAGTGATGCGATGA-1_V12D07-332_A1,0,0,1,0,0,1
AACAACTGGTAGTTGC-1_V12D07-332_A1,2,1,0,0,0,3
CCTGGCTAGACCCGCC-1_V12D07-332_A1,2,2,1,0,0,5
CGCAATTAGGGTAATA-1_V12D07-332_A1,2,1,1,0,0,4
TCGAAATTTAGGACCA-1_V12D07-332_A1,1,0,0,0,0,1
AGACTAGCCTTCCAGA-1_V12D07-332_A1,0,0,0,0,0,0
TTGATCTAACTTTGTC-1_V12D07-332_A1,3,2,1,0,0,6
AAGGAGCGGTTGGTGC-1_V12D07-332_A1,1,0,0,0,0,1
ACTTGGGACCCGGTGG-1_V12D07-332_A1,2,0,2,0,0,4
TGATCTCCGGCGCCAG-1_V12D07-332_A1,1,1,1,1,0,4
CAGTTCAAATTGACAC-1_V12D07-332_A1,3,1,0,0,0,4
GTCCGGCTGAATTGCG-1_V12D07-332_A1,6,0,0,0,0,6
CTGGAAATGGATGCTT-1_V12D07-332_A1,4,0,1,0,0,5
TGATCGGTTTGACCCT-1_V12D07-332_A1,3,1,0,0,0,4
TAGAGTCTAAGCGAAC-1_V12D07-332_A1,1,2,2,0,0,5
GAGACTGATGGGTAGA-1_V12D07-332_A1,5,0,2,0,0,7
TAGCTAAGTCCGGGAG-1_V12D07-332_A1,1,1,0,0,0,2
GGGCGATATGTGTGAA-1_V12D07-332_A1,1,0,0,0,0,1
CTCGAGGTCGAACAGT-1_V12D07-332_A1,3,0,0,0,0,3
GATCCCTTTATACTGC-1_V12D07-332_A1,4,1,0,0,0,5
GTCATGCACCTCCGTT-1_V12D07-332_A1,2,0,0,0,0,2
ACTTTCCTATAGCTTC-1_V12D07-332_A1,3,0,1,0,0,4
TCGCTCGATATATTCC-1_V12D07-332_A1,2,1,0,0,0,3
ATAGGTTGGGCAGATG-1_V12D07-332_A1,0,2,1,0,0,3
CAATTAAGGGTGATGA-1_V12D07-332_A1,2,0,0,0,0,2
ACCGACTGAGTCCCAC-1_V12D07-332_A1,7,0,1,0,0,8
CCTGTCACCCGGGCTC-1_V12D07-332_A1,3,0,0,0,0,3
GATCGGTGGCCATAAC-1_V12D07-332_A1,0,0,2,0,0,2
CCTATGGGTTACCGTC-1_V12D07-332_A1,0,4,0,0,0,4
TTGGGACACTGCCCGC-1_V12D07-332_A1,2,0,1,0,0,3
CGAGGCTAAATATGGC-1_V12D07-332_A1,5,1,0,0,0,6
TCAGGGTGTAACGTAA-1_V12D07-332_A1,3,0,0,0,0,3
CGAGAGATGTGAACCT-1_V12D07-332_A1,6,1,0,0,0,7
TCGCTGGGCGGATTGT-1_V12D07-332_A1,2,1,0,0,0,3
AGATCTCAGGTGTGAT-1_V12D07-332_A1,5,2,0,0,0,7
TGGCCAAACTGAAGTA-1_V12D07-332_A1,3,0,1,0,0,4
GCTTCCGTCCCTAGAC-1_V12D07-332_A1,1,0,0,0,0,1
CAGCAGCCCGTTCCTT-1_V12D07-332_A1,2,0,0,0,0,2
TGTATAACAGATCCTG-1_V12D07-332_A1,3,2,0,0,0,5
CGCGGGAATTAGGCAG-1_V12D07-332_A1,2,0,0,0,0,2
TGCATGTGGTAATCTA-1_V12D07-332_A1,2,2,0,0,0,4
ACAATTTGAGCAGTGG-1_V12D07-332_A1,1,2,0,0,0,3
GAGCTAAGGGCATATC-1_V12D07-332_A1,4,0,1,1,0,6
CCAGATAGTTGAGTGA-1_V12D07-332_A1,1,0,0,0,0,1
CCACAATGTACGTCTT-1_V12D07-332_A1,2,0,0,0,0,2
CAATGGATCTCTACCA-1_V12D07-332_A1,4,0,2,0,0,6
TGTGGCAAAGCGTATG-1_V12D07-332_A1,1,2,0,0,0,3
TAAAGCGTTAGGAGAA-1_V12D07-332_A1,1,1,0,0,0,2
TCCGTTTAGCCTTGAA-1_V12D07-332_A1,3,5,0,0,0,8
CAGCTCGACAAGTTAA-1_V12D07-332_A1,1,0,0,0,0,1
GCCTATAGTGTCAGGG-1_V12D07-332_A1,1,0,3,0,0,4
ATAGACAACGGGACCT-1_V12D07-332_A1,1,1,1,0,0,3
CTACTATCTTTCAGAG-1_V12D07-332_A1,2,1,1,0,0,4
GCGCTGCTTTGCATTT-1_V12D07-332_A1,6,2,0,0,0,8
GCGCATCCAGTCAGCA-1_V12D07-332_A1,3,0,0,0,0,3
GACTCGCGGGAATGAC-1_V12D07-332_A1,2,1,1,0,0,4
CTGGTAACGAGCTCTT-1_V12D07-332_A1,1,0,1,0,0,2
TCCGGCCTAGCGTACA-1_V12D07-332_A1,1,0,0,0,0,1
TCTAGGTGGCGACGCT-1_V12D07-332_A1,1,0,2,1,0,4
ACGCTAGTGATACACT-1_V12D07-332_A1,2,0,1,1,0,4
ATCTGCACCTCTGCGA-1_V12D07-332_A1,1,0,0,0,0,1
CCTCACCTGAGGGAGC-1_V12D07-332_A1,1,0,0,0,0,1
AGTGAGCCTCGCCGCC-1_V12D07-332_A1,0,1,1,0,0,2
ACGAGTACGGATGCCC-1_V12D07-332_A1,2,1,0,0,0,3
GGTACCATTAAGACGG-1_V12D07-332_A1,1,0,3,1,0,5
TTCTGCTAGACTCCAA-1_V12D07-332_A1,0,0,0,1,0,1
TAACTATTACGCCAAA-1_V12D07-332_A1,2,0,1,1,0,4
GCATTCAAGGCAACGC-1_V12D07-332_A1,2,2,0,1,0,5
AGTACATCATTTATCA-1_V12D07-332_A1,1,0,0,1,0,2
GTCGTGTCTGGTCATC-1_V12D07-332_A1,1,2,1,4,0,8
AGTCTAAAGTATACTC-1_V12D07-332_A1,1,1,0,0,0,2
CGGCCCAACCTGTAGT-1_V12D07-332_A1,0,0,0,0,0,0
AGGGAGACATACTTCG-1_V12D07-332_A1,3,0,0,1,0,4
TCCCTAGATCAATAGG-1_V12D07-332_A1,3,0,0,0,0,3
TCCCGTCGCGTCATAG-1_V12D07-332_A1,1,0,0,0,0,1
CGCATCCATCAGCCAG-1_V12D07-332_A1,1,0,1,1,0,3
CTGCACCTAGTCCACA-1_V12D07-332_A1,2,1,0,1,0,4
CGAGGATCGGGAACGA-1_V12D07-332_A1,3,0,0,1,0,4
CAATGAGGTTCGACTA-1_V12D07-332_A1,2,2,0,1,0,5
TCTGACGGGCTAACCC-1_V12D07-332_A1,1,4,0,0,0,5
TTCTATGCCTTTCGCA-1_V12D07-332_A1,0,0,0,0,0,0
AGAGTATAGTGTTACG-1_V12D07-332_A1,2,0,1,0,0,3
CCATTGTTTCCTCCAT-1_V12D07-332_A1,1,0,0,0,0,1
CTCATCACTTAGTGAT-1_V12D07-332_A1,3,0,0,1,0,4
CCGAAGGGCGTACCGC-1_V12D07-332_A1,1,1,0,0,0,2
TCAAGCTGCCTTGAAA-1_V12D07-332_A1,1,2,0,0,0,3
CTCATTAACGTTGCCC-1_V12D07-332_A1,1,0,0,0,0,1
GTCTTCCTCACCTAAG-1_V12D07-332_A1,6,1,0,0,0,7
GGTGATGAAGGAAGTG-1_V12D07-332_A1,3,1,3,0,0,7
TCAATACAATTGCTGC-1_V12D07-332_A1,3,0,0,0,0,3
GCAACCCAAGTTGTTT-1_V12D07-332_A1,0,0,3,0,0,3
ATGAAGTGGACCCAGC-1_V12D07-332_A1,3,1,0,0,0,4
GAGAATCTCACGATCA-1_V12D07-332_A1,5,0,1,0,0,6
TATATCATTGATCAGT-1_V12D07-332_A1,4,0,1,0,0,5
AACTTTACGGGAGCTT-1_V12D07-332_A1,4,0,0,0,0,4
TTCTTGTGTCCATCAG-1_V12D07-332_A1,5,0,0,0,0,5
ACAATTTAGGAGGCTC-1_V12D07-332_A1,2,1,0,0,0,3
ATACTTGTTCTCGAGC-1_V12D07-332_A1,5,0,2,0,0,7
CACGGGATTGAGGGTT-1_V12D07-332_A1,3,0,2,0,0,5
GTTAATGTCTATCTTA-1_V12D07-332_A1,5,4,0,0,0,9
GCGTTATATTTGGAAC-1_V12D07-332_A1,2,3,2,0,0,7
CGTCAAGGCTATAAAT-1_V12D07-332_A1,2,0,0,0,0,2
TTAGCTCTGTAATCCG-1_V12D07-332_A1,1,5,1,0,0,7
AATGGTCCACCGTTCA-1_V12D07-332_A1,5,0,0,0,0,5
GTCATTGCATTGACCC-1_V12D07-332_A1,2,2,1,0,0,5
TGTCCGTGGCGCCTTT-1_V12D07-332_A1,0,1,0,0,0,1
TCAACTAACGTATAAC-1_V12D07-332_A1,4,1,0,0,0,5
TCCTCTCCAGTTGTCC-1_V12D07-332_A1,2,1,1,0,0,4
TGTGTTCGTATCCAAG-1_V12D07-332_A1,3,0,4,0,0,7
CCGCGTAGGTAAGGGC-1_V12D07-332_A1,1,0,2,0,0,3
CTGCGGGTGAAATGTT-1_V12D07-332_A1,1,2,1,0,0,4
TATCTACAGAGGTAAT-1_V12D07-332_A1,2,1,0,0,0,3
CTACTCTAGGCCCGGC-1_V12D07-332_A1,1,1,1,0,0,3
ACAAGCAGTGCCTAGC-1_V12D07-332_A1,2,1,1,0,0,4
TACAAGTCTCGTGCAT-1_V12D07-332_A1,5,0,0,0,0,5
TCGGAATGCGCTCTGA-1_V12D07-332_A1,1,1,0,0,0,2
TCGCGTCCAGAAGGTC-1_V12D07-332_A1,3,1,2,0,0,6
TATGGCCCGGCCTCGC-1_V12D07-332_A1,6,0,0,0,0,6
GCTGGCATATTCACCT-1_V12D07-332_A1,0,4,2,0,0,6
GTCAGAATAGTCTATG-1_V12D07-332_A1,5,1,2,0,0,8
GGCGTCCTATCCGCTG-1_V12D07-332_A1,2,1,0,0,0,3
CGGAGTTTGAGAGACA-1_V12D07-332_A1,1,0,1,0,0,2
AGCACTTAAGGACGCC-1_V12D07-332_A1,2,0,0,0,0,2
TCCACAATGGTTTACG-1_V12D07-332_A1,0,4,0,0,0,4
CCAACGATGCACTGAT-1_V12D07-332_A1,0,1,0,0,0,1
ATTTACAGTTTACTGG-1_V12D07-332_A1,3,0,0,0,0,3
CCCTGAAATGAGTTGA-1_V12D07-332_A1,0,3,0,1,0,4
CAAACGGTCGCACTTT-1_V12D07-332_A1,2,2,0,0,0,4
TGATTCGTCTATCACT-1_V12D07-332_A1,1,1,1,0,0,3
TCAGGTTCTTTGAGAA-1_V12D07-332_A1,2,2,1,0,0,5
CACGCAGCGAGGCTTT-1_V12D07-332_A1,1,1,1,0,0,3
TTAAGCGCCTGACCCA-1_V12D07-332_A1,1,2,1,0,0,4
CTTACACGGTATTCCA-1_V12D07-332_A1,1,2,0,0,0,3
AAGGCTGTGCTCATCG-1_V12D07-332_A1,2,1,0,0,0,3
GACCAGAGCCCTGTAG-1_V12D07-332_A1,0,0,4,0,0,4
TCCCAGGCTTAGCTAA-1_V12D07-332_A1,3,1,0,0,0,4
ATTGAAGATCTTAGTG-1_V12D07-332_A1,1,2,0,0,0,3
AGTTCCTACAGAATTA-1_V12D07-332_A1,2,1,1,0,0,4
GGGCTGGTTAGTCGCG-1_V12D07-332_A1,0,0,0,0,0,0
GAAATGGCGGTGTTAG-1_V12D07-332_A1,3,0,0,0,0,3
TACGAACACGACTTCA-1_V12D07-332_A1,2,1,0,0,0,3
ACCACAAGTTTCTATC-1_V12D07-332_A1,4,3,1,0,0,8
ATATTTAACCCTCAAG-1_V12D07-332_A1,1,1,0,0,0,2
GATCATTCCAAACATT-1_V12D07-332_A1,1,0,0,0,0,1
TCCAGGCGAGTACGGT-1_V12D07-332_A1,1,1,0,0,0,2
GTTTGACCAAATCCTA-1_V12D07-332_A1,0,1,0,0,0,1
CACAGCACCCACGGCA-1_V12D07-332_A1,2,0,1,0,0,3
TGCAAGAATGACGTAA-1_V12D07-332_A1,3,0,1,0,0,4
GCGAAGCCATACCCGT-1_V12D07-332_A1,2,1,0,0,0,3
TCCTTTCTTACGCTTA-1_V12D07-332_A1,2,2,0,0,0,4
GCTGCTCTCCGGACAC-1_V12D07-332_A1,1,1,0,0,0,2
ACTGTCTTCTTTAGAA-1_V12D07-332_A1,3,0,0,0,0,3
TCAAACTTAGATTGTT-1_V12D07-332_A1,4,0,0,0,0,4
CTATGTCACTAGCCCA-1_V12D07-332_A1,3,0,1,0,0,4
TGCGCAAAGCATTTGG-1_V12D07-332_A1,3,1,1,0,0,5
TTAATGTAGACCAGGT-1_V12D07-332_A1,1,0,0,1,0,2
GGCGGTAGGATCATTG-1_V12D07-332_A1,1,1,1,0,0,3
GGCAATAGTCAATGAG-1_V12D07-332_A1,0,1,0,0,0,1
ACACGAGACTCCTTCT-1_V12D07-332_A1,6,0,0,0,0,6
GACACAAGGGAAGAAA-1_V12D07-332_A1,3,0,0,0,0,3
TCAGCAAATGCATCTC-1_V12D07-332_A1,1,2,1,0,0,4
GAGATCTGTCACTCCG-1_V12D07-332_A1,1,2,0,0,0,3
ATGCCGGTCTTGCATA-1_V12D07-332_A1,1,1,0,0,0,2
TTGGGCGGCGGTTGCC-1_V12D07-332_A1,5,0,2,0,0,7
TTGTTGTGTGTCAAGA-1_V12D07-332_A1,1,2,0,1,0,4
ACTGTACGATACACAT-1_V12D07-332_A1,5,1,1,0,0,7
TCCACTTTATCTAGGT-1_V12D07-332_A1,3,1,0,1,0,5
GGTCTGAGAATCTGGA-1_V12D07-332_A1,2,0,1,0,0,3
TAGAAAGGTGGCGCTA-1_V12D07-332_A1,5,0,0,0,0,5
TATGTCTCATTGTGCC-1_V12D07-332_A1,2,0,1,0,0,3
GGATTTCACTTCTATA-1_V12D07-332_A1,4,0,0,0,0,4
TGAGTGGTCCGTGACG-1_V12D07-332_A1,1,0,0,0,0,1
CGCTTTCTTGCATTCG-1_V12D07-332_A1,5,1,0,0,0,6
ACCCAACGCCCGTGGC-1_V12D07-332_A1,0,0,0,0,0,0
GAACGTCTCATGGTCG-1_V12D07-332_A1,1,0,1,0,0,2
AGGGTTCCCTTTGGTT-1_V12D07-332_A1,2,0,0,0,0,2
GTAGCTTCCTCTTGTT-1_V12D07-332_A1,2,1,0,0,0,3
GCATGAGGGACGCGGC-1_V12D07-332_A1,1,0,1,0,0,2
CTACCCTAAGGTCATA-1_V12D07-332_A1,2,0,0,1,0,3
TCACCGCTCGGCACTC-1_V12D07-332_A1,2,1,0,0,0,3
GGCTCGCGTTGAGGTA-1_V12D07-332_A1,3,1,0,0,0,4
CTAACGAAACTTGCTG-1_V12D07-332_A1,1,0,2,1,0,4
TTAAACTCGAATTCAT-1_V12D07-332_A1,2,0,3,0,0,5
TACTTTACTGAGCCGG-1_V12D07-332_A1,2,1,0,0,0,3
GCTTGGATCGATTAGG-1_V12D07-332_A1,3,0,0,0,0,3
CGGTTATCCAACAGTG-1_V12D07-332_A1,1,0,2,0,0,3
CAGACCTGTAAGTGTT-1_V12D07-332_A1,1,0,0,0,0,1
GACGGTCAATAGAAGC-1_V12D07-332_A1,4,0,1,0,0,5
CTGACTGCGCAGCTCG-1_V12D07-332_A1,1,0,0,0,0,1
CCATACCTTTACTTGT-1_V12D07-332_A1,0,1,0,0,0,1
GTAATAAAGGGCTCCC-1_V12D07-332_A1,5,0,0,0,0,5
GTGAACTCCCATTCGA-1_V12D07-332_A1,1,0,1,1,0,3
GTGGTTACTTCTTTCG-1_V12D07-332_A1,2,0,2,0,0,4
TCAGAACCTCCACAGG-1_V12D07-332_A1,1,0,1,0,0,2
TCCCACTCTCTTCCGG-1_V12D07-332_A1,0,2,0,0,0,2
ATCTTGACTTGTCCAA-1_V12D07-332_A1,0,0,2,2,0,4
TCGGGAACGTGCCTAG-1_V12D07-332_A1,2,0,1,0,0,3
GTTAGCCGTAAATCAA-1_V12D07-332_A1,1,0,0,1,0,2
ATTTACTAAGTCCATT-1_V12D07-332_A1,1,1,1,0,0,3
GGGTGCATATGAAAGC-1_V12D07-332_A1,1,1,1,0,0,3
TCCGAATGGTCCTGAG-1_V12D07-332_A1,2,1,1,0,0,4
TGATGGCTGTTTCTGA-1_V12D07-332_A1,1,2,0,1,0,4
AAATAAGGTAGTGCCC-1_V12D07-332_A1,2,0,1,1,0,4
CCACTATCCGGGTCAC-1_V12D07-332_A1,1,1,0,0,0,2
ACACCACATAATTAGC-1_V12D07-332_A1,2,4,0,0,0,6
CGCGGTAAGTCTAGCT-1_V12D07-332_A1,2,0,0,0,0,2
GCGGGCATTACGATGC-1_V12D07-332_A1,1,1,0,0,0,2
AGGATTGCTTACGACA-1_V12D07-332_A1,1,0,0,1,0,2
CTCGGGATAACACCTA-1_V12D07-332_A1,0,0,0,0,0,0
GTCGTCTGGTTGGCTA-1_V12D07-332_A1,0,0,0,0,0,0
GCAATTAGTCGCACCG-1_V12D07-332_A1,2,0,0,2,0,4
GTGACCTAAAGAATAA-1_V12D07-332_A1,1,0,0,1,0,2
CTGAGCGAGACTTATT-1_V12D07-332_A1,1,1,1,0,0,3
CAAGACTCAGAAGCGC-1_V12D07-332_A1,1,0,0,0,0,1
ACTTCGCTAGCGAGTG-1_V12D07-332_A1,3,1,1,0,0,5
CCATACTCGCCTCTCC-1_V12D07-332_A1,2,0,0,0,0,2
ACGATACCTATCCTGA-1_V12D07-332_A1,1,1,1,0,0,3
CTCACCAGTACAAGTG-1_V12D07-332_A1,2,0,2,0,0,4
CGAAGACGGTGAGTGC-1_V12D07-332_A1,4,0,2,0,0,6
AAATTAATAAGCGCGA-1_V12D07-332_A1,1,0,1,0,0,2
GGGCCCTTATCTATAC-1_V12D07-332_A1,2,1,0,0,0,3
CTGCCCACGAAGCGTT-1_V12D07-332_A1,3,1,1,0,0,5
GGACAAGTTGCAGTGA-1_V12D07-332_A1,2,1,1,0,0,4
GTCCGAGAGCAATCAT-1_V12D07-332_A1,5,1,1,0,0,7
ATGGCAGCCGAGAAAC-1_V12D07-332_A1,2,0,1,0,0,3
CCTCGGATGCTACCTG-1_V12D07-332_A1,3,0,0,1,0,4
ATACGGTGAAGATGCA-1_V12D07-332_A1,2,0,0,0,0,2
ACATCAGCTGGGACGC-1_V12D07-332_A1,5,1,0,0,0,6
GGTTGTGTAGCCTGGC-1_V12D07-332_A1,7,0,0,0,0,7
CCTGCGTTCTACGCTT-1_V12D07-332_A1,4,2,0,0,0,6
GAACGTTAGGAAGACG-1_V12D07-332_A1,1,1,1,0,0,3
CTGATAGTGTATCTCA-1_V12D07-332_A1,1,3,2,0,0,6
TTCTGCGAGCGCCCTT-1_V12D07-332_A1,3,0,1,0,0,4
CTTTGGCGCTTTATAC-1_V12D07-332_A1,3,1,0,0,0,4
TCCGAACTTGGCTTAC-1_V12D07-332_A1,2,4,3,0,0,9
TAGATTCCTGGTTATT-1_V12D07-332_A1,2,2,0,0,0,4
CCGACAAAGGGAGTGC-1_V12D07-332_A1,0,2,1,1,0,4
CCATGGCCCTTGTACC-1_V12D07-332_A1,3,0,2,0,0,5
GAAATATCACCATCAG-1_V12D07-332_A1,5,0,0,0,0,5
ACGAAATGGGCGGCAC-1_V12D07-332_A1,3,2,0,0,0,5
GTGAGCGTGCTGCACT-1_V12D07-332_A1,4,0,0,0,0,4
CCGCGGGTACGAAGAA-1_V12D07-332_A1,1,0,2,0,0,3
TCCCTGGCTCGCTGGA-1_V12D07-332_A1,3,0,2,0,0,5
CAGCTTAGTAGGTAGC-1_V12D07-332_A1,6,1,0,0,0,7
CACGAAAGTTAGTCCC-1_V12D07-332_A1,1,0,0,0,0,1
ACCTAATCGACTTCCT-1_V12D07-332_A1,6,1,0,0,0,7
AAGTAGTGACGCGAGG-1_V12D07-332_A1,1,0,1,0,0,2
TCCGATTACATTGCCG-1_V12D07-332_A1,2,2,3,0,0,7
CCTCCGACAATTCAAG-1_V12D07-332_A1,2,1,1,0,0,4
GTTCACAGGAGTCTAG-1_V12D07-332_A1,1,2,1,0,0,4
CGAAGTTGCTCTGTGT-1_V12D07-332_A1,0,0,0,0,0,0
GTCGGATATCTCAGAC-1_V12D07-332_A1,3,0,0,0,0,3
CGCTCTCCGTAGATTA-1_V12D07-332_A1,5,1,0,1,0,7
CAAGCAACGTCGGAGT-1_V12D07-332_A1,3,1,1,0,0,5
CCATTCCCTGCCCACA-1_V12D07-332_A1,2,2,0,0,0,4
CTTTGGCTTTAGTAAA-1_V12D07-332_A1,1,0,1,0,0,2
GGCTATTAAGTTGTAT-1_V12D07-332_A1,2,0,0,0,0,2
CCATTAGCGATAATCC-1_V12D07-332_A1,1,0,1,0,0,2
TGTTCTTCCATTGACT-1_V12D07-332_A1,5,2,2,0,0,9
AGATAACTTCAGGGCC-1_V12D07-332_A1,1,0,1,0,0,2
ATAGACGAAGAGAAAG-1_V12D07-332_A1,3,2,1,0,0,6
GGCGGAGTAATATTAG-1_V12D07-332_A1,2,1,1,0,0,4
TGACCCACGTTAGACA-1_V12D07-332_A1,1,1,1,0,0,3
TCACAGGTTATTGGGC-1_V12D07-332_A1,3,1,1,0,0,5
TCACGCATTGTAGATC-1_V12D07-332_A1,2,0,0,0,0,2
TTGAAGAATTCCCAGG-1_V12D07-332_A1,2,0,0,0,0,2
AAATGGTCAATGTGCC-1_V12D07-332_A1,1,0,1,0,0,2
TAGTGCCCTCCAGAGT-1_V12D07-332_A1,2,1,1,0,0,4
GGTATTGCCGAGTTTA-1_V12D07-332_A1,0,1,0,1,0,2
CGTATTAAGAGATCTA-1_V12D07-332_A1,1,3,0,1,0,5
ACTGTCCAGGATTATA-1_V12D07-332_A1,1,1,0,0,0,2
CGGGCAGCTAAACCGC-1_V12D07-332_A1,3,1,0,0,0,4
TTGCTGATCATGTTCG-1_V12D07-332_A1,3,0,0,1,0,4
TATGGGTACGTATCGT-1_V12D07-332_A1,8,0,1,0,0,9
CAGCTCACTGAGACAT-1_V12D07-332_A1,4,0,2,0,0,6
GGGACTGCATAGATAG-1_V12D07-332_A1,1,0,0,0,0,1
ACGCATTCGTGAGTAC-1_V12D07-332_A1,0,0,0,0,0,0
CTCTGGACGCCTGGTG-1_V12D07-332_A1,3,0,2,0,0,5
AGGGTTTAGTTCGGGA-1_V12D07-332_A1,0,2,0,0,0,2
GGGAGAACTCACAGTA-1_V12D07-332_A1,8,1,0,0,0,9
ATCAATCTGGGCTGCA-1_V12D07-332_A1,6,0,0,0,0,6
TCTTCGATACCAATAA-1_V12D07-332_A1,2,0,1,0,0,3
ACGTAGATTGCTGATG-1_V12D07-332_A1,3,0,3,0,0,6
TCTTGATGCGTAGCGA-1_V12D07-332_A1,3,0,0,0,0,3
GGGCTGCCTAGGGCGA-1_V12D07-332_A1,5,0,2,0,0,7
CTCTCACAATCGATGA-1_V12D07-332_A1,1,2,1,0,0,4
CCAAGCGTAACTCGTA-1_V12D07-332_A1,0,0,0,0,0,0
ACAACAGCATGAGCTA-1_V12D07-332_A1,3,0,0,0,0,3
GTCCCAACGTAAAGTA-1_V12D07-332_A1,3,2,1,0,0,6
TCGGAGTACATGAGTA-1_V12D07-332_A1,5,1,0,0,0,6
GGGAGTTAATGAGGCG-1_V12D07-332_A1,2,0,1,0,0,3
CCGGGCGGTCTCGTCA-1_V12D07-332_A1,3,0,0,0,0,3
CCGTAAGTTGGTCCCA-1_V12D07-332_A1,0,1,2,0,0,3
GGAGGGCTTGGTTGGC-1_V12D07-332_A1,1,2,0,0,0,3
TCGGACGCCCAGCCCA-1_V12D07-332_A1,2,0,0,1,0,3
TCTGTGCCATCATAGT-1_V12D07-332_A1,2,1,0,1,0,4
GTACTGGAGTTAGACC-1_V12D07-332_A1,3,1,0,1,0,5
GGAATGCGCTAGCGTG-1_V12D07-332_A1,2,0,1,0,0,3
GTGTGAATAACTTAGG-1_V12D07-332_A1,2,0,0,0,0,2
GGTCGGCCAGGAGCTT-1_V12D07-332_A1,1,1,0,0,0,2
TAGCCGGCGGTCAGCG-1_V12D07-332_A1,4,0,0,0,0,4
CGGGTGTACCCATTTA-1_V12D07-332_A1,1,1,0,0,0,2
AGTGATTCAAGCAGGA-1_V12D07-332_A1,1,1,0,0,0,2
GTTGGATTGAGAACAC-1_V12D07-332_A1,0,2,1,0,0,3
CACACGCGCTGTCTTA-1_V12D07-332_A1,1,1,0,0,0,2
TAGACGCCCGTACCGG-1_V12D07-332_A1,1,0,1,1,0,3
GGTTTCAATCGGTCAG-1_V12D07-332_A1,2,0,1,1,0,4
AATCTGCGTTGGGACG-1_V12D07-332_A1,4,1,3,0,0,8
TTACGGATGGTTCGAG-1_V12D07-332_A1,1,0,2,1,0,4
CGGCAGGGTCGGGTTG-1_V12D07-332_A1,0,0,2,1,0,3
GCTTTCAGAGGAGGTG-1_V12D07-332_A1,1,0,0,0,0,1
TCTTCCCATGGGCACA-1_V12D07-332_A1,1,0,0,0,0,1
TACCGCGGACTTGCAG-1_V12D07-332_A1,1,1,2,0,0,4
AGAATTATGGATTCGA-1_V12D07-332_A1,0,0,1,0,0,1
ATTGATGAGTCCTAAC-1_V12D07-332_A1,1,2,0,1,0,4
TAGGTCGCCGGAACTG-1_V12D07-332_A1,2,0,0,1,0,3
TAACCTACCGTCCGAG-1_V12D07-332_A1,1,0,1,0,0,2
CTTAGTAGGCCTACAG-1_V12D07-332_A1,2,0,0,0,0,2
CTAGATGTGAGTGTAA-1_V12D07-332_A1,1,0,0,0,0,1
ACTCCCGAATTCGTTT-1_V12D07-332_A1,1,3,1,0,0,5
GTTCATCGTTTGGCTG-1_V12D07-332_A1,2,0,0,0,0,2
ACTTTACCCTCATGAA-1_V12D07-332_A1,1,1,1,0,0,3
GCGAGAGTTGCGTCCA-1_V12D07-332_A1,0,3,0,0,0,3
GTTCGGGCGTACCATT-1_V12D07-332_A1,1,0,1,0,0,2
CGACTTTGTATAGCCT-1_V12D07-332_A1,2,1,1,3,0,7
GCCATCGATGCTGCAT-1_V12D07-332_A1,0,0,0,1,0,1
GCATTTCCAAGGCTCC-1_V12D07-332_A1,1,0,0,0,0,1
ATGTAAGGCTGCTCTT-1_V12D07-332_A1,3,1,2,1,0,7
ACGTTCGCAATCAATT-1_V12D07-332_A1,0,0,0,0,0,0
GTGACGAGGGTGACCC-1_V12D07-332_A1,4,0,0,1,0,5
ATTATAGCTACTTTAC-1_V12D07-332_A1,1,0,0,0,0,1
CGTGTGTTAAACCCTG-1_V12D07-332_A1,1,2,1,0,0,4
TTGGTATGGCTTGTGT-1_V12D07-332_A1,2,0,1,1,0,4
CATTCCCATTCCGTCG-1_V12D07-332_A1,0,2,0,0,0,2
TGCCGAAAGCGTATTC-1_V12D07-332_A1,3,1,1,0,0,5
CAACACATCTCCTGCC-1_V12D07-332_A1,4,0,2,0,0,6
CTGCCTCATATGCAAC-1_V12D07-332_A1,2,1,0,0,0,3
TCCCGCCTATGTGCGT-1_V12D07-332_A1,2,0,0,0,0,2
GGTTACCCGACACTTT-1_V12D07-332_A1,4,1,1,1,0,7
CCAGCGGGATCACCAG-1_V12D07-332_A1,2,1,1,1,0,5
ATGTTTCGGCCCGGAG-1_V12D07-332_A1,1,0,0,0,0,1
GCGTCTAACCTCCTAA-1_V12D07-332_A1,0,1,1,0,0,2
ATCAGGTAGCTGACAG-1_V12D07-332_A1,2,0,2,1,0,5
GGTATGAAAGAACTGA-1_V12D07-332_A1,2,0,0,0,0,2
GTGGCCTAATATCATT-1_V12D07-332_A1,5,0,2,0,0,7
CCTGTGAAACCGTAAC-1_V12D07-332_A1,5,0,1,0,0,6
GGCAGAGAGATCGGGA-1_V12D07-332_A1,4,1,2,0,0,7
TAGCGTCGAATATTGA-1_V12D07-332_A1,6,0,0,0,0,6
CGCCGACTATTCGCTA-1_V12D07-332_A1,2,1,0,0,0,3
TCTGGCGCAAGCCGGG-1_V12D07-332_A1,2,0,1,0,0,3
AGTGGTTGCGTATAGG-1_V12D07-332_A1,5,0,0,0,0,5
ATCGGTTACCTAGTAA-1_V12D07-332_A1,1,0,0,0,0,1
CCTGCCCGTTGTCTAG-1_V12D07-332_A1,1,2,0,0,0,3
GCACACGCCCATGGTC-1_V12D07-332_A1,4,0,0,0,0,4
AGTACGGCCCGTATCG-1_V12D07-332_A1,2,0,0,0,0,2
TATCTAGCCTAAAGGA-1_V12D07-332_A1,1,0,0,0,0,1
CACTCGGTTAGGAGGA-1_V12D07-332_A1,3,1,0,0,0,4
ATGTTCGTCGACCCAC-1_V12D07-332_A1,5,0,1,0,0,6
TTCCTCTGCCCGAATA-1_V12D07-332_A1,4,0,1,0,0,5
TTACTATCGGCTTCTC-1_V12D07-332_A1,5,0,1,0,0,6
GCCGCATTAGTCCGGC-1_V12D07-332_A1,5,1,2,0,0,8
TAAGGGCTGGGAGAGG-1_V12D07-332_A1,4,0,1,0,0,5
TAAGCAGGCGACACGC-1_V12D07-332_A1,1,3,1,0,0,5
AGCACTACCGGCCTGT-1_V12D07-332_A1,3,1,0,0,0,4
GAAAGCCCTTTGGACC-1_V12D07-332_A1,3,1,0,0,0,4
GACCGACTGAAGCGTC-1_V12D07-332_A1,6,1,2,0,0,9
CGGTGAAGACTAAAGT-1_V12D07-332_A1,3,0,1,0,0,4
CCCTGCGCTACGCATA-1_V12D07-332_A1,2,0,1,0,0,3
TACTGGACAGCTCGGC-1_V12D07-332_A1,6,1,0,0,0,7
TTAGTAGGGCGGCGGG-1_V12D07-332_A1,0,3,0,0,0,3
GAGGCTATCAAAGTCG-1_V12D07-332_A1,0,1,0,0,0,1
TTACCATTGATTACCC-1_V12D07-332_A1,4,0,1,0,0,5
ATACCACGGGCAACTT-1_V12D07-332_A1,1,1,1,0,0,3
TGTCCTAAGTCACCGC-1_V12D07-332_A1,0,2,0,0,0,2
AGGTAGGTACAAAGCT-1_V12D07-332_A1,1,0,0,0,0,1
GGCATACAGGTAGCGG-1_V12D07-332_A1,5,1,0,0,0,6
TGTAGTGATCTATAAT-1_V12D07-332_A1,1,1,0,0,0,2
TCCCGGGTGTGCTGCT-1_V12D07-332_A1,2,1,1,0,0,4
TACGATGTTGATCATC-1_V12D07-332_A1,6,1,0,0,0,7
CCTCTCTCCCATCTAG-1_V12D07-332_A1,3,0,0,0,0,3
GCAGGACTATAGAATA-1_V12D07-332_A1,5,1,0,0,0,6
CTAGTGAAGGACAGGA-1_V12D07-332_A1,2,3,0,0,0,5
TACGAGAACTTCACGT-1_V12D07-332_A1,5,0,1,0,0,6
CGTTGTTTCAATTCCC-1_V12D07-332_A1,6,0,1,0,0,7
GCAAATATTACGCTTT-1_V12D07-332_A1,1,0,0,0,0,1
CCAATAGTGCCGTCGA-1_V12D07-332_A1,3,1,0,0,0,4
ATTGCTGCTCCTCCAT-1_V12D07-332_A1,3,1,0,0,0,4
GAGATCTGCTTGGCAT-1_V12D07-332_A1,1,3,1,0,0,5
GCCGAAATTCCTACGT-1_V12D07-332_A1,0,2,1,0,0,3
GGCACTCCACTGGGCA-1_V12D07-332_A1,2,1,1,0,0,4
GGGTCACCGTGACGGT-1_V12D07-332_A1,4,2,0,0,0,6
CACTTAATCAGACGGA-1_V12D07-332_A1,1,1,3,0,0,5
CGTTTCGCTCATTACA-1_V12D07-332_A1,1,1,0,0,1,3
ATAAAGGCTCGGTCGT-1_V12D07-332_A1,3,1,1,0,0,5
CACTAAAGTTGCCTAT-1_V12D07-332_A1,7,0,0,0,1,8
GTGCTCAAGTACTGTC-1_V12D07-332_A1,4,2,1,0,0,7
CCATGCCTGTTTAGTA-1_V12D07-332_A1,1,1,2,0,0,4
TCTAGTTATCAGAAGA-1_V12D07-332_A1,2,0,0,0,0,2
TTGTAATCCGTACTCG-1_V12D07-332_A1,2,0,0,0,0,2
TCCCAGCTTTAGTCTG-1_V12D07-332_A1,1,0,0,0,0,1
CTACGCACGGAGTACC-1_V12D07-332_A1,0,3,0,0,0,3
AAATTAACGGGTAGCT-1_V12D07-332_A1,2,1,1,0,0,4
CGGCCACGCACAAAGT-1_V12D07-332_A1,1,0,1,0,0,2
GAAGCGTGAGGAATTT-1_V12D07-332_A1,1,1,0,0,0,2
ATATCTTAGGGCCTTC-1_V12D07-332_A1,2,1,1,0,0,4
ACGCGGGCCAAGGACA-1_V12D07-332_A1,2,0,0,0,0,2
GCGAGTTCTGCAAAGA-1_V12D07-332_A1,1,1,2,0,0,4
TATTCGTGCCAGAATA-1_V12D07-332_A1,6,1,0,0,0,7
AGGGCTGCAGTTACAG-1_V12D07-332_A1,0,1,2,1,0,4
CTAGCATAGTATAATG-1_V12D07-332_A1,3,1,0,0,0,4
TAGGTTCGAGTTCGTC-1_V12D07-332_A1,2,1,1,0,0,4
GAATTATAGTGAAAGG-1_V12D07-332_A1,3,0,0,0,0,3
CTATCGGGTCTCAACA-1_V12D07-332_A1,4,0,0,0,0,4
GCGCTAATTGAATAGA-1_V12D07-332_A1,3,0,2,0,0,5
ATGCGACAGTCCCATT-1_V12D07-332_A1,3,0,2,0,0,5
GGTAGTGCTCGCACCA-1_V12D07-332_A1,3,0,1,0,0,4
AAGCTCGTGCCAAGTC-1_V12D07-332_A1,1,2,0,0,0,3
TATTCAATTCTAATCC-1_V12D07-332_A1,1,0,2,0,0,3
TTCAAAGTCTCTAGCC-1_V12D07-332_A1,3,0,0,0,0,3
TTGAATATGGACTTTC-1_V12D07-332_A1,2,1,0,0,0,3
AAGAGCTCTTTATCGG-1_V12D07-332_A1,2,0,1,0,0,3
TTACTCCGGCCGGGAA-1_V12D07-332_A1,3,3,1,0,0,7
AAACGAGACGGTTGAT-1_V12D07-332_A1,4,1,1,0,0,6
GCTAAGTAGTTTCTCT-1_V12D07-332_A1,1,2,0,0,0,3
ATAACGCCGGAGGGTC-1_V12D07-332_A1,1,1,2,0,0,4
GGATCCGGAATATACT-1_V12D07-332_A1,4,0,1,0,0,5
TGAAAGGACCTGACTC-1_V12D07-332_A1,1,1,0,0,0,2
TCCGCGGCAGCATCTG-1_V12D07-332_A1,4,0,1,0,0,5
TGCATATGTCTGTCAC-1_V12D07-332_A1,2,0,1,0,0,3
TGTAGGAGAAATTTCC-1_V12D07-332_A1,3,0,1,0,0,4
AGTGAGACTTCCAGTA-1_V12D07-332_A1,0,0,0,0,0,0
CCCAAACATGCTGCTC-1_V12D07-332_A1,1,0,0,1,0,2
GCTTATGAAGCAGGAA-1_V12D07-332_A1,3,1,1,1,0,6
TTCTAACCGAAGCTTA-1_V12D07-332_A1,1,0,0,0,0,1
GGATGTCCTTACCGCA-1_V12D07-332_A1,2,2,2,0,0,6
AGGGTGCTCTCGAGGG-1_V12D07-332_A1,0,1,1,0,0,2
AACTCTCAATAGAGCG-1_V12D07-332_A1,1,0,0,0,0,1
TCTGAATTCCGTACAA-1_V12D07-332_A1,1,0,1,0,0,2
GCGTGGTACTGGGTTA-1_V12D07-332_A1,2,0,1,0,0,3
CGTCGGATAGTGTTGA-1_V12D07-332_A1,3,0,1,1,0,5
ATATGTCTCCCTAGCC-1_V12D07-332_A1,2,0,0,0,0,2
TCTTTAAGACTATGAA-1_V12D07-332_A1,1,0,4,0,0,5
TCATTTAAGTCTCCGA-1_V12D07-332_A1,1,1,0,0,0,2
GATATTGAGATTGGCG-1_V12D07-332_A1,2,1,0,0,0,3
TGACATCGAGCGGACC-1_V12D07-332_A1,4,2,0,1,0,7
GCGTAAATGGCCATAA-1_V12D07-332_A1,3,0,0,1,0,4
ATTGTACAACTCGGCT-1_V12D07-332_A1,1,2,0,0,0,3
TACGCTATAGAAACCT-1_V12D07-332_A1,2,0,0,0,0,2
CACCCAAATCTTATGT-1_V12D07-332_A1,2,0,1,0,0,3
AGATGATGGAGTCTGG-1_V12D07-332_A1,2,0,1,0,0,3
CCACGGTGCCCGGTAG-1_V12D07-332_A1,2,0,1,0,0,3
TCAAGAAATACTAGCT-1_V12D07-332_A1,0,1,0,1,0,2
AGGTATAATTGATAGT-1_V12D07-332_A1,3,0,0,0,0,3
CAAGGTCCTATAGGCT-1_V12D07-332_A1,0,0,1,0,0,1
CCGGCACGACCGTTTC-1_V12D07-332_A1,3,0,0,0,0,3
ACCTCCGTTATTCACC-1_V12D07-332_A1,1,0,0,0,0,1
GCAGCCTATATCACAT-1_V12D07-332_A1,2,0,2,0,0,4
GGTATAGTGACACATA-1_V12D07-332_A1,3,0,2,0,0,5
AAATTCCAGGTCCAAA-1_V12D07-332_A1,4,0,2,0,0,6
TCTTTAGCAGGCGAAC-1_V12D07-332_A1,5,0,1,0,0,6
TATTGACATTTCTGCC-1_V12D07-332_A1,1,0,1,0,0,2
TCTGATCGGGTGCTAG-1_V12D07-332_A1,2,4,1,0,0,7
GGCCCGGAGCATGTCT-1_V12D07-332_A1,2,1,0,0,0,3
GGGCGCAGCGTTACTC-1_V12D07-332_A1,1,1,1,0,0,3
TTGGCGATCCGAATAT-1_V12D07-332_A1,1,2,2,1,0,6
CCACGTAAATTAGACT-1_V12D07-332_A1,1,1,0,0,0,2
TCTGATTGGAAATGGA-1_V12D07-332_A1,2,0,0,0,0,2
ATGGCGGAATAGTCGC-1_V12D07-332_A1,0,1,1,0,0,2
ATCGCTTTACGTCTCA-1_V12D07-332_A1,5,2,0,0,0,7
TACGTGCAAGGTTCCT-1_V12D07-332_A1,3,0,1,1,0,5
CAGGACAGCTGCCCTT-1_V12D07-332_A1,2,0,0,1,0,3
CAAACCAGGTCTGCAT-1_V12D07-332_A1,2,0,0,0,0,2
ACAAGCTATATGGAAG-1_V12D07-332_A1,1,3,2,0,0,6
TCGCCCACTGCGAGAG-1_V12D07-332_A1,1,1,3,0,0,5
AGCCGCAAATTCAAAT-1_V12D07-332_A1,3,0,2,0,0,5
TTAACGTTAAAGCCTG-1_V12D07-332_A1,2,0,0,0,0,2
CAGCGCCAACACGATA-1_V12D07-332_A1,3,0,0,0,0,3
ATCCAATGGTACCGAA-1_V12D07-332_A1,4,1,1,0,0,6
GTGCTGCAGATAAGGA-1_V12D07-332_A1,4,0,0,0,0,4
GGCCTTTGCAACTGGC-1_V12D07-332_A1,3,1,0,0,0,4
GTCGTACCTACGATTG-1_V12D07-332_A1,3,0,2,0,0,5
TAGAAATTCACGTATA-1_V12D07-332_A1,4,1,0,0,0,5
AGAATAAATCTTCAGG-1_V12D07-332_A1,3,2,0,0,0,5
CATTGCGAAATGGGCG-1_V12D07-332_A1,2,1,3,0,0,6
GTCTACTCAATTACAA-1_V12D07-332_A1,1,0,0,0,0,1
TGTAATGACCACAATA-1_V12D07-332_A1,1,0,1,0,0,2
AAAGTCGACCCTCAGT-1_V12D07-332_A1,2,0,0,0,0,2
TACTCGGCACGCCGGG-1_V12D07-332_A1,2,0,1,0,0,3
AGGTGTATCGCCATGA-1_V12D07-332_A1,3,1,1,0,0,5
TGTGCTTTACGTAAGA-1_V12D07-332_A1,6,3,1,0,0,10
AAACCTCATGAAGTTG-1_V12D07-332_A1,5,1,1,0,0,7
TATAGGGTACTCATGA-1_V12D07-332_A1,3,1,1,0,0,5
CCAGCTGATGGTACTT-1_V12D07-332_A1,2,1,0,0,0,3
AATATTGGAGTATTGA-1_V12D07-332_A1,0,2,0,0,0,2
GGCCCTCACCCACTTA-1_V12D07-332_A1,4,0,1,0,0,5
AACCAAGACTTCTCTG-1_V12D07-332_A1,3,2,3,0,0,8
TCGTATTACCCATTGC-1_V12D07-332_A1,7,0,0,0,0,7
ATTCGACGCCGGGCCT-1_V12D07-332_A1,2,1,0,0,0,3
GGCGCAGGACATCTTC-1_V12D07-332_A1,4,1,1,0,0,6
GTACTCCCTTATCGCT-1_V12D07-332_A1,6,1,1,0,0,8
TGGTCTGTTGGGCGTA-1_V12D07-332_A1,0,0,2,0,0,2
AATAACAACGCTCGGC-1_V12D07-332_A1,2,2,3,0,0,7
CATACCCGTACCCAGT-1_V12D07-332_A1,3,2,0,0,0,5
ACAATCCATTTAAACC-1_V12D07-332_A1,4,0,2,0,0,6
GTTACAATTGGTGACG-1_V12D07-332_A1,0,0,0,0,0,0
TTGCCCTGATCACGGG-1_V12D07-332_A1,3,0,1,0,0,4
CTAACCGCGCGCCCGT-1_V12D07-332_A1,1,0,1,0,0,2
CTAAAGAATGCCTACT-1_V12D07-332_A1,0,0,0,0,0,0
ACCCATCTTGAGGGTA-1_V12D07-332_A1,1,1,0,0,0,2
GATCTTTGCAGGGTAT-1_V12D07-332_A1,4,2,0,0,0,6
GGGTACTTCATGAACT-1_V12D07-332_A1,1,2,0,0,0,3
GCCGCTTGTGAGAAAC-1_V12D07-332_A1,2,1,0,0,0,3
CCTGTAAGACATGATA-1_V12D07-332_A1,2,0,1,0,0,3
CGACAGTTCGCGTTAT-1_V12D07-332_A1,2,1,0,0,0,3
ACGATGCATATGTTAT-1_V12D07-332_A1,2,0,0,0,0,2
TGTTCCGCTTCCATGA-1_V12D07-332_A1,3,2,0,0,0,5
GGATGACGCGAGTTTA-1_V12D07-332_A1,4,0,1,0,0,5
GAAGTTTCCACTCAAT-1_V12D07-332_A1,1,1,1,0,0,3
GCGAGGCCCGAGCAGA-1_V12D07-332_A1,0,0,0,0,0,0
CATACTATGTAATTGT-1_V12D07-332_A1,1,1,1,0,0,3
CCAATGTCACAGCAAG-1_V12D07-332_A1,4,0,0,0,0,4
GTTGGATTTGCGTTGG-1_V12D07-332_A1,1,1,0,0,0,2
GGGAGGATGCCCGAAA-1_V12D07-332_A1,2,0,0,0,0,2
GATCGCGGGCTCTCCA-1_V12D07-332_A1,4,0,0,0,1,5
GTTCGCCATAAGTGCC-1_V12D07-332_A1,4,0,1,0,0,5
AGATTATAGGACGTTT-1_V12D07-332_A1,5,2,1,0,0,8
TCGAGACCAACACCGT-1_V12D07-332_A1,4,3,0,0,0,7
TATGGGACCGAGCAGG-1_V12D07-332_A1,0,2,0,0,0,2
GATGCGTCCTGCATTC-1_V12D07-332_A1,5,0,0,0,0,5
TATGGTCTGAGTAACA-1_V12D07-332_A1,1,0,0,0,0,1
GCATAGAGCACTCAGG-1_V12D07-332_A1,3,0,0,0,0,3
CTTCATTGTCAGTGGA-1_V12D07-332_A1,4,0,0,0,0,4
GCAGATTAGGGATATC-1_V12D07-332_A1,2,0,0,0,0,2
CCTGTCGCCCGTAAAT-1_V12D07-332_A1,1,1,1,0,0,3
CAATTTCGTATAAGGG-1_V12D07-332_A1,0,0,0,0,0,0
GTACACTTACCTGAAG-1_V12D07-332_A1,1,0,1,0,0,2
CCAGCCTGGACCAATA-1_V12D07-332_A1,1,0,1,1,0,3
ATGGAGCAGGCCGTGA-1_V12D07-332_A1,2,2,0,0,0,4
GTCATTAGAGCGAACG-1_V12D07-332_A1,4,0,1,0,0,5
AAGACTGCAAGCTACT-1_V12D07-332_A1,1,1,0,0,0,2
CTAGTCACGTCTTAAG-1_V12D07-332_A1,4,1,0,0,0,5
ACTCTTGTATAGTAAC-1_V12D07-332_A1,3,0,1,0,0,4
ATTAGGCGATGCTTTC-1_V12D07-332_A1,1,1,1,0,0,3
TTCGGGACTAATCGCG-1_V12D07-332_A1,3,0,0,1,0,4
TGGACTGTTCGCTCAA-1_V12D07-332_A1,2,1,0,0,0,3
AACGTGCGAAAGTCTC-1_V12D07-332_A1,3,0,0,1,0,4
CCACCCAAGGAAAGTG-1_V12D07-332_A1,5,0,2,0,0,7
CCGCACAAAGACCAAC-1_V12D07-332_A1,0,2,2,0,0,4
GCGATTGTTAACGTTA-1_V12D07-332_A1,1,1,0,0,0,2
ACTCGTCAGTAATCCC-1_V12D07-332_A1,3,2,0,0,0,5
GGTGATAAGGAGCAGT-1_V12D07-332_A1,1,1,2,0,0,4
AAGAGGCATGGATCGC-1_V12D07-332_A1,3,0,0,0,0,3
CACGTTCGTGCTCTAG-1_V12D07-332_A1,6,1,0,0,0,7
CTATTTGGTTACGGAT-1_V12D07-332_A1,2,0,0,0,0,2
GTACAGAGGCAAGGGT-1_V12D07-332_A1,3,1,1,0,0,5
GGGCCGGCCGAAGTAC-1_V12D07-332_A1,1,3,0,0,0,4
CCTGAACGATATATTC-1_V12D07-332_A1,2,0,0,0,0,2
CCGGGCTGCTCCATAC-1_V12D07-332_A1,3,1,0,0,0,4
TACTTGTTAGTAGTCC-1_V12D07-332_A1,3,0,0,0,0,3
CCTAGGCGTAGCGATC-1_V12D07-332_A1,3,0,0,0,0,3
CTGGCGCACAGGTCTG-1_V12D07-332_A1,1,1,1,0,0,3
ACTTATACTTACCCGG-1_V12D07-332_A1,0,0,0,0,0,0
GAAGTCTCCCTAGCGA-1_V12D07-332_A1,4,0,1,0,0,5
ACCGATGGTAGCATCG-1_V12D07-332_A1,1,0,0,0,0,1
CGAGTTTATCGGACTG-1_V12D07-332_A1,2,0,1,0,0,3
CATAACGGACAGTCGT-1_V12D07-332_A1,0,2,0,0,0,2
TGACGATGCACTAGAA-1_V12D07-332_A1,3,0,1,1,0,5
TAGGGAGCTTGGGATG-1_V12D07-332_A1,3,0,1,1,0,5
AGGGTCGATGCGAACT-1_V12D07-332_A1,2,0,2,0,0,4
TATATCCCTGGGAGGA-1_V12D07-332_A1,3,1,0,0,0,4
CATCTTACACCACCTC-1_V12D07-332_A1,3,1,1,0,0,5
GTGCGACAGGGAGTGT-1_V12D07-332_A1,1,1,0,0,0,2
CCGATCTCAACCTTAT-1_V12D07-332_A1,1,1,2,0,0,4
ACGATCATCTTGTAAA-1_V12D07-332_A1,5,0,1,0,0,6
GAAAGAACAGCGTTAT-1_V12D07-332_A1,0,0,0,0,0,0
CTAGGTCTGAAGGAAT-1_V12D07-332_A1,4,3,0,0,0,7
ATATCAACCTACAGAG-1_V12D07-332_A1,4,0,0,0,0,4
AAATAGCTTAGACTTT-1_V12D07-332_A1,5,0,2,0,0,7
GCGACATGTAAACATC-1_V12D07-332_A1,2,0,0,0,0,2
ATAAGTAGGGCGACTC-1_V12D07-332_A1,3,0,0,0,0,3
GCGAGCGCATGCTCCC-1_V12D07-332_A1,0,1,0,0,0,1
AGGGACCGGCTGCGTT-1_V12D07-332_A1,4,0,0,0,0,4
CCTATGAAGTGGTGCC-1_V12D07-332_A1,1,2,0,0,0,3
GCTTACGTAGTTAGTA-1_V12D07-332_A1,1,0,0,0,0,1
CATACTTAGGCAATAC-1_V12D07-332_A1,3,2,0,1,0,6
CCTGTCCCTCACGTTA-1_V12D07-332_A1,2,1,0,0,0,3
CAATGTGCCAACCCTT-1_V12D07-332_A1,1,0,0,0,0,1
GTTAAGTTAGAGTGGG-1_V12D07-332_A1,2,0,3,0,0,5
CTGGGATACGCTACCC-1_V12D07-332_A1,2,0,0,0,0,2
AACCTGTCACGGAATT-1_V12D07-332_A1,2,1,2,0,0,5
ACTGCGGACACACCGT-1_V12D07-332_A1,2,1,1,0,0,4
CCGTGAGGCATTCATG-1_V12D07-332_A1,0,0,0,0,0,0
GCCCAGATGCTGGAGA-1_V12D07-332_A1,1,0,0,0,0,1
TCTGGCCGTTCAAGTT-1_V12D07-332_A1,2,0,2,1,0,5
ATACGAAGGCTTTCCA-1_V12D07-332_A1,0,1,0,0,0,1
GATCCGAATATAAGTG-1_V12D07-332_A1,2,1,0,0,0,3
GTGGAGCATGTCGGCC-1_V12D07-332_A1,4,0,0,0,0,4
ACTCTTCAGCTCCCGC-1_V12D07-332_A1,2,0,2,0,0,4
CCCGATAGCCTCGCCT-1_V12D07-332_A1,0,0,0,0,0,0
ACAGGTGTGTTGTTGC-1_V12D07-332_A1,6,0,0,0,0,6
TGAACTGCTATGACTT-1_V12D07-332_A1,1,0,1,0,0,2
TGACATATATGACGAT-1_V12D07-332_A1,3,0,1,0,0,4
AAGTCTTCTGTGGCCT-1_V12D07-332_A1,4,0,1,0,0,5
ACCAGACCATAACAAC-1_V12D07-332_A1,2,0,1,0,0,3
TGAGACGTACCTCTCA-1_V12D07-332_A1,2,0,2,0,0,4
GACCGTTACATGCGAC-1_V12D07-332_A1,4,1,4,0,0,9
GGTTCGGATTATACTA-1_V12D07-332_A1,3,0,0,0,0,3
CCTCCTGAGCCCACAT-1_V12D07-332_A1,0,1,0,0,0,1
CCGCGATTTGGTAGGT-1_V12D07-332_A1,2,0,1,0,0,3
AATCTCTACTGTGGTT-1_V12D07-332_A1,2,0,1,0,0,3
ACTTTGACTGCATCCT-1_V12D07-332_A1,4,1,0,0,0,5
CCCTGACTAACAAATT-1_V12D07-332_A1,1,1,0,0,0,2
ACGCTGTGAGGCGTAG-1_V12D07-332_A1,1,0,2,0,0,3
GCATACGAGGTCTTTA-1_V12D07-332_A1,4,0,1,0,0,5
TCGGGATTCAAACATA-1_V12D07-332_A1,2,0,0,0,0,2
GGGCCCTACGAAAGGG-1_V12D07-332_A1,4,2,1,0,0,7
CGCCAAGAAGCCGAGT-1_V12D07-332_A1,2,2,1,0,0,5
GGTACATCTGGGACGA-1_V12D07-332_A1,1,0,1,0,0,2
GGATGCTGGCGTTCCT-1_V12D07-332_A1,0,0,0,0,0,0
CCGATTCGAGGGACCC-1_V12D07-332_A1,2,0,1,0,0,3
CCACTGGTGGCTGGTT-1_V12D07-332_A1,4,1,0,0,0,5
GACAGGCACACACTAT-1_V12D07-332_A1,2,1,0,0,0,3
TCAACGCGACCGGCAG-1_V12D07-332_A1,5,0,1,0,0,6
CTACGACTAGCTATAA-1_V12D07-332_A1,1,1,0,0,0,2
CGGTTGACCTGGCATA-1_V12D07-332_A1,3,1,1,0,0,5
ATCCTGAATCGCTGCG-1_V12D07-332_A1,3,1,1,0,0,5
GTTTCATATCGTCGCT-1_V12D07-332_A1,2,0,0,0,0,2
ATAAATATTAGCAGCT-1_V12D07-332_A1,4,1,1,0,0,6
AAGAGGATGTACGCGA-1_V12D07-332_A1,3,0,1,0,0,4
TCCTGCGTTGATACTC-1_V12D07-332_A1,2,1,0,0,0,3
CGTGCATTGTCGACGC-1_V12D07-332_A1,0,0,0,0,0,0
CCGGGTTCGAGGTTAC-1_V12D07-332_A1,0,0,0,0,0,0
CCCAATTTCACAACTT-1_V12D07-332_A1,5,3,0,1,0,9
TGATTTATTAGCTGTG-1_V12D07-332_A1,3,2,1,0,0,6
TGGAAGAAGGGAACGT-1_V12D07-332_A1,2,1,1,0,0,4
GACGCTTGCTTCTAAA-1_V12D07-332_A1,4,0,0,0,0,4
GGGAACGGGAGGTTAG-1_V12D07-332_A1,3,3,0,0,0,6
GCGGCTCTGACGTACC-1_V12D07-332_A1,1,0,0,0,0,1
ACGTTAGATTTGCCCG-1_V12D07-332_A1,2,0,1,0,0,3
GAGAGGGCGCGAGGTT-1_V12D07-332_A1,1,1,0,0,0,2
GCGTCTCTGCATTGGG-1_V12D07-332_A1,2,0,0,0,0,2
GCAGCACACAGCCCAG-1_V12D07-332_A1,2,1,1,0,0,4
CAGGCCGTTTGGGTGT-1_V12D07-332_A1,2,1,0,0,0,3
AACTCAAGTTAATTGC-1_V12D07-332_A1,1,0,1,0,0,2
CTTCGTAGATAGGTGA-1_V12D07-332_A1,2,1,0,0,0,3
TGCAGAGTACCGAGCA-1_V12D07-332_A1,1,2,1,0,0,4
GAAGTGATTTATCGTG-1_V12D07-332_A1,4,0,0,0,0,4
CGCTACGGGACATTTA-1_V12D07-332_A1,3,3,0,1,0,7
CCACACTGAGATATTA-1_V12D07-332_A1,0,0,2,0,0,2
CGATCCGACCCAGTGC-1_V12D07-332_A1,0,1,0,0,0,1
CTGTACTTCTTAGCAT-1_V12D07-332_A1,1,2,0,0,0,3
ACTTATTAGGATCGGT-1_V12D07-332_A1,3,2,0,0,0,5
TAGTCCGCAGAGAATG-1_V12D07-332_A1,2,1,0,0,0,3
TTCACGAAAGGATCAC-1_V12D07-332_A1,1,0,4,0,0,5
TACATTTCTAACGTGC-1_V12D07-332_A1,1,0,0,0,0,1
ACCATATCCGCAATAA-1_V12D07-332_A1,2,1,1,0,0,4
CACTCAAGAGCTATGG-1_V12D07-332_A1,2,0,2,0,0,4
TGTACGAACAAATCCG-1_V12D07-332_A1,4,2,0,0,0,6
ATCATCCAATATTTGT-1_V12D07-332_A1,3,1,0,0,0,4
CGCTATTCTTAGGCTC-1_V12D07-332_A1,3,2,0,0,0,5
TGGCAGCAGTAATAGT-1_V12D07-332_A1,4,0,1,0,0,5
TCACGTGCCCGATTCA-1_V12D07-332_A1,2,1,0,0,0,3
CATACGGCGTCTGGGC-1_V12D07-332_A1,5,2,0,0,0,7
CACATGATTCAGCAAC-1_V12D07-332_A1,3,0,1,0,0,4
GCTAGTAGAGCTTGTA-1_V12D07-332_A1,6,1,0,0,0,7
TGCTGTTGAAGAACTC-1_V12D07-332_A1,2,3,0,0,0,5
CGGAGCATGGCGATCC-1_V12D07-332_A1,1,0,0,0,0,1
TAGCGTTGGGTCTTAC-1_V12D07-332_A1,4,1,1,0,0,6
GTAGCGGCTATACACT-1_V12D07-332_A1,2,0,1,0,0,3
TAACATACAATGTGGG-1_V12D07-332_A1,3,3,2,0,0,8
TCTTCGAATAGACGTT-1_V12D07-332_A1,1,0,0,0,0,1
GATCGTGACTGATATC-1_V12D07-332_A1,0,0,1,1,0,2
GATCCGGGAATTAACA-1_V12D07-332_A1,4,1,1,0,0,6
TTATATACGCTGTCAC-1_V12D07-332_A1,3,1,1,0,0,5
GTCGCGTAACCCGTTG-1_V12D07-332_A1,2,1,1,0,0,4
AGCTCTAGACGTTCCA-1_V12D07-332_A1,5,0,1,1,0,7
GTCAAGCGGACTCGGG-1_V12D07-332_A1,4,0,0,0,0,4
CGAGGGACTGCGGTCG-1_V12D07-332_A1,1,2,1,0,0,4
AATCGCCTCAGCGCCA-1_V12D07-332_A1,1,0,0,0,0,1
CTTGTTGCTGAGTCAA-1_V12D07-332_A1,5,0,1,0,0,6
GATATGAGACACTAAC-1_V12D07-332_A1,3,0,1,0,0,4
TTATGATCTTAACGAA-1_V12D07-332_A1,1,1,0,0,0,2
CGCCGCCCATGCCTGT-1_V12D07-332_A1,4,0,0,0,0,4
CTGGGATAAATAATGG-1_V12D07-332_A1,1,0,0,0,0,1
GTGCCCGTTCGGATTC-1_V12D07-332_A1,4,0,2,0,0,6
TTCAATACTCTGAATC-1_V12D07-332_A1,1,1,1,0,0,3
CGCACATGTCCACTAC-1_V12D07-332_A1,2,1,2,0,0,5
AGAAGAGCGCCGTTCC-1_V12D07-332_A1,3,0,0,0,0,3
GATAACTCGCACTGTG-1_V12D07-332_A1,3,0,0,0,0,3
AGTCGACGGTCTCAAG-1_V12D07-332_A1,5,1,0,0,0,6
GTGACCGCACACTACG-1_V12D07-332_A1,1,0,0,0,0,1
GTATGTGGGTCTAGTT-1_V12D07-332_A1,3,1,1,0,0,5
CTTGAGTTAGGGTAAT-1_V12D07-332_A1,0,1,3,0,0,4
TTAGCTGATTTGCCGT-1_V12D07-332_A1,4,0,1,2,0,7
GCTGTTGCTACCGAAC-1_V12D07-332_A1,4,0,0,0,0,4
TATTACCATCCTGCTT-1_V12D07-332_A1,4,1,1,0,0,6
TTGAATTCACGTGAGG-1_V12D07-332_A1,2,1,1,0,0,4
CCATCTCACCAGTGAA-1_V12D07-332_A1,2,0,2,0,0,4
CGCACGTGCGCTATCA-1_V12D07-332_A1,0,0,2,0,0,2
ACCCGGATGACGCATC-1_V12D07-332_A1,1,0,3,0,0,4
CGCTAGAGACCGCTGC-1_V12D07-332_A1,4,0,2,1,0,7
ATAGTTCCACCCACTC-1_V12D07-332_A1,4,1,0,0,0,5
GCAGACCCAGCACGTA-1_V12D07-332_A1,0,0,1,0,0,1
TAGACTACCTAGCGTT-1_V12D07-332_A1,0,1,0,0,0,1
GGTTCTACTCGTCTGA-1_V12D07-332_A1,0,0,0,0,0,0
GACTCACCCACGTGAG-1_V12D07-332_A1,1,0,0,0,0,1
AGCTCTTCGTAACCTT-1_V12D07-332_A1,2,0,0,0,0,2
ACTATCCAGGGCATGG-1_V12D07-332_A1,4,0,1,0,0,5
AAGGATCGATCGCTTG-1_V12D07-332_A1,0,1,0,0,0,1
ATATCGGTAGGGAGAT-1_V12D07-332_A1,2,0,0,0,0,2
TTCCAGACGAGATTTA-1_V12D07-332_A1,3,1,0,0,0,4
GACCGACGTGAAAGCA-1_V12D07-332_A1,1,0,0,0,0,1
CCTGGAAACGTTCTGC-1_V12D07-332_A1,1,0,2,0,0,3
CCGGTAATGGCTAGTC-1_V12D07-332_A1,1,2,0,0,0,3
GCCGTGGAAGAAATGT-1_V12D07-332_A1,0,1,0,0,0,1
GTCTTGAGGAGCAGTG-1_V12D07-332_A1,3,0,0,0,0,3
TCCCAAAGCCCTAAAT-1_V12D07-332_A1,1,2,2,0,0,5
TTGAGCGCCACGTGAT-1_V12D07-332_A1,1,0,0,0,0,1
TTGAGTCCCGCTGCTG-1_V12D07-332_A1,1,1,0,0,0,2
ATGGAACCTTTGCACA-1_V12D07-332_A1,3,0,0,1,0,4
GCTAGCACCTGGGCCA-1_V12D07-332_A1,0,12,2,0,0,14
CGCCGTCTACCCATCG-1_V12D07-332_A1,2,1,0,1,0,4
GATAGGTGTCCCGGGC-1_V12D07-332_A1,2,0,2,0,0,4
AGGTATGCGGACATTA-1_V12D07-332_A1,0,0,2,1,0,3
TTGGTTCGCTCAAAGG-1_V12D07-332_A1,0,1,1,0,0,2
TCTGGAGCGTAAGAGT-1_V12D07-332_A1,5,3,0,0,0,8
TGCCTAAATTTAATAG-1_V12D07-332_A1,0,0,1,1,0,2
TAATTTCCGTCCAGTA-1_V12D07-332_A1,3,0,0,0,0,3
TCCTTCAATCCCTACG-1_V12D07-332_A1,2,0,2,0,0,4
TACCTATCCCTAGAGG-1_V12D07-332_A1,3,1,0,0,0,4
GCATGGGTACTGACGC-1_V12D07-332_A1,3,1,0,0,0,4
GTCGGGAACATGGTAG-1_V12D07-332_A1,5,0,0,0,0,5
GCAAATGAGGACACTT-1_V12D07-332_A1,2,0,0,0,0,2
GAATGGGCTTATCGAC-1_V12D07-332_A1,3,0,1,0,0,4
TGGTCGTGCAAGGCAA-1_V12D07-332_A1,3,0,0,0,0,3
CACCACGCCACACAGA-1_V12D07-332_A1,4,0,0,0,0,4
GAACCTCGACCTACAC-1_V12D07-332_A1,1,0,0,0,0,1
CAATACGCTCTGAGGC-1_V12D07-332_A1,1,0,1,0,0,2
TGGTAAGCAGGATTGA-1_V12D07-332_A1,3,1,2,0,0,6
AGTGGCTCCGTCGGCC-1_V12D07-332_A1,3,0,0,0,0,3
GATCGGATAGAACCAT-1_V12D07-332_A1,2,0,1,0,0,3
GCTACAGTACGGACCG-1_V12D07-332_A1,4,2,1,0,0,7
TCTATTACTAGAGGAT-1_V12D07-332_A1,6,0,1,0,0,7
TTCAGGCGTCAAAGCC-1_V12D07-332_A1,2,0,0,0,0,2
AGACCGGGAAACCCTG-1_V12D07-332_A1,1,0,1,0,0,2
AGAGATCTCTAAAGCG-1_V12D07-332_A1,2,0,2,0,0,4
CCCTGCCCAATCCGCT-1_V12D07-332_A1,3,0,0,0,0,3
GTGGCGGTCCCAGCGT-1_V12D07-332_A1,1,1,0,0,0,2
GCATTGTAATTCATAT-1_V12D07-332_A1,5,0,0,0,0,5
CCGTTCCGAATCTCGG-1_V12D07-332_A1,4,2,1,0,0,7
AGCTTGATCTTAACTT-1_V12D07-332_A1,4,1,0,0,0,5
CCTGTACTCACGCCCA-1_V12D07-332_A1,3,1,0,0,0,4
AAGTGACGACCGAATT-1_V12D07-332_A1,0,0,0,0,0,0
CTCACTTGGCTGGTAA-1_V12D07-332_A1,2,0,0,0,0,2
CGCCTGGCCTACGTAA-1_V12D07-332_A1,1,1,3,0,0,5
CCCGTAAGTCTAGGCC-1_V12D07-332_A1,2,2,3,0,0,7
TTGGACATGTGGCTTA-1_V12D07-332_A1,3,4,1,0,0,8
ATTACGCGCTGGCAGG-1_V12D07-332_A1,3,1,0,0,0,4
ACGCGCTACACAGGGT-1_V12D07-332_A1,0,3,0,0,0,3
TACGTTTACCGGCAAT-1_V12D07-332_A1,1,1,1,0,0,3
CGAAACGCAATTCATG-1_V12D07-332_A1,6,1,0,0,0,7
TAGTCTAACAACGAGA-1_V12D07-332_A1,1,0,1,0,0,2
TTGCATGCTGATCACG-1_V12D07-332_A1,6,2,0,0,0,8
TCTGGGTAGCGCTCAT-1_V12D07-332_A1,6,1,0,0,0,7
ACATCGGTCAGCCGCG-1_V12D07-332_A1,3,2,1,0,0,6
AGATACCGGTGTTCAC-1_V12D07-332_A1,5,1,1,0,0,7
GATTACTGAATTTGGG-1_V12D07-332_A1,1,3,0,0,0,4
TCCAACTTTAAATTCT-1_V12D07-332_A1,2,0,0,0,0,2
TCCTAGCAAAGAAGCT-1_V12D07-332_A1,5,1,1,0,0,7
GTCTATCTGAGTTTCT-1_V12D07-332_A1,1,1,0,0,0,2
GATGTTCAATCCACGA-1_V12D07-332_A1,0,2,0,0,0,2
AGTTAAACACTTGCGA-1_V12D07-332_A1,3,1,0,0,0,4
AGCTCTTTACTCAGTT-1_V12D07-332_A1,2,0,1,0,0,3
ATCCAGGATTCGTGAA-1_V12D07-332_A1,2,1,0,0,0,3
AGTCAACACCACCATC-1_V12D07-332_A1,0,1,1,0,0,2
CGATACCTCGCGGACA-1_V12D07-332_A1,2,1,1,0,0,4
TACAACGCACAACTCA-1_V12D07-332_A1,5,0,1,0,0,6
AATTAAAGGTCGGCGT-1_V12D07-332_A1,1,2,1,0,0,4
TACGCAGTTCTTTCCT-1_V12D07-332_A1,1,2,1,0,0,4
GACCGTGCTGACGGTG-1_V12D07-332_A1,4,2,0,0,0,6
GGCAAATTACTTTACT-1_V12D07-332_A1,2,2,0,0,0,4
GGTACAAACATGCTAT-1_V12D07-332_A1,2,1,1,0,0,4
CGGGCCTTCTTTGTAA-1_V12D07-332_A1,2,0,1,0,0,3
CGTGAAGTTAATTCAC-1_V12D07-332_A1,1,2,1,0,0,4
ATAGTGAAGCGTTCTC-1_V12D07-332_A1,0,1,0,0,0,1
TACGCCATATTCTAAT-1_V12D07-332_A1,3,1,3,0,0,7
GCCGGGTTAGGGTCGC-1_V12D07-332_A1,3,0,3,0,0,6
TACATAGGCATACACC-1_V12D07-332_A1,8,1,0,0,0,9
GCCGATTGGCCAAGCT-1_V12D07-332_A1,2,2,0,0,0,4
CTGCCATGCATCACAT-1_V12D07-332_A1,0,0,1,0,0,1
TTATGAATGAAAGGGA-1_V12D07-332_A1,1,0,3,0,0,4
GCTGAGGCGTGAGTAT-1_V12D07-332_A1,0,0,2,0,0,2
GCGCCGTTCCACGATA-1_V12D07-332_A1,2,0,5,3,0,10
CGCATGGTGCGATGCT-1_V12D07-332_A1,0,0,0,4,0,4
AGGTTTCACACACCTT-1_V12D07-332_A1,2,1,0,0,0,3
CAAGGATCGCATGTTC-1_V12D07-332_A1,1,0,2,0,0,3
ACGTTAATGTCGAAGA-1_V12D07-332_A1,6,0,1,0,0,7
TCCAGAGCACCGGTTC-1_V12D07-332_A1,0,0,2,0,0,2
GATTCGACGGTTCACG-1_V12D07-332_A1,4,1,1,0,0,6
GTTTCTGCAGTCTCCC-1_V12D07-332_A1,2,0,1,0,0,3
GCTGCACGGTTTCTTA-1_V12D07-332_A1,3,1,3,0,0,7
CGTGCAGACTGGGACA-1_V12D07-332_A1,7,0,0,0,0,7
GTGTTACTATGCGTCC-1_V12D07-332_A1,2,0,0,1,0,3
TCCTCGGGCTGGGCTT-1_V12D07-332_A1,2,0,1,0,0,3
GTGAGGACACTTAAGG-1_V12D07-332_A1,2,1,2,0,0,5
ATACGCCGGCGAAACC-1_V12D07-332_A1,4,2,0,1,0,7
TCTGCCAGAAACTGCA-1_V12D07-332_A1,3,1,2,0,0,6
TTCTGCGGGTTAGCGG-1_V12D07-332_A1,2,0,0,0,0,2
CTCGGTACCACTGCTC-1_V12D07-332_A1,2,1,1,0,0,4
GTAAGTAACAGTCTGG-1_V12D07-332_A1,4,0,0,0,0,4
GTGCGTGTATATGAGC-1_V12D07-332_A1,3,0,0,0,0,3
ATTTGTCTTGGGAGCT-1_V12D07-332_A1,6,0,1,0,0,7
CCTCGGACCGGGATAG-1_V12D07-332_A1,0,1,1,0,0,2
TAGGTGCTCGCCTAGC-1_V12D07-332_A1,2,1,2,0,0,5
CTTTAGGAACACTGTT-1_V12D07-332_A1,2,0,0,0,0,2
TCGGGCCGTCGTGGTA-1_V12D07-332_A1,1,1,2,0,0,4
AGTGCTTGCACGAATA-1_V12D07-332_A1,1,0,0,0,0,1
TGCAGTTTCCTCCCAT-1_V12D07-332_A1,3,0,1,0,0,4
TGAGAGATTTACCACG-1_V12D07-332_A1,3,0,1,0,0,4
GAAACAGATGACCACC-1_V12D07-332_A1,4,0,1,0,0,5
AGCAACATATCTTATT-1_V12D07-332_A1,3,1,3,0,0,7
CAAGTGTGGTTGCAAA-1_V12D07-332_A1,3,0,2,0,0,5
GCCTCATCTGGAAATA-1_V12D07-332_A1,0,0,3,2,0,5
AACCCTACTGTCAATA-1_V12D07-332_A1,6,0,2,0,0,8
ACGTATTACTCCGATC-1_V12D07-332_A1,0,1,0,0,0,1
TCTGGGAACCTTTGAA-1_V12D07-332_A1,2,1,1,0,0,4
GCTCGCTCATGTCCAA-1_V12D07-332_A1,3,2,0,0,0,5
GCGCAAGAGCGCGCTG-1_V12D07-332_A1,1,0,0,0,0,1
TTGACGCTCCATGAGC-1_V12D07-332_A1,3,0,1,0,0,4
TATAGATGGTCGCAGT-1_V12D07-332_A1,0,0,0,1,0,1
TTACATGCCACAACTA-1_V12D07-332_A1,4,0,0,0,0,4
ACATGGCGCCAAAGTA-1_V12D07-332_A1,2,0,1,0,0,3
TATGGTTAGTGGGAGA-1_V12D07-332_A1,2,0,1,0,0,3
CATGACTTCGCTGAAT-1_V12D07-332_A1,2,0,2,1,0,5
ACCACCAATGTAACAA-1_V12D07-332_A1,3,0,0,0,0,3
TCTTAGAGCTCCAATT-1_V12D07-332_A1,0,1,2,0,0,3
CCACGAATTTAACCTC-1_V12D07-332_A1,5,0,2,1,0,8
TTCTTGCTAGCATCTC-1_V12D07-332_A1,1,2,0,0,0,3
ACACCTTACTACTTGC-1_V12D07-332_A1,3,0,0,1,0,4
AGTCGGTTGCGTGAGA-1_V12D07-332_A1,3,0,0,0,0,3
ACCTACAGTATGTGGT-1_V12D07-332_A1,1,0,2,0,0,3
GAGGATAAACAGTGCT-1_V12D07-332_A1,0,2,1,0,0,3
TTCCGGTATCTGTGTC-1_V12D07-332_A1,1,0,0,0,0,1
GGAGGCCGAAGTCGTC-1_V12D07-332_A1,2,1,1,0,0,4
TTCGCTAGGAAGTTGT-1_V12D07-332_A1,3,1,0,0,0,4
TAAAGACAACCCTTTA-1_V12D07-332_A1,0,1,0,0,0,1
GTTGCGCTAACATTAC-1_V12D07-332_A1,4,1,1,0,0,6
GCTGAACTCTCCAGGG-1_V12D07-332_A1,2,0,1,0,0,3
AGCCCTGTCGCACCGT-1_V12D07-332_A1,1,0,0,0,0,1
AGCGCTAGAGCGATGT-1_V12D07-332_A1,4,2,2,0,0,8
TGCGCCGTTAATAACG-1_V12D07-332_A1,0,0,1,0,0,1
TGACAACGCATGTCGC-1_V12D07-332_A1,0,0,0,0,0,0
CGTCTTGAGTGTGACG-1_V12D07-332_A1,2,1,0,0,0,3
GATAGGATTAATTACA-1_V12D07-332_A1,2,0,1,1,0,4
GATACCGTGTCGGAGT-1_V12D07-332_A1,2,1,0,0,0,3
TGTGTCGAAGTCGAGG-1_V12D07-332_A1,1,0,1,0,0,2
GGATCAGAGCCATCAG-1_V12D07-332_A1,5,0,1,0,0,6
GTCCCAATCATCCCGC-1_V12D07-332_A1,2,0,2,0,0,4
TGCCACACTAGAGGAA-1_V12D07-332_A1,8,1,1,0,0,10
TGAATTTCACTTGCCT-1_V12D07-332_A1,1,2,2,0,0,5
CTCAGATTGTGATAAG-1_V12D07-332_A1,2,0,0,0,0,2
CGGACGTTACTTGAAG-1_V12D07-332_A1,3,0,2,0,0,5
CCGCCTTGCGATGTCG-1_V12D07-332_A1,4,0,0,0,0,4
CCAGTCAAATCTCTTA-1_V12D07-332_A1,5,1,1,0,0,7
AAACAGCTTTCAGAAG-1_V12D07-332_A1,2,0,0,0,0,2
TAGCTGATGTGAAGCG-1_V12D07-332_A1,4,0,1,0,0,5
CTTATGCGCTCAGGGC-1_V12D07-332_A1,8,0,0,0,0,8
TGGCTCTTGTCGCGTA-1_V12D07-332_A1,1,2,3,0,0,6
TTGTGAGGCATGACGC-1_V12D07-332_A1,2,0,2,0,0,4
CATAAGCTCTCCGTCT-1_V12D07-332_A1,3,0,1,0,0,4
CCTTCTCAGCGTTCCT-1_V12D07-332_A1,3,0,0,0,0,3
TGCAGCTACGTACTTC-1_V12D07-332_A1,6,0,0,0,0,6
CTCTACACTGGCGATT-1_V12D07-332_A1,2,2,1,0,0,5
TGCAGATCGTCCTAGG-1_V12D07-332_A1,2,0,1,0,0,3
TGCCAAAGTCAGACTT-1_V12D07-332_A1,0,0,0,0,0,0
ACAATAGTCGTACGTT-1_V12D07-332_A1,3,1,0,0,0,4
CATGCCAACTCGCAAA-1_V12D07-332_A1,3,0,3,0,0,6
TGCAGAACTATATCGT-1_V12D07-332_A1,1,1,0,0,0,2
TCGTGTCACGCTGACA-1_V12D07-332_A1,2,0,0,0,0,2
TGATCAGGGAACTGCT-1_V12D07-332_A1,1,1,0,0,0,2
CTTGCAACCGCCTCCT-1_V12D07-332_A1,4,1,0,0,0,5
AGCCCATACATGTAAG-1_V12D07-332_A1,3,1,2,0,0,6
ATCCAATGGAGGGTCC-1_V12D07-332_A1,0,1,0,0,0,1
AAACCGGGTAGGTACC-1_V12D07-332_A1,5,1,1,0,0,7
GCAACCACGGCCGCGT-1_V12D07-332_A1,4,0,1,0,0,5
CGCTTATTCCCGGTCG-1_V12D07-332_A1,0,5,1,0,0,6
TTACTCTGGTACGTAC-1_V12D07-332_A1,1,0,1,0,0,2
GTGGTTTCCGCCTTTC-1_V12D07-332_A1,2,1,1,0,0,4
ATAGGCGGCTATAGAA-1_V12D07-332_A1,3,1,0,0,0,4
GTGCCATCACACGGTG-1_V12D07-332_A1,7,0,0,0,0,7
CCCAACATACGTCGCG-1_V12D07-332_A1,1,1,2,0,0,4
CGGTGCAGATAGAACG-1_V12D07-332_A1,1,0,0,0,0,1
GGGCGGGTTCCCTACG-1_V12D07-332_A1,4,3,1,0,0,8
TGAGCCATACAGTCTC-1_V12D07-332_A1,0,2,1,0,0,3
CTCCGCCCACATGAGG-1_V12D07-332_A1,2,1,0,0,0,3
GTTGAACCGGTTCCAT-1_V12D07-332_A1,2,0,1,0,0,3
TTGACTACCATATGGT-1_V12D07-332_A1,2,1,1,0,0,4
ACCATCGTATATGGTA-1_V12D07-332_A1,1,1,0,0,0,2
TGCGTAAGAACCTGAT-1_V12D07-332_A1,2,1,1,0,0,4
AGAAGGTTGCCGAATT-1_V12D07-332_A1,5,0,1,0,0,6
AGGACGACCCATTAGA-1_V12D07-332_A1,3,0,2,0,0,5
GGTGCTGGTACACATT-1_V12D07-332_A1,3,1,2,0,0,6
GCGCTATGCCGAGGCA-1_V12D07-332_A1,3,0,0,0,0,3
ACCCGGTTACACTTCC-1_V12D07-332_A1,3,0,0,0,0,3
TAACTCATCCGCGCGG-1_V12D07-332_A1,3,0,0,0,0,3
CACAATGAGCTGCTAT-1_V12D07-332_A1,4,0,1,0,0,5
GTTACTTTGGGCCTAG-1_V12D07-332_A1,1,0,0,0,0,1
GGGCCCGTCTTAAACA-1_V12D07-332_A1,1,1,1,0,0,3
GAAATTGTCTCTATAA-1_V12D07-332_A1,2,1,0,0,0,3
GGCGCATGAATTGATG-1_V12D07-332_A1,1,0,0,0,0,1
CATATAGGTACAGTCA-1_V12D07-332_A1,7,1,0,0,0,8
TCAACGAGGAGACAAA-1_V12D07-332_A1,0,1,0,0,0,1
TTGCACAATTCAGAAA-1_V12D07-332_A1,1,0,0,0,0,1
CATCGGACGGGTTAAT-1_V12D07-332_A1,0,1,1,1,0,3
ATTAAACATGCGGACC-1_V12D07-332_A1,4,1,0,0,0,5
TATCTACCACAGCGGG-1_V12D07-332_A1,1,2,1,0,0,4
CGAGACCCTAGAGTGT-1_V12D07-332_A1,6,0,0,0,0,6
ACATCGATCGTTTACC-1_V12D07-332_A1,3,2,0,0,0,5
ATCGACCCAATACAGA-1_V12D07-332_A1,2,0,0,0,0,2
GAATCTGAACATTCTC-1_V12D07-332_A1,6,1,0,0,0,7
AGTTCCTATTTATGTT-1_V12D07-332_A1,1,1,1,0,0,3
CAGTCTGTATACTGGG-1_V12D07-332_A1,6,0,0,0,0,6
GGAGACGACACCTTTG-1_V12D07-332_A1,2,2,1,0,0,5
CCTAAATTAACGGTTC-1_V12D07-332_A1,1,1,5,0,0,7
GCTACGACTTATTGGG-1_V12D07-332_A1,3,1,0,0,0,4
CTGTGCAGGGTAGGTC-1_V12D07-332_A1,4,3,1,0,0,8
ACGCCGCTAGACGACC-1_V12D07-332_A1,2,1,0,0,0,3
ACTTGACTCCCTCTTT-1_V12D07-332_A1,3,0,3,0,0,6
CGCCTCCCTCCTCTAT-1_V12D07-332_A1,2,0,1,0,0,3
CTAGATTTACGACGGC-1_V12D07-332_A1,3,0,0,1,0,4
GATGCTGTATTTCATC-1_V12D07-332_A1,3,0,1,0,0,4
TGCGTTTGTTGACACT-1_V12D07-332_A1,2,0,2,0,0,4
CGTGCCCTCCCGAAGA-1_V12D07-332_A1,2,3,0,0,0,5
ACTCTCTGACTTAGGT-1_V12D07-332_A1,2,0,0,0,0,2
CTGGGTAGGCAGTTAA-1_V12D07-332_A1,1,0,2,0,0,3
GTTTGGCCCAAGTTAT-1_V12D07-332_A1,4,0,0,0,0,4
GAATGTGGTCCGGATT-1_V12D07-332_A1,2,2,1,0,0,5
CCCAGTTAAGGCGCCG-1_V12D07-332_A1,2,0,1,0,0,3
CGGTACTAGAATCAAA-1_V12D07-332_A1,0,0,0,0,0,0
GCTTAATGTAACTAAC-1_V12D07-332_A1,3,0,0,0,0,3
AGGACAGTCGAATCCC-1_V12D07-332_A1,3,0,1,0,0,4
GACAGCCAGACCTGAC-1_V12D07-332_A1,4,1,0,0,0,5
GGCGAAATCTAACTTG-1_V12D07-332_A1,3,3,1,0,0,7
CTGGTAACACATAGAA-1_V12D07-332_A1,6,1,1,0,0,8
TAGCCATTTCAAAGTC-1_V12D07-332_A1,2,0,2,0,0,4
GGGATTTACCGCACCT-1_V12D07-332_A1,6,0,1,0,0,7
ATGCCATTTGCGACCA-1_V12D07-332_A1,2,1,1,1,0,5
GAATAGACGCGACCCA-1_V12D07-332_A1,1,2,0,0,0,3
TGTATGGCGCAGACAG-1_V12D07-332_A1,5,0,1,0,0,6
GGATGAAGATCGCTGA-1_V12D07-332_A1,1,1,1,0,0,3
CGACAATTTGATCTAA-1_V12D07-332_A1,6,0,0,0,0,6
AAAGTTGACTCCCGTA-1_V12D07-332_A1,0,1,0,1,0,2
CGCGGCTCAACTTGAA-1_V12D07-332_A1,6,0,1,0,0,7
CACGCGGAACTGTTGC-1_V12D07-332_A1,0,0,0,0,0,0
TCTTAGAGTGAACTCT-1_V12D07-332_A1,1,1,0,0,0,2
AGTCCATTGGCTGATG-1_V12D07-332_A1,3,0,3,1,0,7
TTAAGATAGGATTGAC-1_V12D07-332_A1,4,1,2,0,0,7
ACATCCTGGTAACTGT-1_V12D07-332_A1,3,0,1,0,0,4
CACCTTGGCGCCTTTG-1_V12D07-332_A1,3,0,0,0,0,3
GCTAGACCGTCTACTG-1_V12D07-332_A1,1,0,1,0,0,2
CGGCCCAGGTATATCC-1_V12D07-332_A1,3,0,0,2,0,5
GTCCATTACTGCTACG-1_V12D07-332_A1,3,1,1,0,0,5
GGGTTTAGGATAGGAT-1_V12D07-332_A1,2,1,1,0,0,4
TAATTAGGACATCCGT-1_V12D07-332_A1,2,0,1,0,0,3
GCTCCCAGTCGGTCCA-1_V12D07-332_A1,4,0,3,0,0,7
ATTCGTGCTATCTCTT-1_V12D07-332_A1,1,0,0,0,0,1
GTTAACTATGTTGTCA-1_V12D07-332_A1,0,1,1,0,0,2
GCTCCGCTCGCTTCAG-1_V12D07-332_A1,2,0,1,0,0,3
GCAACGGCTAGTTATG-1_V12D07-332_A1,1,0,0,0,0,1
AATCGCGCAGAGGACT-1_V12D07-332_A1,1,2,0,0,0,3
AGGTTACACCATGCCG-1_V12D07-332_A1,2,1,0,0,0,3
CGAGATTTCGCTCGGG-1_V12D07-332_A1,2,0,0,0,0,2
CGATAATACTCAGGTT-1_V12D07-332_A1,5,0,0,0,0,5
AAGGCAGGCTGTCTCC-1_V12D07-332_A1,1,0,1,0,0,2
GTAAGTCCACACTCTA-1_V12D07-332_A1,0,0,0,1,0,1
ATGAGGGCAGCGGCTA-1_V12D07-332_A1,2,1,0,0,0,3
GCCGCACTCCGTTTCA-1_V12D07-332_A1,2,1,1,1,0,5
GAGCACGGCGCCTCTT-1_V12D07-332_A1,3,0,2,0,0,5
ACAATTTGGCCATATT-1_V12D07-332_A1,3,1,0,0,0,4
CTGGTTCGCGAGCTAC-1_V12D07-332_A1,1,2,0,0,0,3
GACGGTCCTAGGGTGT-1_V12D07-332_A1,1,1,0,0,0,2
ACTCGCGATCTGACGC-1_V12D07-332_A1,1,0,0,0,0,1
GTGTACGAACCGTTCC-1_V12D07-332_A1,2,0,0,0,0,2
CTTTGACGTCGCTTCT-1_V12D07-332_A1,5,2,0,0,0,7
CGTTATCATACTTCCA-1_V12D07-332_A1,1,0,1,0,0,2
GCTATGCCAGCTTATG-1_V12D07-332_A1,4,0,0,0,0,4
CAGTCGGCCTAGATAT-1_V12D07-332_A1,5,0,1,0,0,6
CCCGTGAGGGCGGTGA-1_V12D07-332_A1,4,0,0,0,0,4
TCTCGTGTTACGAGGA-1_V12D07-332_A1,1,0,1,0,0,2
ACGTCTCGTTCCGGGA-1_V12D07-332_A1,4,0,1,0,0,5
CGAGAGCGCGTAGATA-1_V12D07-332_A1,2,1,0,0,0,3
GACAGATTTCTGGCTC-1_V12D07-332_A1,4,0,0,0,0,4
GGGCCTAAATGGGCTA-1_V12D07-332_A1,5,0,0,0,0,5
ACTTGTAGTCCCTTCA-1_V12D07-332_A1,0,0,0,0,0,0
CCCGAAGTTTCGCGAA-1_V12D07-332_A1,5,0,0,0,0,5
ACCATCCGCCAACTAG-1_V12D07-332_A1,3,1,0,0,0,4
TGCGAATATGGGATTT-1_V12D07-332_A1,0,2,1,0,0,3
TACATCCCTATCCCTG-1_V12D07-332_A1,1,0,1,0,0,2
GTGGGAAGACTGAATC-1_V12D07-332_A1,3,0,1,0,0,4
TCAACATCGACCGAGA-1_V12D07-332_A1,2,0,0,0,0,2
CTATGTGAGTCACGGC-1_V12D07-332_A1,3,0,0,0,0,3
CCGAACACTGGGCCTC-1_V12D07-332_A1,3,0,0,0,0,3
AAACTTGCAAACGTAT-1_V12D07-332_A1,0,1,1,0,0,2
AGGGCGAGCAGCTGAT-1_V12D07-332_A1,6,1,0,0,0,7
AACACGAGACGCGGCC-1_V12D07-332_A1,2,3,0,0,0,5
TGACGAATATTTCCCT-1_V12D07-332_A1,3,1,2,0,0,6
TCGGAGAGTATCGGGA-1_V12D07-332_A1,0,0,3,0,0,3
CAAATCTCTCACAAGG-1_V12D07-332_A1,1,1,0,0,0,2
AGGCCCTAGAACGCCA-1_V12D07-332_A1,3,2,0,0,0,5
TAGAGATCATGCAACT-1_V12D07-332_A1,1,0,1,0,0,2
TTGTTTCCATACAACT-1_V12D07-332_A1,3,0,0,0,0,3
GAGAGGTGCATTCTGG-1_V12D07-332_A1,1,1,0,0,0,2
GTGGACCAACCCGATT-1_V12D07-332_A1,9,2,0,0,0,11
CTGGGCCTGCTATATC-1_V12D07-332_A1,3,0,0,0,0,3
CATAGTCCACAAGAAC-1_V12D07-332_A1,0,1,1,0,0,2
TTGACATGAACGTGGA-1_V12D07-332_A1,2,1,0,0,0,3
GGTTACCACCCTCGGG-1_V12D07-332_A1,0,2,0,0,0,2
TACCGGTCGTTTCCAT-1_V12D07-332_A1,0,0,1,0,0,1
CGAGTACTAAAGAGGA-1_V12D07-332_A1,2,0,1,0,0,3
GCAAGAATTCCTTGGC-1_V12D07-332_A1,5,2,0,0,0,7
TCGCCGAAGTTGCGTC-1_V12D07-332_A1,3,0,1,0,0,4
TTGAGAGTACTGCTAA-1_V12D07-332_A1,4,1,1,0,0,6
GCCACAATTTAAGGAC-1_V12D07-332_A1,4,1,0,0,0,5
ATATTCAGTTAAACCT-1_V12D07-332_A1,1,0,1,0,0,2
TGAGTGCCTCTTAAAT-1_V12D07-332_A1,1,0,0,0,0,1
ATCAGACGGCACGCCG-1_V12D07-332_A1,1,1,0,0,0,2
GTGCGAAATCGAACAC-1_V12D07-332_A1,3,1,0,0,0,4
GTGCCGCTTCAAAGGT-1_V12D07-332_A1,1,0,0,0,0,1
GATACGATGGGAGTCA-1_V12D07-332_A1,4,1,0,0,0,5
GACACTGAGTTCAGTG-1_V12D07-332_A1,5,1,1,0,0,7
ATCCTGCGTGGAATGG-1_V12D07-332_A1,0,1,3,0,0,4
ATCCTACCTAAGCTCT-1_V12D07-332_A1,3,1,2,0,0,6
AGTGATATGAGTAGTT-1_V12D07-332_A1,2,1,3,0,0,6
ATGATGCAATGGTACA-1_V12D07-332_A1,2,0,0,0,0,2
GAAACCGAATTACCTT-1_V12D07-332_A1,3,0,0,0,0,3
AGTGACCTACTTTACG-1_V12D07-332_A1,2,2,0,0,0,4
CAAATGTCCTTCCGTG-1_V12D07-332_A1,2,1,2,0,0,5
TTACTGGGATATTTCA-1_V12D07-332_A1,4,3,0,0,0,7
CTTGCCCAGGCTCTAC-1_V12D07-332_A1,3,0,1,0,0,4
AAATCGTGTACCACAA-1_V12D07-332_A1,1,2,3,0,0,6
GTGATCATAGATCTGC-1_V12D07-332_A1,1,1,0,0,0,2
TGGCAGATTACGATCA-1_V12D07-332_A1,0,2,0,0,0,2
TCACCCTCTTAAGATT-1_V12D07-332_A1,3,1,0,0,0,4
CAGGATATATCGTTGT-1_V12D07-332_A1,2,3,0,0,0,5
CCTGACCACCGATGGT-1_V12D07-332_A1,1,0,0,0,0,1
CTAAAGGGAAATAGGA-1_V12D07-332_A1,0,2,1,0,0,3
CCGCTATCAGCACCAG-1_V12D07-332_A1,7,0,2,0,0,9
CTTTAGTGCTATTATT-1_V12D07-332_A1,5,1,0,0,0,6
CGGGAATTTATGTAAA-1_V12D07-332_A1,1,0,3,0,0,4
TACGACTGCCTCTTAG-1_V12D07-332_A1,4,0,1,0,0,5
AAACTGCTGGCTCCAA-1_V12D07-332_A1,2,2,2,0,0,6
GTACGTTTGCCCGTCA-1_V12D07-332_A1,4,1,0,0,0,5
GGCAAGGCGAAATAGC-1_V12D07-332_A1,4,0,0,1,0,5
GATCTTGGAGGGCATA-1_V12D07-332_A1,1,1,1,0,0,3
AGCGTGGTATTCTACT-1_V12D07-332_A1,1,0,5,0,0,6
CTAAGGGAATGATTGG-1_V12D07-332_A1,3,1,1,0,0,5
CATGGTAAGTAGCGTT-1_V12D07-332_A1,1,1,1,0,0,3
CGTTGAGCGACCGTCG-1_V12D07-332_A1,3,0,0,0,0,3
TGCCCGTACCGTTAAA-1_V12D07-332_A1,0,0,1,0,0,1
ACAAGGGCAGGCTCTG-1_V12D07-332_A1,5,1,1,0,0,7
GAGATCTTCCATGACA-1_V12D07-332_A1,3,1,0,0,0,4
AATGACGTAGGATGTC-1_V12D07-332_A1,3,1,0,0,0,4
GTGGTGGCCAAGTGAA-1_V12D07-332_A1,5,1,1,0,0,7
TCCCGTGTGCAATTTG-1_V12D07-332_A1,6,0,0,1,0,7
ACATCGTATGCAATGG-1_V12D07-332_A1,3,1,0,0,0,4
GCGAAACTTAACTGGA-1_V12D07-332_A1,4,0,1,0,0,5
AATTGAACGCTCTGGT-1_V12D07-332_A1,3,1,0,0,0,4
ACAAATGGTAGTGTTT-1_V12D07-332_A1,1,1,1,0,0,3
ATGGTCGCGTGGTTTC-1_V12D07-332_A1,0,0,3,0,0,3
TGTTATTGTATGTGGC-1_V12D07-332_A1,3,0,1,0,0,4
TTCCGGTTACCCACTT-1_V12D07-332_A1,2,2,1,0,0,5
GAGTGTGCGGTACCCA-1_V12D07-332_A1,0,1,0,0,0,1
CAAGATATTATAACGT-1_V12D07-332_A1,3,1,1,0,0,5
ACACACCAGGACCAGT-1_V12D07-332_A1,4,0,1,0,0,5
ATGGGCCTCGGCCTCT-1_V12D07-332_A1,3,0,1,0,0,4
AAGGTGATAAACCAGC-1_V12D07-332_A1,3,2,0,0,0,5
TCTTACTTATGCCTCT-1_V12D07-332_A1,2,0,2,0,0,4
AAAGTGTGATTTATCT-1_V12D07-332_A1,0,1,3,0,0,4
TGCTCCACAGTTCTTA-1_V12D07-332_A1,7,0,0,0,0,7
CTGGCTGATTCATCCT-1_V12D07-332_A1,3,2,1,0,0,6
TAAGGCTGAATCCCTC-1_V12D07-332_A1,3,0,0,0,0,3
TCTAGTGATATCGTGG-1_V12D07-332_A1,3,0,0,0,0,3
TCGAAGAACCGAGCAC-1_V12D07-332_A1,3,1,1,1,0,6
GACAAACATATGCAGG-1_V12D07-332_A1,1,0,2,0,0,3
AAGTCAATTGTCGTCA-1_V12D07-332_A1,2,0,0,0,0,2
AGTGAACAAACTTCTC-1_V12D07-332_A1,3,2,0,0,0,5
CATGATGGAAGTTAGC-1_V12D07-332_A1,1,1,0,0,0,2
AAGTGCCTTGACTGTA-1_V12D07-332_A1,1,0,0,0,0,1
ATCGCCAGTCAACATT-1_V12D07-332_A1,6,1,1,0,0,8
ACCGCGGTGGAAGTCG-1_V12D07-332_A1,2,0,1,0,0,3
TCTTCTATAACCCGCC-1_V12D07-332_A1,6,0,2,0,0,8
CACATTTCTTGTCAGA-1_V12D07-332_A1,3,0,1,0,0,4
TAGCGTCCCTCGATTG-1_V12D07-332_A1,2,0,1,0,0,3
GTTCGGATCGGGAACA-1_V12D07-332_A1,3,1,0,1,0,5
CAAACTCGCGACGCCG-1_V12D07-332_A1,1,0,0,0,0,1
GTCTTGTAGCTATTCA-1_V12D07-332_A1,4,1,0,0,0,5
TCTCGACGTATCGCCG-1_V12D07-332_A1,2,4,0,0,0,6
TTGCCAAGCAGAACCC-1_V12D07-332_A1,6,0,0,0,0,6
AAACCCGAACGAAATC-1_V12D07-332_A1,1,0,1,0,0,2
TTGAGCAGCCCACGGT-1_V12D07-332_A1,0,0,1,0,0,1
CGCCTTTAGCATGCTC-1_V12D07-332_A1,3,0,2,1,0,6
TGTGGCTCCCACCAAC-1_V12D07-332_A1,1,1,0,0,0,2
CCGCCGTTGAGGATAA-1_V12D07-332_A1,3,1,1,0,0,5
CAATACGAGAGTCTGA-1_V12D07-332_A1,1,0,0,0,0,1
CATCTAGTGAAGGGAA-1_V12D07-332_A1,2,0,1,0,0,3
GGTGGAGGTTGATACG-1_V12D07-332_A1,1,0,1,0,0,2
CCGCACACGAACGTGT-1_V12D07-332_A1,1,0,2,0,0,3
AGAACCCAGCGTGACA-1_V12D07-332_A1,2,1,0,0,0,3
GCGCTCGATCACCTGT-1_V12D07-332_A1,4,0,3,0,0,7
ATCATGGACTACCGAC-1_V12D07-332_A1,0,1,0,0,0,1
TACGCCGCCTCAGAAG-1_V12D07-332_A1,2,1,0,0,0,3
CGACCTACTAGACAAT-1_V12D07-332_A1,2,0,0,0,0,2
GAGTCTTGTAAAGGAC-1_V12D07-332_A1,4,0,0,0,0,4
AATATCCTAGCAAACT-1_V12D07-332_A1,2,1,1,0,0,4
CCCTAGGCAACAAGAG-1_V12D07-332_A1,3,1,1,0,0,5
ACAAAGAAGGTAGGCC-1_V12D07-332_A1,1,0,0,0,0,1
CCCTGGCTGTTCCTTC-1_V12D07-332_A1,2,0,1,0,0,3
TCGCCGCACCGCGTGA-1_V12D07-332_A1,4,1,2,0,0,7
TATAGCGCACGTTATC-1_V12D07-332_A1,1,0,2,0,0,3
TTATCTGACATTAGGA-1_V12D07-332_A1,3,0,0,0,0,3
AGTGGTGTTACCCGTG-1_V12D07-332_A1,5,0,0,0,0,5
GCCAAGAATACTTCTG-1_V12D07-332_A1,4,0,1,0,0,5
CCGGCGTGAGACTCTG-1_V12D07-332_A1,1,1,1,0,0,3
TTCCCGGCGCCAATAG-1_V12D07-332_A1,6,0,0,0,0,6
AAACAGGGTCTATATT-1_V12D07-332_A1,3,0,0,0,0,3
ACAGTAATACAACTTG-1_V12D07-332_A1,3,0,0,0,0,3
CGAACGGCCGGACAAC-1_V12D07-332_A1,6,0,0,0,0,6
GCAACACACTAGAACT-1_V12D07-332_A1,4,0,0,0,0,4
ACTCCCATTCCTAAAG-1_V12D07-332_A1,4,0,1,0,0,5
ACCTGCGTGTCATGTT-1_V12D07-332_A1,5,1,0,0,0,6
TACTTTCCGCACGCCA-1_V12D07-332_A1,3,0,0,0,0,3
AGGTCAGGTGAGAGTG-1_V12D07-332_A1,5,0,0,0,0,5
TCCTCCTAAGACATTC-1_V12D07-332_A1,3,0,0,0,0,3
ATGTGAAAGCCTAATG-1_V12D07-332_A1,4,1,1,0,0,6
AGTCGGCTCAACTTTA-1_V12D07-332_A1,2,0,2,0,0,4
CGATCTGTTGGAGGAC-1_V12D07-332_A1,3,0,0,0,0,3
ACGGGAGTGTCGGCCC-1_V12D07-332_A1,3,1,0,0,0,4
TTAACTTCAGGTAGGA-1_V12D07-332_A1,2,1,0,0,0,3
CCACGGAGCCATAAGA-1_V12D07-332_A1,1,0,1,0,0,2
CTTCTATGTTGAAGTA-1_V12D07-332_A1,2,3,0,0,0,5
CACCGTTGCGCGATAT-1_V12D07-332_A1,6,1,2,0,0,9
TCTAGCAATCTCCGCC-1_V12D07-332_A1,3,0,1,0,0,4
AGTTTGGCCAGACCTA-1_V12D07-332_A1,0,0,1,0,0,1
TTGTAAGGACCTAAGT-1_V12D07-332_A1,2,1,1,0,0,4
AAATTTGCGGGTGTGG-1_V12D07-332_A1,1,3,0,0,0,4
AAGTTCGGCCAACAGG-1_V12D07-332_A1,2,1,2,0,0,5
CCGCTTACCTCACTCT-1_V12D07-332_A1,0,4,1,0,0,5
ATCACGTGCTAATTAA-1_V12D07-332_A1,1,2,0,0,0,3
GGTGAAGTACAGGGAT-1_V12D07-332_A1,4,2,0,0,0,6
GCTGTATTACTGGCCC-1_V12D07-332_A1,1,0,0,0,0,1
AACGGCCATCTCCGGT-1_V12D07-332_A1,5,2,0,0,0,7
TAAGTAACATCTTGAC-1_V12D07-332_A1,6,0,2,0,0,8
TTCTTGAGCCGCGCTA-1_V12D07-332_A1,1,1,2,0,0,4
AGTGCGTAGCTCGTAA-1_V12D07-332_A1,1,1,0,0,0,2
GGGATGGTCGTAACCG-1_V12D07-332_A1,1,1,0,0,0,2
GTCTGGGCGGTCGAGA-1_V12D07-332_A1,1,1,0,0,0,2
CGGAACGTAAACATAG-1_V12D07-332_A1,0,3,2,0,0,5
TGCGACACCCTAGTGC-1_V12D07-332_A1,1,3,0,0,0,4
CAAACGAGTATCGCAG-1_V12D07-332_A1,5,1,0,0,0,6
TCAGTAGGGACTATAA-1_V12D07-332_A1,2,1,0,0,0,3
GCGGTTCCCTATCATG-1_V12D07-332_A1,5,4,0,0,0,9
GTGACTTCAGTAGTGC-1_V12D07-332_A1,1,1,1,0,0,3
CGTCACGTCCATTGGT-1_V12D07-332_A1,2,2,1,0,0,5
ATAAGTTACCGCGACG-1_V12D07-332_A1,4,0,0,0,0,4
CTGAATCCGAGACCTC-1_V12D07-332_A1,4,1,1,0,0,6
TACGACGCTTGCTGCG-1_V12D07-332_A1,2,0,1,0,0,3
GAATTCACCCGGGTGT-1_V12D07-332_A1,3,1,0,0,0,4
GGGTGACACCTTAACT-1_V12D07-332_A1,3,1,0,0,0,4
TGAGTAAATTAGCGTA-1_V12D07-332_A1,1,0,0,0,0,1
GAGTCCGCTTACCGGA-1_V12D07-332_A1,3,0,1,0,0,4
GGCGCGTTCGAGTTTA-1_V12D07-332_A1,2,3,1,1,0,7
ATTCATATACTGTCCA-1_V12D07-332_A1,2,0,0,0,0,2
ATAAACGGACCCGTAA-1_V12D07-332_A1,1,0,0,0,0,1
GTCGTACCATCTCGGG-1_V12D07-332_A1,5,0,0,0,0,5
ATAATAGCTGTTGAAT-1_V12D07-332_A1,3,0,0,0,0,3
TTCCGCGTGAGGCGAT-1_V12D07-332_A1,2,1,1,0,0,4
TACCGGCTCACTGCCC-1_V12D07-332_A1,3,0,0,0,0,3
GTATCTTTCATAACCA-1_V12D07-332_A1,4,0,0,0,0,4
GTTACCTACAACTTGC-1_V12D07-332_A1,2,0,1,0,0,3
TGACTATAATCCTTTC-1_V12D07-332_A1,2,1,2,1,0,6
AAATACCTATAAGCAT-1_V12D07-332_A1,1,2,1,0,0,4
TTATTAGAGCGTGTTC-1_V12D07-332_A1,5,1,1,0,0,7
ATGTGGACATCTTGAT-1_V12D07-332_A1,1,0,2,0,0,3
GTACGCTTCATTGCAC-1_V12D07-332_A1,4,0,3,0,0,7
CACATATTAGCAGGAT-1_V12D07-332_A1,3,1,1,2,0,7
CAAGAGGGCGGAGTAC-1_V12D07-332_A1,1,0,3,0,0,4
TCGCAAAGATGCATTT-1_V12D07-332_A1,0,1,3,0,0,4
GTCGTTATTCGCTTAT-1_V12D07-332_A1,3,1,0,0,0,4
TCGTGTACTATGGATG-1_V12D07-332_A1,2,0,2,0,0,4
GCGGAGAGGGAGAACG-1_V12D07-332_A1,2,1,0,0,0,3
TCACAGGGAATCGCAA-1_V12D07-332_A1,3,0,0,0,0,3
GACTGCACCAGCCCAG-1_V12D07-332_A1,0,1,0,0,0,1
TCCGCTGTCATCCCGG-1_V12D07-332_A1,2,0,1,1,0,4
AGATACTCAAGATCGA-1_V12D07-332_A1,1,2,1,0,0,4
ACTGAATGGCGAAAGT-1_V12D07-332_A1,3,2,1,0,0,6
TCCTACATCCACGGCC-1_V12D07-332_A1,5,0,0,0,0,5
TTCAGCCCTGGTCCAC-1_V12D07-332_A1,4,0,1,0,0,5
TTAGAGTTTAGAAGGA-1_V12D07-332_A1,4,0,1,0,0,5
GGTTAGCTATATGTCT-1_V12D07-332_A1,1,0,1,0,0,2
CTGGTTTCGAGCAAGA-1_V12D07-332_A1,2,0,0,0,0,2
TGGGCCCATACTAATT-1_V12D07-332_A1,3,0,0,0,0,3
ACTTATTTATGTGCCA-1_V12D07-332_A1,1,1,0,0,0,2
TTAGTTATTCGTGGCA-1_V12D07-332_A1,2,0,1,0,0,3
AACCGCTAAGGGATGC-1_V12D07-332_A1,2,1,0,0,0,3
ATACGTCCACTCCTGT-1_V12D07-332_A1,4,0,0,0,0,4
CGACACGCTCCGACAG-1_V12D07-332_A1,4,1,0,0,0,5
TCTGAACTCGTACCCG-1_V12D07-332_A1,0,0,1,0,0,1
AGGATATAGGGATTTA-1_V12D07-332_A1,5,0,2,0,0,7
GTGATCACTAACGCCT-1_V12D07-332_A1,4,0,0,1,0,5
ACCGGGCCTTTGTTGA-1_V12D07-332_A1,4,0,0,0,0,4
TTGACAGGAGCTCCCG-1_V12D07-332_A1,1,1,0,0,0,2
CTCTTCTATTGACTGG-1_V12D07-332_A1,4,0,2,0,0,6
CGTGGCCGAATATCTA-1_V12D07-332_A1,1,2,1,0,0,4
GGTTTAGCCTTTCTTG-1_V12D07-332_A1,2,0,1,0,0,3
TCAAGGTTACTACACC-1_V12D07-332_A1,3,1,3,0,0,7
TTGACTATTGTCCGGC-1_V12D07-332_A1,3,1,1,0,0,5
CGGGAATATAGTATAC-1_V12D07-332_A1,3,0,2,0,0,5
GCAACAGCAGTATGCG-1_V12D07-332_A1,4,0,0,0,0,4
ATCAAACACTGTTCCA-1_V12D07-332_A1,2,0,1,0,0,3
TGGGCAATAGTTGGGT-1_V12D07-332_A1,2,0,1,0,0,3
TGAATGTCAGCCGGCC-1_V12D07-332_A1,2,1,1,0,0,4
CGGCTCTAAAGCTGCA-1_V12D07-332_A1,3,1,1,0,0,5
GGACACAAGTTTACAC-1_V12D07-332_A1,2,1,1,0,0,4
CCGAGAAGTCGCATAA-1_V12D07-332_A1,2,1,1,0,0,4
AACTACCCGTTTGTCA-1_V12D07-332_A1,3,0,0,0,0,3
GCACAAACGAGGCGTG-1_V12D07-332_A1,1,2,0,0,0,3
CACACAGCTTGCGCTC-1_V12D07-332_A1,1,0,0,1,0,2
GTGCTTACATCAGCGC-1_V12D07-332_A1,2,0,3,0,0,5
GCAAACGTCGCCAGGT-1_V12D07-332_A1,1,0,1,0,0,2
GAATAGCATTTAGGGT-1_V12D07-332_A1,2,0,2,0,0,4
TACTGTTTCTCTGGTA-1_V12D07-332_A1,3,1,0,0,0,4
TCCTATCATAGGTAAC-1_V12D07-332_A1,3,0,0,0,0,3
TTCGGTGGAGACGCCC-1_V12D07-332_A1,3,0,1,0,0,4
TGTTGCCGTCGTCCCA-1_V12D07-332_A1,2,1,1,0,0,4
CCAACTTGATAGATCC-1_V12D07-332_A1,2,0,0,0,0,2
CAAAGGTCATCTGAAA-1_V12D07-332_A1,3,0,1,1,0,5
CTAGCTTAATGGTCCC-1_V12D07-332_A1,5,0,0,0,0,5
AGGCCACATTGGTTAC-1_V12D07-332_A1,2,1,0,0,0,3
TTAGGATGGGAGGGTA-1_V12D07-332_A1,3,1,1,0,0,5
TATGACCTTGCGCTGG-1_V12D07-332_A1,3,0,0,0,0,3
ATATACATGTATGGTA-1_V12D07-332_A1,4,2,0,0,0,6
TGTGTGACCATGAATC-1_V12D07-332_A1,2,1,1,0,0,4
CCCACTCCACGGTATC-1_V12D07-332_A1,4,0,1,0,0,5
GGGCAGACGTCACTGC-1_V12D07-332_A1,2,1,1,0,0,4
TCAAAGAGCTATCTGT-1_V12D07-332_A1,3,0,0,0,0,3
AGATGCATCCTGTGTC-1_V12D07-332_A1,3,0,1,0,0,4
GTGAAGTCACGACTCG-1_V12D07-332_A1,5,2,1,0,0,8
TGATTCAGGTCCCGCG-1_V12D07-332_A1,3,2,0,0,0,5
CGCCACAGGTCGCGAT-1_V12D07-332_A1,5,1,2,0,0,8
TTGAATCGTTGTATAA-1_V12D07-332_A1,2,1,1,0,0,4
TGGCCAATTTGGTACT-1_V12D07-332_A1,0,1,0,0,0,1
CGACCCTTAACGCCGG-1_V12D07-332_A1,6,0,0,0,0,6
TCGGCGTACTGCACAA-1_V12D07-332_A1,1,1,0,0,0,2
GAGTAAGGCCACGGGA-1_V12D07-332_A1,3,1,1,0,0,5
ATCAGCTCGTCCACTA-1_V12D07-332_A1,3,2,0,0,0,5
AGGATCACGCGATCTG-1_V12D07-332_A1,2,0,0,0,0,2
AAATGGCCCGTGCCCT-1_V12D07-332_A1,2,1,0,0,0,3
CAGTACCAGTTTACGT-1_V12D07-332_A1,5,0,0,0,0,5
GGTCGTAAGCTCGCAC-1_V12D07-332_A1,4,0,3,0,0,7
CGTTCATGGTGCGCGT-1_V12D07-332_A1,2,0,0,0,0,2
GACTACAAAGCGGTGG-1_V12D07-332_A1,2,0,0,0,0,2
CAGCTGGCGTAACCGT-1_V12D07-332_A1,0,2,0,0,0,2
ACTCGTAACCCGTCCT-1_V12D07-332_A1,4,0,0,0,0,4
CATATGTCAGGCTACG-1_V12D07-332_A1,2,1,0,0,0,3
GCCCGACTTCTTCCCG-1_V12D07-332_A1,2,0,1,0,0,3
CTGGCATCCGAATGAG-1_V12D07-332_A1,0,1,0,0,0,1
AAGTGCGTTAGAATCT-1_V12D07-332_A1,0,2,1,0,0,3
AGAAGTGATTCGTGAT-1_V12D07-332_A1,1,0,0,0,0,1
TACCTTAAGATTTCCC-1_V12D07-332_A1,1,1,0,0,0,2
AATGACAGCAATGTCT-1_V12D07-332_A1,0,2,0,0,0,2
TCAACGCAGGAAATAA-1_V12D07-332_A1,2,3,0,0,0,5
TATTCCTCCGCCCACT-1_V12D07-332_A1,0,0,1,0,0,1
ATCAAACGAAGGTTTG-1_V12D07-332_A1,3,1,2,0,0,6
TTGATTAGCTGTTTCT-1_V12D07-332_A1,2,1,1,0,0,4
CTGCTGAGGCCACGAA-1_V12D07-332_A1,2,2,0,0,0,4
CCGTGTTAAATTCCAT-1_V12D07-332_A1,0,5,0,0,0,5
CACGTCGGCAACCTCT-1_V12D07-332_A1,2,3,1,0,0,6
GTATTCTGAGAAACGA-1_V12D07-332_A1,3,0,0,0,0,3
CGGTGCGCGTTGGTCC-1_V12D07-332_A1,0,1,0,0,0,1
GTGATTCGCCGCTCAA-1_V12D07-332_A1,3,0,0,0,0,3
GCCCGCGCGTAAACGG-1_V12D07-332_A1,1,2,1,1,0,5
AACGTACTGTGGGTAC-1_V12D07-332_A1,1,1,2,0,0,4
GAGTATGCCCGCCTTG-1_V12D07-332_A1,3,0,0,0,0,3
TGATTCTGTCGCCGGT-1_V12D07-332_A1,2,0,1,0,0,3
GGGCGGCAAATGAATT-1_V12D07-332_A1,2,2,0,0,0,4
TTCCAATCTGGCTATC-1_V12D07-332_A1,0,1,0,0,0,1
GGAACCGTGTAAATTG-1_V12D07-332_A1,2,1,1,0,0,4
TTGGTCACACTCGTAA-1_V12D07-332_A1,1,1,0,0,0,2
CGAACCCGCATGCGTC-1_V12D07-332_A1,0,1,0,0,0,1
GGGCGTCACCACGTAA-1_V12D07-332_A1,1,2,2,0,0,5
TACCAGAAGTAGGTTC-1_V12D07-332_A1,1,3,1,0,0,5
TTGGATATCGTCTACG-1_V12D07-332_A1,2,1,0,1,0,4
TAGATATGGACTGGAA-1_V12D07-332_A1,2,1,0,0,0,3
GCGACGATAGTTGTAC-1_V12D07-332_A1,2,1,1,0,0,4
CTGGATTTACACTTGA-1_V12D07-332_A1,0,2,1,0,0,3
GTTATATTATCTCCCT-1_V12D07-332_A1,0,0,3,0,0,3
TATTCCACTCAGCTCG-1_V12D07-332_A1,2,0,0,0,0,2
CTGTTACCCAATCTAG-1_V12D07-332_A1,2,5,1,0,0,8
ACGCGAAGTCAGACGA-1_V12D07-332_A1,4,0,0,0,0,4
GATAGGTAACGTTGAC-1_V12D07-332_A1,0,1,1,0,0,2
TGTTCGTATTGCGGTG-1_V12D07-332_A1,1,0,1,0,0,2
GGTCAGTGGGTCCCAC-1_V12D07-332_A1,4,0,0,0,0,4
AATTCTAGAGTTAGGC-1_V12D07-332_A1,4,1,0,0,0,5
GTTTACGTTCCATCTG-1_V12D07-332_A1,2,0,0,0,0,2
AGACCCACCGCTGATC-1_V12D07-332_A1,1,6,1,0,0,8
TCTAGCATGCCCAGAA-1_V12D07-332_A1,2,1,0,0,0,3
CCCGCAGCGCGAACTA-1_V12D07-332_A1,3,0,0,0,0,3
CTCTATTTGGCTGCAG-1_V12D07-332_A1,2,1,0,1,0,4
TTCTGCCGCGCCTAGA-1_V12D07-332_A1,2,0,1,0,0,3
ACTCCCTAGAATAGTA-1_V12D07-332_A1,3,0,1,1,0,5
CCGAACCTTCCCGGCC-1_V12D07-332_A1,4,0,0,0,0,4
TCAGACGCTATAGAAG-1_V12D07-332_A1,3,0,0,0,0,3
CAGGCGCCATGCTAGG-1_V12D07-332_A1,5,0,0,0,0,5
CACTCGAGCTGAACAA-1_V12D07-332_A1,3,0,0,0,0,3
ACAAGGAAATCCGCCC-1_V12D07-332_A1,6,0,0,0,0,6
ACCACGTGCAGCTATA-1_V12D07-332_A1,2,0,2,0,0,4
ACGGCGACGATGGGAA-1_V12D07-332_A1,0,0,0,0,0,0
TTACTAAAGGACTTTA-1_V12D07-332_A1,2,1,1,0,0,4
GGCTGAAATAGCAAAG-1_V12D07-332_A1,3,1,0,0,0,4
TTAGACGAGTCACCTC-1_V12D07-332_A1,2,1,2,0,0,5
GTAGTCGCGGGAATCA-1_V12D07-332_A1,3,4,1,0,0,8
GCAAACCCTACATTAT-1_V12D07-332_A1,2,2,1,1,0,6
GTTAAAGTAGGACTGG-1_V12D07-332_A1,0,2,1,0,0,3
ACCCTCCCTTGCTATT-1_V12D07-332_A1,3,0,0,0,0,3
CATGTCTCATTTATGG-1_V12D07-332_A1,2,0,3,1,0,6
AATAGAATCTGTTTCA-1_V12D07-332_A1,4,0,1,0,0,5
TCTCATGAGATAGGGT-1_V12D07-332_A1,3,0,0,0,0,3
ATGACTATGCGACATT-1_V12D07-332_A1,2,1,0,0,0,3
CCTAACCCAAACAAGT-1_V12D07-332_A1,1,0,2,0,0,3
AGTCAAGATGACACTT-1_V12D07-332_A1,3,0,2,0,0,5
CGGGAGCTTCAGTGTA-1_V12D07-332_A1,2,1,1,0,0,4
CCACAGTACCCATCCT-1_V12D07-332_A1,0,0,3,0,0,3
GAGCGCGCACGAGTAG-1_V12D07-332_A1,1,0,1,0,0,2
ACCAGTGCGGGAGACG-1_V12D07-332_A1,3,0,0,0,0,3
TCCTTACGACGGTCCG-1_V12D07-332_A1,2,1,1,0,0,4
TAGTCGATCACGGGTT-1_V12D07-332_A1,4,0,0,0,0,4
AGACGAAGTGCCGGTC-1_V12D07-332_A1,4,0,1,0,0,5
CGCTGGTGACTACCCT-1_V12D07-332_A1,5,1,1,0,0,7
AGGCATTGTCGTAGGG-1_V12D07-332_A1,3,2,2,0,0,7
TGGTAGAATATATGGG-1_V12D07-332_A1,3,0,0,0,0,3
TTCTTATCCGCTGGGT-1_V12D07-332_A1,2,0,1,0,0,3
AGTTTGGCACGGGTTG-1_V12D07-332_A1,3,0,2,0,0,5
GCATCGGCCGTGTAGG-1_V12D07-332_A1,2,2,0,0,0,4
ATGCGAGTCCCACCAC-1_V12D07-332_A1,4,1,0,0,0,5
TCGGCGAACCCAAACC-1_V12D07-332_A1,2,0,0,0,0,2
AGAGTAAACTTCACTA-1_V12D07-332_A1,0,0,3,0,0,3
AAGCCGAAGCGGTTTA-1_V12D07-332_A1,4,1,0,0,0,5
CCCGAGTTTCTCCGTA-1_V12D07-332_A1,4,0,2,0,0,6
AATATCGAATCAATGC-1_V12D07-332_A1,0,0,1,0,0,1
GCGCCTCCCACTCCGA-1_V12D07-332_A1,5,0,1,0,0,6
CGTTAAACTAGTTAGG-1_V12D07-332_A1,1,2,2,0,0,5
TGAGTTAAAGACATTC-1_V12D07-332_A1,4,0,5,0,0,9
AACAGGTAGTATGGAT-1_V12D07-332_A1,5,1,0,0,0,6
GAACGCGGGTCACACG-1_V12D07-332_A1,2,1,0,0,0,3
TGTTTGAGATCGTCAG-1_V12D07-332_A1,1,0,0,0,0,1
ATCTCGTGAGCGAAAC-1_V12D07-332_A1,2,1,0,0,0,3
CTGAGAAAGTTCGGCG-1_V12D07-332_A1,5,0,2,0,0,7
ATTACCACACTGCCTG-1_V12D07-332_A1,3,1,2,0,0,6
CTGCTGTCTAACGAGC-1_V12D07-332_A1,8,0,0,0,0,8
CGTGGAAGCCTCGTAC-1_V12D07-332_A1,0,1,1,0,0,2
GGACTCACAAATTAGG-1_V12D07-332_A1,3,0,0,0,0,3
CTTTGCTGTCATGGAT-1_V12D07-332_A1,1,1,3,0,0,5
GGTGTTGGGCGTCTTA-1_V12D07-332_A1,4,0,0,0,0,4
TACCATGTATTGATTT-1_V12D07-332_A1,5,0,0,0,0,5
GGTCTCCAAGTAGTGC-1_V12D07-332_A1,2,0,2,0,0,4
ATCCTTCTGAAAGAAC-1_V12D07-332_A1,4,0,1,0,0,5
CCGGAAGTTATCAGTC-1_V12D07-332_A1,3,0,1,0,0,4
TTAGAGGGATATACAG-1_V12D07-332_A1,2,2,1,0,0,5
TTGTACACCTCGAACA-1_V12D07-332_A1,1,0,0,1,0,2
GTGGGTACTGAGCGTA-1_V12D07-332_A1,3,0,2,2,0,7
CTTAAGCAGCGAGCCG-1_V12D07-332_A1,1,0,1,0,0,2
GCATTGACTTGCGGAA-1_V12D07-332_A1,2,0,0,0,0,2
CCATAACCTGTGCAGT-1_V12D07-332_A1,0,1,0,0,0,1
GGGCTACTATTTCGTG-1_V12D07-332_A1,3,1,1,0,0,5
GGCGAGCGAAACGGCA-1_V12D07-332_A1,3,0,0,0,0,3
GGAGACCATCTACATA-1_V12D07-332_A1,0,1,1,0,0,2
AGACCAAACCACACCT-1_V12D07-332_A1,0,2,1,7,0,10
CGACGCATCCGTACCT-1_V12D07-332_A1,3,0,0,0,0,3
CCTAGGTAAAGGTAGC-1_V12D07-332_A1,4,1,0,0,0,5
AGCGGCGGTTAGCGGT-1_V12D07-332_A1,3,0,0,0,0,3
CTGGACGCAGTCCGGC-1_V12D07-332_A1,7,1,2,0,0,10
AGCCTAATACCCACGT-1_V12D07-332_A1,1,2,0,0,0,3
AATCTGGCTTTCTAGT-1_V12D07-332_A1,0,1,1,0,0,2
CACCCTTGGTGAGACC-1_V12D07-332_A1,4,0,1,0,0,5
GGATCTTGACTCAACC-1_V12D07-332_A1,1,1,0,0,0,2
ACGAGGATACCACTCT-1_V12D07-332_A1,2,2,1,0,0,5
GAGTTGATGGCAATTT-1_V12D07-332_A1,4,0,2,0,0,6
GTGGCAAACAGCGGCA-1_V12D07-332_A1,4,0,0,0,0,4
GATGTAACGAACCACC-1_V12D07-332_A1,4,0,1,0,0,5
AGCCGTGGCTAAATGT-1_V12D07-332_A1,4,0,1,0,0,5
CTCCCTCCTTTCGATC-1_V12D07-332_A1,1,0,1,0,0,2
TTGGAAGAATACAGTC-1_V12D07-332_A1,3,2,0,0,0,5
AGTTAAGTCAACCGCT-1_V12D07-332_A1,0,4,1,0,0,5
CTCATGGTAATTTGCG-1_V12D07-332_A1,4,1,1,0,0,6
AAAGTAGCATTGCTCA-1_V12D07-332_A1,1,1,2,0,0,4
TTGTGGTAGGAGGGAT-1_V12D07-332_A1,6,5,0,0,0,11
AGTCGTGGGCATTACG-1_V12D07-332_A1,6,2,0,0,0,8
ACCTAAGTACCTTTCA-1_V12D07-332_A1,3,1,2,0,0,6
GTAGAGGGAGACAAGT-1_V12D07-332_A1,0,3,0,0,0,3
GATCCTCGACACTGGC-1_V12D07-332_A1,1,2,1,0,0,4
CCTACATTCACAGACG-1_V12D07-332_A1,3,0,0,0,0,3
TTGACCGTGTTAATGA-1_V12D07-332_A1,2,2,1,0,0,5
TCTGTTACCCAGCATA-1_V12D07-332_A1,3,3,0,0,0,6
CTAACTGGTCCGGTTC-1_V12D07-332_A1,1,0,1,0,0,2
AGCGACAGGAACGGTC-1_V12D07-332_A1,1,2,1,0,0,4
TAATAGAACAGAGTTA-1_V12D07-332_A1,3,3,0,0,0,6
ACAGGTGGAGGTGAGG-1_V12D07-332_A1,1,1,1,0,0,3
TGCGAGAATATTACCC-1_V12D07-332_A1,2,2,0,0,0,4
TTGCGTCGGCCAACCG-1_V12D07-332_A1,3,1,2,0,0,6
AGGCTTCCCGAAGAAG-1_V12D07-332_A1,3,4,1,0,0,8
GCGGACCGCGTTGTGG-1_V12D07-332_A1,2,1,1,0,0,4
GTAATCTGATTCTTCG-1_V12D07-332_A1,3,1,0,0,0,4
CCGCGGAATGCGTCAC-1_V12D07-332_A1,6,1,0,0,0,7
TTCCACACAGATTTGA-1_V12D07-332_A1,3,0,0,0,0,3
CTTCTATTAATGCTAG-1_V12D07-332_A1,3,0,0,0,0,3
CATTTGAGTGGTACGT-1_V12D07-332_A1,3,2,0,0,0,5
TCACAGCAAACTCGAA-1_V12D07-332_A1,0,2,0,0,0,2
CAGACGAACCTGATAC-1_V12D07-332_A1,5,0,0,0,0,5
TAGCTAGAAGGCATGA-1_V12D07-332_A1,1,1,0,0,0,2
ATCCAGAGCAACAACC-1_V12D07-332_A1,0,2,1,0,0,3
TCCGGTTCGTCCGGTC-1_V12D07-332_A1,1,3,0,0,0,4
CGCGCATGTTTGATTG-1_V12D07-332_A1,2,1,0,0,0,3
TGGCGATCAAGTTATG-1_V12D07-332_A1,2,1,0,0,0,3
CCCTTTGACAGGTCTT-1_V12D07-332_A1,2,0,0,0,0,2
CAGAGACGGTCACCCA-1_V12D07-332_A1,1,0,1,0,0,2
TAGCTCGCCTGATAAC-1_V12D07-332_A1,3,0,0,0,0,3
TTGTGTTTCCCGAAAG-1_V12D07-332_A1,2,1,1,0,0,4
TATACACAGACGCCTT-1_V12D07-332_A1,3,4,1,0,0,8
ACATTAGTTTATATCC-1_V12D07-332_A1,1,1,0,0,0,2
CCATCGCAGTTAAACT-1_V12D07-332_A1,2,0,0,1,0,3
AATTAGCGCTGCAGCG-1_V12D07-332_A1,1,2,0,0,0,3
TCCGCTTATCCCATTA-1_V12D07-332_A1,6,1,0,0,0,7
GTTTGGGCTTGTGAGC-1_V12D07-332_A1,3,0,1,0,0,4
CTTGTCAACATTCGAG-1_V12D07-332_A1,1,0,0,0,0,1
GGACCAACAGGATAAC-1_V12D07-332_A1,3,0,2,0,0,5
AAGCTAGATCGAGTAA-1_V12D07-332_A1,2,0,1,0,0,3
TACCGTGCCTCGGACC-1_V12D07-332_A1,4,1,1,0,0,6
GTAGCCAAACATGGGA-1_V12D07-332_A1,1,1,2,0,0,4
TGCCAGTACGTGGAGA-1_V12D07-332_A1,3,1,0,0,0,4
ATAAGGTGGAGAACAT-1_V12D07-332_A1,5,1,1,0,0,7
CTTTAATATTGGTCGA-1_V12D07-332_A1,0,3,0,0,0,3
TGGTTCAACGGGTAAT-1_V12D07-332_A1,1,1,1,0,0,3
GCTGCTACTGCGTAGC-1_V12D07-332_A1,2,0,0,0,0,2
CTGCACAACTACATAT-1_V12D07-332_A1,3,0,2,0,0,5
ATATTCCACATAGTGA-1_V12D07-332_A1,6,0,0,0,0,6
TGGCAAACTAAATTAC-1_V12D07-332_A1,0,1,0,0,0,1
ACCGCAATAACTGCCT-1_V12D07-332_A1,3,1,0,0,0,4
TCGCACCAGGAGGCAG-1_V12D07-332_A1,2,1,0,0,0,3
ACTTCAGGCTGATCCC-1_V12D07-332_A1,1,0,0,0,0,1
ACAAATCGCACCGAAT-1_V12D07-332_A1,3,2,3,0,0,8
TCTGATGTATTCTGTC-1_V12D07-332_A1,3,1,1,0,0,5
CTTTACCGAATAGTAG-1_V12D07-332_A1,1,0,0,0,0,1
GCAGATCCATAAGACT-1_V12D07-332_A1,1,2,2,0,0,5
TTCCTCGGACTAACCA-1_V12D07-332_A1,4,0,0,0,0,4
TTATCCGGGATCTATA-1_V12D07-332_A1,5,2,0,0,0,7
CTGGAAGACACGGTGG-1_V12D07-332_A1,2,2,1,0,0,5
GTTCGTCTAAAGAACT-1_V12D07-332_A1,4,1,0,0,0,5
GTCTATTGGTTCCGGT-1_V12D07-332_A1,4,0,1,0,0,5
CTAGGCGCCCTATCAG-1_V12D07-332_A1,3,0,0,0,0,3
AACGGACGTACGTATA-1_V12D07-332_A1,0,0,1,0,0,1
AACACACGCTCGCCGC-1_V12D07-332_A1,1,0,2,0,0,3
GCTACTATAGTAGAGT-1_V12D07-332_A1,2,1,0,0,0,3
AGCATATCAATATGCT-1_V12D07-332_A1,5,0,1,0,0,6
CGAACAGTATGGGCGT-1_V12D07-332_A1,3,0,0,0,0,3
ACAATTGTGTCTCTTT-1_V12D07-332_A1,3,0,0,0,0,3
GATCGCTACCCGATTT-1_V12D07-332_A1,3,0,1,0,0,4
ATTGCGATCAGTAACT-1_V12D07-332_A1,5,0,0,0,0,5
CAGCAGTCCAGACTAT-1_V12D07-332_A1,4,2,1,0,0,7
AGAGGCTTCGGAAACC-1_V12D07-332_A1,3,1,1,0,0,5
AAACAAGTATCTCCCA-1_V12D07-332_A1,6,1,0,1,0,8
GGCAGCAAACCTATGC-1_V12D07-332_A1,3,1,1,0,0,5
ACTAGTTGCGATCGTC-1_V12D07-332_A1,1,1,1,0,0,3
TTGGACCATCTGGCAA-1_V12D07-332_A1,1,1,1,0,0,3
CCCTCCTCGCTCGTAT-1_V12D07-332_A1,2,0,2,0,0,4
GAGCGCAAATACTCCG-1_V12D07-332_A1,2,0,0,0,0,2
ATTACATGTCAGTCTT-1_V12D07-332_A1,4,0,0,0,0,4
TTGGGACGTAAGAGTT-1_V12D07-332_A1,5,0,1,0,0,6
CTTCGGCCAATTGTTT-1_V12D07-332_A1,2,0,2,0,0,4
AGACCGCTCCGCGGTT-1_V12D07-332_A1,6,1,2,0,0,9
GACCGCGTCTGACGTG-1_V12D07-332_A1,1,0,2,0,0,3
CCAAATAACAAGATTC-1_V12D07-332_A1,5,1,1,0,0,7
TCTTTAGAGTCTAACA-1_V12D07-332_A1,2,1,0,0,0,3
CTCCCAATGAGTCGCG-1_V12D07-332_A1,2,0,1,0,0,3
TAGTCTTTCCGAATTG-1_V12D07-332_A1,5,0,1,0,0,6
GAGTAAACCGGAAAGT-1_V12D07-332_A1,1,0,3,0,0,4
GATCTCGACGCTGTGG-1_V12D07-332_A1,4,0,0,0,0,4
CTGACATAGAAATAGA-1_V12D07-332_A1,2,2,0,0,0,4
TATACCGAGTGCCACA-1_V12D07-332_A1,2,1,1,0,0,4
TCCGAACGTTGCCGCT-1_V12D07-332_A1,1,0,0,0,0,1
GCAGAAGGTAATCTCC-1_V12D07-332_A1,1,1,0,0,0,2
GGTACTAAGTGCTTTG-1_V12D07-332_A1,1,0,0,0,0,1
CAGAATATTCGTTATC-1_V12D07-332_A1,8,1,0,0,0,9
TAATCAACCAAATGGG-1_V12D07-332_A1,0,3,1,0,0,4
TCTGCTTAGAACAAGC-1_V12D07-332_A1,6,0,1,0,0,7
AACTGAGTTATACTGA-1_V12D07-332_A1,4,5,0,0,0,9
CCTCAACGATCGCTGT-1_V12D07-332_A1,1,0,1,0,0,2
CGGTACGGCAAACCCA-1_V12D07-332_A1,1,1,1,0,0,3
CAGATGTTTGTCCCAA-1_V12D07-332_A1,5,0,1,1,0,7
GTTTGTTAGCCAAGTA-1_V12D07-332_A1,0,1,0,0,0,1
ACGTGACAAAGTAAGT-1_V12D07-332_A1,1,1,1,0,0,3
TTGTCACCGCGGTATC-1_V12D07-332_A1,1,0,2,0,0,3
GATCTAACCGTATTCA-1_V12D07-332_A1,2,0,1,0,0,3
ATGGAAATTTAAGGAG-1_V12D07-332_A1,2,0,0,0,0,2
ATTGATCACCACATTT-1_V12D07-332_A1,1,0,0,0,0,1
ACTGCTCGGAAGGATG-1_V12D07-332_A1,0,0,0,0,0,0
TCTAAAGAACAGTCTC-1_V12D07-332_A1,0,0,0,0,0,0
CTGGGTTGAGTTAAAG-1_V12D07-332_A1,2,1,0,0,0,3
CCCAGTAAACTTGGGA-1_V12D07-332_A1,6,1,0,0,0,7
AGATTCACAACCGATA-1_V12D07-332_A1,1,1,0,0,0,2
AGAAGGTACACTTCAC-1_V12D07-332_A1,3,0,0,0,0,3
GCAGGAACTTAGATCT-1_V12D07-332_A1,2,0,0,0,0,2
AATCTAGGTTTACTTG-1_V12D07-332_A1,1,2,1,0,0,4
CCCGGTGTATCGGAAT-1_V12D07-332_A1,4,0,1,0,0,5
TTATCCTCAAGGAATA-1_V12D07-332_A1,6,0,2,0,0,8
AGCATCATTTCGAAAG-1_V12D07-332_A1,3,2,0,0,0,5
CGCGAGTCTGCCGGGT-1_V12D07-332_A1,2,0,1,0,0,3
TGCGTCATGACTGAGC-1_V12D07-332_A1,2,1,1,0,0,4
GTATGAAATTTCACTC-1_V12D07-332_A1,3,2,0,0,0,5
TTGGTTGCGGTGCGCG-1_V12D07-332_A1,3,0,1,0,0,4
ACAGAACTGAGAACAA-1_V12D07-332_A1,5,0,0,0,0,5
CTACTATCATAGGTTT-1_V12D07-332_A1,2,0,1,0,0,3
CCTCTATCGATTAGCA-1_V12D07-332_A1,4,3,0,0,0,7
CCGTATCTCGTCGTAG-1_V12D07-332_A1,2,0,2,0,0,4
TCACGATGTCCGTGGA-1_V12D07-332_A1,0,3,4,0,0,7
TCAACAAAGATAATTC-1_V12D07-332_A1,1,1,0,0,0,2
ATGACGCGTTCTATCC-1_V12D07-332_A1,1,0,1,0,0,2
ATTTGCGCGAGTAGCT-1_V12D07-332_A1,4,0,2,0,0,6
TTCTTGGACGATCTGC-1_V12D07-332_A1,1,0,1,0,0,2
AGACGACGATGCCGCT-1_V12D07-332_A1,7,0,0,0,0,7
GGTCTCTGAATGGACT-1_V12D07-332_A1,1,1,1,0,0,3
GCTCAATCCGTTTATT-1_V12D07-332_A1,2,2,0,0,0,4
CCAGAAAGCAACTCAT-1_V12D07-332_A1,1,1,0,0,0,2
CACCGTTAGGGATCAC-1_V12D07-332_A1,2,3,0,0,0,5
AATAACACTAGAACAA-1_V12D07-332_A1,4,0,2,0,0,6
CACCCGGTTTGTGACT-1_V12D07-332_A1,0,1,0,0,0,1
CCACCAACTTTACTGT-1_V12D07-332_A1,2,2,1,0,0,5
AACTCTCAGTGTGCTC-1_V12D07-332_A1,3,2,1,0,0,6
AAACCGTTCGTCCAGG-1_V12D07-332_A1,2,3,1,0,0,6
CAGCGATTCCCTTCAA-1_V12D07-332_A1,1,1,0,0,0,2
GCTAGCTTGAATAGCT-1_V12D07-332_A1,0,2,0,0,0,2
TTGCGGCATCAGAAAG-1_V12D07-332_A1,0,3,3,0,0,6
AATAGAACAGAGTGGC-1_V12D07-332_A1,0,3,1,0,0,4
GCCATCGAGCTGCGTG-1_V12D07-332_A1,3,2,1,0,0,6
ACACTGATCAAGGTGT-1_V12D07-332_A1,3,2,0,0,0,5
ACCAACGCTTATTTAT-1_V12D07-332_A1,3,0,0,0,0,3
GACATCGATTTATAAC-1_V12D07-332_A1,1,2,1,0,0,4
CAGACACCGATCGCTG-1_V12D07-332_A1,1,1,0,0,0,2
CCAAGAAAGTGGGCGA-1_V12D07-332_A1,2,2,0,0,0,4
GGTAGACCGTTGGGCG-1_V12D07-332_A1,0,0,1,1,0,2
TCGTTAGGAGTCCCTA-1_V12D07-332_A1,0,5,0,0,0,5
ACGGCCAACATGGACT-1_V12D07-332_A1,5,5,1,0,0,11
GTGAGTGGTACAACGC-1_V12D07-332_A1,2,1,1,0,0,4
GAGACTTCGCGACCGA-1_V12D07-332_A1,3,2,0,0,0,5
GAAGTCAGTTGCACTA-1_V12D07-332_A1,3,1,1,0,0,5
GTTTGGTAGGGTCAAC-1_V12D07-332_A1,3,0,0,0,0,3
ACGGCACTTGCTTGGG-1_V12D07-332_A1,2,0,0,0,0,2
CCTCTGTACTATTCTA-1_V12D07-332_A1,0,0,0,0,0,0
CTATTCATGTGTCCCA-1_V12D07-332_A1,8,1,0,0,0,9
GCCCGATCTGTGGTCG-1_V12D07-332_A1,4,0,2,1,0,7
TTAGAAGAACATGACT-1_V12D07-332_A1,1,1,0,0,0,2
AGGATAAAGTCGGGAT-1_V12D07-332_A1,3,1,1,0,0,5
CGGCAAACATCGTGCG-1_V12D07-332_A1,2,1,1,0,0,4
CTAGTTACAACCCGGT-1_V12D07-332_A1,0,0,0,0,0,0
TTCGACAGAGCCCGTG-1_V12D07-332_A1,1,2,0,0,0,3
AAGCATACTCTCCTGA-1_V12D07-332_A1,4,1,0,0,0,5
GACGACGATCCGCGTT-1_V12D07-332_A1,4,0,1,0,0,5
GGTAGAAGACCGCCTG-1_V12D07-332_A1,0,1,1,0,0,2
GAGATGGGAGTCGACA-1_V12D07-332_A1,2,3,0,0,0,5
AACGATAATGCCGTAG-1_V12D07-332_A1,0,1,1,1,0,3
TGGTCCCACGCTACGG-1_V12D07-332_A1,2,1,1,0,0,4
CTGCTTGGCGATAGCT-1_V12D07-332_A1,3,0,2,0,0,5
ATCGGAGACAGACGGC-1_V12D07-332_A1,1,1,1,0,0,3
TAGCGTCCGGTGTGGT-1_V12D07-332_A1,4,2,0,0,0,6
GTTGAGTCCCGCCGGT-1_V12D07-332_A1,3,0,2,1,0,6
AAATAGGGTGCTATTG-1_V12D07-332_A1,0,2,0,0,0,2
AAGTGTTTGGAGACGG-1_V12D07-332_A1,3,1,1,0,0,5
AGCACTACCTCACCAG-1_V12D07-332_A1,4,0,1,0,0,5
TGCCTTGGCCAGGCAA-1_V12D07-332_A1,3,0,0,0,0,3
TCGTCTTAGGCGTTAA-1_V12D07-332_A1,4,1,0,0,0,5
TTCTGACCGGGCTCAA-1_V12D07-332_A1,4,0,2,0,0,6
CAGAACTTAGCCCTCT-1_V12D07-332_A1,2,1,0,0,0,3
AGCTCCTTCGCACATC-1_V12D07-332_A1,4,0,2,0,0,6
ACAGGCTTGCCCGACT-1_V12D07-332_A1,4,2,0,0,0,6
GCTATACGTCTCGGAC-1_V12D07-332_A1,2,0,0,0,0,2
GAGCCAGCTACCTGTG-1_V12D07-332_A1,3,2,2,0,0,7
TGCTAAGTGTCTATTT-1_V12D07-332_A1,1,1,0,0,0,2
GTCCTACGAATAGTCT-1_V12D07-332_A1,3,0,2,0,0,5
CAGTGTCGGCTGGCCC-1_V12D07-332_A1,4,0,1,0,0,5
CTATCGACGAAATACA-1_V12D07-332_A1,4,0,2,0,0,6
CATCATTACCCTGAGG-1_V12D07-332_A1,1,1,1,0,0,3
TAAGTTGCGACGTAGG-1_V12D07-332_A1,2,1,1,0,0,4
AGTGCACGCTTAAGAA-1_V12D07-332_A1,2,1,1,0,0,4
TGTGCCGGTGCCGGAA-1_V12D07-332_A1,4,2,0,0,0,6
AGGAGGCCTTCGCGCG-1_V12D07-332_A1,3,0,3,0,0,6
TCCGCGGCCCAATGAA-1_V12D07-332_A1,3,0,4,0,0,7
TCCGTTAAGCTAATAT-1_V12D07-332_A1,2,1,0,0,0,3
AAATCTAGCCCTGCTA-1_V12D07-332_A1,1,0,2,0,0,3
CGCAGGCGATCCAAAC-1_V12D07-332_A1,4,0,3,0,0,7
CCATATGGAAACTATA-1_V12D07-332_A1,2,0,2,0,0,4
CACCGTATCCCATCCG-1_V12D07-332_A1,6,1,0,0,0,7
GGTCAAGACTACTTCG-1_V12D07-332_A1,3,0,0,0,0,3
CCCGTTTCGCAGATGT-1_V12D07-332_A1,4,1,2,0,0,7
GTTATAATACGGTGAA-1_V12D07-332_A1,2,0,0,0,0,2
ACTTGTGGATGGAACG-1_V12D07-332_A1,0,3,1,0,0,4
GTTCGCTGAGACGTCT-1_V12D07-332_A1,1,0,2,0,0,3
GACACTGGAACCCGAT-1_V12D07-332_A1,8,0,1,0,0,9
CCCAGGTCTGAAGGCT-1_V12D07-332_A1,5,1,1,0,0,7
TCTCGAGGAGGTTCGC-1_V12D07-332_A1,3,0,0,0,0,3
ACTATCTGCCCGCGTA-1_V12D07-332_A1,6,0,0,0,0,6
CCTAAATTGTATCCTA-1_V12D07-332_A1,6,0,1,0,0,7
AGAAATTATGACTCGC-1_V12D07-332_A1,4,2,0,0,0,6
TCCAGCGCTATAAGCG-1_V12D07-332_A1,2,0,0,0,0,2
TCGTGTATTGGTCACG-1_V12D07-332_A1,3,1,1,0,0,5
CCACATACTGCACCCA-1_V12D07-332_A1,1,0,0,0,0,1
GTTGCGGACGGTCAGG-1_V12D07-332_A1,3,0,1,0,0,4
GTATTTAATGGCATAA-1_V12D07-332_A1,0,1,1,0,0,2
GTCGATAGGTGACTTT-1_V12D07-332_A1,2,2,0,0,0,4
AATAATCTTCGTATCG-1_V12D07-332_A1,5,1,1,0,0,7
ATTGTTCAACGATCCG-1_V12D07-332_A1,4,2,1,0,0,7
GTGCAGCGTAGAGTAG-1_V12D07-332_A1,6,0,0,0,0,6
TGTGGTAGGGTGCCTT-1_V12D07-332_A1,2,1,0,0,0,3
TGTGGACTATCTACGT-1_V12D07-332_A1,4,1,2,1,0,8
GGCGGGCTCTAAGAGT-1_V12D07-332_A1,1,0,1,0,0,2
TGTGCCAGAGGCAAAG-1_V12D07-332_A1,1,1,0,0,0,2
TGGCTTATGTATAATG-1_V12D07-332_A1,0,1,0,0,0,1
GCAAGCTGGAAACCGC-1_V12D07-332_A1,4,2,1,0,0,7
GATATCAAGCAGGAGC-1_V12D07-332_A1,0,0,0,0,0,0
CACCAATCATCCGTCT-1_V12D07-332_A1,4,0,2,0,0,6
CCACATGGCTCTTTAT-1_V12D07-332_A1,2,4,0,0,0,6
GTCCTACTCTACGGGC-1_V12D07-332_A1,1,3,0,0,0,4
CTCGAGACATACGATA-1_V12D07-332_A1,0,4,2,0,0,6
TATCAGTGGCGTAGTC-1_V12D07-332_A1,2,1,0,0,0,3
TGACAGGACAAGTCCA-1_V12D07-332_A1,0,7,0,0,0,7
TATTAACACCAAAGCA-1_V12D07-332_A1,2,1,1,0,0,4
TAGGCGATGAGGTCTC-1_V12D07-332_A1,2,5,1,0,0,8
CCGCCGGAACTTCTCG-1_V12D07-332_A1,3,1,1,0,0,5
GCCATTAGCCTCAAAC-1_V12D07-332_A1,2,0,0,0,0,2
GTTAGGCTACCCGTTT-1_V12D07-332_A1,3,0,1,0,0,4
GGGTATTCTAGCAAAC-1_V12D07-332_A1,3,0,0,0,0,3
GCCCTAGCCGTCGCGA-1_V12D07-332_A1,3,0,0,0,0,3
CAGATCCTGGTTTGAA-1_V12D07-332_A1,4,0,0,0,0,4
CTTCAGTGGTCGCCTA-1_V12D07-332_A1,0,1,1,0,0,2
GGGCAACCGCACGTGC-1_V12D07-332_A1,1,1,1,0,0,3
GACCCAATTATGATAC-1_V12D07-332_A1,1,0,0,0,0,1
GAAGCTCGGACCCGTC-1_V12D07-332_A1,1,0,1,0,0,2
CGTCGGGTCTAAGCGC-1_V12D07-332_A1,2,0,0,0,0,2
GAGGCCCGACTCCGCA-1_V12D07-332_A1,1,2,1,0,0,4
TTGCCATAGCCCGCTC-1_V12D07-332_A1,2,0,1,0,0,3
TAACATACACGCGATC-1_V12D07-332_A1,5,0,1,0,0,6
CCGACGGGCATGAGGT-1_V12D07-332_A1,2,0,0,0,0,2
AATGTGCCCGAGGTGT-1_V12D07-332_A1,5,0,0,0,0,5
AGCTGTAACCTCAATC-1_V12D07-332_A1,0,2,0,0,0,2
CGAGTGAAGGTACCAG-1_V12D07-332_A1,1,1,1,0,0,3
AGTCTCACAAGACTAC-1_V12D07-332_A1,3,2,1,0,0,6
AAATTGATAGTCCTTT-1_V12D07-332_A1,0,5,0,0,0,5
TAAGTCGCCGAGTATC-1_V12D07-332_A1,0,0,3,0,0,3
GCGGAGAAACTTCGCA-1_V12D07-332_A1,0,0,0,0,0,0
GGCAAAGGCGCCAATA-1_V12D07-332_A1,3,1,0,0,0,4
ATTTCCGGGTTCTGCG-1_V12D07-332_A1,2,1,0,0,0,3
TAAACCCAGGAGGGCA-1_V12D07-332_A1,2,0,1,0,0,3
TTCGGGCGCTAGTCTT-1_V12D07-332_A1,2,3,2,0,0,7
GTGGAGTCGGCGGTTG-1_V12D07-332_A1,3,1,1,0,0,5
GCACGCCTACTTAGAT-1_V12D07-332_A1,2,2,1,0,0,5
CAATATTCTTGACCTA-1_V12D07-332_A1,2,0,0,0,0,2
CGTTTGTGTAGAGGGT-1_V12D07-332_A1,4,4,0,0,0,8
CATAGCGTTGCCCACC-1_V12D07-332_A1,3,0,1,0,0,4
TGATACATTTAGCCGT-1_V12D07-332_A1,2,1,0,0,0,3
TTCCGGCCTTGAGGCT-1_V12D07-332_A1,2,3,0,0,0,5
CCTATACCGTCCTGTC-1_V12D07-332_A1,2,7,0,0,0,9
TCGTTGCTATCCGGTC-1_V12D07-332_A1,1,1,0,1,0,3
TGGCGACTGCTCCAAA-1_V12D07-332_A1,0,1,1,0,0,2
CAGAGGCGATGCATGA-1_V12D07-332_A1,1,0,0,0,0,1
TCACAGGAGAATAAGA-1_V12D07-332_A1,1,0,0,0,0,1
GGGTTAACATTTGAGT-1_V12D07-332_A1,0,0,1,0,0,1
GCGGGCGAGCCTTACC-1_V12D07-332_A1,4,0,1,0,0,5
TGCCAATGGGTACTCT-1_V12D07-332_A1,2,3,1,0,0,6
AGGGACTCTACGCGAC-1_V12D07-332_A1,3,1,0,0,0,4
GACGCCGTAAAGGCTA-1_V12D07-332_A1,4,2,1,0,0,7
AAAGGCTCTCGCGCCG-1_V12D07-332_A1,4,1,1,0,0,6
CTGGCTGGTTGTCAGT-1_V12D07-332_A1,5,0,0,0,0,5
ACATCCCGGCCATACG-1_V12D07-332_A1,2,1,0,0,0,3
CTCTTGTCCCGCTTGG-1_V12D07-332_A1,3,2,0,0,0,5
TACGCCTCCATTCCGA-1_V12D07-332_A1,1,2,1,0,0,4
CGGAGCAATTTAATCG-1_V12D07-332_A1,2,0,2,0,0,4
AACTAGGCTTGGGTGT-1_V12D07-332_A1,3,3,0,0,0,6
GCGTCGCCAGGGTGAT-1_V12D07-332_A1,1,0,1,0,0,2
GTTGGTCATGCTATCC-1_V12D07-332_A1,3,1,1,0,0,5
GCTGGCGGCGCATGCT-1_V12D07-332_A1,2,0,1,0,0,3
TGAGCGGAAAGTGTTC-1_V12D07-332_A1,1,0,0,0,0,1
CTTTCTGTGCGGGCTT-1_V12D07-332_A1,1,0,2,1,0,4
ATCTAATATCCTACGG-1_V12D07-332_A1,3,3,0,0,0,6
AACCTTTAAATACGGT-1_V12D07-332_A1,2,3,0,0,0,5
TTCACTCGAGCACCTA-1_V12D07-332_A1,2,2,1,0,0,5
CTGCACTCCAGTACAG-1_V12D07-332_A1,5,0,2,0,0,7
CCATTTCTACCTATTA-1_V12D07-332_A1,2,2,4,0,0,8
CAAGCGGCACATAATT-1_V12D07-332_A1,2,0,1,0,0,3
GTTAACATCACTTAAA-1_V12D07-332_A1,2,0,1,0,0,3
ATATAAATGTAGCTGC-1_V12D07-332_A1,6,1,0,0,0,7
GCCTCTATACATAGCA-1_V12D07-332_A1,1,2,0,0,0,3
GTGTCGTATAGCGTTC-1_V12D07-332_A1,5,0,3,0,0,8
ATACGTACTTAGCCAC-1_V12D07-332_A1,2,1,2,0,0,5
GCTATCATACTCATGG-1_V12D07-332_A1,2,0,1,0,1,4
TATCCAATTGGTTATC-1_V12D07-332_A1,1,0,1,0,1,3
TCTCCCTGGGCAGCGT-1_V12D07-332_A1,3,3,0,0,0,6
CCTATAATGAGTGCCC-1_V12D07-332_A1,3,2,0,0,0,5
CAATGCGAGAAGTATC-1_V12D07-332_A1,5,0,0,1,0,6
TACCAATAAAGTACCA-1_V12D07-332_A1,1,2,1,0,0,4
GCTAGGCACCACGGAG-1_V12D07-332_A1,3,2,0,0,0,5
GGTGGACTGCTCTGGC-1_V12D07-332_A1,1,0,0,0,0,1
TATTCCGAGCTGTTAT-1_V12D07-332_A1,3,0,0,0,0,3
TTGAGAAGTTTAGCAT-1_V12D07-332_A1,6,1,0,0,0,7
GTCCGGACCTGAAATT-1_V12D07-332_A1,2,0,0,0,0,2
CTGTGGTCGGGAGATA-1_V12D07-332_A1,2,1,3,0,0,6
CATGTAAGAGACATTT-1_V12D07-332_A1,3,1,0,0,0,4
CACGTTTCGTACACAC-1_V12D07-332_A1,3,0,1,0,0,4
CATCCTCTCAAAGATC-1_V12D07-332_A1,3,0,5,0,0,8
GATTAACCGAAAGCCC-1_V12D07-332_A1,1,1,1,0,0,3
AACGCTGTTGCTGAAA-1_V12D07-332_A1,2,1,0,0,0,3
TTCAGCTGGCGTGCCC-1_V12D07-332_A1,3,1,2,0,0,6
TAGAGGTTCTACTTGT-1_V12D07-332_A1,2,0,0,0,0,2
GTATCAAACGTTAGCT-1_V12D07-332_A1,3,0,0,0,0,3
AATCATGTAAAGACTC-1_V12D07-332_A1,1,0,2,0,0,3
AGTCACTAGCTCTCGA-1_V12D07-332_A1,2,1,1,0,0,4
GCGAAACGATCGGGAG-1_V12D07-332_A1,2,0,0,0,0,2
CATGGATTGTCTTCCG-1_V12D07-332_A1,2,0,2,0,0,4
ATTGGATTACAGCGTA-1_V12D07-332_A1,4,0,0,0,0,4
CACACACGCTAACGAG-1_V12D07-332_A1,0,0,4,0,0,4
CTATGGGAAGCGGAAT-1_V12D07-332_A1,0,0,4,0,0,4
TGCCTAATTGAAGATT-1_V12D07-332_A1,2,0,2,0,0,4
TGGCAATGGGACGGCG-1_V12D07-332_A1,2,1,1,0,0,4
ACCTCCGCCCTCGCTG-1_V12D07-332_A1,3,0,0,0,0,3
CGGCAATAAGATCGCC-1_V12D07-332_A1,5,0,1,0,0,6
CCTTGACCACTTTATT-1_V12D07-332_A1,0,0,3,1,0,4
TCATTTAGAAGTGTGA-1_V12D07-332_A1,0,0,0,1,0,1
CAGAATAACACACGGA-1_V12D07-332_A1,4,0,2,0,0,6
TCTGAGCAATTGACTG-1_V12D07-332_A1,2,0,1,0,0,3
CAACGTGGTGGAGTCT-1_V12D07-332_A1,2,0,1,0,0,3
CACAGTTCGCTTCCCA-1_V12D07-332_A1,3,0,0,0,0,3
TCTCTCGCCGCACATA-1_V12D07-332_A1,3,0,2,0,0,5
TGGGCAGGCCACCGCA-1_V12D07-332_A1,3,0,0,1,0,4
CTCCTGTTCAAGGCAG-1_V12D07-332_A1,5,3,0,0,0,8
TATTTGATTTGCACAG-1_V12D07-332_A1,0,0,0,0,0,0
GCCACTCCTTACGGTA-1_V12D07-332_A1,5,0,1,0,0,6
ACCGATATTTAATCAT-1_V12D07-332_A1,1,0,0,0,0,1
TTATTATCTGGAAGGC-1_V12D07-332_A1,0,0,1,0,0,1
TACATGCCGGAATTGT-1_V12D07-332_A1,3,0,1,1,0,5
GGCACTCAGCCGACCC-1_V12D07-332_A1,3,0,0,0,0,3
AAACCGGAAATGTTAA-1_V12D07-332_A1,3,0,0,0,0,3
AGACAGGCATCTCAGC-1_V12D07-332_A1,1,1,0,0,0,2
GTGGTGATGGTTTGTG-1_V12D07-332_A1,3,0,1,0,0,4
CCGATATGACGTAAGG-1_V12D07-332_A1,2,0,0,0,0,2
CATACACAAAGTCAGC-1_V12D07-332_A1,2,2,0,2,0,6
TGCCGTTCTTAATCGG-1_V12D07-332_A1,2,1,0,0,0,3
TCGAGTCTACGATTCG-1_V12D07-332_A1,1,1,0,0,0,2
ACTTCCAGTGGAAGCT-1_V12D07-332_A1,0,2,0,1,0,3
CAATTGGGCCGCACTC-1_V12D07-332_A1,0,1,0,0,0,1
AAATCGCGGAAGGAGT-1_V12D07-332_A1,1,0,1,0,0,2
ATATCAATTCCAGCCT-1_V12D07-332_A1,0,2,0,0,0,2
CTTTGTCGAATGCTCC-1_V12D07-332_A1,1,5,1,0,0,7
TGAGGCATGTACTGTG-1_V12D07-332_A1,2,0,1,2,0,5
TTCGCCGCTCGCGCTA-1_V12D07-332_A1,3,0,1,0,0,4
GACTCCTTCCAATTGA-1_V12D07-332_A1,5,0,1,0,0,6
ACCGAAGAGTCTGGTT-1_V12D07-332_A1,2,1,1,0,0,4
TGGCATGAAGTTTGGG-1_V12D07-332_A1,0,2,0,0,0,2
ACGAGGTTTACAACGT-1_V12D07-332_A1,0,0,0,1,0,1
AACCCATCCCATGATC-1_V12D07-332_A1,0,0,1,0,0,1
TCGACAACTGAACCCG-1_V12D07-332_A1,3,3,0,0,0,6
TATCTTGCAATACAAC-1_V12D07-332_A1,0,0,0,0,0,0
TATTATGTTTGCCTGC-1_V12D07-332_A1,2,1,0,0,0,3
GTCAAAGAAGTGGTGT-1_V12D07-332_A1,5,0,0,0,0,5
GGGACAGAGTTACTCC-1_V12D07-332_A1,2,0,1,0,0,3
AGCAACCGAAAGTAAT-1_V12D07-332_A1,0,0,0,0,0,0
CTCTCTAACTGCCTAG-1_V12D07-332_A1,3,0,1,0,0,4
ATACGGAACGTCGTTT-1_V12D07-332_A1,3,0,2,0,0,5
TCGGTCCCGACAATAG-1_V12D07-332_A1,0,0,0,0,0,0
CGCGCAAATGTCCAGA-1_V12D07-332_A1,2,1,0,0,0,3
TCTAATACTGCCTCAG-1_V12D07-332_A1,3,1,2,0,0,6
CTCGGTTGTCGGCCCT-1_V12D07-332_A1,3,0,0,0,0,3
GGTAACCGGGAGGATA-1_V12D07-332_A1,2,1,2,0,0,5
CAGGCGCACGGTGGTC-1_V12D07-332_A1,3,0,0,0,0,3
TCATCGATGGTCCCAA-1_V12D07-332_A1,4,3,1,0,0,8
CAAAGATTATTGGGCC-1_V12D07-332_A1,6,1,1,0,0,8
ACAATGAATACGGAGA-1_V12D07-332_A1,2,4,1,0,0,7
GCTCCTGACATACTGG-1_V12D07-332_A1,3,0,0,0,0,3
GATGACAAGTAGGGCA-1_V12D07-332_A1,1,1,0,0,0,2
TACGCCGAGGGTACCC-1_V12D07-332_A1,1,0,0,0,0,1
AAGCGTCCCTCATCGA-1_V12D07-332_A1,0,0,4,0,0,4
CACTCCTATGTAAGAT-1_V12D07-332_A1,2,1,0,0,0,3
TCGAGCCAGGCAGGCC-1_V12D07-332_A1,1,0,0,0,0,1
TCGTCAAGTACGCGCA-1_V12D07-332_A1,2,2,0,0,0,4
CCCGTAGCTGGGAAGA-1_V12D07-332_A1,3,1,1,0,0,5
ACCCTATGCCATATCG-1_V12D07-332_A1,3,2,1,0,0,6
GTGGTATAGTCTGCCG-1_V12D07-332_A1,1,0,2,0,0,3
CCGGTTTGTAATTGTG-1_V12D07-332_A1,2,2,1,0,0,5
GTCGCCGTTGTGTGTT-1_V12D07-332_A1,1,0,1,0,0,2
TACTGAACAGATTTAG-1_V12D07-332_A1,3,3,1,0,0,7
TATTAACCTGACCGCG-1_V12D07-332_A1,2,2,0,0,0,4
CTGTAGCCATCTCACT-1_V12D07-332_A1,2,5,0,0,0,7
TACTATGGTTCCTCAG-1_V12D07-332_A1,0,0,1,0,0,1
GAGTCAGACCAGAATC-1_V12D07-332_A1,4,1,0,0,0,5
TAAGGCATAACATCAA-1_V12D07-332_A1,1,1,0,0,0,2
CTTCCGCTCCGTGAAG-1_V12D07-332_A1,2,1,0,0,0,3
GGGCTATGATCGATGG-1_V12D07-332_A1,4,1,0,0,0,5
GGTCGGTCGTCCACAG-1_V12D07-332_A1,1,2,0,0,0,3
GGGACCCGTATATCTT-1_V12D07-332_A1,1,1,0,0,0,2
GAAAGCAGTGCACTTT-1_V12D07-332_A1,0,2,0,0,0,2
AGCGCATAATGAATCG-1_V12D07-332_A1,4,0,1,0,0,5
GCTGCTAAGTAGTCGA-1_V12D07-332_A1,4,0,0,1,0,5
AATAGTCCGTCCCGAC-1_V12D07-332_A1,2,2,0,0,0,4
AGCAGCCAGATGAATA-1_V12D07-332_A1,1,2,0,0,0,3
CCTCGCGCTGTGCGAT-1_V12D07-332_A1,1,0,1,0,0,2
TTGTGTATGCCACCAA-1_V12D07-332_A1,2,1,1,0,0,4
TGCTCGGCGAAACCCA-1_V12D07-332_A1,7,1,0,0,0,8
CGATTAAATATCTCCT-1_V12D07-332_A1,4,0,0,0,0,4
TGCCGTGGATCGTCCT-1_V12D07-332_A1,1,0,0,0,0,1
GTGGACGCATTTGTCC-1_V12D07-332_A1,3,0,0,0,0,3
ACCCGGAAACTCCCAG-1_V12D07-332_A1,2,0,1,0,0,3
CCGCATGTGGTACGAT-1_V12D07-332_A1,1,0,0,0,0,1
GCAAACCTTGGCCATA-1_V12D07-332_A1,3,3,1,0,0,7
ATTCACTGATGTTGGA-1_V12D07-332_A1,2,0,1,0,0,3
ACTCCCTAATGCTAAA-1_V12D07-332_A1,2,1,0,1,0,4
TCCTAAATTGGGAAGC-1_V12D07-332_A1,4,0,0,0,0,4
GAACAGATTACTAAAT-1_V12D07-332_A1,4,1,5,0,0,10
ATACAGGCCCTCCAAT-1_V12D07-332_A1,4,0,0,0,0,4
CGATTCGCCTGGCTGC-1_V12D07-332_A1,0,0,1,0,0,1
TCCGCCTGTCTACAAG-1_V12D07-332_A1,3,0,0,0,0,3
CACATCTCACCGACGA-1_V12D07-332_A1,3,0,0,0,0,3
CGTCGTCCTTCGCGAA-1_V12D07-332_A1,3,2,0,0,0,5
CGTTGAATACCGCGCT-1_V12D07-332_A1,1,0,1,0,0,2
ACCAATATGCAAGTTA-1_V12D07-332_A1,1,0,0,1,1,3
ACGGATGGTGCGGATA-1_V12D07-332_A1,4,2,0,0,0,6
CACCCTAACAAGATCT-1_V12D07-332_A1,0,1,1,0,0,2
AAGCTCTTTCATGGTG-1_V12D07-332_A1,3,2,1,0,0,6
CATGGGTATGCCTTAT-1_V12D07-332_A1,2,1,0,0,0,3
GCGCGTCATTGGTACA-1_V12D07-332_A1,7,0,0,0,0,7
TCTGAAGCACGTGGTC-1_V12D07-332_A1,3,1,0,1,0,5
AAGTTCACTCCAAGCT-1_V12D07-332_A1,3,2,0,0,0,5
TTGGACCTATAACAGT-1_V12D07-332_A1,2,2,1,0,0,5
ATCAGCCTCATGCTGC-1_V12D07-332_A1,2,1,1,0,0,4
AGTACTCTTATGCCCA-1_V12D07-332_A1,2,0,0,1,0,3
GCGCTTAAATAATTGG-1_V12D07-332_A1,4,1,0,0,0,5
TTGTGAACCTAATCCG-1_V12D07-332_A1,1,2,0,0,0,3
AGTCGTCGACCACCAA-1_V12D07-332_A1,1,0,0,0,0,1
TCCTTTAAATCCGCTT-1_V12D07-332_A1,1,0,3,0,0,4
ACTGAAACGCCGTTAG-1_V12D07-332_A1,1,1,2,0,0,4
GCACACACTGGTAGCC-1_V12D07-332_A1,4,0,3,0,0,7
TAAGGGCCTGTCCGAT-1_V12D07-332_A1,2,1,1,0,0,4
GCTAGAGTAGAGATGT-1_V12D07-332_A1,3,1,0,0,0,4
CACAGGGCCATATAGT-1_V12D07-332_A1,4,0,2,0,0,6
CCATGCCCTAGATTTC-1_V12D07-332_A1,1,0,2,0,0,3
TCGCGTAGCAGTGTCC-1_V12D07-332_A1,3,1,2,0,0,6
GACGAGGCTAATAAAC-1_V12D07-332_A1,4,0,2,0,0,6
CTACACTCGCAGATGG-1_V12D07-332_A1,2,1,1,0,0,4
ACGCATACGTTTACTA-1_V12D07-332_A1,2,0,2,0,0,4
GGAGCAACATTTCAAG-1_V12D07-332_A1,0,0,0,0,0,0
CGAGAGGGTAGCCGCG-1_V12D07-332_A1,2,0,2,0,0,4
TCGTGTTCGACCACAA-1_V12D07-332_A1,3,0,3,0,0,6
TCTACCCAATAGAGAG-1_V12D07-332_A1,2,0,3,0,0,5
ATAAACGTTGCACCAC-1_V12D07-332_A1,2,0,1,1,0,4
TCAACTGCAGAGTCAG-1_V12D07-332_A1,0,0,3,1,0,4
AGCTCCATATATGTTC-1_V12D07-332_A1,2,0,1,0,0,3
GTAACATCTAAGATAA-1_V12D07-332_A1,3,0,0,2,0,5
CCGACAATAGGCCGCC-1_V12D07-332_A1,3,0,2,0,0,5
ATGCTTAGGAGTTGAT-1_V12D07-332_A1,2,0,2,1,0,5
AACCCGAGCAGAATCG-1_V12D07-332_A1,3,0,3,0,0,6
CGGGTTTGTTAGGGCT-1_V12D07-332_A1,3,1,0,0,0,4
AGGCACGTGACTGTCC-1_V12D07-332_A1,8,1,1,0,0,10
GACAAGAGATGAGATT-1_V12D07-332_A1,3,1,1,0,0,5
AGCCCTTGGACATCCC-1_V12D07-332_A1,3,1,1,0,0,5
GCAGTTCGATCCGAGC-1_V12D07-332_A1,2,0,0,0,0,2
TCGAGGGCAACAGACG-1_V12D07-332_A1,3,3,0,0,0,6
ACTTTGTCGACGCACT-1_V12D07-332_A1,4,1,2,0,0,7
GAGTATCAAAGTTACA-1_V12D07-332_A1,3,1,1,0,0,5
CCAGGCTGGCGTCTGA-1_V12D07-332_A1,5,0,1,0,0,6
GGACTCTTCCGGTTGA-1_V12D07-332_A1,8,0,0,0,0,8
TCCCAGCACACGACAT-1_V12D07-332_A1,3,0,1,0,0,4
GCTCCATGAGTGCAGA-1_V12D07-332_A1,2,0,1,1,0,4
GCAGTGCGGGCGGATG-1_V12D07-332_A1,2,1,1,0,0,4
GCGTTCTGACTAAGCG-1_V12D07-332_A1,1,0,1,0,0,2
ATTTGGAGATTGCGGT-1_V12D07-332_A1,2,0,1,1,0,4
AAGGGTTTGATTTCAG-1_V12D07-332_A1,0,0,1,0,0,1
CCGGCCGCGAGCATAT-1_V12D07-332_A1,0,0,0,0,0,0
GAGTTCTGTGGGTGCT-1_V12D07-332_A1,1,0,0,0,0,1
AAACGAAGATGGAGTA-1_V12D07-332_A1,2,1,1,0,0,4
AATTACGAGACCCATC-1_V12D07-332_A1,0,0,1,0,0,1
CCTTTGAATTATGGCT-1_V12D07-332_A1,3,1,0,0,0,4
CATGGTATTAGTTTGT-1_V12D07-332_A1,0,0,0,0,0,0
AACGAAAGTCGTCCCA-1_V12D07-332_A1,0,3,0,0,0,3
ACATAAGTCGTGGTGA-1_V12D07-332_A1,1,1,0,0,0,2
GCACAACCTCGGGCGT-1_V12D07-332_A1,1,0,0,0,0,1
ATGCACGCGCTGTTCA-1_V12D07-332_A1,0,1,0,1,0,2
CGATGTTGTTATCTAC-1_V12D07-332_A1,4,1,0,0,0,5
GTCTCCTGCCAGTATG-1_V12D07-332_A1,6,0,0,0,0,6
GATGCCTTCTGCGGCA-1_V12D07-332_A1,4,0,0,0,0,4
ACCGGTCAGGTACACC-1_V12D07-332_A1,2,0,0,0,0,2
GTGGAGCGTTTACCGA-1_V12D07-332_A1,2,0,1,0,0,3
AGGCGGTTTGTCCCGC-1_V12D07-332_A1,1,0,0,0,0,1
TCCCTGGCGTATTAAC-1_V12D07-332_A1,3,0,1,0,0,4
AAACACCAATAACTGC-1_V12D07-332_A1,4,0,0,0,0,4
TGGACGCAATCCAGCC-1_V12D07-332_A1,6,0,0,0,0,6
GGAACCTTGACTCTGC-1_V12D07-332_A1,2,1,0,0,0,3
GTATCTCAGTCTTGAC-1_V12D07-332_A1,5,1,0,0,0,6
GCTGAATCTTCCAATC-1_V12D07-332_A1,7,0,1,0,0,8
AGATGCAAGACGTGCA-1_V12D07-332_A1,4,1,0,0,0,5
TTAAGGCCCGTACTTT-1_V12D07-332_A1,1,0,2,0,0,3
AGTATGCTGGAGACCA-1_V12D07-332_A1,2,0,0,0,0,2
GCGGCAAAGTATTGCC-1_V12D07-332_A1,1,2,1,0,0,4
GCGCAAATATATTCAA-1_V12D07-332_A1,2,0,0,0,0,2
GAAGAAACGATATTGT-1_V12D07-332_A1,4,1,1,0,0,6
GGACCTCTAGGCCGCC-1_V12D07-332_A1,1,1,0,0,0,2
AACAGCTGTGTGGCAA-1_V12D07-332_A1,0,2,0,0,0,2
TCGAATATCCCGCAGG-1_V12D07-332_A1,1,4,0,0,0,5
GCGACCCAACCATCTG-1_V12D07-332_A1,1,1,1,0,0,3
AGAGAAGGAGTACAAT-1_V12D07-332_A1,1,0,0,0,0,1
GGCTCCTCCACCTGTT-1_V12D07-332_A1,3,2,2,0,0,7
TCAGTGTATACGTCAT-1_V12D07-332_A1,3,1,0,0,0,4
ATTATTATGTCCGTCA-1_V12D07-332_A1,2,1,1,0,0,4
TTAGGTCATAACCGAC-1_V12D07-332_A1,4,0,0,0,0,4
AAGATGGCACCGGACC-1_V12D07-332_A1,5,1,1,0,0,7
CTACAAGAAATAACCC-1_V12D07-332_A1,4,0,1,0,0,5
ACTATTTCCGGGCCCA-1_V12D07-332_A1,6,1,1,0,0,8
TTGTTTCACATCCAGG-1_V12D07-332_A1,4,0,0,0,0,4
CGCTGTGTGGATGTTG-1_V12D07-332_A1,1,2,1,0,0,4
TCAACATAGCGCCCTA-1_V12D07-332_A1,3,0,0,0,0,3
GGCCGTTTGGGTTTCA-1_V12D07-332_A1,1,2,1,0,0,4
TACTCTTTCGTCTTCA-1_V12D07-332_A1,4,0,1,0,0,5
TTCGCGCGCCATACGA-1_V12D07-332_A1,5,3,1,0,0,9
CGGAAAGAATCAAACG-1_V12D07-332_A1,2,2,1,0,0,5
AGGCAGGGAGCGTACT-1_V12D07-332_A1,3,0,0,0,0,3
CCTTTAAGGGAGCACT-1_V12D07-332_A1,3,0,0,0,0,3
CGCCCAGCACGCCTAG-1_V12D07-332_A1,1,1,1,0,0,3
AGTATTTGGCACGACC-1_V12D07-332_A1,2,2,0,0,0,4
TATCCGCACCGTCGGG-1_V12D07-332_A1,4,2,1,0,0,7
ACCCGTGTCATCAGTA-1_V12D07-332_A1,2,1,0,0,0,3
CAACTGCTCATCCGAT-1_V12D07-332_A1,3,0,0,1,0,4
CCGGAGCGTACTTTCT-1_V12D07-332_A1,3,0,0,0,0,3
TACCGTAGGTTAACTA-1_V12D07-332_A1,0,1,0,0,0,1
TGAGGAGTGCCAGCTT-1_V12D07-332_A1,3,0,0,0,0,3
CCAGTCTTGTCATAGA-1_V12D07-332_A1,0,1,0,0,0,1
GGGCAGAGCAATCGTT-1_V12D07-332_A1,2,0,0,0,0,2
TACCAAATAGCCCAGA-1_V12D07-332_A1,2,1,0,0,1,4
TACCTACTCCCAGTAT-1_V12D07-332_A1,0,5,0,0,0,5
TGTGAGACTAGCCCAA-1_V12D07-332_A1,5,0,0,0,0,5
ATACCTAACCAAGAAA-1_V12D07-332_A1,1,1,0,0,0,2
GTCGGGAAGCAGAAAC-1_V12D07-332_A1,2,0,0,0,0,2
AATTAACGGATTTCCA-1_V12D07-332_A1,0,1,0,0,0,1
GAACCCTCTGTGTTCT-1_V12D07-332_A1,5,1,0,0,0,6
ATATAAAGCGCTCGTG-1_V12D07-332_A1,2,1,2,0,0,5
CCTGGTCGAATGTGGG-1_V12D07-332_A1,4,1,1,0,0,6
CTAGGTTCGGACGTGA-1_V12D07-332_A1,3,0,0,0,0,3
TCGGGAGACAGCGTAC-1_V12D07-332_A1,5,0,0,0,0,5
CATAAGAAGCTTGGCT-1_V12D07-332_A1,2,0,0,0,0,2
AAGCACCCTGCGTATC-1_V12D07-332_A1,3,2,0,0,0,5
AGTTTGCACCTGCCTC-1_V12D07-332_A1,4,1,1,0,0,6
GACTGCAAATCGAGCT-1_V12D07-332_A1,1,0,2,0,0,3
GTGTATATCAGCGGGC-1_V12D07-332_A1,2,1,0,0,0,3
CTTCAACTCCACTTGG-1_V12D07-332_A1,3,1,0,0,0,4
ACTTACGCATCCACGC-1_V12D07-332_A1,4,0,2,0,0,6
CATGAGATGCACTCTC-1_V12D07-332_A1,1,1,1,0,0,3
GAGCACCTGTGTCCAG-1_V12D07-332_A1,2,0,0,0,0,2
CGCGACCGCGACAGAT-1_V12D07-332_A1,2,0,0,0,0,2
GTCCCGCGACGTTATG-1_V12D07-332_A1,3,1,1,0,0,5
GCAGTGTGGCTATAGG-1_V12D07-332_A1,6,1,1,0,0,8
ATACTGCCTTACACCG-1_V12D07-332_A1,3,0,1,0,0,4
TACAGAAACGGTGGGC-1_V12D07-332_A1,7,0,1,0,0,8
GGCGCGGAGATCTTTC-1_V12D07-332_A1,8,0,0,0,0,8
CGTTAATGTCCCGACG-1_V12D07-332_A1,3,0,1,0,0,4
GCTAACTGAAGTCTGA-1_V12D07-332_A1,4,1,0,0,0,5
AGTGATAACCTGCGCG-1_V12D07-332_A1,3,0,2,0,0,5
TATGATCTTCTCTTTA-1_V12D07-332_A1,5,0,1,0,0,6
TGTACCTACACGAGGG-1_V12D07-332_A1,1,0,2,0,0,3
ATATCGTTCCTCGAAC-1_V12D07-332_A1,1,0,0,0,0,1
CGGCGCCATCAATCCC-1_V12D07-332_A1,2,0,1,0,0,3
CCTGTTTGAAGACACG-1_V12D07-332_A1,3,0,1,1,0,5
GCCACTCAGAGCGCGA-1_V12D07-332_A1,1,0,3,0,0,4
TCGGCTTGTATCGACG-1_V12D07-332_A1,2,1,0,0,0,3
TAGATGGTTCCTTACT-1_V12D07-332_A1,3,0,0,0,0,3
ATCGTTAGCTAGCGGA-1_V12D07-332_A1,6,0,0,0,0,6
ACAGCGACATTCTCAT-1_V12D07-332_A1,0,1,0,0,0,1
ATTCAACCATTTAAGG-1_V12D07-332_A1,2,0,0,0,0,2
CACTCTTCTGCTAGCC-1_V12D07-332_A1,1,1,3,1,0,6
CTAACTGATAATCGCC-1_V12D07-332_A1,2,0,3,0,0,5
TGATGTCAATTAAGTG-1_V12D07-332_A1,3,0,4,0,0,7
CGCCGTTCAGCATAGT-1_V12D07-332_A1,2,0,0,0,0,2
ATACTACCCGTACCAC-1_V12D07-332_A1,0,0,2,1,0,3
CCACTGTTTGGATTAA-1_V12D07-332_A1,1,0,3,1,0,5
CACTACGGGAGCTGCC-1_V12D07-332_A1,0,0,3,0,0,3
GACCAAACGTTGACTG-1_V12D07-332_A1,0,0,1,0,0,1
AAGAGGCCCTTTGGAA-1_V12D07-332_A1,4,0,2,0,0,6
ACACGTAGGCCACAAG-1_V12D07-332_A1,0,0,3,0,0,3
TACTCTTACTTTACTG-1_V12D07-332_A1,3,0,1,0,0,4
AGAGCCGCCGAGATTT-1_V12D07-332_A1,3,1,1,0,0,5
GGCCTGCTTCTCCCGA-1_V12D07-332_A1,5,1,0,1,0,7
TCAAGCGCGGACGGTA-1_V12D07-332_A1,1,1,0,0,0,2
ACACTGGGACAGTCGT-1_V12D07-332_A1,2,1,0,0,0,3
TGTGTAGTAGCACGTG-1_V12D07-332_A1,3,0,0,0,0,3
CTAGCCACAGGCGAGC-1_V12D07-332_A1,4,0,0,0,0,4
CTATCGCGTAGAGAAC-1_V12D07-332_A1,1,1,0,0,0,2
GTTCCCGTAAACATAT-1_V12D07-332_A1,1,0,0,0,0,1
TCTTTCCTTCGAGATA-1_V12D07-332_A1,6,1,1,0,0,8
ATATTGGAGAGGCCTT-1_V12D07-332_A1,2,1,1,1,0,5
AGGCGATAACTGGCGT-1_V12D07-332_A1,4,1,0,0,0,5
ACCCGGAGCACCACAA-1_V12D07-332_A1,4,1,0,0,0,5
TGAGCTCAACTGTATA-1_V12D07-332_A1,5,0,0,0,0,5
ACGACCCATGAGTTGC-1_V12D07-332_A1,2,0,0,0,0,2
CGGTCAGTCCATATTT-1_V12D07-332_A1,1,0,1,0,0,2
TCCGGCTGTCGGGTCG-1_V12D07-332_A1,5,0,0,0,0,5
ATTCCCGAAGGTACAG-1_V12D07-332_A1,1,1,1,0,0,3
CTAACAGCACAATAAC-1_V12D07-332_A1,0,0,0,0,0,0
TTGTGCGGAAGCGGAT-1_V12D07-332_A1,0,1,0,0,0,1
GGGCACTATTGACCAT-1_V12D07-332_A1,2,2,0,0,0,4
CCATAGAGGCTGCCAG-1_V12D07-332_A1,1,1,2,0,0,4
CCGAAGCATTGACCAA-1_V12D07-332_A1,2,1,2,0,0,5
TACTGAGGGAAGAAAG-1_V12D07-332_A1,0,1,0,0,0,1
TATGTAGAAACCCGGC-1_V12D07-332_A1,2,0,0,1,0,3
TGGTTAACTTACATTT-1_V12D07-332_A1,1,2,0,1,0,4
AGAACCCTCAATTGGG-1_V12D07-332_A1,3,0,0,0,0,3
CCTATATCGTGTCACG-1_V12D07-332_A1,0,3,0,0,0,3
ACGGCTGGATGTAGAA-1_V12D07-332_A1,0,1,0,0,0,1
CTCGCATTGCATAGCC-1_V12D07-332_A1,3,0,0,0,0,3
ACTTTGGTCGTGCTCC-1_V12D07-332_A1,1,0,0,0,0,1
GCTGGTTTAGGCCATA-1_V12D07-332_A1,1,1,0,0,0,2
TGTCGTTATCACATAT-1_V12D07-332_A1,1,0,0,0,0,1
ACACATGATCAAATCT-1_V12D07-332_A1,1,2,0,0,0,3
TATCCATCTCGGTTAG-1_V12D07-332_A1,1,1,0,0,0,2
CTCGTCGAGGGCTCAT-1_V12D07-332_A1,1,0,0,1,0,2
ATCAATGCCGTGGCTG-1_V12D07-332_A1,1,0,2,0,0,3
GAAACATAGGAAACAG-1_V12D07-332_A1,2,1,0,0,0,3
TAATAGGTCACCAGAA-1_V12D07-332_A1,3,0,1,0,0,4
CACCAGTCAGCATGCA-1_V12D07-332_A1,4,0,0,0,0,4
GAGCGCTGTTAGGTAA-1_V12D07-332_A1,1,1,0,0,0,2
CCCTATGTAGAGCAGA-1_V12D07-332_A1,3,0,0,0,0,3
GATCGCTATATCTCAG-1_V12D07-332_A1,5,0,0,0,0,5
AAGGGACTATGCATTC-1_V12D07-332_A1,0,0,2,0,0,2
CTCGGGTTCTCTGGCC-1_V12D07-332_A1,2,1,1,0,0,4
TATATATCGAGAAATG-1_V12D07-332_A1,2,0,1,0,0,3
ACCCGAGCGAAATTAC-1_V12D07-332_A1,2,1,1,0,0,4
TTGTTTCATTAGTCTA-1_V12D07-332_A1,3,1,0,0,0,4
ATGGGACCTGCTGAAC-1_V12D07-332_A1,3,0,0,0,0,3
TGCGACGGCCGAACGT-1_V12D07-332_A1,4,0,4,0,0,8
AGCTAACAAGCAATGT-1_V12D07-332_A1,4,0,1,0,0,5
CGTGTCTCGTTACGAC-1_V12D07-332_A1,1,0,1,0,0,2
CTAAATCCGGTGTACA-1_V12D07-332_A1,6,1,1,0,0,8
GAATAGTGCTCGATTA-1_V12D07-332_A1,3,1,0,0,0,4
AACAATACATTGTCGA-1_V12D07-332_A1,4,0,1,0,0,5
CACATCGTGCACGCGC-1_V12D07-332_A1,3,2,0,0,0,5
ACCGTGACCACGTGGG-1_V12D07-332_A1,3,0,1,0,0,4
CCCAATGAGATTTGCA-1_V12D07-332_A1,0,0,1,0,0,1
TCAGCAGTAGGCCCTG-1_V12D07-332_A1,0,0,0,0,0,0
CTACTCAAGGTATAGT-1_V12D07-332_A1,4,0,1,0,0,5
TAGTAGCTTATACCAG-1_V12D07-332_A1,0,0,3,0,0,3
ACGTTCGTTCAGGAAA-1_V12D07-332_A1,1,6,0,0,0,7
TTAGAATAAGGGTCGG-1_V12D07-332_A1,2,2,1,0,0,5
TTCTAGAAAGTCTTAT-1_V12D07-332_A1,4,1,0,0,0,5
CCTTCAGTTAAAGTGA-1_V12D07-332_A1,9,1,0,0,0,10
TAGCTAGTGATGATGG-1_V12D07-332_A1,1,0,0,0,0,1
AGCCCGGTAGCCTGTA-1_V12D07-332_A1,2,0,1,0,0,3
TACCTCAGTTGTCTGT-1_V12D07-332_A1,4,4,0,0,0,8
GACGGGTTGGCCCGTA-1_V12D07-332_A1,3,1,1,0,0,5
GAAACCTATACAAATG-1_V12D07-332_A1,4,1,0,0,0,5
TCCACCTCTAGCCTTT-1_V12D07-332_A1,5,0,0,0,0,5
AAGACCCAACTGAACA-1_V12D07-332_A1,3,1,0,0,0,4
CATACACGGTTCCCAC-1_V12D07-332_A1,3,1,2,0,0,6
ACTACGCGTTAGAATT-1_V12D07-332_A1,3,0,0,0,0,3
CTTGGCCAAGCTGGGA-1_V12D07-332_A1,2,1,2,0,0,5
TTACCCTAGGGATTGG-1_V12D07-332_A1,0,0,0,0,0,0
TTCGCACTGTACGACA-1_V12D07-332_A1,2,0,0,0,0,2
TAGGTGTTCCACAGAT-1_V12D07-332_A1,1,2,2,0,0,5
GAAGCCTGCACATTCC-1_V12D07-332_A1,1,1,0,0,0,2
GGCTTTCAATAAGGGT-1_V12D07-332_A1,2,0,0,0,0,2
TCCAGGGTATATACGA-1_V12D07-332_A1,4,0,2,0,0,6
CTCGCCGAATGTAGGG-1_V12D07-332_A1,6,1,1,0,0,8
AGGAAGCTGTCCGCCG-1_V12D07-332_A1,1,0,0,0,0,1
GTCTCAAGGCCCGGCT-1_V12D07-332_A1,5,0,1,0,0,6
ACCGACACATCTCCCA-1_V12D07-332_A1,6,0,1,0,0,7
TATACGCGTCATCACT-1_V12D07-332_A1,4,0,3,0,0,7
ATCTGGGCTGTTCTTG-1_V12D07-332_A1,8,0,0,0,0,8
TCAAATTTGAGACTCA-1_V12D07-332_A1,2,1,0,0,0,3
GTTAAGGGTGCGATGT-1_V12D07-332_A1,0,0,2,0,0,2
AGCAAAGGCCGCTAGT-1_V12D07-332_A1,5,0,1,0,0,6
TTATAGGTAATTGTCT-1_V12D07-332_A1,1,1,2,0,0,4
TTGTGCAGCCACGTCA-1_V12D07-332_A1,6,1,1,1,0,9
ACGGACTCTCAAAGCG-1_V12D07-332_A1,4,1,0,0,0,5
ATGCTCTGGCGCGGTA-1_V12D07-332_A1,3,1,1,0,0,5
ATAATCTTGGAGAACC-1_V12D07-332_A1,0,1,1,0,0,2
CTCATTGCTCTAACAA-1_V12D07-332_A1,3,0,1,0,0,4
TAGGTGACGATAACCT-1_V12D07-332_A1,2,0,1,0,0,3
CGGATCCTCAAGGACT-1_V12D07-332_A1,0,1,0,0,0,1
GGGCGTGGTTTCCCAG-1_V12D07-332_A1,2,0,1,0,0,3
TGGCTATGTGACATAC-1_V12D07-332_A1,2,4,1,0,0,7
CTTAGTGTAGTAGCAT-1_V12D07-332_A1,1,0,0,1,0,2
GGATTGCTGTGACTCC-1_V12D07-332_A1,1,1,0,0,0,2
ACTTCCATGCGGGACA-1_V12D07-332_A1,0,0,0,0,0,0
ACTCAAGTGCAAGGCT-1_V12D07-332_A1,2,0,0,0,0,2
ACAAGGATGCTTTAGG-1_V12D07-332_A1,1,0,1,0,0,2
TTGAACGACGTGCTGA-1_V12D07-332_A1,5,0,1,0,0,6
ATTCATCGTTGAGGCA-1_V12D07-332_A1,3,0,1,0,0,4
TGCAACCCATCTGCGG-1_V12D07-332_A1,2,1,5,0,0,8
AGTGCTAAACACAGCA-1_V12D07-332_A1,1,0,2,0,0,3
AACTCCAGAGCGTGTT-1_V12D07-332_A1,5,0,3,0,0,8
TCTCCACAAGTTGAAT-1_V12D07-332_A1,1,0,1,0,0,2
CTTTGCATCGCTCTTG-1_V12D07-332_A1,1,0,1,0,0,2
TCACAAACCGAGGTAC-1_V12D07-332_A1,2,0,0,0,0,2
CCGTAGGAAATCCCTG-1_V12D07-332_A1,5,0,1,0,0,6
AAACATTTCCCGGATT-1_V12D07-332_A1,7,0,0,0,0,7
GCCTCCGACAATTCAC-1_V12D07-332_A1,1,1,2,0,0,4
TCTGCATACCTTGCTT-1_V12D07-332_A1,2,0,0,0,0,2
ACCCATTTGTCCCTCT-1_V12D07-332_A1,1,1,2,0,0,4
CTGCAGAGAATCAGAG-1_V12D07-332_A1,1,0,1,0,0,2
GGAAACTAAATGGGCC-1_V12D07-332_A1,1,0,1,0,0,2
CAACCTACCGAGCAGT-1_V12D07-332_A1,2,1,0,2,0,5
CCGTAGGGTTGTTTAC-1_V12D07-332_A1,1,0,5,0,0,6
TTCCATCGACAGCGTG-1_V12D07-332_A1,2,0,1,1,0,4
ATCTCCCACGGAATAT-1_V12D07-332_A1,7,0,1,0,0,8
GTTTCAAACGAGTTGT-1_V12D07-332_A1,3,0,1,0,0,4
GGAACTTTGGCGATTA-1_V12D07-332_A1,3,0,1,1,0,5
CTGCAAGCACGTTCCG-1_V12D07-332_A1,4,1,0,0,0,5
CACAGTCCCGCTTCGC-1_V12D07-332_A1,2,0,0,0,0,2
TACGCTCGGTATTGGA-1_V12D07-332_A1,5,2,0,0,0,7
CTGGTAAAGTGTGGGC-1_V12D07-332_A1,0,1,3,0,0,4
CAACCAGTGGCCTACC-1_V12D07-332_A1,3,0,3,0,0,6
TCTTCGCGGTGAGAGG-1_V12D07-332_A1,3,0,3,0,0,6
TTCGGGTTGCCACGGG-1_V12D07-332_A1,2,0,2,0,0,4
ACCGATAGGCATAACC-1_V12D07-332_A1,5,0,2,0,0,7
CTTATAGATGGCTGTT-1_V12D07-332_A1,1,0,1,0,0,2
AGACGCCCACTTCGCC-1_V12D07-332_A1,4,0,0,0,0,4
AGGTCGCCTCCCAACA-1_V12D07-332_A1,6,1,1,0,0,8
CCTCACGTCAGCTAAT-1_V12D07-332_A1,1,0,3,0,0,4
CCACCTGTATGGAATA-1_V12D07-332_A1,2,0,1,0,0,3
GGACTCGAAGCTTTCA-1_V12D07-332_A1,3,1,1,0,0,5
AAGCCGGAGAGCAGGA-1_V12D07-332_A1,4,0,2,0,0,6
GCCTATCAGGTAAGAT-1_V12D07-332_A1,5,0,1,0,0,6
TCAGAGTGTGAGCATG-1_V12D07-332_A1,1,2,2,0,0,5
AAACATGGTGAGAGGA-1_V12D07-332_A1,0,1,0,0,0,1
ATCATTGTACCGCATT-1_V12D07-332_A1,4,3,0,0,0,7
TCAGCTTGAGCTTTCG-1_V12D07-332_A1,4,3,0,0,0,7
CCGCGCAAGATACCCA-1_V12D07-332_A1,0,1,1,0,0,2
CTATACTTAAAGCGAG-1_V12D07-332_A1,1,0,0,0,0,1
ACCGTCCACTGGGCCC-1_V12D07-332_A1,2,1,0,1,0,4
AAGACCAAATAACTCA-1_V12D07-332_A1,1,1,0,2,0,4
TGTTTCTGAAGCGTGC-1_V12D07-332_A1,0,0,0,0,0,0
TTCTCTTACAGGTGAT-1_V12D07-332_A1,0,0,0,0,0,0
AATTCATTGTCATGCA-1_V12D07-332_A1,0,1,0,0,0,1
GCCCGAGAGTCTAAAT-1_V12D07-332_A1,5,0,0,0,0,5
ATATAGAGTATTGGTC-1_V12D07-332_A1,2,2,0,0,0,4
TTGAAGGATGGGCGCC-1_V12D07-332_A1,0,0,0,0,0,0
TAGTACCACAACTTTC-1_V12D07-332_A1,0,0,3,1,0,4
ATCCCATCCACAGCGC-1_V12D07-332_A1,0,1,0,0,0,1
CTTAGGTATAGACCAG-1_V12D07-332_A1,4,3,1,0,0,8
TGACTCCGAATCATAC-1_V12D07-332_A1,1,1,2,0,0,4
ACTACATCCCGACAAG-1_V12D07-332_A1,4,1,0,1,0,6
TTGCCGCAGACCTACA-1_V12D07-332_A1,1,0,1,0,0,2
TAAGAGGGACAGGGAC-1_V12D07-332_A1,1,0,0,0,0,1
CGAATGAAGTCATTGC-1_V12D07-332_A1,0,0,0,0,0,0
AAGGGAACGACTGGCT-1_V12D07-332_A1,3,0,0,1,0,4
CGAATCTGCTCGACGC-1_V12D07-332_A1,1,0,0,0,0,1
ATCGTGGAAAGTCTGG-1_V12D07-332_A1,2,1,1,0,0,4
CCTATGGCTCCTAGTG-1_V12D07-332_A1,2,0,0,0,0,2
CGTCGCTTGGTTATAC-1_V12D07-332_A1,1,1,1,0,0,3
TGCTTAGAGAGAATGC-1_V12D07-332_A1,3,0,0,0,0,3
GATTGCTCCAGTTGCA-1_V12D07-332_A1,0,0,3,0,0,3
CGTGCTTCTACCTAAA-1_V12D07-332_A1,3,1,0,0,0,4
ACTCCAATATCATCAT-1_V12D07-332_A1,6,1,1,0,0,8
GCCGACCCACGACTGC-1_V12D07-332_A1,3,0,2,0,0,5
GAGGGTAGTAACAAAG-1_V12D07-332_A1,1,2,0,0,0,3
GGCCGAGACTCTGGTG-1_V12D07-332_A1,5,0,0,0,0,5
TATATAGGGCTTTACG-1_V12D07-332_A1,2,1,1,0,0,4
TGCCGGATGTACGAGC-1_V12D07-332_A1,3,0,1,0,0,4
AGGTAGATCGAGATAT-1_V12D07-332_A1,4,1,0,0,0,5
GATCAACATAAAGGGA-1_V12D07-332_A1,3,0,2,0,0,5
TAACAGCGTTTGTGCT-1_V12D07-332_A1,2,0,0,0,0,2
CTATAGGCGTTGATGT-1_V12D07-332_A1,2,1,0,0,0,3
GGTTTAATTACCATCG-1_V12D07-332_A1,3,0,1,0,0,4
CTCTTCTGGAAGTTAG-1_V12D07-332_A1,0,2,1,0,0,3
ATCTGACATGGAAGGA-1_V12D07-332_A1,0,0,1,0,0,1
TACGTACTAGTGCTGA-1_V12D07-332_A1,2,1,0,0,0,3
ATGACTATCAGCTGTG-1_V12D07-332_A1,4,1,0,0,0,5
CTTTGGGATTGTTGCA-1_V12D07-332_A1,3,2,0,0,0,5
AGACTGTTACCGGGTC-1_V12D07-332_A1,2,0,2,0,0,4
TCCTAACCGTCGGGCA-1_V12D07-332_A1,4,0,0,0,0,4
ACGCAAACTAATAGAT-1_V12D07-332_A1,2,0,0,0,0,2
AAGTGAGTCGGGTTTA-1_V12D07-332_A1,6,1,2,0,0,9
TAAAGCGGTATTTCCA-1_V12D07-332_A1,4,3,1,0,0,8
CTCCTCCAGCTCACAC-1_V12D07-332_A1,1,0,1,0,0,2
CGGTCCGTCGCAAGCC-1_V12D07-332_A1,1,2,0,0,0,3
CCTATATTTGTCCTGG-1_V12D07-332_A1,8,0,0,0,0,8
TCCAATAAAGGCTACC-1_V12D07-332_A1,5,2,0,0,0,7
AAAGGCTACGGACCAT-1_V12D07-332_A1,2,0,0,0,0,2
CGTGACCAGTCCTCTG-1_V12D07-332_A1,3,1,1,0,0,5
GATCTGCTATCTAAGG-1_V12D07-332_A1,6,1,1,0,0,8
CGAATGACGCATAATG-1_V12D07-332_A1,3,0,2,0,0,5
GCTCAATGTAATACCG-1_V12D07-332_A1,2,2,0,0,0,4
CTATGCCCGAATGCAA-1_V12D07-332_A1,1,2,0,0,0,3
CACAGGGCCGTTGTCA-1_V12D07-332_A1,2,0,0,0,0,2
TCAATACGCCGTCATG-1_V12D07-332_A1,1,0,0,0,0,1
AGCGGACACTTCGTAG-1_V12D07-332_A1,1,0,0,0,0,1
ATACGTTATGCACGGA-1_V12D07-332_A1,2,2,0,0,0,4
GAGTAGATACTAGTTG-1_V12D07-332_A1,1,0,0,0,0,1
CCAGCTCGAACGCATT-1_V12D07-332_A1,5,2,2,0,0,9
TGCTTCCCAAGCAGTA-1_V12D07-332_A1,3,2,0,0,0,5
GTAGACACGCCTGACT-1_V12D07-332_A1,1,2,0,0,0,3
CTCACATTTACTAAAT-1_V12D07-332_A1,2,0,0,0,0,2
GAATGCGAATCGGTTC-1_V12D07-332_A1,3,1,1,0,0,5
TAAGGCCCGTCACCCT-1_V12D07-332_A1,4,1,1,0,0,6
GAGTATGCGCGTGCAT-1_V12D07-332_A1,2,2,0,0,0,4
ATCCACATCGACAGAA-1_V12D07-332_A1,4,3,2,0,0,9
TAGACGAAACGCCAAT-1_V12D07-332_A1,6,0,0,0,0,6
CAGCAGTCTGTGCTGC-1_V12D07-332_A1,2,1,0,0,0,3
CTCACTGTGATACTTA-1_V12D07-332_A1,2,0,0,0,0,2
TTAATTGCTTTGGGTG-1_V12D07-332_A1,1,0,1,0,0,2
GTAGTCTACGATATTG-1_V12D07-332_A1,1,1,1,0,0,3
TTGCCGCTTTCTAGTA-1_V12D07-332_A1,0,0,1,0,0,1
GAACCTTTAACGATCC-1_V12D07-332_A1,4,0,0,0,0,4
TGGACCAATCTAAGAT-1_V12D07-332_A1,1,0,2,1,0,4
CTAGTAGAAAGGGATT-1_V12D07-332_A1,1,1,1,0,0,3
AACCTCGCTTTAGCCC-1_V12D07-332_A1,0,1,2,0,0,3
GAGTGTCAACCAGAAA-1_V12D07-332_A1,3,2,0,0,0,5
GTGATCCTTGTCATGA-1_V12D07-332_A1,0,0,2,0,0,2
CTCAACTAACCCGGAT-1_V12D07-332_A1,1,2,0,0,0,3
AGTGGCGTCTGAAGGT-1_V12D07-332_A1,4,0,3,1,0,8
GGGAAGGGCTTTCTCA-1_V12D07-332_A1,6,1,0,0,0,7
AGGCCTGAGAATCTCG-1_V12D07-332_A1,4,0,2,0,0,6
AGCCACAGGTTACCCG-1_V12D07-332_A1,0,1,0,0,0,1
TGCAATCTAACACGGT-1_V12D07-332_A1,2,1,0,0,0,3
GTTTGGGTTTCGCCCG-1_V12D07-332_A1,3,0,1,0,0,4
CCTATGTCCACTCCAC-1_V12D07-332_A1,4,0,1,0,0,5
CTGCCTTTCTAGTAAA-1_V12D07-332_A1,3,0,0,0,0,3
TTAGTAAACCTGCTCT-1_V12D07-332_A1,3,0,1,0,0,4
TTGTGGTGGTACTAAG-1_V12D07-332_A1,2,1,0,0,0,3
CCTCCTGTTGTGTCGT-1_V12D07-332_A1,3,0,0,0,0,3
ACAAAGCATGACCTAG-1_V12D07-332_A1,2,1,4,0,0,7
ATAGCAACTAGGGAAG-1_V12D07-332_A1,4,0,0,0,0,4
CCGCTCTTCCGAACTA-1_V12D07-332_A1,5,2,1,0,0,8
TAGAATAGCCGATGAA-1_V12D07-332_A1,9,0,0,0,0,9
GGTCTCCGTCCAGGTT-1_V12D07-332_A1,4,0,0,2,0,6
TAATTACGTCAGTAGA-1_V12D07-332_A1,3,0,2,1,0,6
TCAGCCAATCCGTAAA-1_V12D07-332_A1,2,0,2,1,0,5
ATCATAGCCCTATGTA-1_V12D07-332_A1,5,0,2,1,0,8
GAGGCCTGTTGATACA-1_V12D07-332_A1,0,1,0,0,0,1
ATATACGCTCGTGACG-1_V12D07-332_A1,3,0,4,0,0,7
CCCTTTAATGGAGTTC-1_V12D07-332_A1,4,0,0,0,0,4
TTACACGATCTGCGAC-1_V12D07-332_A1,3,0,0,0,0,3
TCGCATAAAGGGCGCA-1_V12D07-332_A1,3,0,0,0,0,3
TGTAGCCATCCCATTC-1_V12D07-332_A1,4,1,0,0,0,5
GGGTCTATCGCTTTCC-1_V12D07-332_A1,2,1,2,1,0,6
GGAGGGTCAAGTAAGA-1_V12D07-332_A1,4,0,1,0,0,5
TACGGCATGGACGCTA-1_V12D07-332_A1,2,0,0,0,0,2
CACGTCAATCAATGGA-1_V12D07-332_A1,3,0,1,0,0,4
CGCTTGGACGGATAGA-1_V12D07-332_A1,3,0,1,0,0,4
CGCGGTACGGTATACA-1_V12D07-332_A1,6,0,1,0,0,7
CCTACTCAACACGATT-1_V12D07-332_A1,2,0,1,0,0,3
CGTTTGGTGTTGTGGG-1_V12D07-332_A1,2,0,1,0,0,3
GTTGTTGCAAGATGGC-1_V12D07-332_A1,4,0,0,0,0,4
CATTCGTCGTAGCGGT-1_V12D07-332_A1,0,8,1,0,0,9
CAGCCTCGATAGCGGT-1_V12D07-332_A1,1,0,1,0,0,2
TCATAAGTCCAAGAAG-1_V12D07-332_A1,4,0,1,0,0,5
AAAGTGCCATCAATTA-1_V12D07-332_A1,0,1,0,0,0,1
GTTGCAGTCGACAACA-1_V12D07-332_A1,4,0,0,0,0,4
TAAATGGGCTACTGAG-1_V12D07-332_A1,8,0,0,0,0,8
GGACAAGCCATGATCG-1_V12D07-332_A1,2,1,0,0,0,3
TCCAATGCGTCGCCGC-1_V12D07-332_A1,0,2,0,0,0,2
AAAGAATGACCTTAGA-1_V12D07-332_A1,0,2,1,0,0,3
CCTATTATTCCGGCCG-1_V12D07-332_A1,1,2,1,0,0,4
CAGTAAGGGACGTCTC-1_V12D07-332_A1,3,0,0,0,0,3
GGGATGGACCCGCGTC-1_V12D07-332_A1,0,1,0,0,0,1
GACGCATACCCGTCGG-1_V12D07-332_A1,1,0,0,1,0,2
GGGCAGGATTTCTGTG-1_V12D07-332_A1,1,1,1,1,0,4
TATCTGAGCCGATATT-1_V12D07-332_A1,0,0,1,0,0,1
AATGTATGGCACTGTA-1_V12D07-332_A1,1,0,1,0,0,2
GCCTTTGTCAGTGGAC-1_V12D07-332_A1,0,0,0,0,0,0
AACCATAGGGTTGAAC-1_V12D07-332_A1,1,0,1,0,0,2
AAACTTAATTGCACGC-1_V12D07-332_A1,0,0,0,0,0,0
TAGGCGGCTGCAAAGA-1_V12D07-332_A1,1,1,1,2,0,5
TCCATCAATACTAATC-1_V12D07-332_A1,1,0,0,0,0,1
ACCTCGAACTTATGCT-1_V12D07-332_A1,3,2,1,0,0,6
ACAAACCATGCGTCCT-1_V12D07-332_A1,0,0,0,0,0,0
ACACCGGTCTGACCGC-1_V12D07-332_A1,2,1,0,0,0,3
ATGGCAGCATTACGAT-1_V12D07-332_A1,1,0,0,1,0,2
CTGGTGAATGGGCCTA-1_V12D07-332_A1,1,1,0,0,0,2
CACAGAGACGAGGACG-1_V12D07-332_A1,1,1,2,0,0,4
GCACAAACCCTAGATG-1_V12D07-332_A1,0,0,0,0,0,0
ACTATGTCCAGCTGCC-1_V12D07-332_A1,2,1,0,0,0,3
AAGCCGCCGTGAAATC-1_V12D07-332_A1,1,0,3,0,0,4
ATGGGTGTATACCTCC-1_V12D07-332_A1,2,2,2,0,0,6
TAAGCGCGAATCAAAT-1_V12D07-332_A1,0,0,0,1,0,1
AGCCCGGCATTAGAGG-1_V12D07-332_A1,0,0,0,0,0,0
GTGATCAAGCGTGCAC-1_V12D07-332_A1,1,1,0,0,0,2
CTGCCTTTAATACCTT-1_V12D07-332_A1,0,1,0,0,0,1
TACCTCCACACCAATG-1_V12D07-332_A1,3,2,0,0,0,5
GAGCATCAACAACTTG-1_V12D07-332_A1,1,1,0,0,0,2
CATACGAACTAGCTGG-1_V12D07-332_A1,3,0,1,0,0,4
GGGAACGGTTTCAGAT-1_V12D07-332_A1,4,0,1,0,0,5
AGGGTGCCGTTCTTTA-1_V12D07-332_A1,5,0,1,0,0,6
ACGACTGGTCATACTC-1_V12D07-332_A1,4,0,0,0,0,4
GGATCTTACTGCCCTT-1_V12D07-332_A1,3,0,2,0,0,5
TACTCCTCTAGTTGAC-1_V12D07-332_A1,6,1,1,0,0,8
GTAGCTCCGGGAGGCT-1_V12D07-332_A1,1,0,2,0,0,3
GGACTCGTGAGTGGTC-1_V12D07-332_A1,4,1,0,0,0,5
GTAGTTCGAAGGCGAA-1_V12D07-332_A1,3,0,1,0,0,4
CTCAAACCACTGCCCG-1_V12D07-332_A1,1,0,1,0,0,2
GAGGGAGTCAGATCGC-1_V12D07-332_A1,7,0,0,0,0,7
GCGTCCCTAAGACATA-1_V12D07-332_A1,4,0,0,0,0,4
TCTCTTACCGCGAACC-1_V12D07-332_A1,2,1,0,0,0,3
GGCTACTATACACTCC-1_V12D07-332_A1,2,0,0,0,0,2
CGTTGCCCGCGTGGGA-1_V12D07-332_A1,1,1,1,0,0,3
TATAGAGTCGCTTGAA-1_V12D07-332_A1,0,1,2,0,0,3
ATGTTGTAGTCTGTTT-1_V12D07-332_A1,5,0,0,0,0,5
AGTATACACAGCGACA-1_V12D07-332_A1,5,1,0,0,0,6
TGTGGTTGCTAAAGCT-1_V12D07-332_A1,2,0,0,0,0,2
TGATTCCCGGTTACCT-1_V12D07-332_A1,1,1,1,0,0,3
CACTGACGATTGTGGA-1_V12D07-332_A1,3,1,3,0,0,7
AACATTGTGACTCGAG-1_V12D07-332_A1,2,0,0,0,0,2
GTCCAATATTTAGCCT-1_V12D07-332_A1,4,1,1,0,0,6
GCTCTTTCCGCTAGTG-1_V12D07-332_A1,1,0,0,0,0,1
GGGTCAGGAGCTAGAT-1_V12D07-332_A1,5,0,0,0,0,5
AGGTGGTGACCTTCGC-1_V12D07-332_A1,2,1,0,0,0,3
CCCGGGTCGTTCAGGG-1_V12D07-332_A1,1,0,2,0,0,3
AGCCAAGCTTTGTGTC-1_V12D07-332_A1,4,0,1,0,0,5
TGTGGCGGGCTTCTGG-1_V12D07-332_A1,0,0,0,0,0,0
CGAGGGTATCCAGGTG-1_V12D07-332_A1,2,0,0,1,0,3
CGTTCAGACCCGCGAA-1_V12D07-332_A1,3,0,0,0,0,3
TCATATGAGCTTTGTT-1_V12D07-332_A1,2,0,1,0,0,3
AGTTGACGGTCCTTGC-1_V12D07-332_A1,2,0,1,0,0,3
ATAATTAGCTAAGTAG-1_V12D07-332_A1,3,1,1,0,0,5
GGTCTTGAGCGCTCTT-1_V12D07-332_A1,1,0,1,0,0,2
CGTTGTCGGCAATTGA-1_V12D07-332_A1,1,0,0,0,0,1
TCTTGCTCCCGATACT-1_V12D07-332_A1,1,1,1,0,0,3
AGCAGAAGGAGAAAGA-1_V12D07-332_A1,0,2,1,0,0,3
GAAGCCACTGATTATG-1_V12D07-332_A1,3,1,2,0,0,6
TGCTCTTGAGAGTTTG-1_V12D07-332_A1,1,0,0,0,0,1
GACATCCGTCGAACTG-1_V12D07-332_A1,5,0,1,0,0,6
AGATATAATACGACTA-1_V12D07-332_A1,2,1,1,1,0,5
TCGCTACTGGCTTTGA-1_V12D07-332_A1,1,2,1,0,0,4
GTGACAGCTTCCCACT-1_V12D07-332_A1,2,0,1,0,0,3
GTGACGCAGGTTTCAT-1_V12D07-332_A1,4,2,0,0,0,6
GGGAAGACGGTCTGTC-1_V12D07-332_A1,6,0,2,0,0,8
CGTCGCATGTGAGCCA-1_V12D07-332_A1,5,0,0,0,0,5
AGAAGGTTGTAGGTCG-1_V12D07-332_A1,1,1,1,0,0,3
GGCCGGCGTCTGCTAT-1_V12D07-332_A1,2,0,0,0,0,2
TTGACCAGGAACAACT-1_V12D07-332_A1,3,1,0,0,0,4
AGTCGTATAAAGCAGA-1_V12D07-332_A1,4,0,5,0,0,9
GGCGTAGGGAAAGCTG-1_V12D07-332_A1,5,0,2,0,0,7
AAACCTAAGCAGCCGG-1_V12D07-332_A1,2,0,3,0,0,5
ATTGCCTTTATGTTTG-1_V12D07-332_A1,5,0,0,0,0,5
CAGGCAGTCTTACCAG-1_V12D07-332_A1,5,0,0,0,0,5
AGCTAAGTACGCAGGC-1_V12D07-332_A1,1,0,0,0,0,1
AAATCCGATACACGCC-1_V12D07-332_A1,0,2,0,0,0,2
CGAGAGCTTTCACTAC-1_V12D07-332_A1,3,1,0,0,0,4
CGCCCAGCGTTTCACG-1_V12D07-332_A1,7,0,0,1,0,8
TTAAGTATTGTTATCC-1_V12D07-332_A1,0,1,2,0,0,3
AAACGGGCGTACGGGT-1_V12D07-332_A1,7,0,0,0,0,7
GTATCCTTTGGTAACC-1_V12D07-332_A1,2,0,0,0,0,2
CATAGTCAAATACATA-1_V12D07-332_A1,4,0,1,0,0,5
TCTATGCTATAACGAC-1_V12D07-332_A1,4,1,1,0,0,6
ACGTTCTGTACAAGTC-1_V12D07-332_A1,1,0,1,1,0,3
CGCGAAGTGGCATACT-1_V12D07-332_A1,2,0,0,0,0,2
ACCAACCGCACTCCAC-1_V12D07-332_A1,6,1,0,0,0,7
GTCATGCGCGAGGGCT-1_V12D07-332_A1,3,1,0,0,0,4
TAGGCTAAAGTGGCAC-1_V12D07-332_A1,2,0,1,1,0,4
TGGCTACACTCTACCT-1_V12D07-332_A1,6,0,1,1,0,8
GTCAACCAGGCCTATA-1_V12D07-332_A1,2,0,3,0,0,5
ATCTTATCGCACACCC-1_V12D07-332_A1,3,0,2,0,0,5
GTCTATTGCATGCTCG-1_V12D07-332_A1,4,0,3,1,0,8
GCACGTGGTTTACTTA-1_V12D07-332_A1,4,0,3,0,0,7
ATTCGCGCCTTGAGAG-1_V12D07-332_A1,4,1,0,0,0,5
AGCGATGCGCCTAATA-1_V12D07-332_A1,2,1,1,0,0,4
TCTATAGGTGGGTAAT-1_V12D07-332_A1,1,0,0,0,0,1
AGATACCAATAGAACC-1_V12D07-332_A1,3,1,0,0,0,4
CGTGTATGGGAGCTGA-1_V12D07-332_A1,4,0,0,1,0,5
ATGTACATGCGGTGAG-1_V12D07-332_A1,4,1,1,0,0,6
TTGGCTCAATATGTGT-1_V12D07-332_A1,4,0,1,0,0,5
GTTCGGAGCACTCAAC-1_V12D07-332_A1,4,0,1,0,0,5
TCCCTCTTCTCAAGGG-1_V12D07-332_A1,4,0,2,0,0,6
TTACGTATCTATGACA-1_V12D07-332_A1,4,1,1,0,0,6
CCCATATAGGTCGATT-1_V12D07-332_A1,4,1,0,0,0,5
GTCCACGTCGCATTCG-1_V12D07-332_A1,1,0,1,0,0,2
AATTGTGGTTGCCAAA-1_V12D07-332_A1,4,1,0,0,0,5
AGGAACGAACGACTTC-1_V12D07-332_A1,4,1,0,0,0,5
TAATTCCAATGCTTCA-1_V12D07-332_A1,5,0,4,1,0,10
AGGGCCCTAATGTTCT-1_V12D07-332_A1,7,0,1,0,0,8
AGGTGTTGCCGACCAC-1_V12D07-332_A1,4,1,0,0,0,5
CTGAGAGTAGAAATAC-1_V12D07-332_A1,3,0,2,0,0,5
TAGAAGAAGGGTTACA-1_V12D07-332_A1,4,0,2,0,0,6
GGTGACTGATAGAGAG-1_V12D07-332_A1,1,0,2,0,0,3
TACCCTCGGTAACCCT-1_V12D07-332_A1,5,0,0,0,0,5
TGTAAGACTGATAAGA-1_V12D07-332_A1,0,1,1,0,0,2
GTCACTCATGAGCGAT-1_V12D07-332_A1,1,2,0,0,0,3
CGGTTTACTGAACATT-1_V12D07-332_A1,1,1,0,0,0,2
GAGATCGATCTTACTC-1_V12D07-332_A1,0,0,0,0,0,0
TCTTTCATCCGTCCTT-1_V12D07-332_A1,0,0,0,0,0,0
TCGGATCTGGATGACC-1_V12D07-332_A1,1,2,2,0,0,5
GTCCTAGGATACCTTA-1_V12D07-332_A1,2,0,0,0,0,2
TGTACCCGACCCTAAT-1_V12D07-332_A1,0,0,0,0,0,0
AGGTTCTCCTTTCCGG-1_V12D07-332_A1,1,2,0,0,0,3
AATTGCGTGGATTACA-1_V12D07-332_A1,1,1,2,0,0,4
CGATAGCGATACAGTG-1_V12D07-332_A1,2,0,0,0,0,2
CGCCCTAATTGTTCAA-1_V12D07-332_A1,0,3,0,1,0,4
ATTATGAGACCCAATT-1_V12D07-332_A1,0,0,0,0,0,0
CCTCCTAGCTAGAGTC-1_V12D07-332_A1,3,0,1,1,0,5
CGAAGGGTTTCAGATT-1_V12D07-332_A1,0,0,0,0,0,0
CACAAGCTAAGAAAGG-1_V12D07-332_A1,2,1,0,0,0,3
CACCGGTAGAGACATT-1_V12D07-332_A1,6,0,0,1,0,7
ACTCATGGCAGCCTTC-1_V12D07-332_A1,3,5,0,0,0,8
CATCCAATATAGTTTG-1_V12D07-332_A1,0,0,0,1,0,1
CAGATATGAAGATGAC-1_V12D07-332_A1,0,0,0,0,0,0
GCAAAGGGCGTTAGCC-1_V12D07-332_A1,4,0,0,0,0,4
CTGTTGTTCAGTCGTA-1_V12D07-332_A1,1,1,1,0,0,3
AAAGGCCCTATAATAC-1_V12D07-332_A1,1,0,0,1,0,2
AACATTGAAGTTGATC-1_V12D07-332_A1,3,0,0,0,0,3
GCTAGCGATAGGTCTT-1_V12D07-332_A1,3,0,0,2,0,5
ATTGCCTATTAGACCG-1_V12D07-332_A1,3,1,0,0,0,4
GGGCGTTTACATTCAT-1_V12D07-332_A1,0,0,0,2,0,2
CCTCTACAAGGATTGG-1_V12D07-332_A1,4,0,0,0,0,4
AGTGACTGTGACACAA-1_V12D07-332_A1,1,0,0,0,0,1
AGCCCTCCCTGGTGGC-1_V12D07-332_A1,3,1,1,0,0,5
CGGTTGAGTATCCTTC-1_V12D07-332_A1,4,1,1,0,0,6
CATTATCCCATTAACG-1_V12D07-332_A1,2,0,0,0,0,2
AATGTGCTAATCTGAG-1_V12D07-332_A1,2,0,0,0,0,2
CTTAGTTGAGGAATCG-1_V12D07-332_A1,1,0,0,0,0,1
CTTCTGGGCGTACCTA-1_V12D07-332_A1,2,0,0,0,0,2
AGTCAAATGATGTGAT-1_V12D07-332_A1,5,1,0,0,0,6
TGAACAAGCAGGGACT-1_V12D07-332_A1,3,0,1,0,0,4
AATACCGGAGGGCTGT-1_V12D07-332_A1,5,0,0,0,0,5
GTTTGGTGATCGGTGC-1_V12D07-332_A1,7,1,1,0,0,9
GACTGCTGGTGAGAAA-1_V12D07-332_A1,2,0,0,0,0,2
CGATCCTCGCAACATA-1_V12D07-332_A1,4,0,2,0,0,6
CCAACCTTATGTAACT-1_V12D07-332_A1,6,0,0,0,0,6
CGTGGTACCCAAAGGC-1_V12D07-332_A1,1,2,1,0,0,4
AACCCGACAACCCGTG-1_V12D07-332_A1,3,0,2,0,0,5
TATGTAAAGTGCTTAA-1_V12D07-332_A1,3,1,0,0,0,4
GCAAGTGTAAAGCATG-1_V12D07-332_A1,2,0,1,0,0,3
GTAACTGCCCAAGGAG-1_V12D07-332_A1,2,0,0,0,0,2
GGTGCATAAATGATTA-1_V12D07-332_A1,1,0,0,0,0,1
TAGTCCCGGAGACCAC-1_V12D07-332_A1,0,1,2,0,0,3
CGGCCAGAGCGACCAT-1_V12D07-332_A1,0,0,1,0,0,1
TGAATGAGTGTTTCCC-1_V12D07-332_A1,4,3,0,0,0,7
TTCACTTCCTAGAACG-1_V12D07-332_A1,2,0,1,0,0,3
CGCTTAGTATTGATAC-1_V12D07-332_A1,7,1,0,0,0,8
AACGCGACCTTGGGCG-1_V12D07-332_A1,6,1,1,0,0,8
GTGCACCAGCTTCAAC-1_V12D07-332_A1,1,0,1,0,0,2
TTCTATTAAACGCAGC-1_V12D07-332_A1,1,1,2,0,0,4
TGGCAAGCACAAGTCG-1_V12D07-332_A1,3,1,0,0,0,4
ATCTGCTGTTATCGCC-1_V12D07-332_A1,2,0,0,0,0,2
AATTCCAAGCATGTAC-1_V12D07-332_A1,0,0,2,0,0,2
AAACGGTTGCGAACTG-1_V12D07-332_A1,6,0,0,0,0,6
GAAGGAGTCGAGTGCG-1_V12D07-332_A1,5,1,1,0,0,7
GGCAAGCCCATAGTGG-1_V12D07-332_A1,5,1,0,0,0,6
TGACCAAATCTTAAAC-1_V12D07-332_A1,3,0,0,0,0,3
TTCGGTACTGTAGAGG-1_V12D07-332_A1,2,0,0,0,0,2
ATGTACGATGACGTCG-1_V12D07-332_A1,1,1,0,1,0,3
ATCTAGCTTGTGAGGG-1_V12D07-332_A1,2,0,0,1,0,3
AGCGGGTCTGACACTC-1_V12D07-332_A1,1,1,0,0,0,2
GAGGTACGCGTGTCCC-1_V12D07-332_A1,1,3,1,0,0,5
GCACTGCCTACCTTTA-1_V12D07-332_A1,0,1,0,0,0,1
GGAGCGAGGCCTACTT-1_V12D07-332_A1,3,0,1,0,0,4
AAACTCGGTTCGCAAT-1_V12D07-332_A1,0,1,1,0,0,2
GGCGCTTCATTCCCTG-1_V12D07-332_A1,1,3,1,0,0,5
TGCTCGGTGGGTCACC-1_V12D07-332_A1,1,2,0,0,0,3
AAGCGCAGGGCTTTGA-1_V12D07-332_A1,1,0,0,0,0,1
GACCTTCCACGTCTAC-1_V12D07-332_A1,1,1,2,0,0,4
GTTAGCCCATGACATC-1_V12D07-332_A1,3,1,0,0,0,4
AATTCGATTCGAGGAT-1_V12D07-332_A1,1,1,1,0,0,3
AGTCTTTAAAGTGTCC-1_V12D07-332_A1,0,0,2,0,0,2
GACTAGGCCGTTAGGT-1_V12D07-332_A1,2,0,0,0,0,2
TCCAAGCCTAGACACA-1_V12D07-332_A1,2,1,1,0,0,4
GATTGGGAAAGGTTGT-1_V12D07-332_A1,3,0,0,0,0,3
GATGAGGAACCTTCGG-1_V12D07-332_A1,1,1,0,0,0,2
TGAATACCGACGCGTA-1_V12D07-332_A1,3,1,0,0,0,4
AATCGTGAGCCGAGCA-1_V12D07-332_A1,3,0,3,0,0,6
GCGAAGAATCTGACGG-1_V12D07-332_A1,1,0,1,0,0,2
GAACAACTGGGATGAA-1_V12D07-332_A1,2,1,2,0,0,5
TCGCCGACATATTCGC-1_V12D07-332_A1,2,1,0,0,0,3
CGTAGAGAGTAATTAT-1_V12D07-332_A1,2,0,0,0,0,2
CGATAGTCGTACTGCA-1_V12D07-332_A1,3,0,0,0,0,3
CGCATGCCGAATGCGT-1_V12D07-332_A1,1,2,0,0,0,3
CTCTAGCCCTCGGAAA-1_V12D07-332_A1,1,0,0,0,0,1
TCCAACTCAGCTATCT-1_V12D07-332_A1,1,1,0,1,0,3
GTCTAGTGAGCCGCTT-1_V12D07-332_A1,0,3,1,0,0,4
TACCGAATAATTGTAA-1_V12D07-332_A1,2,1,3,0,0,6
ATATAACACGGGCGCA-1_V12D07-332_A1,4,0,1,0,0,5
GCATGCTAATAACGAT-1_V12D07-332_A1,7,0,0,0,0,7
TCCGGGCTTGACGGGA-1_V12D07-332_A1,3,0,2,0,0,5
ATTATTCAGAGTCACT-1_V12D07-332_A1,2,1,0,1,0,4
TAGCAGTATGACTAAA-1_V12D07-332_A1,4,0,0,0,0,4
TATGAAGAATTAAGGT-1_V12D07-332_A1,1,0,0,0,0,1
CAAGGCCAGTGGTGCA-1_V12D07-332_A1,0,0,2,0,0,2
TGCGTACGGCTAATTG-1_V12D07-332_A1,4,0,2,0,0,6
CAGATAATGGGCGGGT-1_V12D07-332_A1,0,1,0,0,0,1
GAGAACGGTTCTGACT-1_V12D07-332_A1,5,0,1,0,0,6
CGCTTCGGTCTAAGAC-1_V12D07-332_A1,4,1,0,0,0,5
AGCATTACGAGGCAAG-1_V12D07-332_A1,2,1,2,0,0,5
AAGTTGTGATGTTATA-1_V12D07-332_A1,3,0,0,0,0,3
TTGCTCATAGTACGTG-1_V12D07-332_A1,1,0,2,0,0,3
TACTTAAACATGTACA-1_V12D07-332_A1,7,1,0,0,0,8
AGTGAGTCGAATTAAC-1_V12D07-332_A1,2,0,1,0,0,3
TAGGCCTATATAGTCT-1_V12D07-332_A1,7,1,0,0,0,8
ACTCGCCGTTCGATAA-1_V12D07-332_A1,3,0,1,0,0,4
GGTACGTTGCGGCCGG-1_V12D07-332_A1,0,0,2,0,0,2
TATTGCCGGGCTTGTA-1_V12D07-332_A1,5,0,2,0,0,7
GGTAAACTCTGCGCTG-1_V12D07-332_A1,5,0,1,0,0,6
TCCCTTGTCTGAAACT-1_V12D07-332_A1,2,0,0,0,0,2
CATGATCGCTTTGAGA-1_V12D07-332_A1,3,0,1,0,0,4
GGACGGGCGACCAACC-1_V12D07-332_A1,0,1,0,0,0,1
GAGAGGCCTATGTGTA-1_V12D07-332_A1,2,0,0,0,0,2
TCGTAACTCCCAAGAC-1_V12D07-332_A1,4,0,0,0,0,4
CGTATCTAGAACTAAG-1_V12D07-332_A1,6,0,0,0,0,6
GCACCTTCCCGAAGGT-1_V12D07-332_A1,2,0,1,0,0,3
TACCTCTTTACCATCC-1_V12D07-332_A1,1,1,0,0,0,2
TGACTCTAACTGGTAA-1_V12D07-332_A1,2,2,1,0,0,5
GAGAAACTGGATCCCA-1_V12D07-332_A1,1,0,1,0,0,2
ATCCGGACCAGCCTGA-1_V12D07-332_A1,2,0,1,0,0,3
TTATTTAGGTTCCTTA-1_V12D07-332_A1,5,1,0,0,0,6
CGAATTCCCGGTTCAA-1_V12D07-332_A1,3,0,1,0,0,4
TAGTTTGATCGGTCGC-1_V12D07-332_A1,0,0,0,1,0,1
AGTCGAAACGATTCAG-1_V12D07-332_A1,1,1,0,1,0,3
ACGTCGGGCAACTCGG-1_V12D07-332_A1,0,0,0,0,0,0
ACTTGCTCTATCTACC-1_V12D07-332_A1,1,0,1,0,0,2
ATTACGGGCTACGGTT-1_V12D07-332_A1,1,0,0,1,0,2
GCAAACGTAAGCGACC-1_V12D07-332_A1,0,0,0,0,0,0
TTCGGACTGGGCATGG-1_V12D07-332_A1,0,0,0,0,0,0
GGGCCATTCGTGCTGG-1_V12D07-332_A1,0,2,0,1,0,3
GAGTTGTCACCAGTCT-1_V12D07-332_A1,3,2,0,1,0,6
AGTAATTTGCAAGCGT-1_V12D07-332_A1,1,2,0,0,0,3
GTGGCCGGTTTCTCGG-1_V12D07-332_A1,0,0,1,0,0,1
ATCTTAGGGCATTAAT-1_V12D07-332_A1,1,2,2,0,0,5
CTACATATCGCGGGAC-1_V12D07-332_A1,0,1,0,0,0,1
ATGGTATTTACTGATT-1_V12D07-332_A1,1,0,0,0,0,1
CCGTCAACCTCTGGCG-1_V12D07-332_A1,0,0,0,0,0,0
GCTTCGACGTTCAATC-1_V12D07-332_A1,0,0,0,0,0,0
GACCGATTAAATATGT-1_V12D07-332_A1,3,1,1,1,0,6
GTCGAATTTGGGCGCT-1_V12D07-332_A1,0,1,0,0,0,1
TCACGGCCCAAGAGAG-1_V12D07-332_A1,0,1,0,0,0,1
CTACGATCCTATCCTA-1_V12D07-332_A1,0,2,0,1,0,3
TGCAGTGGTAGGGAAC-1_V12D07-332_A1,1,0,0,1,0,2
TTGCCTAATCCAAAGT-1_V12D07-332_A1,1,3,0,1,0,5
AGCGAGACGTGAAGGC-1_V12D07-332_A1,2,1,0,0,0,3
TTCTACCTCAATCGGT-1_V12D07-332_A1,1,1,0,0,0,2
TACGCTGCTGTGTTAA-1_V12D07-332_A1,0,1,1,0,0,2
TAGTCCTGCACTAAGC-1_V12D07-332_A1,2,0,1,3,0,6
AGCACACGTTTAGACT-1_V12D07-332_A1,2,1,0,0,0,3
GTTCGACAATTGTATA-1_V12D07-332_A1,3,1,0,0,0,4
CCATGTTCATCTATAT-1_V12D07-332_A1,3,1,0,0,0,4
CCCTCGATAATACACA-1_V12D07-332_A1,2,0,0,0,0,2
ACTGCCCGCCATTCTC-1_V12D07-332_A1,3,0,0,0,0,3
CTATATCCAGCCTGGC-1_V12D07-332_A1,2,0,0,0,0,2
CGCACGTCTGTTTATG-1_V12D07-332_A1,1,0,1,0,0,2
AATCAGGTTTCATTTA-1_V12D07-332_A1,0,2,1,0,0,3
AGAGAAACACCAGAAA-1_V12D07-332_A1,3,1,0,0,0,4
ACCCGATTGGTTCCGA-1_V12D07-332_A1,1,0,1,0,0,2
TACCAGGAATCCCGTC-1_V12D07-332_A1,3,1,1,0,0,5
AAGTGCTTCTCTATTG-1_V12D07-332_A1,2,0,0,0,0,2
TGCATGTGACCCATAG-1_V12D07-332_A1,1,0,0,0,0,1
TAGATTCAAAGTGCGG-1_V12D07-332_A1,3,1,1,0,0,5
AGGGTCAGAGCACTCG-1_V12D07-332_A1,4,0,2,0,0,6
GTGAGATAACCTTATA-1_V12D07-332_A1,1,2,0,0,0,3
GTGTCAGTGTACGTGG-1_V12D07-332_A1,7,1,1,0,0,9
CTGTAGTGAGGATCGA-1_V12D07-332_A1,3,1,0,0,0,4
GATAGTGCGAGTAAGT-1_V12D07-332_A1,0,0,2,0,0,2
AGGGTTCAGACGGTCC-1_V12D07-332_A1,2,1,0,0,0,3
GGACTCGACAGCGCAT-1_V12D07-332_A1,3,1,0,0,0,4
CACTCTCAAGCATCGA-1_V12D07-332_A1,1,2,0,0,0,3
GAGCGGAATGCGGTGT-1_V12D07-332_A1,3,1,0,0,0,4
CAGTTCGAGGACCCGA-1_V12D07-332_A1,3,0,0,0,0,3
CGTAACTTCGACACTT-1_V12D07-332_A1,3,0,0,0,0,3
TGATCACCACACTGAC-1_V12D07-332_A1,2,0,2,0,0,4
CATACTTCTTTCTCCG-1_V12D07-332_A1,3,2,0,0,0,5
CAAGTAAGTGATAGAC-1_V12D07-332_A1,5,1,0,0,0,6
AGCCCGCAACAAGCAG-1_V12D07-332_A1,5,0,0,0,0,5
GCTCCATGCAAAGCAA-1_V12D07-332_A1,5,1,1,0,0,7
TCGTACCGACGTCAAG-1_V12D07-332_A1,3,2,3,0,0,8
ATTATCGGAATGTACG-1_V12D07-332_A1,0,3,1,0,0,4
ACCTACTATAAATCTA-1_V12D07-332_A1,4,0,3,0,0,7
TATCCTATCAACTGGT-1_V12D07-332_A1,1,3,0,0,0,4
GCGCGGTCTAGTAACT-1_V12D07-332_A1,4,2,0,0,0,6
CCTTCGTATAGAATCC-1_V12D07-332_A1,3,0,1,0,0,4
TGGGCGATACAATAAG-1_V12D07-332_A1,2,1,0,0,0,3
TGACATGTAACGTGAC-1_V12D07-332_A1,1,2,0,0,0,3
TTGGGAAGACGAGCCG-1_V12D07-332_A1,3,5,0,0,0,8
GGTGTAAATCGATTGT-1_V12D07-332_A1,3,0,1,0,0,4
GAACTGTGGAGAGACA-1_V12D07-332_A1,3,1,0,0,0,4
TCCACATCGTATATTG-1_V12D07-332_A1,6,0,0,0,0,6
CCTATGGTCAAAGCTG-1_V12D07-332_A1,0,2,4,0,0,6
TCCTTGTCCTTTAATT-1_V12D07-332_A1,4,0,0,0,0,4
AAGTTTATGGGCCCAA-1_V12D07-332_A1,1,0,1,1,0,3
GTCCGGGTTCACATTA-1_V12D07-332_A1,2,1,0,1,0,4
ATGTAGCGCGCGTAGG-1_V12D07-332_A1,2,0,2,0,0,4
TACGGAAGCCAAACCA-1_V12D07-332_A1,3,0,1,0,0,4
GCCCTGAGGATGGGCT-1_V12D07-332_A1,0,0,0,0,0,0
CGGGCGATGGATCACG-1_V12D07-332_A1,3,1,0,0,0,4
TGCGGACTTGACTCCG-1_V12D07-332_A1,1,0,0,0,0,1
TAATACTAGAACAGAC-1_V12D07-332_A1,5,1,1,0,0,7
TCAAATTGTTGTGCCG-1_V12D07-332_A1,2,0,0,0,0,2
GGGCAGTCAACGCCAA-1_V12D07-332_A1,1,0,2,0,0,3
TCGCTGCCAATGCTGT-1_V12D07-332_A1,4,0,0,0,0,4
TACGTGGGCCCAGGGC-1_V12D07-332_A1,0,1,0,0,0,1
GCCTACGTTCTGTGCA-1_V12D07-332_A1,3,0,0,0,0,3
TTGCGTGTGTAGGCAT-1_V12D07-332_A1,2,0,1,0,0,3
TCCTAAAGATTCAGAC-1_V12D07-332_A1,3,3,1,0,0,7
TGGGTGCACAAGCCAT-1_V12D07-332_A1,3,4,0,0,0,7
GGGAGCGACCGTAGTG-1_V12D07-332_A1,3,0,1,0,0,4
CATAGAGGAGATACTA-1_V12D07-332_A1,5,1,1,0,0,7
CTTCGATTGCGCAAGC-1_V12D07-332_A1,1,1,0,0,0,2
GTGCCTGAGACCAAAC-1_V12D07-332_A1,4,0,3,0,0,7
TCATCCTCAGCTGCTT-1_V12D07-332_A1,3,2,2,0,0,7
TGCAACTACTGGTTGA-1_V12D07-332_A1,8,0,0,0,0,8
ATGTTGATTAGAGACT-1_V12D07-332_A1,5,0,2,0,0,7
GTTTCTAGAGGCGCGG-1_V12D07-332_A1,6,0,0,0,0,6
TACAAGGGCTTCTTTA-1_V12D07-332_A1,5,1,1,0,0,7
ACAGGCACGGATCCTT-1_V12D07-332_A1,7,0,0,0,0,7
CCCAAGTCATTACACT-1_V12D07-332_A1,3,0,0,0,0,3
ACTCTGACCTAATAGA-1_V12D07-332_A1,6,0,0,0,0,6
GGATGGCTTGAAGTAT-1_V12D07-332_A1,1,2,2,0,0,5
ACCCTCCCGTCAGGGC-1_V12D07-332_A1,5,0,1,0,0,6
AGCTTCTTCTCGAGCA-1_V12D07-332_A1,6,0,1,0,0,7
TTGCGCTTGATCAATA-1_V12D07-332_A1,3,0,3,0,0,6
TGGGTGTAATAGATTT-1_V12D07-332_A1,6,2,0,0,0,8
CATGGTTTATTAATCA-1_V12D07-332_A1,0,1,1,1,0,3
TTGCCTTCTCGCCGGG-1_V12D07-332_A1,2,1,0,0,0,3
TTAAAGTAAGTCGCCA-1_V12D07-332_A1,3,0,4,0,0,7
AGTTGGCAAGGCTAGA-1_V12D07-332_A1,5,0,1,0,0,6
CCGCACTTGCAATGAC-1_V12D07-332_A1,0,1,0,0,0,1
AATGTTGTCGTGAGAC-1_V12D07-332_A1,5,0,1,0,0,6
CCAAGGTTGCCCTTTC-1_V12D07-332_A1,5,0,0,0,0,5
TGTGACTAGAGTTTGC-1_V12D07-332_A1,0,2,0,0,0,2
TTGTGATCTGTTCAGT-1_V12D07-332_A1,0,0,0,0,0,0
GGAGTTGATTCTGTGT-1_V12D07-332_A1,2,0,0,0,0,2
GTAGTGAGCAACCTCA-1_V12D07-332_A1,3,0,0,0,0,3
AAGACATACGTGGTTT-1_V12D07-332_A1,3,1,0,0,0,4
CATCCCGAGATTCATA-1_V12D07-332_A1,1,0,2,0,0,3
GGCCGCAGGAACCGCA-1_V12D07-332_A1,9,0,3,0,0,12
CCAGAAACTGATGCGA-1_V12D07-332_A1,7,1,0,0,0,8
ACCCGTAGTCTAGTTG-1_V12D07-332_A1,2,0,1,0,0,3
AGGGTCTGGACGCAGT-1_V12D07-332_A1,0,0,2,0,0,2
TTGAAACCCTCATTCC-1_V12D07-332_A1,4,1,0,1,0,6
TCAATCCCGCGCCAAA-1_V12D07-332_A1,1,0,1,0,0,2
AGGACATCGGCACACT-1_V12D07-332_A1,3,2,1,0,0,6
GACAAGACGCCCGTGC-1_V12D07-332_A1,3,1,3,0,0,7
GAGTAAATTAAGAACC-1_V12D07-332_A1,0,0,2,1,0,3
TAAGTCGGTGAGCTAG-1_V12D07-332_A1,1,0,2,0,0,3
CTTACTGACTCCTCTG-1_V12D07-332_A1,1,2,1,0,0,4
TTAACTGATCGTTTGG-1_V12D07-332_A1,1,0,1,0,0,2
GGGCGATCCATAGGCC-1_V12D07-332_A1,0,1,1,1,0,3
CGTATTGTTTGGCGCC-1_V12D07-332_A1,0,0,0,0,0,0
CGCGTGGGCCTGTGTT-1_V12D07-332_A1,0,1,1,0,0,2
AAATCTGCCCGCGTCC-1_V12D07-332_A1,0,0,1,0,0,1
GCTGAAGGGTTCTTGG-1_V12D07-332_A1,0,1,0,0,0,1
TAATTGCGCTGATTAC-1_V12D07-332_A1,3,0,1,0,0,4
TCGCGCGTTTACATGA-1_V12D07-332_A1,2,0,0,0,0,2
TAACTGAAATACGCCT-1_V12D07-332_A1,0,0,1,0,0,1
CCTGTCGTGTATGAAG-1_V12D07-332_A1,2,0,0,1,0,3
CGGGAACGCCCTGCAT-1_V12D07-332_A1,1,1,0,0,0,2
AGTTGCGGTCCTCAAC-1_V12D07-332_A1,1,1,0,0,0,2
GGGTCCTTGGAAGAAG-1_V12D07-332_A1,1,0,1,0,0,2
CGGGAAGTACCGTGGC-1_V12D07-332_A1,1,1,0,0,0,2
ACGGTCACCGAGAACA-1_V12D07-332_A1,0,0,0,0,0,0
TAGACTCAGTTGGCCT-1_V12D07-332_A1,0,0,0,0,0,0
CCTTCCGCAACGCTGC-1_V12D07-332_A1,2,1,1,0,0,4
CAGTGTTAATCTCTCA-1_V12D07-332_A1,1,0,1,1,0,3
CAGGCCAGTACCACCT-1_V12D07-332_A1,1,1,0,1,0,3
GATCGCTGTGGTGCGT-1_V12D07-332_A1,1,0,1,0,0,2
GTATCTCGGGCGCTTT-1_V12D07-332_A1,2,1,0,0,0,3
CCGGGCTAAGAATTTC-1_V12D07-332_A1,0,1,0,0,0,1
CTTCACGCCCTGGTAC-1_V12D07-332_A1,2,0,0,1,0,3
CGGATGAATGCTGTGA-1_V12D07-332_A1,0,1,1,0,0,2
CTCTGCAGGCATTCTT-1_V12D07-332_A1,2,0,0,1,0,3
TCAAAGTCACGGCGTC-1_V12D07-332_A1,1,0,2,0,0,3
TGGGTTTCGGGCGTAC-1_V12D07-332_A1,1,1,1,0,0,3
TGCTATGGCAAAGGGA-1_V12D07-332_A1,2,2,1,0,0,5
TTCACGGTCGTCACGT-1_V12D07-332_A1,0,1,0,0,0,1
CGTAAAGCAAGAAATC-1_V12D07-332_A1,2,0,1,1,0,4
CTGATCCCTTTATGCA-1_V12D07-332_A1,1,0,1,0,0,2
GAGTATACCCTAATCA-1_V12D07-332_A1,2,0,0,0,0,2
CCACGGCAGGTGTAGG-1_V12D07-332_A1,0,0,0,0,0,0
ACGTACTTTGGCACGG-1_V12D07-332_A1,2,0,1,0,0,3
CCTGAGAATAAATGCA-1_V12D07-332_A1,2,1,0,0,0,3
TTGATGCCGCTCGTCG-1_V12D07-332_A1,2,0,1,0,0,3
GCCAGGAAAGAACACT-1_V12D07-332_A1,1,0,0,0,0,1
TCCGACCGCTAATCAA-1_V12D07-332_A1,3,0,1,0,0,4
TATATCAAAGTGATCT-1_V12D07-332_A1,4,2,0,0,0,6
CCTCGGTTTCCTTGCC-1_V12D07-332_A1,2,2,0,0,0,4
TAAATTTAGTAACACC-1_V12D07-332_A1,6,1,0,0,0,7
CTCGTTACGGCTACCA-1_V12D07-332_A1,2,3,0,0,0,5
GCCGTCGGTTTCGGGC-1_V12D07-332_A1,2,0,1,0,0,3
GTTCCGTCCGCCTGCA-1_V12D07-332_A1,1,1,0,0,0,2
CTAGGGATAGGGACAA-1_V12D07-332_A1,1,1,0,0,0,2
GTCCAGGCACGTGTGC-1_V12D07-332_A1,3,0,0,0,0,3
GAGGAATATCTCTTTG-1_V12D07-332_A1,1,1,0,0,0,2
CGTTCAAGGAAACGGA-1_V12D07-332_A1,1,0,0,0,0,1
GTGGGAACAAACCGGG-1_V12D07-332_A1,1,0,6,0,0,7
GGGCACGTAGTACTGT-1_V12D07-332_A1,1,0,0,0,0,1
ACTACAAAGAGAGGTG-1_V12D07-332_A1,2,1,1,0,0,4
GGTGTAGGTAAGTAAA-1_V12D07-332_A1,4,0,0,0,0,4
CCTGTTCAACCTCGGG-1_V12D07-332_A1,1,0,0,0,0,1
TGAGGTGTGTGGCGGA-1_V12D07-332_A1,1,1,1,0,0,3
ATTGTCTGTTTCATGT-1_V12D07-332_A1,4,1,0,0,0,5
GCCGGTCGTATCTCTC-1_V12D07-332_A1,6,0,1,0,0,7
ATATGGGATAGCAACT-1_V12D07-332_A1,0,1,0,0,0,1
GATAGAACCCGCTAGG-1_V12D07-332_A1,1,1,0,0,0,2
ATCCCATTTCCGTGGG-1_V12D07-332_A1,4,1,1,0,0,6
GATGCTACCTTCGATG-1_V12D07-332_A1,4,2,0,0,0,6
TGCAAAGTTCGTCTGT-1_V12D07-332_A1,3,3,1,0,0,7
GTTCAGTCGCCAAATG-1_V12D07-332_A1,5,0,0,0,0,5
GTCTCCGCCTCAATAC-1_V12D07-332_A1,3,0,0,0,0,3
AGTAGAAGGCGCCTCA-1_V12D07-332_A1,1,2,1,0,0,4
GTTGTAGATTTATGAG-1_V12D07-332_A1,2,1,0,0,0,3
CTATTTGCTTGGAGGA-1_V12D07-332_A1,3,1,0,0,0,4
AGCCATATAGTATGTG-1_V12D07-332_A1,1,1,0,0,0,2
TGTTCCGGCCTGAGCT-1_V12D07-332_A1,3,0,2,0,0,5
TGCCGTGGGACCCAAT-1_V12D07-332_A1,0,0,1,0,0,1
TTGCAAGAAGACTCCT-1_V12D07-332_A1,3,2,0,0,0,5
CCGCTCCAGGGCGATC-1_V12D07-332_A1,2,2,0,0,0,4
CAAACCCTCCGGCGGG-1_V12D07-332_A1,0,1,2,0,0,3
CGGACCTTTACGTCCC-1_V12D07-332_A1,2,1,0,0,0,3
ACGTAGGAGAGTCGCT-1_V12D07-332_A1,4,3,0,1,0,8
CTGCGACCTCGCCGAA-1_V12D07-332_A1,1,3,1,0,0,5
GGCCCAGCTGGTTTGC-1_V12D07-332_A1,2,1,1,0,0,4
GGATTAATCATGGACC-1_V12D07-332_A1,1,0,2,0,0,3
GAGATGGCTTTAATCA-1_V12D07-332_A1,3,0,0,0,0,3
AGTACAGAAGCTTATA-1_V12D07-332_A1,0,0,0,1,0,1
GCGGCTTTAGCAAGTT-1_V12D07-332_A1,3,0,0,0,0,3
ACCGAGTCTCCTTATT-1_V12D07-332_A1,3,0,1,0,0,4
GACCACACTTCCCTTT-1_V12D07-332_A1,2,0,0,0,0,2
TGTAGCCAATTCCGTT-1_V12D07-332_A1,2,1,1,1,0,5
CTCGTCTGTGCCTTCG-1_V12D07-332_A1,1,0,3,0,0,4
GGACTCTTTGACTAAG-1_V12D07-332_A1,2,0,1,0,0,3
TCATCGACGACCGTCG-1_V12D07-332_A1,4,0,0,0,0,4
TACTACGTGCAATGCG-1_V12D07-332_A1,2,0,0,0,0,2
CCCTACTTGAACAATG-1_V12D07-332_A1,1,1,1,0,0,3
GCAGCTGTCAACGCAT-1_V12D07-332_A1,4,1,0,0,0,5
ATCTACCATCTGCTCC-1_V12D07-332_A1,5,0,1,0,0,6
TCTCAAATCAATCGGG-1_V12D07-332_A1,3,1,2,0,0,6
ACTCCGGCCGACCACT-1_V12D07-332_A1,3,0,0,0,0,3
TACACCTCTTCGAATC-1_V12D07-332_A1,6,0,0,0,0,6
GTGGCTGTTTCTGTTC-1_V12D07-332_A1,4,2,1,0,0,7
ACGACTCTAGGGCCGA-1_V12D07-332_A1,4,0,0,0,0,4
TCGTTTACGCGACCCT-1_V12D07-332_A1,4,1,0,0,0,5
AGGATATCCGACTGCA-1_V12D07-332_A1,3,0,0,0,0,3
GACACTTCCAATTACC-1_V12D07-332_A1,2,0,1,0,0,3
ACGGTACAGTTCAATG-1_V12D07-332_A1,0,0,1,0,0,1
CTTGATGACCATCCAG-1_V12D07-332_A1,5,1,0,0,0,6
CTGGTAAAGACTTACA-1_V12D07-332_A1,5,0,3,0,0,8
CTTGCCCACCCACGCA-1_V12D07-332_A1,0,1,0,0,0,1
CATTACGCAGGAAGGG-1_V12D07-332_A1,4,0,1,0,0,5
GGACAACCATGAAGCC-1_V12D07-332_A1,2,0,1,0,0,3
GTTATCAAGCTATCGA-1_V12D07-332_A1,3,2,2,1,0,8
AGGTGCACGTCCACAT-1_V12D07-332_A1,3,0,3,0,0,6
AAAGAATGTGGACTAA-1_V12D07-332_A1,6,0,2,0,0,8
ACCAAGTCATCGGCAG-1_V12D07-332_A1,2,0,0,0,0,2
AGTAACTATAGCAGCC-1_V12D07-332_A1,3,0,0,0,0,3
GGGAAAGAATGCCAAC-1_V12D07-332_A1,1,1,1,0,0,3
AATCGGTATAGCCCTC-1_V12D07-332_A1,9,0,0,0,0,9
GGCACTGCGGTGGTTT-1_V12D07-332_A1,0,1,3,0,0,4
CGTCCTCATCGCGTGC-1_V12D07-332_A1,1,1,0,0,0,2
CTTAACTTACAGTATA-1_V12D07-332_A1,3,0,1,0,0,4
GTGAGTCGACTAATAG-1_V12D07-332_A1,4,0,0,0,0,4
TGTACTTCCGGGCATG-1_V12D07-332_A1,4,0,0,0,0,4
CACAAACCGCAGAACT-1_V12D07-332_A1,5,0,0,0,0,5
GCTTTACACAACTGGG-1_V12D07-332_A1,3,0,1,0,0,4
CACCGATGATGGGTAC-1_V12D07-332_A1,3,1,0,0,0,4
TCAATATACAGGAGGC-1_V12D07-332_A1,3,0,1,0,0,4
AACGACCTCCTAGCCG-1_V12D07-332_A1,6,0,1,0,0,7
GTTACCAAGGCGTACG-1_V12D07-332_A1,4,0,1,0,0,5
TAGCTCACTGTGTTTG-1_V12D07-332_A1,7,0,1,0,0,8
TCGGCAGGGTTAAGGG-1_V12D07-332_A1,4,0,1,0,0,5
TGTTAACAAAGTGACT-1_V12D07-332_A1,3,0,3,0,0,6
CAGAGCGATGGATGCT-1_V12D07-332_A1,2,1,3,0,0,6
CATAGTGGGCACGCCT-1_V12D07-332_A1,2,0,2,0,0,4
AAACGCTGGGCACGAC-1_V12D07-332_A1,3,0,0,0,0,3
TGTTCTCATACTATAG-1_V12D07-332_A1,2,0,2,0,0,4
TCCGCTGGGTCGATCG-1_V12D07-332_A1,1,1,0,0,0,2
TTAGCATCCCTCACGT-1_V12D07-332_A1,0,0,0,0,0,0
AGCCTTGTCACTGATA-1_V12D07-332_A1,0,1,1,0,0,2
GTTTCTTGTTAGAGCT-1_V12D07-332_A1,0,0,0,0,0,0
TCGGAGTCCTGGTTGC-1_V12D07-332_A1,1,3,1,0,0,5
ACGGGTTGTGACCTGT-1_V12D07-332_A1,0,2,0,0,0,2
TGACAGAAATCTTGCT-1_V12D07-332_A1,0,0,0,1,0,1
TAGCCATGATTGCCTA-1_V12D07-332_A1,0,2,1,0,0,3
CGAAGCCACAGCATGG-1_V12D07-332_A1,1,1,0,0,0,2
ACCCGTAGCAGAGAAT-1_V12D07-332_A1,0,0,0,0,0,0
AGCTTGATCAGGGTAG-1_V12D07-332_A1,0,5,1,0,0,6
CTATAAGTAGGGTTTG-1_V12D07-332_A1,1,0,0,0,0,1
TATAGTTAGGTGTACT-1_V12D07-332_A1,0,1,0,0,0,1
TACGCTGATAGTTGTA-1_V12D07-332_A1,0,1,1,1,0,3
TTCTCAATTGCTACAA-1_V12D07-332_A1,0,1,2,0,0,3
GTTGCCCTAACGGGTG-1_V12D07-332_A1,2,2,1,0,0,5
GACATTTCGCCCAGCC-1_V12D07-332_A1,1,0,1,0,0,2
GTAACTACGTAGACCT-1_V12D07-332_A1,0,1,2,1,0,4
CCAGTGTACAGACCGA-1_V12D07-332_A1,0,0,1,0,0,1
GCCCGATGCCCAGTTC-1_V12D07-332_A1,0,1,2,0,0,3
CGAACCTCTTTCCTAG-1_V12D07-332_A1,2,1,0,1,0,4
CATGCACATGAGAGGC-1_V12D07-332_A1,0,1,0,0,0,1
CCAAATCAAAGGGCAA-1_V12D07-332_A1,2,2,0,0,0,4
GTAGTTTAAGCACACG-1_V12D07-332_A1,1,0,1,0,0,2
TAAGTGAATAGTCTAC-1_V12D07-332_A1,0,1,0,0,0,1
GGTCCACGTCTATTTG-1_V12D07-332_A1,0,0,0,0,0,0
CCCTCAGATCGAGAAC-1_V12D07-332_A1,1,0,0,0,0,1
ACATTCGCGCGGAATA-1_V12D07-332_A1,1,0,0,1,0,2
CTATGAACACCTTGCC-1_V12D07-332_A1,1,1,0,0,0,2
CGAATGGTAGGTCGTC-1_V12D07-332_A1,2,0,0,0,0,2
TCGACATAGCGTAGCG-1_V12D07-332_A1,0,0,1,0,0,1
GACGTTGCTCGGCGGC-1_V12D07-332_A1,0,0,0,0,0,0
CTCGAGGCAAGTTTCA-1_V12D07-332_A1,5,0,0,1,0,6
GCTGGGAGCGCGTCAA-1_V12D07-332_A1,1,0,1,0,0,2
GACGATATCACTGGGT-1_V12D07-332_A1,0,2,0,0,0,2
CAGCTCTGGGCTCACT-1_V12D07-332_A1,1,1,0,0,0,2
TAGTCTGCGGCACATT-1_V12D07-332_A1,3,0,0,0,0,3
TGGTCGATATACCTCT-1_V12D07-332_A1,3,1,0,0,0,4
TTCAGTTCAAGAGGAG-1_V12D07-332_A1,0,2,1,0,0,3
GTCTGTAGGTTGAACA-1_V12D07-332_A1,2,0,0,0,0,2
GAGAGTCTCGGGAGAG-1_V12D07-332_A1,5,0,0,0,0,5
TTGTTTGTATTACACG-1_V12D07-332_A1,2,0,0,0,0,2
GCACAGCACGGGCCGA-1_V12D07-332_A1,2,0,1,0,0,3
AAACAGTGTTCCTGGG-1_V12D07-332_A1,0,0,0,0,0,0
TGGAGAATAATCGTCC-1_V12D07-332_A1,4,0,0,1,0,5
CGCCGCGTTCTGAACG-1_V12D07-332_A1,1,2,0,0,0,3
CATGCGTTGAGAGGAG-1_V12D07-332_A1,1,1,1,0,0,3
TACGCTCCTAGAACTG-1_V12D07-332_A1,2,0,1,0,0,3
CCTTGTGAACGTGGTT-1_V12D07-332_A1,2,0,0,0,0,2
TTAAAGGCGATGCTCG-1_V12D07-332_A1,2,1,0,0,0,3
TAAAGTGCACGTCTCG-1_V12D07-332_A1,2,0,0,0,0,2
TGTCCGCAAACAATTC-1_V12D07-332_A1,0,0,0,0,0,0
AGGCCTATCATACCAA-1_V12D07-332_A1,3,1,0,0,0,4
ACTGGGATGCCAGTGC-1_V12D07-332_A1,2,0,0,0,0,2
CGATCCACCATTGTTG-1_V12D07-332_A1,6,0,1,0,0,7
GGGCATGCATGTCGAG-1_V12D07-332_A1,3,3,0,0,0,6
TCCAGGCAGGACGATC-1_V12D07-332_A1,5,3,1,0,0,9
CAATGACCCTTAATTT-1_V12D07-332_A1,6,2,0,0,0,8
ATCAAGATCCCAGGAC-1_V12D07-332_A1,4,1,1,0,0,6
CTCAGAGCTAATGTCG-1_V12D07-332_A1,3,0,0,0,0,3
CTGCGATTTCGAGATT-1_V12D07-332_A1,5,0,0,0,0,5
ATGGTATTGGGAACCG-1_V12D07-332_A1,4,0,0,0,0,4
TAGGTTCTGCTGAGAA-1_V12D07-332_A1,5,1,1,0,0,7
GCCTGTCCCGGTGCAT-1_V12D07-332_A1,2,0,1,0,0,3
GGCCTGCTCTGATGTT-1_V12D07-332_A1,3,2,1,0,0,6
TAGAGGGAGTTTATCT-1_V12D07-332_A1,2,1,0,0,0,3
CTCTACATCCTGCGTG-1_V12D07-332_A1,3,1,0,0,0,4
ACACATTTCCGTAGAC-1_V12D07-332_A1,3,1,1,0,0,5
TGGGTGTTAAGTAGAA-1_V12D07-332_A1,3,0,0,0,0,3
GAGCTCAACATGAGCG-1_V12D07-332_A1,1,0,1,0,0,2
GCACACAGCTATTACC-1_V12D07-332_A1,1,3,0,0,0,4
GCGACGGTAGTCTCCT-1_V12D07-332_A1,6,0,2,0,0,8
GTATCAAGGTACTTCC-1_V12D07-332_A1,1,0,0,0,0,1
GGAAAGGGAATTGAGC-1_V12D07-332_A1,2,0,1,0,0,3
TACACAGCCGTGGTGC-1_V12D07-332_A1,1,3,0,0,0,4
CGGTTGGGCAGGGTCC-1_V12D07-332_A1,1,1,0,0,0,2
GCACGCCGATTCCCGC-1_V12D07-332_A1,0,1,0,0,0,1
CGCTTTCCGCCAAGGT-1_V12D07-332_A1,3,2,0,0,0,5
TGCCCGATAGTTAGAA-1_V12D07-332_A1,3,3,0,0,0,6
TCAGAACGGCGGTAAT-1_V12D07-332_A1,2,1,0,0,0,3
CCACTCAGATCCGCAA-1_V12D07-332_A1,0,1,0,0,0,1
GAAGGGTCATTAAGAC-1_V12D07-332_A1,3,1,0,0,0,4
GCGGTCTTGCTTTCAC-1_V12D07-332_A1,6,0,1,0,0,7
GGAAGGACACCGTATA-1_V12D07-332_A1,1,1,2,0,0,4
CGCGGGAATTCCTTTC-1_V12D07-332_A1,4,0,0,0,0,4
TCTATCCGATTGCACA-1_V12D07-332_A1,3,1,1,0,0,5
TACTCGTTTGAATCAA-1_V12D07-332_A1,1,0,0,0,0,1
GTCTGCCGACTCGACG-1_V12D07-332_A1,3,5,0,0,0,8
TACGGGTAATAACATA-1_V12D07-332_A1,3,0,0,0,0,3
CCAGTTCGGTAACTCA-1_V12D07-332_A1,3,0,2,0,0,5
CGTGCACACCACTGTA-1_V12D07-332_A1,2,2,0,0,0,4
CTTCAGTTGGACAACG-1_V12D07-332_A1,1,0,0,0,0,1
TGATCTATCACACTCT-1_V12D07-332_A1,3,0,0,0,0,3
TAGCAGATACTTAGGG-1_V12D07-332_A1,5,0,0,0,0,5
CACCGGGCATCACAAG-1_V12D07-332_A1,4,1,0,0,0,5
AGTGGCCCGCAAATGG-1_V12D07-332_A1,2,1,0,0,0,3
CTCGCTAGGTAAGCGA-1_V12D07-332_A1,4,1,0,0,0,5
GATAGATAGTACAGTC-1_V12D07-332_A1,4,0,0,1,0,5
CGAGACTACTGCTGCT-1_V12D07-332_A1,2,0,1,0,0,3
ACATTTGAAACCTAAC-1_V12D07-332_A1,1,0,1,1,0,3
GACACAGCCGGGACTG-1_V12D07-332_A1,4,0,2,0,0,6
ACGGAACACGAGTGCC-1_V12D07-332_A1,7,1,1,0,0,9
ACGCCAGTGCGTTTGC-1_V12D07-332_A1,1,2,0,0,0,3
GCACCTAGGCGAGTCC-1_V12D07-332_A1,4,1,1,0,0,6
TCACTATCCCTTCGGT-1_V12D07-332_A1,2,0,2,0,0,4
TGAGTGTAACAACGGG-1_V12D07-332_A1,4,0,0,0,0,4
ATTGGTTGTGCATTAC-1_V12D07-332_A1,3,2,2,0,0,7
CTGGCGATTTACATGT-1_V12D07-332_A1,2,1,0,0,0,3
TCCACCAAGACATAGG-1_V12D07-332_A1,3,0,2,0,0,5
AACGTCGCTGCACTTC-1_V12D07-332_A1,4,0,0,0,0,4
GTCTCCCGAGTCCCGT-1_V12D07-332_A1,4,0,1,0,0,5
AGCCCGCACTACAATG-1_V12D07-332_A1,1,1,2,0,0,4
GGCACGCTGCTACAGT-1_V12D07-332_A1,4,0,0,0,0,4
GCTTGAGTGACCTCTG-1_V12D07-332_A1,4,2,2,0,0,8
ATAGCCATAACAGTCA-1_V12D07-332_A1,3,0,0,0,0,3
TAGGAGGCTCGAGAAC-1_V12D07-332_A1,3,0,1,0,0,4
GTCGGGTGAAGTACCG-1_V12D07-332_A1,3,2,0,0,0,5
CACCCGCGTTTGACAC-1_V12D07-332_A1,1,0,1,0,0,2
TCTCAGGCTACTCGCT-1_V12D07-332_A1,2,0,1,0,0,3
TAGATTCTCTAGCAAA-1_V12D07-332_A1,2,1,1,0,0,4
CCCATTATTGTATCCT-1_V12D07-332_A1,3,0,0,0,0,3
GTTAATAGCGTCATTA-1_V12D07-332_A1,3,0,0,0,0,3
TACTCATTGACGCATC-1_V12D07-332_A1,3,0,0,0,0,3
TAGTGACAAGCTCTAC-1_V12D07-332_A1,3,4,0,0,0,7
ATCGCCGTGGTTCATG-1_V12D07-332_A1,2,1,0,0,0,3
CTGCTCTCAACACACC-1_V12D07-332_A1,7,0,0,1,0,8
GCATGACACAAAGGAA-1_V12D07-332_A1,7,0,1,0,0,8
CAACGATCGATCCAAT-1_V12D07-332_A1,4,0,2,0,0,6
ATACAGCGTCCACTGA-1_V12D07-332_A1,0,1,0,0,0,1
TCACGATTAATACGTT-1_V12D07-332_A1,2,0,0,1,0,3
CGTGAACTGACCCGAT-1_V12D07-332_A1,0,0,0,0,0,0
TCGATGTTACGGCCGT-1_V12D07-332_A1,0,0,0,0,0,0
GACCGGTGATACTCTC-1_V12D07-332_A1,0,0,0,0,0,0
TCTGTTTAGATTGTTC-1_V12D07-332_A1,0,0,0,0,0,0
GCTACTCGGACGCAGA-1_V12D07-332_A1,2,1,0,1,0,4
AAGAAAGTTTGATGGG-1_V12D07-332_A1,0,1,0,0,0,1
CGCCAGTAGTACCTTG-1_V12D07-332_A1,0,2,0,0,0,2
CTCCCTTGTATCAAGG-1_V12D07-332_A1,0,0,0,0,0,0
ACTTTATACACCACTT-1_V12D07-332_A1,0,0,0,1,0,1
AGATCTGGAGAGGATA-1_V12D07-332_A1,0,0,0,0,0,0
TCATCCATCTGATCAC-1_V12D07-332_A1,1,2,0,0,0,3
AGAACACGGCGATGGT-1_V12D07-332_A1,2,0,0,0,0,2
CCGCTCCGGATAAGCT-1_V12D07-332_A1,0,1,0,0,0,1
TGGTCGGGTACAGGGC-1_V12D07-332_A1,3,0,0,0,0,3
ACGGACGCAGCGACAA-1_V12D07-332_A1,0,1,0,0,0,1
ACATGCTTACGGCAGC-1_V12D07-332_A1,2,0,0,0,0,2
CAGGGAGATAGGCCAG-1_V12D07-332_A1,0,1,0,1,0,2
TCGCCACCCGGATTAC-1_V12D07-332_A1,2,0,0,1,0,3
TCTTGGTCAATGATAC-1_V12D07-332_A1,0,1,2,1,0,4
CATAGGGACACTTGTG-1_V12D07-332_A1,0,2,0,0,0,2
CACGAGCAAACCAGAC-1_V12D07-332_A1,2,1,0,0,0,3
GGGATATTGATCGCCA-1_V12D07-332_A1,0,0,1,0,0,1
TAATGTCGGTTCATGG-1_V12D07-332_A1,2,0,0,0,0,2
CGATTTGTCATTAATG-1_V12D07-332_A1,0,2,0,0,0,2
TTAAGATACCCAGAGA-1_V12D07-332_A1,3,3,0,1,0,7
CGACCGTTGGTATTCG-1_V12D07-332_A1,0,3,0,0,0,3
ACTACCATCCGAGGGC-1_V12D07-332_A1,0,0,0,0,0,0
TCTACGCACGATCTCC-1_V12D07-332_A1,2,1,0,1,0,4
AAGCCACTTGCAGGTA-1_V12D07-332_A1,1,2,0,0,0,3
ACGTTGTCGTTGAAAG-1_V12D07-332_A1,0,1,0,0,0,1
ACCGCTAGTCATTGGT-1_V12D07-332_A1,0,0,0,0,0,0
CATGAGTCCATCACGG-1_V12D07-332_A1,0,1,0,0,0,1
ATGTCTTGTTTGACTC-1_V12D07-332_A1,1,0,0,2,0,3
TCCCAAACATCCTCTA-1_V12D07-332_A1,2,0,0,0,0,2
CAACGCGATGAGCCAA-1_V12D07-332_A1,4,1,0,2,0,7
GACACCCAAAGACGCG-1_V12D07-332_A1,0,1,0,0,0,1
ACGTTCACTATGCCGC-1_V12D07-332_A1,2,1,0,1,0,4
ATGGACTGCTTAGTTG-1_V12D07-332_A1,2,1,0,1,0,4
CCATGGCAAACGCTCA-1_V12D07-332_A1,1,0,0,0,0,1
TTGTCTCGGCAAGATG-1_V12D07-332_A1,3,0,0,0,0,3
TTCGAACGAAACATGC-1_V12D07-332_A1,1,0,0,0,0,1
GGAAAGTCTTGATTGT-1_V12D07-332_A1,0,1,0,0,0,1
ATCATAGATCGACGAG-1_V12D07-332_A1,4,0,1,0,0,5
GATTAGAAACAAGCGT-1_V12D07-332_A1,2,2,0,0,0,4
GCTGCGAAGAATTATT-1_V12D07-332_A1,3,2,1,0,0,6
TTCCAGTGGGTTTCGT-1_V12D07-332_A1,5,1,0,0,0,6
GCTCATTGATCATATC-1_V12D07-332_A1,1,0,4,0,0,5
ATACGAGGTTTGTAAG-1_V12D07-332_A1,2,0,0,0,0,2
GTCTATACACGCATGG-1_V12D07-332_A1,1,0,1,0,0,2
GATTTGCGCTAACACC-1_V12D07-332_A1,2,1,0,0,0,3
TGGTGCCCTGCCTTAC-1_V12D07-332_A1,2,1,0,0,0,3
TCGAATCGCAGGGTAG-1_V12D07-332_A1,0,0,0,0,0,0
GGTAGGCCAATATCAC-1_V12D07-332_A1,5,0,1,0,0,6
CGTAAATAACAAAGGG-1_V12D07-332_A1,3,1,0,0,0,4
GACTCTAGAGTTCCAA-1_V12D07-332_A1,7,1,1,0,0,9
ACTTGTTACCGGATCA-1_V12D07-332_A1,3,2,0,0,0,5
GGCATTGAACATCTCA-1_V12D07-332_A1,2,2,1,0,0,5
AACCCGCTGTATTCCA-1_V12D07-332_A1,1,2,0,0,0,3
TAACAGGTTCCCTTAG-1_V12D07-332_A1,1,3,0,0,0,4
GTTCTTGTAACTCAAT-1_V12D07-332_A1,1,0,1,0,0,2
GATTCTGTTAATGAGT-1_V12D07-332_A1,4,0,1,0,0,5
GGACACCTCGGTGTTG-1_V12D07-332_A1,3,5,0,0,0,8
CGATCGAGAAGCACCA-1_V12D07-332_A1,1,1,0,0,0,2
CTGCTCTGACGGCAAA-1_V12D07-332_A1,8,0,1,0,0,9
CCCAGGAAGAATTCGA-1_V12D07-332_A1,3,0,2,0,0,5
TGTCGTGGGTATAGGC-1_V12D07-332_A1,4,0,0,0,0,4
ATATGTCTAGAGCGTG-1_V12D07-332_A1,1,2,0,0,0,3
GCGGGCAGACGGGTGA-1_V12D07-332_A1,0,1,1,0,0,2
CGAAGATCAGTTTCAT-1_V12D07-332_A1,1,1,0,0,0,2
ACGCCACTCGAAACAG-1_V12D07-332_A1,2,1,0,0,0,3
CTTAGATGTTTCATCC-1_V12D07-332_A1,0,1,1,0,0,2
GCGAATGGACTAGCGA-1_V12D07-332_A1,4,0,0,0,0,4
TAAATTGTGGGTAAAG-1_V12D07-332_A1,3,0,0,0,0,3
ATTTATACTGGTAAAG-1_V12D07-332_A1,3,1,0,0,0,4
GCGTCGTAACATGGTC-1_V12D07-332_A1,2,0,1,0,0,3
CGGTATGGGCACTCTG-1_V12D07-332_A1,3,0,1,0,0,4
CTATCACAACGCTGGA-1_V12D07-332_A1,3,0,0,0,0,3
ACCACACGGTTGATGG-1_V12D07-332_A1,2,0,0,0,0,2
TCAGCGCACGCCGTTT-1_V12D07-332_A1,2,0,0,0,0,2
AATGTTAAGACCCTGA-1_V12D07-332_A1,1,2,0,0,0,3
CTTACATAGATTTCTT-1_V12D07-332_A1,2,3,0,0,0,5
AACATAGCGTGTATCG-1_V12D07-332_A1,3,0,0,1,0,4
AGCAGTCGAAGCATGC-1_V12D07-332_A1,1,1,0,0,0,2
GTACTACGGCCTCGTT-1_V12D07-332_A1,3,0,0,0,0,3
TTGGCCAAATTGTATC-1_V12D07-332_A1,2,1,0,0,0,3
TCAGAGGACGCGTTAG-1_V12D07-332_A1,3,0,1,0,0,4
AGTAATCTAAGGGTGG-1_V12D07-332_A1,3,2,0,0,0,5
AATTATACCCAGCAAG-1_V12D07-332_A1,0,0,1,0,0,1
CCCTACCCACACCCAG-1_V12D07-332_A1,7,0,0,0,0,7
CTCTGTCCATGCACCA-1_V12D07-332_A1,7,1,2,0,0,10
TCGCCTCCTTCGGCTC-1_V12D07-332_A1,2,0,2,0,0,4
CCTGATTCGCGAAGAA-1_V12D07-332_A1,2,0,0,0,0,2
GACTTCAACGCATCAA-1_V12D07-332_A1,2,0,0,0,0,2
GCTTCCCGTAAGCTCC-1_V12D07-332_A1,2,1,0,0,0,3
AGAACTGTACTTTGTA-1_V12D07-332_A1,2,0,0,0,0,2
CCTTAAGTACGCAATT-1_V12D07-332_A1,4,0,0,0,0,4
GGCCAATTGTATAGAC-1_V12D07-332_A1,2,1,1,0,0,4
AGAATACAGGCTATCC-1_V12D07-332_A1,11,0,0,0,0,11
AATACCTGATGTGAAC-1_V12D07-332_A1,4,1,0,0,0,5
TAGAGTGTTCCGGGTA-1_V12D07-332_A1,2,0,1,0,0,3
GCTTCCATGTAACCGC-1_V12D07-332_A1,3,0,2,0,0,5
GGTTCGCATTTGCCGT-1_V12D07-332_A1,2,1,0,0,0,3
TCAATCCGGGAAGTTT-1_V12D07-332_A1,6,0,0,0,0,6
CCGGAAGTGCAATATG-1_V12D07-332_A1,5,0,1,0,0,6
CTCATAAATGTGTATA-1_V12D07-332_A1,2,1,3,0,0,6
GACGGGCATCGAATTT-1_V12D07-332_A1,3,1,1,0,0,5
GCTAAGCCCAGTATGC-1_V12D07-332_A1,4,2,1,0,0,7
GCTATAAGGGCCAGGA-1_V12D07-332_A1,7,0,1,0,0,8
GCGGATTACTTGTTCT-1_V12D07-332_A1,4,2,0,0,0,6
TACAACAGCGCATACA-1_V12D07-332_A1,3,0,1,0,0,4
TCTAACCTAGCCTGCG-1_V12D07-332_A1,4,1,2,0,0,7
TCTACCCGCATCATTT-1_V12D07-332_A1,6,0,1,0,0,7
GTCTTACCACGCCAAG-1_V12D07-332_A1,6,1,0,0,0,7
AATAACGTCGCGCCCA-1_V12D07-332_A1,4,2,0,0,0,6
CGTTTCGGTTATATGC-1_V12D07-332_A1,4,0,0,0,0,4
TACGCTGCACGGTCGT-1_V12D07-332_A1,3,1,1,0,0,5
CGTTAAATACGACCAG-1_V12D07-332_A1,1,0,1,0,0,2
TCGACTGACGATGGCT-1_V12D07-332_A1,1,0,2,0,0,3
ACGCTACTGAATGGGC-1_V12D07-332_A1,3,0,1,0,0,4
AAGGGTTAGCCATGCG-1_V12D07-332_A1,4,1,0,0,0,5
ACGTTTCGGTGCACTT-1_V12D07-332_A1,6,2,0,0,0,8
TTAACCCGAGGCGTGT-1_V12D07-332_A1,0,0,0,0,0,0
GCCCGTCAAGCCCAAT-1_V12D07-332_A1,6,0,0,0,0,6
ATTCGTCCCGAGGTTA-1_V12D07-332_A1,3,1,0,0,0,4
TCAAATTATGTTCGAC-1_V12D07-332_A1,2,1,0,0,0,3
AACGTTCTACCATTGT-1_V12D07-332_A1,1,0,0,0,0,1
CTGTCCTGCGCACTAC-1_V12D07-332_A1,0,1,0,1,0,2
GCCCAGCGACACAAAG-1_V12D07-332_A1,1,0,0,0,4,5
TATAGCTATTATCTCT-1_V12D07-332_A1,3,0,1,2,0,6
AAGCTATGGATTGACC-1_V12D07-332_A1,0,0,0,0,0,0
CCGAAACACGACCTCT-1_V12D07-332_A1,2,4,0,0,0,6
ATCAGAAGCTGGTTGC-1_V12D07-332_A1,1,1,0,1,0,3
TGAACCTGAATGTGAG-1_V12D07-332_A1,0,1,0,0,0,1
TCAGAGCATGTCAACG-1_V12D07-332_A1,0,1,0,0,0,1
ATACCCTCCCGGCCAA-1_V12D07-332_A1,0,0,1,0,0,1
GCCACCTTATTCGCGA-1_V12D07-332_A1,0,0,0,0,0,0
CAACGAGCTTATTATG-1_V12D07-332_A1,0,0,0,1,0,1
GATCCAACCTTTAAAC-1_V12D07-332_A1,0,1,0,0,0,1
TTGTGGAGACAGCCGG-1_V12D07-332_A1,0,1,0,1,0,2
AGATAATCACACCTAT-1_V12D07-332_A1,0,0,0,0,0,0
GGTTAGGGATGCTAAT-1_V12D07-332_A1,1,1,0,0,0,2
TCATGAAGCGCTGCAT-1_V12D07-332_A1,0,0,0,1,0,1
CCAGGCGAGATGGTCT-1_V12D07-332_A1,0,0,0,0,0,0
CGACTTGCCGGGAAAT-1_V12D07-332_A1,4,1,1,0,0,6
GTGCCAAACGTTTCGA-1_V12D07-332_A1,1,0,0,0,0,1
TGCTCAAAGGATGCAC-1_V12D07-332_A1,1,1,0,0,0,2
GCCTCAGGTACCGGTC-1_V12D07-332_A1,0,0,0,0,0,0
ACAAGTAATTGTAAGG-1_V12D07-332_A1,1,2,0,1,0,4
TTAGAGTATTGTCGAG-1_V12D07-332_A1,0,0,0,0,0,0
GTCATCCCAAACTCAC-1_V12D07-332_A1,1,1,0,0,0,2
CTCCTAGTAATCGTGA-1_V12D07-332_A1,0,0,0,0,0,0
CCCTCATCACAGAGTA-1_V12D07-332_A1,0,0,0,0,0,0
GGAAACAGAGCTTGGG-1_V12D07-332_A1,0,1,1,0,0,2
ACATCGCAATATTCGG-1_V12D07-332_A1,1,0,1,0,0,2
TTAGCCATAGGGCTCG-1_V12D07-332_A1,0,1,0,0,0,1
CGGATTCTGCCTTATG-1_V12D07-332_A1,1,0,0,0,0,1
TTGTTGGCAATGACTG-1_V12D07-332_A1,0,1,0,0,0,1
GGATCTACCGTTCGTC-1_V12D07-332_A1,0,0,0,0,0,0
GGTGGGATTAGGTCCC-1_V12D07-332_A1,1,1,0,0,0,2
AATAGGCACGACCCTT-1_V12D07-332_A1,0,0,0,1,0,1
GAGGTCCGTTCGCTGT-1_V12D07-332_A1,1,1,0,1,0,3
TGACAACTTAAAGGTG-1_V12D07-332_A1,0,1,0,0,0,1
AGCTAAGCTCCGTCCG-1_V12D07-332_A1,0,0,0,0,0,0
CTAGCCCGGGAGACGA-1_V12D07-332_A1,0,1,0,1,0,2
CCCAGATTCCCGTGAC-1_V12D07-332_A1,1,0,0,0,0,1
GCCCGTTCACACAATT-1_V12D07-332_A1,0,1,0,0,0,1
ACAAACTCCATCAGAG-1_V12D07-332_A1,0,2,0,0,0,2
GGTTCCGTACGACTAA-1_V12D07-332_A1,0,0,0,0,0,0
TTGCGGAAAGCTGCCC-1_V12D07-332_A1,3,0,1,0,0,4
GGAACTCGTGAATACG-1_V12D07-332_A1,3,0,0,0,0,3
GGTTACCGCTCCCTAC-1_V12D07-332_A1,1,1,0,0,0,2
AGCGACTTTGAAGACA-1_V12D07-332_A1,2,0,1,0,0,3
CCGTTTCCTTTCCGTG-1_V12D07-332_A1,3,0,0,0,0,3
TGGATGGCATCTTGGA-1_V12D07-332_A1,1,0,0,0,0,1
CAAGTCGTTGAAATCT-1_V12D07-332_A1,6,0,1,0,0,7
TGCAAACGTACTAGTT-1_V12D07-332_A1,0,0,0,0,0,0
GGCTGTCCTACTGCGG-1_V12D07-332_A1,3,0,0,0,0,3
TACTGCATGATTAAAT-1_V12D07-332_A1,3,1,1,0,0,5
CGGACCTCTGTAGTTA-1_V12D07-332_A1,3,0,1,0,0,4
CCCTAGCTCTAAGGTC-1_V12D07-332_A1,2,1,2,0,0,5
GTAACAGGTTAACGGC-1_V12D07-332_A1,2,0,1,0,0,3
CCCGCAAATAATCATC-1_V12D07-332_A1,2,1,0,0,0,3
AATCCCGCTCAGAGCC-1_V12D07-332_A1,4,0,3,0,0,7
AACGTCATCCGGCTTG-1_V12D07-332_A1,4,1,1,0,0,6
CTCGTGGCACTGAAAG-1_V12D07-332_A1,2,0,2,0,0,4
CTTTATCCGACGCATG-1_V12D07-332_A1,8,0,1,0,0,9
AAATGACTGATCAAAC-1_V12D07-332_A1,1,2,0,0,0,3
TTCGTGCATGTTATAG-1_V12D07-332_A1,6,1,1,0,0,8
ATCAAAGAGCCGTGGT-1_V12D07-332_A1,3,2,0,0,0,5
ATGTCATAATAAACGA-1_V12D07-332_A1,0,1,0,0,0,1
CTTAATCGACTTAGTA-1_V12D07-332_A1,0,2,0,0,0,2
CTAAAGGATGAGATAC-1_V12D07-332_A1,3,1,0,0,0,4
GTGCTATCCAGCTGGA-1_V12D07-332_A1,1,0,0,0,0,1
GACAGAGGTCTTCAGT-1_V12D07-332_A1,3,0,2,0,0,5
TCGATTTACGAAACGA-1_V12D07-332_A1,1,4,2,0,0,7
AGGCTTAAGTTGCACA-1_V12D07-332_A1,1,1,1,0,0,3
TAGGATCTTAACCGCA-1_V12D07-332_A1,0,2,2,0,0,4
GACTTTCGAGCGGTTC-1_V12D07-332_A1,1,0,0,0,0,1
CCCTGGGAGGGATCCT-1_V12D07-332_A1,1,0,1,0,0,2
TAGTAGTTGCCGGACA-1_V12D07-332_A1,2,0,1,0,0,3
GCCCTAAGTGCAGGAT-1_V12D07-332_A1,2,0,0,0,0,2
ACTTGGGCTTTCGCCA-1_V12D07-332_A1,5,0,0,0,0,5
CATGATACGGTGAAAC-1_V12D07-332_A1,3,0,0,0,0,3
TCCTGCAGCCGCCAAT-1_V12D07-332_A1,1,3,1,0,0,5
GTCCGTTAGAGGGCCT-1_V12D07-332_A1,0,3,0,0,0,3
GCTTTATTAAGTTACC-1_V12D07-332_A1,3,1,0,0,0,4
AATCGAGGTCTCAAGG-1_V12D07-332_A1,0,1,0,1,0,2
GTGCTGTTAGAACATA-1_V12D07-332_A1,0,1,1,0,0,2
GGCTTCTCGTGGGTGG-1_V12D07-332_A1,1,0,1,0,0,2
CCTACAGTTGAGGGAG-1_V12D07-332_A1,0,0,2,0,0,2
TATCCCTCGATCTGCA-1_V12D07-332_A1,4,2,0,0,0,6
CCGGTATCTGGCGACT-1_V12D07-332_A1,0,1,1,0,0,2
CTCTAACACCGGCAGC-1_V12D07-332_A1,3,1,0,0,0,4
CTTCATCACCAGGGCT-1_V12D07-332_A1,1,0,0,0,0,1
GGCTGGCAATCCCACG-1_V12D07-332_A1,1,1,1,0,0,3
CAAACCATAAGCGTAT-1_V12D07-332_A1,3,0,0,0,0,3
CATGTGGGCTCATCAC-1_V12D07-332_A1,2,1,1,0,0,4
CCCGTGACAGTGCCTT-1_V12D07-332_A1,1,2,0,0,0,3
GATTATCTTGCATTAT-1_V12D07-332_A1,2,1,0,0,0,3
GAGTCCACCAGGTTTA-1_V12D07-332_A1,0,2,0,0,0,2
TGTACTATCGCTCGTT-1_V12D07-332_A1,1,0,0,0,0,1
TTAGCGAATAGATAGG-1_V12D07-332_A1,4,0,0,0,0,4
ACATACAATCAAGCGG-1_V12D07-332_A1,4,0,1,0,0,5
ATTCGTGTACCCATTC-1_V12D07-332_A1,1,1,1,0,0,3
GCTAGCAACGCACCTA-1_V12D07-332_A1,4,0,3,0,0,7
ACCTCAGCGAGGCGCA-1_V12D07-332_A1,6,0,4,0,0,10
TCCGGGCCACTAACGG-1_V12D07-332_A1,5,0,0,0,0,5
TCCCAATATCGACGAC-1_V12D07-332_A1,1,0,1,0,0,2
GGATTGAAGTAGCCTC-1_V12D07-332_A1,5,2,1,0,0,8
GGCGCACAGTTTACCT-1_V12D07-332_A1,3,0,0,0,0,3
CCCGGCACGTGTCAGG-1_V12D07-332_A1,2,0,1,0,0,3
AGTAAGGGACAGAATC-1_V12D07-332_A1,2,1,0,0,0,3
TTGCGCACAACCACGT-1_V12D07-332_A1,8,0,0,0,0,8
CCTGCTACAACCATAC-1_V12D07-332_A1,2,0,1,0,0,3
CTGGGCTACTGGAGAG-1_V12D07-332_A1,1,1,0,0,0,2
AGCTACGAATGGTGGT-1_V12D07-332_A1,2,1,1,0,0,4
ATTCGTTTATCGTATT-1_V12D07-332_A1,4,0,2,0,0,6
GGCATTCCCTCCCTCG-1_V12D07-332_A1,3,0,0,0,0,3
AGTTATTCAGACTGTG-1_V12D07-332_A1,0,2,2,0,0,4
CCACTTTCCTTCTAGG-1_V12D07-332_A1,0,1,0,0,0,1
CGCAGTTCTATCTTTC-1_V12D07-332_A1,1,0,0,0,0,1
AGGAGCGTTTATTATC-1_V12D07-332_A1,4,1,0,0,0,5
GACAGGTAATCCGTGT-1_V12D07-332_A1,4,0,0,0,0,4
TTCCCAAAGTACTGAT-1_V12D07-332_A1,2,0,1,0,0,3
CTGCAGGGTGACGCTC-1_V12D07-332_A1,1,2,0,0,0,3
TCATGGAGGCCTTTGT-1_V12D07-332_A1,2,0,0,0,0,2
ATGGCCCGAAAGGTTA-1_V12D07-332_A1,6,2,0,0,0,8
CGTAATATGGCCCTTG-1_V12D07-332_A1,2,1,0,0,0,3
AGAGTCTTAATGAAAG-1_V12D07-332_A1,1,2,1,0,0,4
GAACGTTTGTATCCAC-1_V12D07-332_A1,2,0,1,0,0,3
ATTGAATTCCCTGTAG-1_V12D07-332_A1,1,1,1,0,0,3
TACCTCACCAATTGTA-1_V12D07-332_A1,2,1,1,0,0,4
AGTCGAATTAGCGTAA-1_V12D07-332_A1,2,1,1,0,0,4
TTGAAGTGCATCTACA-1_V12D07-332_A1,4,1,0,0,0,5
