key,oligo,other,neuron,microglia,astrocyte,n_cells
CTAATGCGCCCAACAA-1_V12D07-332_A1,5,2,0,1,0,8
GCCACCCATTCCACTT-1_V12D07-332_A1,4,1,0,0,0,5
GTTCGGTGTGGATTTA-1_V12D07-332_A1,5,0,0,2,0,7
GGAGACATTCACGGGC-1_V12D07-332_A1,1,1,0,0,0,2
TAGAACGCCAGTAACG-1_V12D07-332_A1,3,0,0,0,0,3
TGATGGGACTAAGTCA-1_V12D07-332_A1,5,2,0,1,0,8
TCGCCTCGACCTGTTG-1_V12D07-332_A1,2,0,0,0,0,2
AGGAAAGCCTCTGATG-1_V12D07-332_A1,5,0,0,0,0,5
GTATCGGGACGAGCTG-1_V12D07-332_A1,1,1,0,0,0,2
CATACGGGTGCATGAT-1_V12D07-332_A1,3,0,0,1,0,4
AAATTGCGGCGGTTCT-1_V12D07-332_A1,0,1,0,0,0,1
CATTCAGGTCAGTGCG-1_V12D07-332_A1,3,0,0,0,0,3
AATCAGACTGCAGGAC-1_V12D07-332_A1,4,0,0,0,0,4
CTGGCTGCTAACGTAA-1_V12D07-332_A1,4,1,0,0,0,5
AAGACTAACCCGTTGT-1_V12D07-332_A1,3,0,0,0,0,3
CGCGCAAGGAACTACA-1_V12D07-332_A1,4,1,0,0,0,5
ACGGCGGGTTGCCCTG-1_V12D07-332_A1,4,1,0,0,0,5
GTGCGCAGCTTGCTCC-1_V12D07-332_A1,1,0,0,2,0,3
TATGATTCTGCTTGGT-1_V12D07-332_A1,3,0,0,0,0,3
TTACGGTGTCACCGAG-1_V12D07-332_A1,2,2,0,1,0,5
TGAGCAGTCGTGAAGT-1_V12D07-332_A1,4,1,0,1,0,6
GTGTATGACTTTAAAG-1_V12D07-332_A1,1,0,0,2,0,3
TGTACTGTGCCAAAGT-1_V12D07-332_A1,6,0,0,0,0,6
GTCAATTGTACTGAAG-1_V12D07-332_A1,2,0,0,0,0,2
AGCTTATAGAGACCTG-1_V12D07-332_A1,3,1,0,0,0,4
AACTTTAGCTGCTGAG-1_V12D07-332_A1,2,1,0,0,0,3
GGCATCAACGAGCACG-1_V12D07-332_A1,2,0,0,0,0,2
TTATAGATGCACATTA-1_V12D07-332_A1,0,0,0,1,0,1
TGCTATACAAACGGAC-1_V12D07-332_A1,2,0,0,1,0,3
TATTCCGGCAGTCCTA-1_V12D07-332_A1,4,0,0,0,0,4
ATGTGTAGTTTAGTCA-1_V12D07-332_A1,1,1,0,0,0,2
AAGTTTACTAATGGCA-1_V12D07-332_A1,0,0,0,1,0,1
GATTGACACTCTGCTC-1_V12D07-332_A1,3,0,0,0,0,3
ACCGTTCCCGCTCTGA-1_V12D07-332_A1,6,0,0,1,0,7
CATTCACTGACAGCTA-1_V12D07-332_A1,5,1,0,0,0,6
CATGAACCTCTTATCA-1_V12D07-332_A1,5,0,0,3,0,8
AATAAGTCCTCGAGAC-1_V12D07-332_A1,4,0,2,1,0,7
CTACGAACTAGGTCGA-1_V12D07-332_A1,6,1,0,1,0,8
CACTACTCAGTTCTGT-1_V12D07-332_A1,2,1,0,0,0,3
CATTTATCGTTCAAGA-1_V12D07-332_A1,0,1,0,0,0,1
TAGAAACCACTAAGTA-1_V12D07-332_A1,0,1,0,0,0,1
TCGTATTTCGTCCGGA-1_V12D07-332_A1,1,0,0,1,0,2
ATCCACGCTAAATGTT-1_V12D07-332_A1,1,0,0,0,0,1
ATAAAGGTCAAGTACG-1_V12D07-332_A1,0,0,0,0,0,0
TAGGAACAGCCTCCAG-1_V12D07-332_A1,1,0,1,1,0,3
CACACGTTTCAATGGG-1_V12D07-332_A1,3,4,0,1,0,8
AGTAACGTTCATCCTG-1_V12D07-332_A1,2,1,2,1,0,6
TCTACACGTTCATGCA-1_V12D07-332_A1,0,0,0,0,0,0
TCGGTTAGCCATGTAG-1_V12D07-332_A1,0,0,0,0,0,0
TAAGTAAATGTGCCGC-1_V12D07-332_A1,0,2,1,0,0,3
TGGCACGAGCTCGAGT-1_V12D07-332_A1,0,0,0,0,0,0
GAACTTAGCGCCCGGT-1_V12D07-332_A1,0,1,0,0,0,1
ATAGGAATCTAAGCTT-1_V12D07-332_A1,2,0,0,0,0,2
CAATATGTAGATTTAC-1_V12D07-332_A1,0,0,0,1,0,1
TTATAGTCCAAGGTGC-1_V12D07-332_A1,0,0,0,2,0,2
CCTCGTTACGCCTGTT-1_V12D07-332_A1,0,0,1,0,0,1
ACGCATAAATGACATG-1_V12D07-332_A1,0,0,0,0,0,0
CTTTGGCAGACAGAGT-1_V12D07-332_A1,0,0,1,1,0,2
AGTGGGAGTATACACG-1_V12D07-332_A1,3,1,0,0,0,4
GGTCTTGGTGTTAACT-1_V12D07-332_A1,2,1,0,0,0,3
GGCTGGCAGCTTTATG-1_V12D07-332_A1,2,0,0,0,0,2
CGCCAATTATTGCGTT-1_V12D07-332_A1,1,2,0,2,0,5
GGTAACCGGCAAAGGT-1_V12D07-332_A1,3,0,0,0,0,3
TGGGACCATTGGGAGT-1_V12D07-332_A1,0,0,0,1,0,1
CTGCAGGTGCTCGGCC-1_V12D07-332_A1,2,1,0,0,0,3
CCGGTGCGAGTGATAG-1_V12D07-332_A1,3,1,0,0,0,4
GGGTACACTCTGGAGG-1_V12D07-332_A1,2,0,0,0,0,2
TAGCCAGAGGGTCCGG-1_V12D07-332_A1,2,2,0,0,0,4
CTTGTGAGGACAGCGG-1_V12D07-332_A1,4,0,0,1,0,5
GAAGGGCATAACCATG-1_V12D07-332_A1,3,1,0,1,0,5
CAACATGGCCTGATAA-1_V12D07-332_A1,1,0,0,1,0,2
CAATTTGACCGGGAAG-1_V12D07-332_A1,6,1,0,0,0,7
TCTGACTGTAATGGTT-1_V12D07-332_A1,0,3,0,0,0,3
TTCATAGCCTTGTAAC-1_V12D07-332_A1,0,5,0,0,0,5
TGGAAACGGAGTGAAC-1_V12D07-332_A1,0,2,0,0,0,2
ATCGCACGATTGTTCA-1_V12D07-332_A1,0,4,0,1,0,5
CGCCACCCGCATTAAC-1_V12D07-332_A1,2,0,0,0,0,2
TGGACCACGGCGTTGA-1_V12D07-332_A1,5,2,0,0,0,7
GTATATGTTACGGCGG-1_V12D07-332_A1,3,0,0,0,0,3
GTATTCTTACCGTGCT-1_V12D07-332_A1,4,2,0,0,0,6
TTCAGAGTAACCTGAC-1_V12D07-332_A1,4,1,0,0,0,5
GCGGTAACCCAAATGA-1_V12D07-332_A1,2,1,0,1,0,4
CTACGTGTTGCCACCA-1_V12D07-332_A1,6,2,0,0,0,8
CTAGATAAACTCCTCG-1_V12D07-332_A1,0,0,0,1,0,1
TCCATTAGTTGGATAG-1_V12D07-332_A1,4,1,0,2,0,7
CTGGCTCCTGCGGGAT-1_V12D07-332_A1,0,1,0,1,0,2
CAGTCTCTCGGCTAAT-1_V12D07-332_A1,1,2,0,0,0,3
GTATGACGTGGGAAAC-1_V12D07-332_A1,0,0,0,0,0,0
AGTCACTCCGCCTCAT-1_V12D07-332_A1,2,0,0,1,0,3
GCAGCGGTGGGCATTA-1_V12D07-332_A1,4,0,0,0,0,4
TATGGAGTTTCTCGTT-1_V12D07-332_A1,0,3,0,0,0,3
ACTCAACGAATGTATT-1_V12D07-332_A1,2,0,0,0,0,2
AACACGCGGCCGCGAA-1_V12D07-332_A1,2,1,0,1,0,4
CGATATTAGCCGCAGG-1_V12D07-332_A1,1,0,0,0,0,1
AGCGTCTGAACCCGCA-1_V12D07-332_A1,3,1,0,0,0,4
GATGTCCGGATCACAT-1_V12D07-332_A1,4,0,0,1,0,5
GGTCACGTTAGATTCA-1_V12D07-332_A1,3,0,0,0,0,3
TTAAGGATACGGAGGT-1_V12D07-332_A1,2,0,1,2,0,5
GTGCGGGACCATCGGC-1_V12D07-332_A1,1,3,0,0,0,4
CCATCTTGTTCACAAT-1_V12D07-332_A1,2,1,0,0,0,3
TCCGAGAAGGCTAAGC-1_V12D07-332_A1,2,1,0,1,0,4
TGGCGGTGTGCGATTG-1_V12D07-332_A1,4,1,0,2,0,7
ATCCTGCTGCAGATAG-1_V12D07-332_A1,2,2,0,3,0,7
TTATGCGTCCCGGTCC-1_V12D07-332_A1,2,0,0,2,0,4
CATAATGAGCGGGCGA-1_V12D07-332_A1,1,1,0,3,0,5
AGACATAGATCCTTCC-1_V12D07-332_A1,4,0,0,1,0,5
GGTGAAACCGGGAATG-1_V12D07-332_A1,1,1,0,1,0,3
AACTGGTGTGGGCCTT-1_V12D07-332_A1,2,1,0,1,0,4
GTAGCGCTGTTGTAGT-1_V12D07-332_A1,1,0,0,0,0,1
TTGTTTGTGTAAATTC-1_V12D07-332_A1,3,2,0,0,0,5
GGATCAAAGGACGAGG-1_V12D07-332_A1,5,0,0,2,0,7
CGTAGCGCCGACGTTG-1_V12D07-332_A1,2,1,0,1,0,4
CAAGTGAACTTTGGTT-1_V12D07-332_A1,1,0,0,1,0,2
GTAGACAACCGATGAA-1_V12D07-332_A1,2,0,0,2,0,4
CAATGGTCGGCCTGGG-1_V12D07-332_A1,1,0,0,0,0,1
ACAGATTAGGTTAGTG-1_V12D07-332_A1,2,1,0,1,0,4
GTTATCACCTTCTGAA-1_V12D07-332_A1,3,0,0,1,0,4
TGGTATCGGTCTGTAT-1_V12D07-332_A1,3,0,0,0,0,3
GGAATAACCTCAAGAA-1_V12D07-332_A1,1,1,0,0,0,2
ATTATCTCGACAGATC-1_V12D07-332_A1,2,0,0,3,0,5
CCGAGGGATGTTAGGC-1_V12D07-332_A1,4,0,0,2,0,6
TGAGATCAAATACTCA-1_V12D07-332_A1,3,0,0,1,0,4
AAACGAAGAACATACC-1_V12D07-332_A1,1,1,0,1,0,3
CTGGTCCTAACTTGGC-1_V12D07-332_A1,6,1,0,0,0,7
TGCACGAGTCGGCAGC-1_V12D07-332_A1,5,0,0,0,0,5
ATAGTCTTTGACGTGC-1_V12D07-332_A1,5,0,0,0,0,5
TGGAGCTAAAGTTCCC-1_V12D07-332_A1,3,2,0,0,0,5
GGGTGGTCCAGCCTGT-1_V12D07-332_A1,6,0,0,1,0,7
CATGCATGGAGACCCT-1_V12D07-332_A1,1,2,0,1,0,4
ACACGGCACTATGCAT-1_V12D07-332_A1,1,1,0,0,0,2
CCCTGGTATGGGCGGC-1_V12D07-332_A1,3,1,0,0,0,4
GGAGGATTGAAAGGAG-1_V12D07-332_A1,3,0,0,0,0,3
CCGCTGGTGCCATTCA-1_V12D07-332_A1,3,0,0,1,0,4
GTTAGAGTGTGCCGCT-1_V12D07-332_A1,8,0,0,0,0,8
TCGGAATGACCATCAA-1_V12D07-332_A1,3,3,0,0,0,6
TTCAATTAGCCATAAT-1_V12D07-332_A1,3,1,0,1,0,5
GATGTGTTGTCACAAG-1_V12D07-332_A1,3,2,2,1,0,8
TCTTTCTCTTAAGGAG-1_V12D07-332_A1,3,0,0,0,0,3
ACCCTTTAGTTCTCCA-1_V12D07-332_A1,1,0,0,0,0,1
ACCACAACTCAGAACA-1_V12D07-332_A1,2,1,0,1,0,4
TATGATAAATCTAACG-1_V12D07-332_A1,1,0,0,0,0,1
GATCCTCTTGCGCTTA-1_V12D07-332_A1,0,1,0,0,0,1
TTCTACCTTTATGTTG-1_V12D07-332_A1,2,2,0,0,0,4
GAAATACCTGCTGGCT-1_V12D07-332_A1,3,1,0,1,0,5
ATTCTGAGTATGAACT-1_V12D07-332_A1,1,0,1,0,0,2
GGATTAAGCTAAGGTC-1_V12D07-332_A1,2,0,1,0,0,3
AGTACGTGGCCTGTCT-1_V12D07-332_A1,0,2,0,0,0,2
TCAGGGTGCACGAAAC-1_V12D07-332_A1,0,0,1,0,0,1
AAATTTACCGAAATCC-1_V12D07-332_A1,2,1,0,0,0,3
TTGAGGCATTTAACTC-1_V12D07-332_A1,1,1,1,0,0,3
AACCAGTATCACTCTT-1_V12D07-332_A1,3,0,2,0,0,5
CACCGGAGATATCTCC-1_V12D07-332_A1,2,0,0,0,0,2
GACTGGGCGCCGCAAC-1_V12D07-332_A1,2,0,0,0,0,2
CACGTCTATGATGTGG-1_V12D07-332_A1,2,0,1,0,0,3
TTAAGACGAACGAACC-1_V12D07-332_A1,0,1,0,0,0,1
TGACCAGCTTCAAAGT-1_V12D07-332_A1,2,2,0,0,0,4
AGAGTTAGAGACCGAT-1_V12D07-332_A1,1,0,0,0,0,1
TTCGGACTGATGCCTT-1_V12D07-332_A1,2,1,0,0,0,3
CTCGAATGGAACGTAT-1_V12D07-332_A1,2,2,1,0,0,5
GGACGGCTTGCGCAAC-1_V12D07-332_A1,0,1,0,2,0,3
CTAAGTACAGGGCTAC-1_V12D07-332_A1,0,2,0,1,0,3
ACAAATTCAGATCTGA-1_V12D07-332_A1,0,1,0,1,0,2
CATGGAAATGGGACCA-1_V12D07-332_A1,0,1,0,0,0,1
GGTGGACCACGTGTTA-1_V12D07-332_A1,1,3,0,0,0,4
CACGACGTAATAGTAA-1_V12D07-332_A1,4,1,0,1,0,6
CGGGTTCGGCACGTAT-1_V12D07-332_A1,0,2,0,0,0,2
CTGGGCTATCCTTTGG-1_V12D07-332_A1,0,3,0,0,0,3
GTATTAGGGTTCGCGT-1_V12D07-332_A1,1,0,0,1,0,2
TCATTCGTATAATTTG-1_V12D07-332_A1,0,8,0,1,0,9
AATAGCAAGCCTCCTG-1_V12D07-332_A1,2,0,0,1,0,3
CATCTACCCGAGAACG-1_V12D07-332_A1,1,0,1,0,0,2
GCTTCAGTGGGATTAC-1_V12D07-332_A1,0,2,0,1,0,3
TCTGTGATGGAGGTTG-1_V12D07-332_A1,0,0,0,0,0,0
ATCCACTTTCAGACTA-1_V12D07-332_A1,1,1,1,1,0,4
ATGGTTACGAAACATG-1_V12D07-332_A1,0,2,0,1,0,3
GGCCCAATCTAGAGGG-1_V12D07-332_A1,0,2,0,0,0,2
GATGGTGAAATAACCC-1_V12D07-332_A1,0,0,0,0,0,0
AGAGGGACAATTGTCC-1_V12D07-332_A1,0,0,0,0,0,0
CGCGTACATTCTGGAA-1_V12D07-332_A1,1,1,0,0,0,2
CAAGAAACCCTAAACT-1_V12D07-332_A1,0,0,0,0,0,0
TTGGTGCGGTGTTGAA-1_V12D07-332_A1,0,0,2,1,0,3
GGTTCCCTAGTGTCTC-1_V12D07-332_A1,0,2,0,0,0,2
CGATAACCAATTTGAG-1_V12D07-332_A1,1,0,0,0,0,1
GCCCACTGGTCCACAA-1_V12D07-332_A1,0,0,0,0,0,0
GAGGGCCGGCAGAGTC-1_V12D07-332_A1,1,0,0,0,4,5
CGACACGGATGCCCAC-1_V12D07-332_A1,0,1,1,1,0,3
CTGTCTGTGGCTGGCT-1_V12D07-332_A1,3,0,0,0,0,3
ATATTATCCCGTATTT-1_V12D07-332_A1,2,1,0,0,0,3
GCGCTGGCGGAAAGTC-1_V12D07-332_A1,3,1,0,1,0,5
ATCTAACGTCCCTATG-1_V12D07-332_A1,4,0,0,0,0,4
GTCAGACAGCGTTGGA-1_V12D07-332_A1,2,0,0,2,0,4
GCCAGGCTTAGTGGTA-1_V12D07-332_A1,3,1,0,1,0,5
ATTCAAAGTACCTGTT-1_V12D07-332_A1,7,0,0,1,0,8
TGGACGTAGGCGAATC-1_V12D07-332_A1,1,2,0,0,0,3
ACACATTGACGCAACA-1_V12D07-332_A1,2,0,0,0,0,2
GATATCAGTATGTATC-1_V12D07-332_A1,3,5,0,0,0,8
TGGGCCTTGCCTGCAT-1_V12D07-332_A1,1,1,0,1,0,3
CAAAGTCAGGTTAGCT-1_V12D07-332_A1,1,0,0,1,0,2
GGATCCCTACCAGCTA-1_V12D07-332_A1,6,0,0,0,0,6
ATCGTCCAATCGAGTC-1_V12D07-332_A1,2,0,0,1,0,3
ACATGGCTCAATTTAG-1_V12D07-332_A1,3,1,0,0,0,4
AGGCCCAGTGACTGGT-1_V12D07-332_A1,5,1,0,0,0,6
GCTTCCAGCTTAGATT-1_V12D07-332_A1,1,1,0,0,0,2
TGCTTGAAACCATGCA-1_V12D07-332_A1,0,1,0,0,0,1
CAATATTGGACTAGTG-1_V12D07-332_A1,3,0,0,1,0,4
CGTGCTGGCCTAGTCG-1_V12D07-332_A1,1,0,0,0,0,1
CCTGCGATAGAACTGT-1_V12D07-332_A1,2,3,0,0,0,5
GGGTAATGCTGTGTTT-1_V12D07-332_A1,0,0,0,0,0,0
AACGCGAACGGCAACA-1_V12D07-332_A1,2,0,0,1,0,3
TGTCGGCATGGTGGAA-1_V12D07-332_A1,0,0,0,0,0,0
AGCGTACGAGAGCTAG-1_V12D07-332_A1,0,0,0,0,0,0
ATACTCTCGCCACTCT-1_V12D07-332_A1,0,0,0,0,0,0
AATCCATGCAAGGGTG-1_V12D07-332_A1,0,0,0,0,0,0
TTAAACAGAGTCCCGC-1_V12D07-332_A1,0,0,0,0,0,0
CCACAGCTGAAATCAT-1_V12D07-332_A1,0,0,0,0,0,0
CGGTTCCGGCTTCTTG-1_V12D07-332_A1,0,0,0,0,0,0
GACGTGAGACTCCATG-1_V12D07-332_A1,1,0,0,1,0,2
TCGTTGGCTCGTCAAT-1_V12D07-332_A1,0,0,0,0,0,0
GGTGAACGGGCTAGCC-1_V12D07-332_A1,1,1,0,0,0,2
GCACTGTGCAAATGTA-1_V12D07-332_A1,2,1,0,0,0,3
ACGAGAACCCATCACG-1_V12D07-332_A1,5,1,0,1,0,7
CCAGCTACGCCTCATA-1_V12D07-332_A1,2,3,0,1,0,6
TCCCGGTCAGGAATTT-1_V12D07-332_A1,5,1,0,1,0,7
TCGCATTCAATGACTT-1_V12D07-332_A1,6,1,0,0,0,7
CTGGTTCAACGCATCA-1_V12D07-332_A1,3,0,0,1,0,4
GGTGATTTCATCTTGT-1_V12D07-332_A1,5,1,0,5,0,11
CACCCTTTCCTCGCTC-1_V12D07-332_A1,3,2,0,0,0,5
CAACTTGTAGTGGGCA-1_V12D07-332_A1,4,0,0,1,0,5
AATATCAAGGTCGGAT-1_V12D07-332_A1,4,2,0,1,0,7
ACTCAGACCTGCTTCT-1_V12D07-332_A1,5,0,0,1,0,6
TTGGAGTCTCCCTTCT-1_V12D07-332_A1,4,0,0,1,0,5
GGATACTCATGAATTG-1_V12D07-332_A1,2,1,0,1,0,4
TGGGCACAAACAGAAC-1_V12D07-332_A1,5,1,0,1,0,7
GAGCCACGGTAGTAGG-1_V12D07-332_A1,4,0,0,2,0,6
TCGATAGGCTAGTCGC-1_V12D07-332_A1,1,1,0,1,0,3
TAACCGCCCGCAGTGC-1_V12D07-332_A1,3,0,0,2,0,5
GCCTATTTGCTACACA-1_V12D07-332_A1,1,0,0,0,0,1
TTGACGATTCAGCACG-1_V12D07-332_A1,1,0,0,0,0,1
TTAAACCGGTAGCGAC-1_V12D07-332_A1,3,1,0,0,0,4
ACCGAAAGGGCCCTGC-1_V12D07-332_A1,3,0,0,1,0,4
ACGTTCCGCGCTCCGT-1_V12D07-332_A1,4,0,0,0,0,4
ATACCAGGCTAATAGA-1_V12D07-332_A1,1,0,0,0,0,1
CGGCTTTGTATGATAA-1_V12D07-332_A1,5,2,0,1,0,8
CTTGACCCGAAAGATA-1_V12D07-332_A1,6,2,0,2,0,10
CGCAGAAACATTTGCG-1_V12D07-332_A1,4,0,0,2,0,6
GACCCGTCGCCGGCTA-1_V12D07-332_A1,4,0,0,3,0,7
AATCGGGACACTACGA-1_V12D07-332_A1,4,0,0,1,0,5
GTCACAAAGTTTCCAA-1_V12D07-332_A1,1,0,0,1,0,2
TATATTCGCGTCGATA-1_V12D07-332_A1,0,0,0,0,0,0
CCTCCCGACAATCCCT-1_V12D07-332_A1,2,0,0,3,0,5
CGACATGCGATCTTCT-1_V12D07-332_A1,4,1,0,1,0,6
AACACGACTGTACTGA-1_V12D07-332_A1,3,0,0,0,0,3
CCCAACCACACTAACA-1_V12D07-332_A1,4,0,0,2,0,6
CACCGCCGACCAGCGA-1_V12D07-332_A1,2,0,0,0,0,2
TGGTATCGCATCCCAA-1_V12D07-332_A1,3,0,0,1,0,4
CAGAGTGATTTAACGT-1_V12D07-332_A1,3,1,0,0,0,4
AACCCTGGTGGAACCA-1_V12D07-332_A1,1,2,0,0,0,3
GTCAGTTGTGCTCGTT-1_V12D07-332_A1,2,1,0,1,0,4
ATTGACGTAACTCGGT-1_V12D07-332_A1,2,0,0,1,0,3
GATGTCGGTCAACTGC-1_V12D07-332_A1,2,0,0,1,0,3
AGGGCAGCGGCGTGGT-1_V12D07-332_A1,2,1,0,2,0,5
ACATCGTTAACCTAGT-1_V12D07-332_A1,5,0,0,2,0,7
TCCATTGTGACCTCGT-1_V12D07-332_A1,4,0,0,0,0,4
TGTTTAATACTTCATC-1_V12D07-332_A1,4,2,0,0,0,6
TTGCTGGCCGGGCTTC-1_V12D07-332_A1,3,0,0,0,0,3
CATATTATTTGCCCTA-1_V12D07-332_A1,2,1,0,0,0,3
CTGCCTAGCCACCAAG-1_V12D07-332_A1,0,3,0,0,0,3
ACGAGATATTTGCTTA-1_V12D07-332_A1,2,0,0,2,0,4
GACTACAATTGCTCGT-1_V12D07-332_A1,3,0,0,0,0,3
AACGTGATGAAGGACA-1_V12D07-332_A1,1,1,0,0,0,2
ACTCTCTTATACACGA-1_V12D07-332_A1,1,0,0,0,0,1
CGCATCATGGCTTCAG-1_V12D07-332_A1,0,3,0,0,0,3
CGGCTCTTCGTCGAAC-1_V12D07-332_A1,0,3,0,1,0,4
ATTCTTCGTACTTATG-1_V12D07-332_A1,0,4,0,3,0,7
AGTGAGGGTTTCTGAC-1_V12D07-332_A1,0,2,0,0,0,2
GCCAGGCGTTCGCATG-1_V12D07-332_A1,3,4,0,1,0,8
GACTAACACAGCACCT-1_V12D07-332_A1,1,0,0,0,0,1
CAATGGAATCTACATA-1_V12D07-332_A1,1,2,1,0,0,4
GTGGTCAGCGAAGTAT-1_V12D07-332_A1,3,0,0,0,0,3
ATGGCTGGAAATGGCC-1_V12D07-332_A1,2,0,0,0,0,2
ATCAGGTCGCCATTGC-1_V12D07-332_A1,1,1,0,1,0,3
TATCACCATGTAAAGT-1_V12D07-332_A1,1,1,0,0,0,2
AGCGCTTATGGGCAAG-1_V12D07-332_A1,1,2,0,0,0,3
AAGCGGCGTCATGGGT-1_V12D07-332_A1,1,0,0,1,0,2
ACTAATACGTCAGGCG-1_V12D07-332_A1,1,1,1,1,0,4
GGCTGAGCATCGTAAG-1_V12D07-332_A1,1,1,1,0,0,3
CGGTTGGGTTCAAGTT-1_V12D07-332_A1,4,1,0,0,0,5
GACTGATTGGTCACAA-1_V12D07-332_A1,1,0,0,1,0,2
AGACGGGCCGATTTAA-1_V12D07-332_A1,6,0,1,0,0,7
ACCAGTGCCCGGTCAA-1_V12D07-332_A1,0,1,0,1,0,2
GTCCTTTAATGACTTC-1_V12D07-332_A1,0,0,0,0,0,0
CCTACAAGTCCGGAAT-1_V12D07-332_A1,3,4,1,0,0,8
GCCTGCTACACTGAGA-1_V12D07-332_A1,0,0,1,0,0,1
GACTCGGTCGGCGGAT-1_V12D07-332_A1,3,0,0,0,0,3
CTAGACATATATGTAG-1_V12D07-332_A1,3,2,0,1,0,6
TCGCCCAACTGACTCC-1_V12D07-332_A1,0,0,0,0,0,0
AAACTAACGTGGCGAC-1_V12D07-332_A1,0,1,0,0,0,1
AACTGAGGTCAGCGTC-1_V12D07-332_A1,0,1,1,1,0,3
ACAATGATTCTTCTAC-1_V12D07-332_A1,0,0,0,0,0,0
ATAAGTACCCGATTGT-1_V12D07-332_A1,1,2,1,0,0,4
ATTGGGAGTTCTGTAA-1_V12D07-332_A1,3,1,0,1,0,5
CGAACATAGTCAGAAA-1_V12D07-332_A1,0,0,0,1,0,1
TAGCTCAGATCCTAGT-1_V12D07-332_A1,3,1,0,0,0,4
GTGTCGTATTCACCTT-1_V12D07-332_A1,2,1,0,1,0,4
CTCACCGATCCAAACT-1_V12D07-332_A1,0,2,0,0,0,2
ATATGTGCACAAACCA-1_V12D07-332_A1,3,0,1,2,0,6
CAGTCCAACGCCTTCT-1_V12D07-332_A1,0,0,0,0,0,0
TCGTCCGGGTACACTC-1_V12D07-332_A1,1,1,0,1,0,3
GCAGAAACGTAATCCA-1_V12D07-332_A1,0,0,0,0,0,0
TTCGAGCCGGCGCTAC-1_V12D07-332_A1,1,2,1,0,0,4
GGAAGATAAGACTGTA-1_V12D07-332_A1,0,0,0,0,0,0
ATAAGCAAACACCGAG-1_V12D07-332_A1,0,2,0,0,0,2
GCATAAATTGAACGCC-1_V12D07-332_A1,0,3,1,0,0,4
CGCCGGTGTCGCAGTA-1_V12D07-332_A1,0,1,0,0,0,1
GACCTGGTCTGGGCGT-1_V12D07-332_A1,2,2,0,0,0,4
AGCCGCTTGATTAGCG-1_V12D07-332_A1,1,0,0,1,0,2
CCCGGCTAGGTGAGAA-1_V12D07-332_A1,2,2,0,0,0,4
CGAGCCGAGCACTCGA-1_V12D07-332_A1,0,1,0,1,0,2
TAGTGCTTGAATCCTT-1_V12D07-332_A1,2,0,0,1,0,3
CAACCGCACCTAGACA-1_V12D07-332_A1,1,2,0,2,0,5
ACCACTGTTCAAGAAG-1_V12D07-332_A1,2,1,0,0,0,3
AGATGCTATAACGAGC-1_V12D07-332_A1,1,3,0,2,0,6
AATTACTCGTACGCTC-1_V12D07-332_A1,1,1,0,0,0,2
CGTCAATCTTTAACAT-1_V12D07-332_A1,4,1,0,1,0,6
CCAAAGCAGTTGGTTG-1_V12D07-332_A1,2,0,0,3,0,5
CCATATTGGATCATGA-1_V12D07-332_A1,5,1,0,0,0,6
CGTACCGAAAGTCTAG-1_V12D07-332_A1,0,1,0,1,0,2
CTCGAGATCCAAAGCA-1_V12D07-332_A1,0,0,0,0,0,0
TGGATAGAGTAACAGA-1_V12D07-332_A1,2,0,0,0,0,2
TCACAGATCCTCAAAC-1_V12D07-332_A1,0,0,0,0,0,0
AGAGCTACGAAAGCAT-1_V12D07-332_A1,0,0,0,0,0,0
TGCGTGATTGGGTGTC-1_V12D07-332_A1,0,0,0,0,0,0
CACATGTTTGGACATG-1_V12D07-332_A1,0,0,0,0,0,0
TTCGCATCCGGAAGCA-1_V12D07-332_A1,0,0,0,0,0,0
CCCTAGTGTCAGGTGT-1_V12D07-332_A1,0,0,0,0,0,0
TTACCGCCTTAGGGAA-1_V12D07-332_A1,0,0,0,0,0,0
CCAGTCCATTATTCGA-1_V12D07-332_A1,0,0,0,0,0,0
CGTAAACGCTTGAGTG-1_V12D07-332_A1,0,0,0,0,0,0
ATTCCTTCCAGGCGGT-1_V12D07-332_A1,0,0,0,0,0,0
TTCCTTTCTGTGTTGC-1_V12D07-332_A1,0,0,0,0,0,0
AGTTGACATCGGCTGG-1_V12D07-332_A1,0,0,0,0,0,0
AACTCGATGGCGCAGT-1_V12D07-332_A1,0,0,0,0,0,0
GATAAGGCAGATGCAA-1_V12D07-332_A1,0,0,0,0,0,0
GGCTGGCTAGCTTAAA-1_V12D07-332_A1,0,0,0,0,0,0
CCTCATGCAGCTACGA-1_V12D07-332_A1,0,0,0,0,0,0
GACGCCTGTTGCAGGG-1_V12D07-332_A1,0,0,0,0,0,0
TAATTAGATGGATATG-1_V12D07-332_A1,0,0,0,0,0,0
GAGGGCATCGCGTATC-1_V12D07-332_A1,3,2,0,0,0,5
CTTGTGAGTCTTTGAC-1_V12D07-332_A1,5,0,0,5,0,10
TCAACACATTGGGTAA-1_V12D07-332_A1,6,1,0,3,0,10
ACTGTATACGCGAGCA-1_V12D07-332_A1,2,0,0,3,0,5
GTGAAACGTGCTCCAC-1_V12D07-332_A1,3,3,0,5,0,11
CGAGTGCTATAGTTCG-1_V12D07-332_A1,3,0,0,0,0,3
GTACTGCATGAAGCGT-1_V12D07-332_A1,4,0,0,1,0,5
GTAACTTGCGGCAGTC-1_V12D07-332_A1,3,0,0,1,0,4
GAATCGCCGGACACGG-1_V12D07-332_A1,1,2,0,0,0,3
GGGAGTAATGGCTGGC-1_V12D07-332_A1,1,3,0,0,0,4
CATGAACCGACATTTG-1_V12D07-332_A1,4,0,0,2,0,6
TCTGTCATACAAGAGC-1_V12D07-332_A1,1,0,0,0,0,1
GTCGTCAATTATAAGG-1_V12D07-332_A1,6,0,0,0,0,6
TAAAGAGCCCGAAACC-1_V12D07-332_A1,6,1,0,1,0,8
GTACTGAGGTCGTAAC-1_V12D07-332_A1,5,0,0,0,0,5
AAAGACCCAAGTCGCG-1_V12D07-332_A1,5,0,0,1,0,6
CGTCAGTGCGCACAAG-1_V12D07-332_A1,3,1,0,1,0,5
TGTATCCTTATTCCAT-1_V12D07-332_A1,1,0,0,1,0,2
ATTCTCGTCTCTTTAG-1_V12D07-332_A1,2,0,0,0,0,2
AAAGTCACTGATGTAA-1_V12D07-332_A1,3,0,0,0,0,3
TGTCTACAGTTTCTGT-1_V12D07-332_A1,6,1,0,0,0,7
TTAACGTCGCAAGACC-1_V12D07-332_A1,0,0,0,0,0,0
CTATGTCTATTGAAAC-1_V12D07-332_A1,0,0,0,1,0,1
TCGGGTGAAACTGCTA-1_V12D07-332_A1,0,1,0,0,0,1
TGTCCCGACATAGCAC-1_V12D07-332_A1,1,0,0,1,0,2
ACAGCATAGAGCCAGT-1_V12D07-332_A1,5,0,0,1,0,6
ATATTCCCACAGGTCA-1_V12D07-332_A1,6,0,0,1,0,7
TTGGATCGACTTCTGG-1_V12D07-332_A1,5,0,0,1,0,6
CACCATCGGAGGAGAC-1_V12D07-332_A1,0,0,0,3,0,3
TCGTTCGTTATTATGT-1_V12D07-332_A1,1,0,0,0,0,1
CTTAACTTCGAAGTAC-1_V12D07-332_A1,4,0,0,0,0,4
GCACAAGTGTCGGAAG-1_V12D07-332_A1,4,1,0,0,0,5
TACCAGCTAGGTTTAA-1_V12D07-332_A1,2,0,0,0,0,2
ACGTACAGATTTCTCT-1_V12D07-332_A1,3,0,0,0,0,3
AATTTGGTTCCAAAGA-1_V12D07-332_A1,1,1,0,0,0,2
GTAAGGATTTGTCGGA-1_V12D07-332_A1,3,1,0,0,0,4
CATCATCTACCCGGAC-1_V12D07-332_A1,6,0,0,0,0,6
ACGATGGATCCGATGC-1_V12D07-332_A1,2,0,0,4,0,6
CACTCAGCTCTTGAGG-1_V12D07-332_A1,4,1,0,0,0,5
TAGATCCGAAGTCGCA-1_V12D07-332_A1,7,4,0,0,0,11
TGAAACTTATGCAAGC-1_V12D07-332_A1,3,1,0,0,0,4
GCGATTCTGGAAGCAG-1_V12D07-332_A1,3,2,0,0,0,5
CAAACTATTGAGCTTC-1_V12D07-332_A1,5,0,0,1,0,6
TAGAATTAAGGGCAAC-1_V12D07-332_A1,5,1,0,1,0,7
CGAAACATAGATGGCA-1_V12D07-332_A1,1,0,0,0,0,1
GATGGTGCCCTAGGCA-1_V12D07-332_A1,0,2,0,1,0,3
CCCGCAGGGCCCAAAG-1_V12D07-332_A1,1,0,0,0,0,1
ACAGCGCACCCGCAGC-1_V12D07-332_A1,0,4,4,3,0,11
GGTAAATGTGCGTTAC-1_V12D07-332_A1,0,0,0,0,0,0
GTCCTTCTAGTGGGTT-1_V12D07-332_A1,0,3,0,0,0,3
GGAAGCTCGCTTACAG-1_V12D07-332_A1,1,0,0,0,0,1
CACCGATACACCGAGC-1_V12D07-332_A1,5,2,0,0,0,7
CAGCCGGGCCCTCTAT-1_V12D07-332_A1,5,1,1,0,0,7
CGGAGCTTATAACACC-1_V12D07-332_A1,0,3,0,0,0,3
ATTACAACTACCGGCC-1_V12D07-332_A1,1,6,0,0,0,7
TCCTCTGGCCCATTAG-1_V12D07-332_A1,3,0,0,1,0,4
CGGCACCGTTAGCGCC-1_V12D07-332_A1,4,0,0,1,0,5
TCGGTCCCTGACTCCA-1_V12D07-332_A1,2,0,0,2,0,4
TGGTTGGAGGATCCTG-1_V12D07-332_A1,1,0,0,1,0,2
CTGCGGTAGTCACGTG-1_V12D07-332_A1,4,0,0,0,0,4
GTGCCTCAGTGTACGG-1_V12D07-332_A1,1,0,0,0,0,1
ATCGTTCACTTTCGCC-1_V12D07-332_A1,3,1,0,1,0,5
ACTTACCGGGCGCGCA-1_V12D07-332_A1,0,2,0,0,0,2
CTAGACTGCATTTCGT-1_V12D07-332_A1,0,1,0,0,0,1
TTGCCGGTGATCCCTC-1_V12D07-332_A1,0,1,1,0,0,2
CTGTCACGCCAGGCGC-1_V12D07-332_A1,0,0,0,1,0,1
CGGTATAGGTATTAGC-1_V12D07-332_A1,1,0,0,0,0,1
CCAACGCTTGCCAGGG-1_V12D07-332_A1,0,1,0,0,0,1
CGTTGAGTAATTGCGT-1_V12D07-332_A1,2,0,1,1,0,4
TGTATTTACCTAATGC-1_V12D07-332_A1,0,0,1,0,0,1
TAAATGCCGTCTCATG-1_V12D07-332_A1,0,0,0,0,0,0
CGGTTTATGAAGGAAC-1_V12D07-332_A1,0,0,0,0,0,0
GCAAGATGTGTTCGCG-1_V12D07-332_A1,2,2,0,1,0,5
AAAGGTAAGCTGTACC-1_V12D07-332_A1,0,2,0,0,0,2
GTACGTCACGTATTAA-1_V12D07-332_A1,1,0,0,0,0,1
AGTACCTTCGAGTGCT-1_V12D07-332_A1,1,2,1,0,0,4
ATTGTGACTTCGCTGC-1_V12D07-332_A1,0,0,0,1,0,1
TGTATCAGACTGAAGC-1_V12D07-332_A1,0,0,0,0,0,0
GAGACCCTGCAACGCC-1_V12D07-332_A1,1,1,0,0,0,2
TGGGTGGGATGTCATT-1_V12D07-332_A1,3,0,0,0,0,3
GGCTAATGATTGAAAT-1_V12D07-332_A1,1,1,0,1,0,3
ATAACGTTACCTCCAC-1_V12D07-332_A1,0,0,0,0,0,0
TGCGAGATGGCGGCCA-1_V12D07-332_A1,0,1,0,1,0,2
CACACTTGTATTGCGA-1_V12D07-332_A1,0,1,0,0,0,1
GCTGGTGACTCGTAGT-1_V12D07-332_A1,0,0,1,0,0,1
CGACACCGCTTAAGGA-1_V12D07-332_A1,1,0,1,0,0,2
GTAACAACTGACCTTG-1_V12D07-332_A1,2,1,1,0,0,4
CAACTGAGGGTATGAC-1_V12D07-332_A1,0,2,0,0,0,2
CTAATTATGAAGCGTA-1_V12D07-332_A1,0,0,0,0,0,0
CCGATCTTAAGAGGCT-1_V12D07-332_A1,0,1,0,0,0,1
CGACTCGGTACACGGT-1_V12D07-332_A1,0,0,1,1,0,2
TGCTGCGTCAGAGTTA-1_V12D07-332_A1,0,0,0,0,0,0
AGAGTTGCAGGCCTCC-1_V12D07-332_A1,0,0,0,0,0,0
ACTGGCGAACCTGCGT-1_V12D07-332_A1,2,1,1,0,0,4
ACTAAGGACGCACACC-1_V12D07-332_A1,2,1,0,1,0,4
CGTCCAGATGGCTCCA-1_V12D07-332_A1,2,0,0,0,0,2
ACTATCGCCGGCTAAA-1_V12D07-332_A1,1,2,0,0,0,3
GATAGCGTACCACGCG-1_V12D07-332_A1,1,0,0,2,0,3
AGGACTTATAGGAGAA-1_V12D07-332_A1,3,1,0,0,0,4
TAGTCGGGATTCTTCG-1_V12D07-332_A1,1,1,0,0,0,2
ACCATTAAGGGTGTCA-1_V12D07-332_A1,1,1,0,1,0,3
TTAATGTGTTTGCAGG-1_V12D07-332_A1,1,0,0,1,0,2
TCCGCAGCCACCTAGC-1_V12D07-332_A1,3,1,0,2,0,6
GAGGAGATCCTCATGC-1_V12D07-332_A1,2,0,0,0,0,2
GGTCCTTCATACGACT-1_V12D07-332_A1,6,1,0,2,0,9
CCCTGTTGGCAAAGAC-1_V12D07-332_A1,3,1,0,1,0,5
GTCATCTCCTACAGCT-1_V12D07-332_A1,3,1,0,1,0,5
GCGAGAAACGGGAGTT-1_V12D07-332_A1,4,0,0,0,0,4
CGTCGCGGCGGGATTT-1_V12D07-332_A1,0,0,0,0,0,0
CATTGTGTGCTAGATC-1_V12D07-332_A1,0,0,0,0,0,0
CGCGGCAGTATTACGG-1_V12D07-332_A1,0,0,0,0,0,0
GAAATGGGATGTAAAC-1_V12D07-332_A1,0,0,0,0,0,0
CATTCCCTAAGTACAA-1_V12D07-332_A1,0,0,0,0,0,0
AGTTCTGCGTTGTATC-1_V12D07-332_A1,0,0,0,0,0,0
ACCCTATAGGACTGAG-1_V12D07-332_A1,0,0,0,0,0,0
TTAGATAGGTCGATAC-1_V12D07-332_A1,0,0,0,0,0,0
ATTGATAGCAACGAGA-1_V12D07-332_A1,0,0,0,0,0,0
TCTCGGCTCCAGGACT-1_V12D07-332_A1,0,0,0,0,0,0
CTTGAGGTTATCCCGA-1_V12D07-332_A1,0,0,0,0,0,0
AAGAAGGATCAGTTAG-1_V12D07-332_A1,0,0,0,0,0,0
GTACGACGGCGCTGCG-1_V12D07-332_A1,0,0,0,0,0,0
CTTATGTTGACTACCA-1_V12D07-332_A1,0,0,0,0,0,0
CGGCACTCAAGAAAGT-1_V12D07-332_A1,0,0,0,0,0,0
GTCAAAGTTTACATAG-1_V12D07-332_A1,0,0,0,0,0,0
CTCCTAAGTTATGTCT-1_V12D07-332_A1,0,0,0,0,0,0
ACTGTGCTAGTAGATC-1_V12D07-332_A1,0,0,0,0,0,0
GTTTGGCCGCTCAGCG-1_V12D07-332_A1,2,0,0,2,0,4
TTATCCAATCGAACTC-1_V12D07-332_A1,8,1,0,1,0,10
CCGTACCCAAGCGCCA-1_V12D07-332_A1,6,0,0,2,0,8
CATACAAAGCCGAACC-1_V12D07-332_A1,2,2,0,3,0,7
GGTCGGTAATTAGACA-1_V12D07-332_A1,2,3,0,2,0,7
AGCGGGAAGGGTCCAT-1_V12D07-332_A1,11,0,2,1,3,17
GCCCACCAAGGCTGTC-1_V12D07-332_A1,8,0,0,2,0,10
GTAGACGTCGTTACAT-1_V12D07-332_A1,3,0,0,0,0,3
GAGCATCATCCCTGGG-1_V12D07-332_A1,1,3,0,1,0,5
AGGTAACCTCCTATTC-1_V12D07-332_A1,4,4,0,1,0,9
GGTTTGAGTGCTGGAA-1_V12D07-332_A1,2,2,0,0,0,4
GCACTAGTCGCGCTAT-1_V12D07-332_A1,5,0,0,1,0,6
GGTAACTATGTATCTG-1_V12D07-332_A1,2,1,0,0,0,3
GCGGTCCCTAGACGCA-1_V12D07-332_A1,1,1,0,2,0,4
CGAGCGTTGATCAGCC-1_V12D07-332_A1,6,1,0,0,0,7
AATCCAAGGGCCTGAG-1_V12D07-332_A1,4,0,0,0,0,4
CCGTGCCCATGACGGC-1_V12D07-332_A1,2,0,0,0,0,2
GAAATTCACATCGCTG-1_V12D07-332_A1,2,0,0,1,0,3
CTCTGCGAAGCAAGCA-1_V12D07-332_A1,1,0,0,1,0,2
AGTAGGTAACATACAT-1_V12D07-332_A1,3,0,0,0,0,3
ATTGGGAATATCTTGG-1_V12D07-332_A1,2,1,0,1,0,4
TAGAGCTACGAAGAAC-1_V12D07-332_A1,2,0,0,2,0,4
TGCGGCATAGTTCAAC-1_V12D07-332_A1,2,0,0,1,0,3
CCGCCGGTCAACACAC-1_V12D07-332_A1,1,1,0,2,0,4
TCGTATAGTGCAATTA-1_V12D07-332_A1,2,0,0,0,0,2
TAGTTTATTCTTGCTT-1_V12D07-332_A1,3,0,0,1,0,4
GATATCTCATGCAATA-1_V12D07-332_A1,5,1,0,1,0,7
CGTTTAAGCGGAGCAC-1_V12D07-332_A1,4,0,0,2,0,6
CATGCTGGCTCCAATT-1_V12D07-332_A1,0,0,0,0,0,0
GAAACAGCCATGCAGT-1_V12D07-332_A1,1,0,0,0,0,1
AGTTTCGCAGGTCGGA-1_V12D07-332_A1,1,0,0,2,0,3
CTCATGGCTCACAATC-1_V12D07-332_A1,1,0,0,0,0,1
AACCGTTGTGTTTGCT-1_V12D07-332_A1,1,2,0,1,0,4
ACCCTTCATCTGCGAA-1_V12D07-332_A1,2,0,0,0,0,2
TGCGGTGAAATTTCAT-1_V12D07-332_A1,4,0,0,0,0,4
CAAATTGTCAGCAAGC-1_V12D07-332_A1,3,1,0,1,0,5
GAGGTACATCCATCTT-1_V12D07-332_A1,4,1,0,0,0,5
AAATGGCATGTCTTGT-1_V12D07-332_A1,2,3,0,1,0,6
TCATCCCAGAGGGTGG-1_V12D07-332_A1,5,0,0,0,0,5
CGTAGCGAATTGTCAG-1_V12D07-332_A1,0,1,0,1,0,2
CCTAGTTAGTCGCATG-1_V12D07-332_A1,3,1,0,0,0,4
GAAACTCTAATGAAGG-1_V12D07-332_A1,7,0,0,0,0,7
TTGTATCACACAGAAT-1_V12D07-332_A1,6,0,0,0,0,6
TTCAAGCCGAGCTGAG-1_V12D07-332_A1,3,0,0,1,0,4
AGGTACGATATTGCCA-1_V12D07-332_A1,0,0,0,0,0,0
TTAAGCCGACAACTTC-1_V12D07-332_A1,5,2,0,0,0,7
GTCTTAGTACAGCCGG-1_V12D07-332_A1,2,0,0,0,0,2
TGGGTAAGGTTCCCGC-1_V12D07-332_A1,6,0,0,2,0,8
CTACGCCATTTCCGAT-1_V12D07-332_A1,7,1,0,0,0,8
GACCGTCAGGTCGTGA-1_V12D07-332_A1,3,1,0,1,0,5
TAGTTAAGATAGGATA-1_V12D07-332_A1,3,2,0,1,0,6
GAATATTCGGAGTCCC-1_V12D07-332_A1,1,0,0,0,0,1
CAAACTACGATAGAGA-1_V12D07-332_A1,1,0,0,0,0,1
CAGGAAGACTTTATAT-1_V12D07-332_A1,3,1,0,1,0,5
TTCGTAATCCCAGCGG-1_V12D07-332_A1,3,0,0,0,0,3
GTGAGGAGCGGTTGAG-1_V12D07-332_A1,6,0,0,1,0,7
CAATCCCTATACCAGC-1_V12D07-332_A1,1,3,0,0,0,4
AGGGAAACGAGGTACT-1_V12D07-332_A1,0,0,0,0,0,0
TCCTGCCAACTGGAGA-1_V12D07-332_A1,0,2,0,3,0,5
AATTTGGGACATAGTA-1_V12D07-332_A1,0,0,0,0,0,0
AACTCCTAATCCCATG-1_V12D07-332_A1,5,0,0,1,0,6
GCTCATTACTGCATGT-1_V12D07-332_A1,5,0,1,0,0,6
TCTCGAACGAGGTCAC-1_V12D07-332_A1,0,1,0,1,0,2
TCACTACGACCAATGC-1_V12D07-332_A1,0,0,0,1,0,1
GTGATGCACAACATCT-1_V12D07-332_A1,0,0,0,0,0,0
CCGACGTAAACACAAC-1_V12D07-332_A1,2,1,0,0,0,3
TGGGATGCACTCATTC-1_V12D07-332_A1,0,2,0,0,0,2
TTCCATCATGCGGTGA-1_V12D07-332_A1,0,0,0,0,0,0
TGCACAGTGAAGTTAT-1_V12D07-332_A1,1,1,1,1,0,4
CTATTGTGTTTGGTCA-1_V12D07-332_A1,1,0,1,0,0,2
TGCGAGCCCTTCCGCG-1_V12D07-332_A1,0,0,0,0,0,0
TTGAAAGGTGTAAAGG-1_V12D07-332_A1,0,1,0,0,0,1
GGTGCAGAGCCTATCG-1_V12D07-332_A1,1,0,0,1,0,2
ACTATATGCTGTGTTC-1_V12D07-332_A1,0,1,0,0,0,1
TCCTGGCGCTGCCTGG-1_V12D07-332_A1,0,0,0,1,0,1
GAGCCGAGCGTTTATT-1_V12D07-332_A1,0,1,0,1,0,2
AGAATGCGGGTTCGGA-1_V12D07-332_A1,0,2,0,0,0,2
ATGCGACAATTGGTCC-1_V12D07-332_A1,0,0,1,0,0,1
TTCCGGCTCGACTTCT-1_V12D07-332_A1,2,1,1,0,0,4
TGATTATGGCACGCAG-1_V12D07-332_A1,1,1,0,1,0,3
GGTTTGACAAGAAGCT-1_V12D07-332_A1,1,1,0,0,0,2
GCAGCTATGGACAGGT-1_V12D07-332_A1,1,0,0,0,0,1
CACCATGATCGCAAAG-1_V12D07-332_A1,0,0,0,0,0,0
GTCGGAAGGATACCAG-1_V12D07-332_A1,0,0,0,0,0,0
GGCCCAGTTATCAGCA-1_V12D07-332_A1,0,1,0,0,0,1
GGGCCTATTTAAGTAT-1_V12D07-332_A1,1,4,1,0,0,6
GTTGTTACATTGCGCT-1_V12D07-332_A1,0,0,0,0,0,0
CAACTCCGTAACTTGC-1_V12D07-332_A1,2,0,1,1,0,4
GATCTTTGCTCAAAGA-1_V12D07-332_A1,0,1,0,0,0,1
TCGCTTAATTACGAAG-1_V12D07-332_A1,0,0,0,0,0,0
CGATCATTAGAGGCAC-1_V12D07-332_A1,0,1,0,0,0,1
TGTTCTCTACTCCCTA-1_V12D07-332_A1,2,0,1,0,0,3
GCTTAGGGAAGCGGTA-1_V12D07-332_A1,0,0,0,0,0,0
CAGGTTTAGTACTACA-1_V12D07-332_A1,0,0,0,0,0,0
AAGCGGAGTGCGCGCA-1_V12D07-332_A1,0,1,0,0,0,1
TCAGATGGAGACGTAG-1_V12D07-332_A1,0,0,0,0,0,0
TCGCACTAACGTTTGT-1_V12D07-332_A1,2,1,0,1,0,4
CACGTCGGGTTCTAGA-1_V12D07-332_A1,1,2,0,0,0,3
GGAGTACACATGAGCT-1_V12D07-332_A1,2,0,0,0,0,2
GTGTGTCGACGTCGCT-1_V12D07-332_A1,5,2,0,0,0,7
GAAGCTCTTTGCTTAG-1_V12D07-332_A1,5,0,0,0,0,5
ACACCGAGCGCTCTTT-1_V12D07-332_A1,2,1,0,0,0,3
CGTAATAATTACGAGT-1_V12D07-332_A1,3,0,0,0,0,3
CATCAACACCTACTAA-1_V12D07-332_A1,2,1,0,0,0,3
CCAAGTTTCTACAGAT-1_V12D07-332_A1,6,0,0,3,0,9
CACTTCGTCTTATCTC-1_V12D07-332_A1,1,1,0,1,0,3
CCCTGATGTAACTCGT-1_V12D07-332_A1,0,1,0,0,0,1
CCATAGTCAGTAACCC-1_V12D07-332_A1,5,2,0,1,0,8
CGGGCCATAGCCGCAC-1_V12D07-332_A1,0,0,0,0,0,0
CTCCGGCTTGTAGACA-1_V12D07-332_A1,0,0,0,0,0,0
AACTTGCGTTCTCGCG-1_V12D07-332_A1,0,0,0,0,0,0
AATGAGTTCGCATATG-1_V12D07-332_A1,0,0,0,0,0,0
CGAGGCCAGGCATTGG-1_V12D07-332_A1,0,0,0,0,0,0
TCTGCGTCCGGTTTCT-1_V12D07-332_A1,0,0,0,0,0,0
CAATCCTGCCGTGGAG-1_V12D07-332_A1,0,0,0,0,0,0
CTGAGCAAGTAACAAG-1_V12D07-332_A1,0,0,0,0,0,0
GGGTACCCACGGTCCT-1_V12D07-332_A1,0,0,0,0,0,0
ACGGAATTTAGCAAAT-1_V12D07-332_A1,0,0,0,0,0,0
GGGCGGTCCTATTGTC-1_V12D07-332_A1,0,0,0,0,0,0
ATGTTACGAGCAATAC-1_V12D07-332_A1,0,0,0,0,0,0
AACCATGGGATCGCTA-1_V12D07-332_A1,0,0,0,0,0,0
TCGCATCCCTAAGTGT-1_V12D07-332_A1,0,0,0,0,0,0
ACTTAGTACGACAAGA-1_V12D07-332_A1,2,0,0,1,0,3
GAGCTCTCGGACCTAA-1_V12D07-332_A1,4,1,0,2,0,7
TCTATTACGCTGGCGA-1_V12D07-332_A1,7,0,0,2,0,9
AGATACGACTTCATAT-1_V12D07-332_A1,4,0,0,0,0,4
CGCTATACCGCCCACT-1_V12D07-332_A1,5,0,0,0,0,5
CAGTGTCCGCAGAATG-1_V12D07-332_A1,0,0,0,0,0,0
CCATCCATACCAAGTC-1_V12D07-332_A1,3,0,0,1,0,4
AACCCAGAGACGGAGA-1_V12D07-332_A1,0,1,0,0,0,1
GAAGAACGGTGCAGGT-1_V12D07-332_A1,3,0,0,0,0,3
GATAAATCGGTGGATG-1_V12D07-332_A1,4,1,0,0,0,5
CAGCTCGTGCTTGTGT-1_V12D07-332_A1,1,1,0,0,0,2
GAGTACGGGTATACAA-1_V12D07-332_A1,3,1,0,0,0,4
CATCGCCCGCGGCCAA-1_V12D07-332_A1,1,3,0,2,0,6
TCTTACAGAGGTACCG-1_V12D07-332_A1,3,1,0,2,0,6
TGGAAGACGAACACCA-1_V12D07-332_A1,2,2,0,0,0,4
GTTGTCGTGTTAGTTG-1_V12D07-332_A1,2,0,0,0,0,2
CCAAGGAACAGAGAGG-1_V12D07-332_A1,0,1,0,1,0,2
CTGCACCTGGAACCGC-1_V12D07-332_A1,2,3,0,1,0,6
CGCTTTCATACCGGTG-1_V12D07-332_A1,7,0,0,0,0,7
GTTCTTCCCTCGATGT-1_V12D07-332_A1,4,1,0,3,0,8
ATTTAACTCGTATTAC-1_V12D07-332_A1,5,0,0,1,0,6
AACGATAGAAGGGCCG-1_V12D07-332_A1,2,0,0,1,0,3
TATCCTGCATGGGAAT-1_V12D07-332_A1,5,4,0,2,0,11
AGGCCCATTGTACAGG-1_V12D07-332_A1,2,1,0,1,0,4
CCGGCGCATATTGGAT-1_V12D07-332_A1,1,0,0,0,0,1
ATCTGTAATTGTACCC-1_V12D07-332_A1,3,0,0,1,0,4
GAGCGAGGGAGTACCG-1_V12D07-332_A1,1,0,0,1,0,2
TTATTAGGGAAGCATC-1_V12D07-332_A1,3,1,0,2,0,6
CTTCTTACGTCGTATA-1_V12D07-332_A1,1,0,0,1,0,2
GAAGTGCTGGATAGCT-1_V12D07-332_A1,2,2,0,0,0,4
GTGCAACAAATGTGGC-1_V12D07-332_A1,5,1,0,1,0,7
CATGCGTTAGACAGAA-1_V12D07-332_A1,0,0,0,0,0,0
ACACACTTTCTACACG-1_V12D07-332_A1,2,1,0,0,0,3
AGCCCTAAGCGAAGTT-1_V12D07-332_A1,2,1,0,2,0,5
ATTAATTCGGTCACTC-1_V12D07-332_A1,3,0,0,0,0,3
AACAGGAAATCGAATA-1_V12D07-332_A1,3,1,0,0,0,4
ACGTTTAGTTGTGATC-1_V12D07-332_A1,4,0,0,1,0,5
TCCTTCAGTGGTCGAA-1_V12D07-332_A1,2,0,0,0,0,2
CGAACGCCCAGTGCCG-1_V12D07-332_A1,2,1,0,1,0,4
CCTCGAAGTGGACGGG-1_V12D07-332_A1,2,1,0,1,0,4
CTCTGTTTGAGGATTC-1_V12D07-332_A1,5,0,0,2,0,7
TGGGCACGTTCTATGG-1_V12D07-332_A1,7,0,0,0,0,7
ACTATTCGTCCGTGGT-1_V12D07-332_A1,5,0,0,0,0,5
CCTCTGGCCTAGACGG-1_V12D07-332_A1,3,2,0,0,0,5
CCATAAACAACCCGAC-1_V12D07-332_A1,3,2,0,0,0,5
CATAGTACATTGAGAG-1_V12D07-332_A1,5,0,0,0,0,5
ATTTCATTATTTCGCG-1_V12D07-332_A1,3,0,0,0,0,3
CAACTATATCGAATGC-1_V12D07-332_A1,4,2,0,0,0,6
CTAGTATTCGGAATTA-1_V12D07-332_A1,1,1,1,0,0,3
GTGGAACCTACATGCG-1_V12D07-332_A1,3,2,0,2,0,7
CCTAAAGGCTGACGCT-1_V12D07-332_A1,3,0,0,0,0,3
CGTGACATTGGGTCGT-1_V12D07-332_A1,2,0,0,1,0,3
CCAATCGGTAGATCGA-1_V12D07-332_A1,4,0,0,0,0,4
ATTGTCGCAATACCTT-1_V12D07-332_A1,0,0,0,0,0,0
AAATTACACGACTCTG-1_V12D07-332_A1,4,0,0,0,0,4
CACTCCTCTCGGTCGG-1_V12D07-332_A1,3,1,1,0,0,5
AAATAACCATACGGGA-1_V12D07-332_A1,3,1,1,0,0,5
AGTTACTCTATCGTGG-1_V12D07-332_A1,4,0,0,0,0,4
CGTTAGCTCACAACTG-1_V12D07-332_A1,5,2,0,0,0,7
GAATGTATGGCAGGTC-1_V12D07-332_A1,0,2,0,0,0,2
GCAACCACCAGACCGG-1_V12D07-332_A1,2,2,0,0,0,4
TCACTCGTGCAACGGC-1_V12D07-332_A1,1,1,0,0,0,2
AAACAGAGCGACTCCT-1_V12D07-332_A1,1,0,0,0,0,1
CAGCCTCTCCTCAAGA-1_V12D07-332_A1,3,0,0,0,0,3
TTGCGTGAACGCTTAG-1_V12D07-332_A1,0,0,0,0,0,0
CCGCCTGCGAATTGGT-1_V12D07-332_A1,1,0,0,0,0,1
AGATGAGGGTTGCGAT-1_V12D07-332_A1,0,1,0,0,0,1
CGGTGGGCTCCAGCCT-1_V12D07-332_A1,1,0,0,1,0,2
GGCAGCGGTAATCCTA-1_V12D07-332_A1,4,3,1,2,0,10
GCTAGCAGGGAGTGGG-1_V12D07-332_A1,0,0,1,0,0,1
CTCAAGACATTAGCGC-1_V12D07-332_A1,1,2,0,1,0,4
CACGGCGCGCCAAAGG-1_V12D07-332_A1,2,1,0,1,0,4
TGCAATTTGGGCACGG-1_V12D07-332_A1,3,1,0,1,0,5
ATGCCAATCGCTCTGC-1_V12D07-332_A1,0,1,0,0,0,1
GCTGGACCCAAAGTGG-1_V12D07-332_A1,1,0,0,0,0,1
ATTCCTAAGACGTGGA-1_V12D07-332_A1,2,1,0,0,0,3
TCCGGAGGAAGGGCTG-1_V12D07-332_A1,5,0,0,0,0,5
TCGGTGACCGCTCCGG-1_V12D07-332_A1,0,2,0,1,0,3
TCCGAAGTAGTCACCA-1_V12D07-332_A1,1,0,1,0,0,2
CATGTAGGAGCGCCAA-1_V12D07-332_A1,0,1,0,0,0,1
CACAAGAAAGATATTA-1_V12D07-332_A1,0,1,0,0,0,1
AGGGTCAGTAACCCTA-1_V12D07-332_A1,1,0,1,0,0,2
TAAGCCCTTACGACCA-1_V12D07-332_A1,1,2,0,0,0,3
ATACCGTCATCCATAA-1_V12D07-332_A1,0,1,0,0,0,1
GGACGTCCATAGTTGG-1_V12D07-332_A1,0,0,0,0,0,0
CATCAAACTGGCGCCC-1_V12D07-332_A1,2,1,0,0,0,3
AAACGTGTTCGCCCTA-1_V12D07-332_A1,3,1,0,0,0,4
AAATTGGTGAGAAGCA-1_V12D07-332_A1,0,1,0,1,0,2
GGTCATTGTAGTCATA-1_V12D07-332_A1,2,1,0,0,0,3
TGCAGTGAGGCTCGGG-1_V12D07-332_A1,1,0,0,0,0,1
GAACATTAGTATGTTA-1_V12D07-332_A1,0,0,0,0,0,0
GGTTTGCGAACACGTA-1_V12D07-332_A1,2,0,1,0,0,3
ACACAAATATTCCTAG-1_V12D07-332_A1,0,0,1,0,0,1
TTGGGTTTATTCAGCG-1_V12D07-332_A1,4,1,0,0,0,5
ATTCGCAGAGGACACT-1_V12D07-332_A1,1,0,0,0,0,1
GATTTAGTGCGTACTG-1_V12D07-332_A1,0,0,0,0,0,0
TAGAAACACAATAGTG-1_V12D07-332_A1,2,0,0,0,0,2
CAGTAGATGATGTCCG-1_V12D07-332_A1,3,0,0,0,0,3
TCTTAACTCGGATGTA-1_V12D07-332_A1,2,0,0,0,0,2
TACATCTTGTTTCTTG-1_V12D07-332_A1,4,0,0,0,0,4
TTCATAGGGTGTCCAT-1_V12D07-332_A1,1,0,0,0,0,1
TGAAGTAGCTTACGGA-1_V12D07-332_A1,3,1,0,0,0,4
GCACAAGTGGATCATA-1_V12D07-332_A1,0,4,0,0,0,4
AGTCAGCCACCGCCTG-1_V12D07-332_A1,0,0,0,0,0,0
TCATCACTCGAGCTCG-1_V12D07-332_A1,0,0,0,0,0,0
CTCAGGACTCACCTGT-1_V12D07-332_A1,0,0,0,0,0,0
CGGTGTACTTGATCCC-1_V12D07-332_A1,4,0,0,2,0,6
CCTACGGCTCAGTCGA-1_V12D07-332_A1,3,0,0,0,0,3
GTACTTGGGCACTTCT-1_V12D07-332_A1,4,2,0,1,0,7
TGATTTCCTCCTGACG-1_V12D07-332_A1,3,0,0,0,0,3
CCTCACCAATCTTGAC-1_V12D07-332_A1,4,0,0,0,0,4
GGTGAGATGCAGATAA-1_V12D07-332_A1,2,0,0,1,0,3
GCTAGTTTCATTGAGG-1_V12D07-332_A1,2,4,0,0,0,6
AGGACATCGCACGTCG-1_V12D07-332_A1,2,0,0,1,0,3
GTGGACGTGCTGAGAC-1_V12D07-332_A1,1,1,0,1,0,3
TAAGGAACTTGTGGGA-1_V12D07-332_A1,3,0,0,1,0,4
TCGCTGTGCGTAAATC-1_V12D07-332_A1,4,0,0,0,0,4
GCATCCCTAACTTTGA-1_V12D07-332_A1,2,0,0,0,0,2
CACCCACACGTCACCC-1_V12D07-332_A1,3,0,0,1,0,4
CCCTCATTCTGGAATT-1_V12D07-332_A1,3,0,0,1,0,4
AGGGCGTGATCGGCTA-1_V12D07-332_A1,2,1,0,2,0,5
GGTGCGGATAAGTGGC-1_V12D07-332_A1,3,1,0,0,0,4
TAATATTGAAATTCGC-1_V12D07-332_A1,1,2,0,0,0,3
CTTACACTGGGAAATA-1_V12D07-332_A1,2,3,0,3,0,8
ACCAAGAACGCGTGTC-1_V12D07-332_A1,1,4,0,0,0,5
GCCTTCAGCCCTACCG-1_V12D07-332_A1,3,0,0,2,0,5
GATGCTACAAGCGCCT-1_V12D07-332_A1,3,2,0,0,0,5
CCGGGACCCGCAGAGA-1_V12D07-332_A1,2,3,0,2,0,7
GTTCCAGTCTGACCAT-1_V12D07-332_A1,2,2,0,0,0,4
ATGATCGGGAATAGAC-1_V12D07-332_A1,4,4,0,0,0,8
TTGGATTGGGTACCAC-1_V12D07-332_A1,1,1,0,2,0,4
TACCTCACGCTTGTAC-1_V12D07-332_A1,5,1,0,0,0,6
CATGGCAGGAAGATCG-1_V12D07-332_A1,2,0,0,0,0,2
ATGACGCCGGCTCTAA-1_V12D07-332_A1,3,1,0,1,0,5
AGCGACATCCCATTCA-1_V12D07-332_A1,5,3,0,0,0,8
AGTAATGTCTTGCCGC-1_V12D07-332_A1,3,1,0,2,0,6
TTCTTAGTGGCTCAGA-1_V12D07-332_A1,6,3,0,0,0,9
CGTCTGGAAGGGCCCG-1_V12D07-332_A1,2,0,0,1,0,3
ACGTGCGCCTCGTGCA-1_V12D07-332_A1,2,1,0,0,0,3
AGAGCGGGCTAATCAT-1_V12D07-332_A1,2,0,0,0,0,2
GCGTCGAAATGTCGGT-1_V12D07-332_A1,2,0,0,1,0,3
AACTGATATTAGGCCT-1_V12D07-332_A1,2,0,0,1,0,3
CGAGCTGGGCTTTAGG-1_V12D07-332_A1,5,1,0,2,0,8
GGGTGTTTCAGCTATG-1_V12D07-332_A1,6,1,0,1,0,8
TTAATTTCAGACGCGG-1_V12D07-332_A1,2,3,0,2,0,7
ACTGCCGTCGTAACTC-1_V12D07-332_A1,2,0,0,0,0,2
GTGCACGAAAGTGACT-1_V12D07-332_A1,6,0,0,0,0,6
ATCTCCCTGCAATCTA-1_V12D07-332_A1,2,0,0,0,0,2
ACGCCAGATGATTTCT-1_V12D07-332_A1,4,0,0,1,0,5
AGCTATTTAATCCAAC-1_V12D07-332_A1,2,0,0,1,0,3
CCACGAGAAGAGAATC-1_V12D07-332_A1,2,2,0,1,0,5
GATTCCGCGTTTCCGT-1_V12D07-332_A1,3,0,0,1,0,4
GTCGGATGTAGCGCGC-1_V12D07-332_A1,2,2,0,0,0,4
TATTTATACCGAGTAG-1_V12D07-332_A1,5,0,0,0,0,5
GTAGGTGATCCGTGTA-1_V12D07-332_A1,1,0,0,1,0,2
AGTTAAGCGGTCCCGG-1_V12D07-332_A1,2,0,0,3,0,5
CTGGCGACATAAGTCC-1_V12D07-332_A1,3,0,0,0,0,3
TTGGCCTAGAATTTCG-1_V12D07-332_A1,0,0,0,0,0,0
GGCATATCGGTTCTGC-1_V12D07-332_A1,3,1,0,1,0,5
GGGCGTCCACTGGCTC-1_V12D07-332_A1,6,0,1,0,0,7
TTACCCATTGCCGGGT-1_V12D07-332_A1,3,0,0,0,0,3
TTAGACACGATCGTTG-1_V12D07-332_A1,3,1,0,0,0,4
GCGCTGATCCAGACTC-1_V12D07-332_A1,2,0,0,0,0,2
TTCGGCAACCCGCTGA-1_V12D07-332_A1,1,0,0,0,0,1
GATATTTCCTACATGG-1_V12D07-332_A1,1,1,0,0,0,2
CTGCGTTACGATATAA-1_V12D07-332_A1,3,0,0,1,0,4
TAATAAACAAGGAGAT-1_V12D07-332_A1,2,1,0,0,0,3
AACCTTTACGACGTCT-1_V12D07-332_A1,2,0,0,1,0,3
AGTCCCGCCTTTAATT-1_V12D07-332_A1,3,1,0,1,0,5
TGAGATTAGGCCCTAA-1_V12D07-332_A1,4,0,0,0,0,4
AGTGTATTGCGCATTG-1_V12D07-332_A1,4,0,0,1,0,5
GTTGGATTCAGTGGCT-1_V12D07-332_A1,2,1,0,1,0,4
TAAAGCTGCAATAGGG-1_V12D07-332_A1,1,0,0,0,0,1
AGTAGGAAGGAAGTTG-1_V12D07-332_A1,0,0,0,1,0,1
TATCACTTCGAGTAAC-1_V12D07-332_A1,1,0,0,1,0,2
TGATCTACGCTGATCT-1_V12D07-332_A1,0,0,0,1,0,1
GGATCATCCCGTACGC-1_V12D07-332_A1,1,1,0,0,0,2
TGACACTTCTCTTTGC-1_V12D07-332_A1,1,2,0,1,0,4
AGCCCTTCTAATCCGA-1_V12D07-332_A1,2,1,0,3,0,6
CACCGCGTCCACTCTA-1_V12D07-332_A1,1,2,0,0,0,3
TAATTGGAATCGGGAA-1_V12D07-332_A1,2,0,0,1,0,3
TCGTAAGCTCCGAGGA-1_V12D07-332_A1,4,1,0,0,0,5
TATATTACAAATGTCG-1_V12D07-332_A1,2,1,0,0,0,3
CGCGAGAGGGACTTGT-1_V12D07-332_A1,3,4,0,1,0,8
GGACCTACGGTAACGT-1_V12D07-332_A1,1,1,1,0,0,3
GAAATATGCTTGAATG-1_V12D07-332_A1,1,0,0,0,0,1
CCGTATTAGCGCAGTT-1_V12D07-332_A1,1,3,1,0,0,5
AGGCGTCTATGGACGG-1_V12D07-332_A1,0,2,0,0,0,2
AACATCGATACGTCTA-1_V12D07-332_A1,0,2,1,0,0,3
TGAATATGCTATAAAC-1_V12D07-332_A1,0,1,0,0,0,1
ACCAAACACCCAGCGA-1_V12D07-332_A1,1,1,0,1,0,3
TGGCTTGTACAAGCTT-1_V12D07-332_A1,0,0,0,2,0,2
GAATGAAGGTCTTCAG-1_V12D07-332_A1,0,1,1,0,0,2
AGATACCAGCACTTCA-1_V12D07-332_A1,0,1,0,2,0,3
GCGGTCCCGGTGAAGG-1_V12D07-332_A1,3,0,1,0,0,4
GAGGCATTTGCAGCAG-1_V12D07-332_A1,0,1,0,0,0,1
GGCAAGCCAGGGATAG-1_V12D07-332_A1,1,1,0,0,0,2
TCTACGGGCTCAGTTG-1_V12D07-332_A1,0,1,0,0,0,1
TCTGCGAATCGTTCGC-1_V12D07-332_A1,0,0,0,0,0,0
AGCTCGTTGATGGAAA-1_V12D07-332_A1,2,2,0,0,0,4
TGAATGAGATACAGCA-1_V12D07-332_A1,0,2,0,0,0,2
ACCCTTGCCTGGGTCG-1_V12D07-332_A1,1,0,1,0,0,2
GGCGAACCGTTCTGAT-1_V12D07-332_A1,0,0,0,0,0,0
GCGATGTCTGTGCTTG-1_V12D07-332_A1,1,0,0,0,1,2
ATTAACACCTGAGATA-1_V12D07-332_A1,1,3,0,3,0,7
GAAATCTGACCAAGTT-1_V12D07-332_A1,1,1,0,2,0,4
CCTGACAAACTCGCGC-1_V12D07-332_A1,0,0,0,0,0,0
ATGTCATTTCCCATTG-1_V12D07-332_A1,4,0,0,0,0,4
TAACTCCATGGAGGCT-1_V12D07-332_A1,0,0,0,0,0,0
CTTGTTTATGTAGCCA-1_V12D07-332_A1,0,0,0,0,0,0
GATGGCGCACACATTA-1_V12D07-332_A1,7,0,0,0,0,7
ATAATAGTGTAGGGAC-1_V12D07-332_A1,1,0,0,1,0,2
CGCTATTCAATGTATG-1_V12D07-332_A1,1,0,0,1,0,2
ATATTGCTGTCAAAGT-1_V12D07-332_A1,3,0,0,0,0,3
GGATTCAGTACGGTGG-1_V12D07-332_A1,2,0,0,1,0,3
TTCTTAGTGAACGGTG-1_V12D07-332_A1,5,0,0,0,0,5
AATGGTTCTCACAAGC-1_V12D07-332_A1,2,2,0,0,0,4
TATACACGCAAAGTAT-1_V12D07-332_A1,0,0,0,0,0,0
CTTCATAGCTCAAGAA-1_V12D07-332_A1,2,1,0,0,0,3
CAACGGTTCTTGATAC-1_V12D07-332_A1,1,1,0,0,0,2
ACACCCGAGAAATCCG-1_V12D07-332_A1,2,0,0,0,0,2
TCTATCATGCAGTTAC-1_V12D07-332_A1,1,0,0,0,0,1
CCCGCCATGCTCCCGT-1_V12D07-332_A1,2,0,0,0,0,2
CGCTTCCACTGAAATC-1_V12D07-332_A1,1,2,0,1,0,4
CACTGTCCAAGTGAGA-1_V12D07-332_A1,2,1,0,1,0,4
ATTACTAGCCTCTTGC-1_V12D07-332_A1,2,0,0,4,0,6
CATAGTAGCATAGTAG-1_V12D07-332_A1,5,0,0,2,0,7
CAACTCCTTGATCCCG-1_V12D07-332_A1,1,0,0,1,0,2
AAGTAGAAGACCGGGT-1_V12D07-332_A1,3,0,0,1,0,4
GCGGGAACCAGGCCCT-1_V12D07-332_A1,4,0,0,1,0,5
ATTAGATTGATAGCGG-1_V12D07-332_A1,4,0,0,3,0,7
CTCGGTCCGTAGCCTG-1_V12D07-332_A1,5,1,0,2,0,8
TGGCTTTGGGTAGACA-1_V12D07-332_A1,0,3,0,1,0,4
TATCCATATCATGCGA-1_V12D07-332_A1,3,1,0,2,0,6
GGAGTGCCGCCCTGGA-1_V12D07-332_A1,3,2,0,2,0,7
TGAGAATGCTTTACCG-1_V12D07-332_A1,1,2,0,0,0,3
TTAACCAACCCTCCCT-1_V12D07-332_A1,2,2,0,0,0,4
TGTTTCGGTACTTCTC-1_V12D07-332_A1,2,1,0,0,0,3
TTGCTGAAGGAACCAC-1_V12D07-332_A1,1,2,0,1,0,4
TATTTAGTCTAGATCG-1_V12D07-332_A1,4,0,0,1,0,5
CTCCGGCCTAATATGC-1_V12D07-332_A1,0,0,0,0,0,0
TTGTGGCCCTGACAGT-1_V12D07-332_A1,3,2,0,1,0,6
TCGCCGGTCGATCCGT-1_V12D07-332_A1,2,1,0,0,0,3
CCATAGGTTGGCGTGG-1_V12D07-332_A1,3,1,0,0,0,4
GAACGACCGAATGATA-1_V12D07-332_A1,4,0,0,0,0,4
TCCGATAATTGCCATA-1_V12D07-332_A1,3,1,0,0,0,4
CATTACGTCGGCCCGT-1_V12D07-332_A1,3,0,0,1,0,4
CAAGCACCAAATGCCT-1_V12D07-332_A1,0,2,0,0,0,2
TGCATGGATCGGATCT-1_V12D07-332_A1,1,1,0,1,0,3
GAAATCGCGCGCAACT-1_V12D07-332_A1,2,0,0,0,0,2
CTGAAAGAGATCCGAC-1_V12D07-332_A1,0,1,0,1,0,2
CACCTCGATGGTGGAC-1_V12D07-332_A1,5,0,0,3,0,8
ATTTGTTCCAGGGCTC-1_V12D07-332_A1,3,0,0,1,0,4
TGGGCCACAAGAGCGC-1_V12D07-332_A1,3,0,0,1,0,4
CCTTCTTGATCCAGTG-1_V12D07-332_A1,1,0,0,2,0,3
CCTCGCCAGCAAATTA-1_V12D07-332_A1,1,2,0,0,0,3
TTCATGGCGCAACAGG-1_V12D07-332_A1,2,1,0,0,0,3
TTAATCAGTACGTCAG-1_V12D07-332_A1,5,0,0,1,0,6
CCTATCTATATCGGAA-1_V12D07-332_A1,4,0,0,0,0,4
ATTATACTTTGCTCGT-1_V12D07-332_A1,4,0,0,0,0,4
ATGGATCCGGCGTCCG-1_V12D07-332_A1,0,2,0,0,0,2
CGCCCGCTTCCGTACA-1_V12D07-332_A1,4,1,0,1,0,6
GGATTCCGCTATACCC-1_V12D07-332_A1,5,0,0,0,0,5
CGGTCTATCAACCCGT-1_V12D07-332_A1,4,1,0,0,0,5
ATGCCGGTTGATGGGA-1_V12D07-332_A1,4,0,0,1,0,5
TCATGCAGGTTCTCAT-1_V12D07-332_A1,1,1,0,0,0,2
TGAGCTTTAATGACGC-1_V12D07-332_A1,3,1,0,1,0,5
TCCCTTAGATTACTCG-1_V12D07-332_A1,1,1,0,0,0,2
ATATCTCCCTCGTTAA-1_V12D07-332_A1,2,0,0,0,0,2
AGCTCTTCCCAGTGCA-1_V12D07-332_A1,4,0,0,2,0,6
TCGCTAAACCGCTATC-1_V12D07-332_A1,0,2,0,0,0,2
CACATTCTTTCGATGG-1_V12D07-332_A1,0,0,0,1,0,1
GATATGCGGTAGCCAA-1_V12D07-332_A1,4,1,0,1,0,6
CGTTTCACTTCGGGCG-1_V12D07-332_A1,5,1,0,1,0,7
CCAATTACGGGTCGAG-1_V12D07-332_A1,2,2,0,0,0,4
GCAGGTAGAGTATGGT-1_V12D07-332_A1,1,0,0,1,0,2
GTCGTATTGGCGTACA-1_V12D07-332_A1,3,0,0,0,0,3
GAAATTAGCACGGATA-1_V12D07-332_A1,1,2,0,2,0,5
AATGCACCAAGCAATG-1_V12D07-332_A1,3,1,0,0,0,4
AGGACGCTCGATGTTG-1_V12D07-332_A1,1,0,0,0,0,1
GGCTAAAGGGCGGGTC-1_V12D07-332_A1,2,0,0,0,0,2
CATCTATCCCGTGTCT-1_V12D07-332_A1,1,1,0,1,0,3
CAGTAACTATTTATTG-1_V12D07-332_A1,4,1,0,1,0,6
CATATACTACTGATAA-1_V12D07-332_A1,3,1,0,0,0,4
GCGTTCGGAGACCGGG-1_V12D07-332_A1,4,1,1,1,0,7
AAGTTCAGTCTGCGTA-1_V12D07-332_A1,0,0,0,0,0,0
CGAAGCTATAAATTCA-1_V12D07-332_A1,3,0,1,0,0,4
CGCGGTCACAAACCAA-1_V12D07-332_A1,3,2,0,0,0,5
GGGAATGAGCCCTCAC-1_V12D07-332_A1,2,0,0,0,0,2
ACGGAGCGCAAATTAC-1_V12D07-332_A1,1,8,0,0,0,9
CGTTCTTCGCACACCT-1_V12D07-332_A1,0,1,0,1,0,2
GAATAGCCCTGCGGTC-1_V12D07-332_A1,0,0,0,0,0,0
AATAGCTACCGCGTGC-1_V12D07-332_A1,1,0,0,0,0,1
CCGAGCTGTGCTTGTC-1_V12D07-332_A1,1,1,0,0,0,2
GATGACGATGATCGCG-1_V12D07-332_A1,1,0,0,1,0,2
GCCTATGCTGGGCCTT-1_V12D07-332_A1,0,0,0,0,0,0
TTACTGTCTAGAGCTC-1_V12D07-332_A1,0,0,1,0,0,1
AGCGGTTGCCGCTCTG-1_V12D07-332_A1,2,2,0,0,0,4
GCTTGCAGCACAATTG-1_V12D07-332_A1,0,1,0,1,0,2
CCGGAGGTCTTATGGT-1_V12D07-332_A1,0,0,0,2,0,2
ACAGTATACCGTGGGA-1_V12D07-332_A1,0,0,0,0,0,0
GGGATCCCAATACAAA-1_V12D07-332_A1,1,0,0,0,0,1
ATTACGACTCCACAGT-1_V12D07-332_A1,0,1,0,0,0,1
CTCACACGCAAGCCTA-1_V12D07-332_A1,0,0,0,0,0,0
CCAGATGTAAATGGGT-1_V12D07-332_A1,0,0,0,0,0,0
GAACTTGTGCACGGGA-1_V12D07-332_A1,3,0,0,0,0,3
AAGCCGCTTTACCTTG-1_V12D07-332_A1,0,1,0,0,0,1
TCCATTCCCACTAGAG-1_V12D07-332_A1,0,1,0,1,0,2
AGAGCGCTTGTAACGG-1_V12D07-332_A1,1,0,0,0,0,1
TGGGTTCCCGGACGGA-1_V12D07-332_A1,2,0,0,0,0,2
GCTGCGCCTCCCACGT-1_V12D07-332_A1,2,0,0,0,0,2
CTGTTGGCTCTTCTGA-1_V12D07-332_A1,0,1,1,1,0,3
TTGTTCTAGATACGCT-1_V12D07-332_A1,1,1,0,1,0,3
CCCTCAAGCTCTTAGT-1_V12D07-332_A1,1,0,0,2,0,3
CAGTAATCCCTCCCAG-1_V12D07-332_A1,2,0,0,0,0,2
GTATTAAGGCGTCTAA-1_V12D07-332_A1,2,0,0,0,0,2
CTAATTTCAACAACAC-1_V12D07-332_A1,2,2,0,0,0,4
TTAGCAACATGGATGT-1_V12D07-332_A1,5,0,0,0,0,5
ATGCTCAGTGTTGCAT-1_V12D07-332_A1,1,1,0,0,0,2
GATGTTTGTGCGAGAT-1_V12D07-332_A1,1,1,0,0,0,2
CACTTCGCCACAGGCT-1_V12D07-332_A1,1,0,0,2,0,3
CTGTATGGTGTAGAAA-1_V12D07-332_A1,3,2,0,1,0,6
TACGTGCACTATGCTG-1_V12D07-332_A1,2,0,0,0,0,2
GTATCAGCTTGGGTTC-1_V12D07-332_A1,1,0,0,0,0,1
TAACAAAGGGAGAAGC-1_V12D07-332_A1,2,0,0,0,0,2
TTACATCGTGGCCTGG-1_V12D07-332_A1,2,0,0,0,0,2
TCTGAACCGGTCGGCT-1_V12D07-332_A1,4,1,0,1,0,6
GGCTCGTGCCACCAGC-1_V12D07-332_A1,1,0,0,1,0,2
TATAAGTGAGGATAGC-1_V12D07-332_A1,2,2,0,0,0,4
GCCCGCGCGTTTGACA-1_V12D07-332_A1,1,2,0,0,0,3
TGCTGGTTGGACAATT-1_V12D07-332_A1,2,0,0,0,0,2
GCCTAGCGATCTGACC-1_V12D07-332_A1,1,0,0,2,0,3
CCATGCTCTGCAGGAA-1_V12D07-332_A1,3,0,0,0,0,3
TATAAATCCACAAGCT-1_V12D07-332_A1,2,3,0,1,0,6
CGCTCGACATAATGAT-1_V12D07-332_A1,3,1,0,0,0,4
CCAATTGAATGTTAAT-1_V12D07-332_A1,0,0,0,1,0,1
GCTAATACCGAATGCC-1_V12D07-332_A1,1,0,0,0,0,1
TTCAACGACCCGACCG-1_V12D07-332_A1,3,1,0,1,0,5
TTCCTCGAGGGTGTCT-1_V12D07-332_A1,4,2,0,0,0,6
CAACGACCCGTTTACA-1_V12D07-332_A1,0,0,0,0,0,0
CTTGTACTTGTTGACT-1_V12D07-332_A1,0,2,0,0,0,2
TCTCTAATAGCTGGTA-1_V12D07-332_A1,5,2,0,0,0,7
ATTATGCCATAGGGAG-1_V12D07-332_A1,5,2,0,0,0,7
GACAACGCAGCTTACG-1_V12D07-332_A1,0,2,0,1,0,3
AGATGACTCGCCCACG-1_V12D07-332_A1,4,1,0,1,0,6
GTGCGGGTCTCCAAAT-1_V12D07-332_A1,3,1,0,0,0,4
GTACGAGATTGCGACA-1_V12D07-332_A1,2,0,1,0,0,3
GTATAGGACTCAGTAG-1_V12D07-332_A1,3,0,0,2,0,5
TTGCACGGAGCAGCAC-1_V12D07-332_A1,3,0,0,0,0,3
CACAGCTAGGGAGTGA-1_V12D07-332_A1,5,0,0,0,0,5
ATACTAGCATGACCCT-1_V12D07-332_A1,2,2,0,0,0,4
CCAAGACTTCTGCGAA-1_V12D07-332_A1,4,0,0,0,0,4
ACATAATAAGGCGGTG-1_V12D07-332_A1,4,1,0,2,0,7
TAATACACAGTAGTAT-1_V12D07-332_A1,4,1,0,2,0,7
TCTTGGTAACACCAAA-1_V12D07-332_A1,3,1,0,0,0,4
AACTGGGTCCCGACGT-1_V12D07-332_A1,1,0,0,0,0,1
ATCACTTCATCCTCGC-1_V12D07-332_A1,3,0,0,0,0,3
TGGAAGGATAAAGATG-1_V12D07-332_A1,4,2,0,1,0,7
CATGATGCACAATTCT-1_V12D07-332_A1,5,0,0,0,0,5
TGCCTGATCAAACGAT-1_V12D07-332_A1,3,0,0,0,0,3
ATAGGGATATCCTTGA-1_V12D07-332_A1,2,5,0,0,0,7
CACCTAATCAGTTTAC-1_V12D07-332_A1,3,0,0,0,0,3
TGTGACTACGCCAGTC-1_V12D07-332_A1,2,0,0,1,0,3
CCCGACCATAGTCCGC-1_V12D07-332_A1,0,0,0,0,0,0
CGCGCCCGACTTAATA-1_V12D07-332_A1,6,1,0,0,0,7
TGCCACCTGGCGAAAC-1_V12D07-332_A1,1,1,0,0,0,2
CTGCCAAGGTTGGAAG-1_V12D07-332_A1,1,0,0,0,0,1
TCTCCAACGTAGGTTA-1_V12D07-332_A1,2,0,0,1,0,3
TTCTTGGAGTAATGAG-1_V12D07-332_A1,1,1,0,2,0,4
GTCTCGATCTGCTTTC-1_V12D07-332_A1,0,1,0,0,0,1
TACTCTCCGAACAAAT-1_V12D07-332_A1,0,2,0,3,0,5
ATCACATTAGAATATC-1_V12D07-332_A1,2,0,0,1,0,3
TACGGGATGCTAGCAG-1_V12D07-332_A1,2,2,0,0,0,4
AGCTGAAGTAAACCAA-1_V12D07-332_A1,1,1,0,1,0,3
CATGGGTCGGGTGTGG-1_V12D07-332_A1,3,2,0,1,0,6
CACCCACGAGGCAATT-1_V12D07-332_A1,1,0,0,0,0,1
TGCCATTACTAAAGAA-1_V12D07-332_A1,2,0,0,0,0,2
CCGTTACGTTAGAACA-1_V12D07-332_A1,1,0,0,0,0,1
GCCAGGAGTAACCGAT-1_V12D07-332_A1,1,0,0,2,0,3
GGAAAGTGCCCATGCC-1_V12D07-332_A1,1,0,0,0,0,1
TCTTACCGGAACTCGT-1_V12D07-332_A1,5,0,0,1,0,6
TATGTCAAGACCGACT-1_V12D07-332_A1,4,0,2,1,0,7
CCTAACTAAGGCTCTA-1_V12D07-332_A1,2,0,0,0,0,2
GCGGTGAACTGCGCTC-1_V12D07-332_A1,3,0,0,1,0,4
CCTCGCGCGATATAGG-1_V12D07-332_A1,2,0,0,1,0,3
ATCGGCAAGCAGTCCA-1_V12D07-332_A1,2,2,0,0,0,4
AGATCGTGCATAAGAT-1_V12D07-332_A1,2,1,0,2,0,5
ATTCAGGACCTATTTC-1_V12D07-332_A1,1,1,0,0,0,2
AGCTAGAAGCAGAAGT-1_V12D07-332_A1,1,0,0,1,0,2
TTCGCTATCTGACGTG-1_V12D07-332_A1,4,0,0,1,0,5
TTCCGCAGAGAAATAT-1_V12D07-332_A1,1,0,0,0,0,1
CAGTACATTCTCTAAA-1_V12D07-332_A1,1,0,0,0,0,1
GTGAAGATTTCAAGTG-1_V12D07-332_A1,2,2,0,0,0,4
AACGCATGATCTGGGT-1_V12D07-332_A1,0,0,2,0,0,2
CCCAGAGGAGGGCGTA-1_V12D07-332_A1,2,0,0,0,0,2
GGAAACCTTGTTGAAT-1_V12D07-332_A1,2,1,1,1,0,5
GTGAAGCCGTATAGTC-1_V12D07-332_A1,3,0,0,0,0,3
GAGCTGTCGTCTCGGA-1_V12D07-332_A1,0,0,0,0,0,0
TGTCATTTGTTGGGAA-1_V12D07-332_A1,4,0,1,0,0,5
ACCAACACCACACACT-1_V12D07-332_A1,3,0,1,0,0,4
AAATGATTCGATCAGC-1_V12D07-332_A1,0,1,0,0,0,1
CTGCTTTATGTCCGCG-1_V12D07-332_A1,1,2,1,0,0,4
GCGAGAGGCCATGTAA-1_V12D07-332_A1,3,1,2,0,0,6
ATTGACCGGCGATGAC-1_V12D07-332_A1,0,0,0,1,0,1
ACCCTGGTAACGCCCT-1_V12D07-332_A1,1,3,1,0,0,5
GTTGGACCGCATCAGG-1_V12D07-332_A1,1,0,0,0,0,1
CGTTTACAAGGCAGCT-1_V12D07-332_A1,0,0,0,1,0,1
CGGTCCATGAGACTCC-1_V12D07-332_A1,0,1,0,0,0,1
GTTCGTCTGGGTCCCT-1_V12D07-332_A1,4,0,0,0,0,4
TGTACTACTCTCACGG-1_V12D07-332_A1,1,1,0,0,0,2
AGTGAAGATGGTGTCC-1_V12D07-332_A1,0,2,0,0,0,2
GAGGGCCATAATATTA-1_V12D07-332_A1,0,0,0,0,0,0
ACTCCCGTAGACTAGG-1_V12D07-332_A1,1,1,0,0,0,2
CGTCAAATGGTCGCAG-1_V12D07-332_A1,2,0,1,0,0,3
AAGTCTAGTAGCTGCC-1_V12D07-332_A1,1,1,0,1,0,3
AAGAAATCACCAGATT-1_V12D07-332_A1,0,1,1,0,0,2
GAGTGCACGGACAACA-1_V12D07-332_A1,0,0,0,0,0,0
GTTCAAATCAGATGTC-1_V12D07-332_A1,0,3,0,1,0,4
CATGGCTCCCTATGTC-1_V12D07-332_A1,1,0,0,0,0,1
GGCCACACGAAAGCCT-1_V12D07-332_A1,2,1,0,2,0,5
GAAGCCGGGTAAGCTC-1_V12D07-332_A1,0,1,0,2,0,3
TACATGACCTTATCCG-1_V12D07-332_A1,1,0,0,0,0,1
AATACAATGTTTCAGG-1_V12D07-332_A1,1,1,0,0,0,2
CCAGAGACAAAGCCGG-1_V12D07-332_A1,2,1,0,0,0,3
CCGAAGTATATTGTTC-1_V12D07-332_A1,6,1,0,0,0,7
GCTAAACCTGAGGTGA-1_V12D07-332_A1,2,0,0,0,0,2
TCATACTTACAGATCC-1_V12D07-332_A1,0,0,0,0,0,0
CGAGCACTTCAAGTTT-1_V12D07-332_A1,5,0,0,2,0,7
TAGCAACCTGTCACAA-1_V12D07-332_A1,0,1,0,0,0,1
TGGGAAATGCCTTTCC-1_V12D07-332_A1,0,1,0,0,0,1
AGACCATGGGATACAA-1_V12D07-332_A1,4,0,0,1,0,5
TAAATGAATCCGTTTC-1_V12D07-332_A1,0,1,0,1,0,2
ACAACGGTCCCTGCGA-1_V12D07-332_A1,7,1,1,1,0,10
GTCACTCTCCAAATCT-1_V12D07-332_A1,2,0,0,1,0,3
TTCTACTTGCGAGGGC-1_V12D07-332_A1,4,2,0,0,0,6
CGCAATTACTTTCGGT-1_V12D07-332_A1,1,1,0,0,0,2
CTGTTCATCTCACGGG-1_V12D07-332_A1,6,1,0,1,0,8
TTCTTGTAACCTAATG-1_V12D07-332_A1,6,2,0,1,0,9
GCTTGATGATAATCAG-1_V12D07-332_A1,1,0,0,0,0,1
TTGGCTCGCATGAGAC-1_V12D07-332_A1,5,0,0,0,0,5
GCCCAGTTGGTATGCC-1_V12D07-332_A1,0,4,0,0,0,4
ATTCCTCCGCCAGTGC-1_V12D07-332_A1,2,4,0,1,0,7
TCGTCCGCTGGCGTCT-1_V12D07-332_A1,3,0,0,0,0,3
GGAGAAGTCATTGGCA-1_V12D07-332_A1,1,0,0,0,0,1
TTGTTAGCAAATTCGA-1_V12D07-332_A1,1,1,0,1,0,3
TCTAGCATCTTCGATG-1_V12D07-332_A1,1,1,0,0,0,2
TTCTAGGCCAATTGTG-1_V12D07-332_A1,4,0,0,1,0,5
TCACGGTCATCGCACA-1_V12D07-332_A1,2,4,0,1,0,7
ATGAAGCCAAGGAGCC-1_V12D07-332_A1,8,1,0,1,0,10
AATGACTGTCAGCCGG-1_V12D07-332_A1,2,1,0,0,0,3
CCAAACAGAACCCTCG-1_V12D07-332_A1,1,0,0,0,0,1
TATCGATGATTAAACG-1_V12D07-332_A1,1,1,0,1,0,3
GAACACACATCAACCA-1_V12D07-332_A1,1,0,0,1,0,2
CCCGTCAGCGTCTGAC-1_V12D07-332_A1,7,2,0,0,0,9
AGCATCGTCGATAATT-1_V12D07-332_A1,2,1,0,1,0,4
GACTAAGATCATGCAC-1_V12D07-332_A1,7,2,0,0,0,9
TAGGGTGTTTCAAGAG-1_V12D07-332_A1,2,1,0,0,0,3
TGGTTCGTAGCAAAGG-1_V12D07-332_A1,2,0,0,0,0,2
CTGTTCACTGCCTGTG-1_V12D07-332_A1,6,0,0,1,0,7
ATGTGCATCCGACGCA-1_V12D07-332_A1,7,0,0,0,0,7
TTGTCGTTCAGTTACC-1_V12D07-332_A1,2,0,0,2,0,4
CGGGATCAATGTAAGA-1_V12D07-332_A1,1,1,0,0,0,2
TTATCTGTATCATAAC-1_V12D07-332_A1,2,3,0,0,0,5
ATCGACTCTTTCCGTT-1_V12D07-332_A1,3,0,0,3,0,6
CTCATTTGATGGGCGG-1_V12D07-332_A1,4,4,0,1,0,9
GTAAGCGGGCAGTCAG-1_V12D07-332_A1,3,3,0,1,0,7
TCTATCGGTCGCAACA-1_V12D07-332_A1,4,2,0,0,0,6
AACGCGGTCTCCAGCC-1_V12D07-332_A1,1,3,0,1,0,5
ATTAATACTACGCGGG-1_V12D07-332_A1,4,0,0,1,0,5
CTTTAACTTTCAAAGG-1_V12D07-332_A1,1,0,0,2,0,3
CGTACCTGATAGGCCT-1_V12D07-332_A1,3,1,0,1,0,5
GAATGTTGGGTAATCT-1_V12D07-332_A1,0,1,0,1,0,2
TGCGGAGTAAAGGTGC-1_V12D07-332_A1,2,1,0,3,0,6
CCTGAATATTTACATA-1_V12D07-332_A1,0,0,0,0,0,0
TTGCTCCCATACCGGA-1_V12D07-332_A1,5,0,0,1,0,6
CCTCTAATCTGCCAAG-1_V12D07-332_A1,0,0,0,0,0,0
AGGTTGAGGCACGCTT-1_V12D07-332_A1,1,1,0,2,0,4
TCCCGTCAGTCCCGCA-1_V12D07-332_A1,1,0,0,0,0,1
TCCGATGACTGAGCTC-1_V12D07-332_A1,1,1,0,0,0,2
CAGCCTCCTGCAGAGG-1_V12D07-332_A1,4,1,0,0,0,5
CTTAGCCTTCCACATG-1_V12D07-332_A1,1,3,0,1,0,5
ATTAATGAACCAGTCG-1_V12D07-332_A1,1,3,0,0,0,4
ACGATACATAGAACTA-1_V12D07-332_A1,2,0,0,0,0,2
AGCCACTCCCGTGCTT-1_V12D07-332_A1,2,3,0,0,0,5
ATACGGGTTTCGATTG-1_V12D07-332_A1,0,0,0,0,0,0
CTGTCAAATGGCTCGG-1_V12D07-332_A1,5,0,0,2,0,7
GCTCGGAATTTAAAGC-1_V12D07-332_A1,6,0,0,1,0,7
TAGGCATGTTACGCCA-1_V12D07-332_A1,2,0,0,3,0,5
TGGCAACTCGCGCGCC-1_V12D07-332_A1,2,1,0,2,0,5
ATCAGTAGGCAGGGAT-1_V12D07-332_A1,1,4,0,2,0,7
TATCGATCTATGCATA-1_V12D07-332_A1,8,0,0,0,0,8
CGACTCAGGATGTTAT-1_V12D07-332_A1,1,1,0,1,0,3
GCCATATTGCACACAG-1_V12D07-332_A1,4,3,0,0,0,7
AATTCATAAGGGATCT-1_V12D07-332_A1,2,3,0,1,0,6
CGGTAGAGGTGCAGGT-1_V12D07-332_A1,5,1,0,0,0,6
AATGATGATACGCTAT-1_V12D07-332_A1,0,1,0,0,0,1
CTTGTGCTCACCGATT-1_V12D07-332_A1,3,0,0,0,0,3
TTCCAATCAGAGCTAG-1_V12D07-332_A1,5,0,0,0,0,5
CGATGGACCCTACGCC-1_V12D07-332_A1,4,1,0,0,0,5
GGTCGGATAAACGGCG-1_V12D07-332_A1,2,0,0,1,0,3
TTAGCTAATACGATCT-1_V12D07-332_A1,0,0,0,1,0,1
CTCGATATTTGCGAGC-1_V12D07-332_A1,3,0,0,1,0,4
ATTACTTACTGGGCAT-1_V12D07-332_A1,6,2,0,2,0,10
CTAGCCGATGTTATGA-1_V12D07-332_A1,2,4,0,1,0,7
TACTGCAATCAATTAC-1_V12D07-332_A1,3,0,0,0,0,3
TAGTCTGTGACGTTGC-1_V12D07-332_A1,2,0,1,0,0,3
CTCGTTTCTAATGTTT-1_V12D07-332_A1,5,1,0,0,0,6
TTCGTTCAACGAAGTT-1_V12D07-332_A1,3,1,0,0,0,4
CTGAATTTATTGCCAG-1_V12D07-332_A1,3,1,0,0,0,4
TGGAATATCCTTGACC-1_V12D07-332_A1,3,0,0,0,0,3
CAGATCATTTAAAGTC-1_V12D07-332_A1,0,0,0,2,0,2
CTCCTTTACGCAAGTC-1_V12D07-332_A1,3,1,0,0,0,4
TCCCAAACAGACAACG-1_V12D07-332_A1,3,0,1,0,0,4
ATCGCTGCGTGCAGCA-1_V12D07-332_A1,1,0,0,0,0,1
TTAGTTCAAGTGTTCG-1_V12D07-332_A1,1,0,0,0,0,1
AAACTCGTGATATAAG-1_V12D07-332_A1,0,0,0,3,0,3
TTAACGAACAAGCAGT-1_V12D07-332_A1,0,0,0,1,0,1
GTTATATCAGGAGCCA-1_V12D07-332_A1,0,0,0,1,0,1
CAAATTGGATTATGCC-1_V12D07-332_A1,1,2,0,2,0,5
CGAGGAGCTTCCATAT-1_V12D07-332_A1,1,1,0,0,0,2
GGAGACCAATGTGCTT-1_V12D07-332_A1,0,1,0,0,0,1
CATTGATGAACACGCC-1_V12D07-332_A1,0,1,0,0,0,1
GTCAATGCTATAATTT-1_V12D07-332_A1,1,1,0,1,0,3
ACCACCCTCTCTTCTA-1_V12D07-332_A1,0,2,0,0,0,2
TGGAGGGAAACACCTC-1_V12D07-332_A1,2,0,0,1,0,3
CACGGACGTGGATGGC-1_V12D07-332_A1,1,1,1,0,0,3
AACTTTCTCGATCATG-1_V12D07-332_A1,1,0,0,1,0,2
CGTATTGTTTCCTAAT-1_V12D07-332_A1,0,1,0,0,0,1
CCTACTGCGGCGGCCA-1_V12D07-332_A1,0,2,0,0,0,2
CTTAGGTCCCAATCGT-1_V12D07-332_A1,0,2,0,0,0,2
CGCAATCGATCATTAG-1_V12D07-332_A1,2,0,0,2,0,4
TGGTTATGCTTGCGGT-1_V12D07-332_A1,2,1,1,0,0,4
GGCTTGGCTCTCACCT-1_V12D07-332_A1,2,1,0,1,0,4
ATTGGTAGGATCCGCT-1_V12D07-332_A1,3,1,0,0,0,4
TCAGGGCGACTTCCTT-1_V12D07-332_A1,4,1,0,0,0,5
TCTGCAGATTCGAGTC-1_V12D07-332_A1,1,0,0,0,0,1
CTCTCGCTGTACTATG-1_V12D07-332_A1,3,0,1,0,0,4
AATAGTCGCGAGTCGG-1_V12D07-332_A1,0,1,0,0,0,1
AGTTACCCTTAAGACT-1_V12D07-332_A1,2,0,0,0,0,2
CTTAAATAAGACCCAT-1_V12D07-332_A1,2,1,0,1,0,4
GGTTGTGCTCTTGTCC-1_V12D07-332_A1,3,0,0,1,0,4
GTGAGTCTAAGACGGA-1_V12D07-332_A1,3,1,0,1,0,5
CGCGACACTGCGCAGC-1_V12D07-332_A1,2,1,0,2,0,5
GCTCGCGGTTCCGCTC-1_V12D07-332_A1,0,1,0,2,0,3
TTAACTCACGCGTGGA-1_V12D07-332_A1,2,2,0,0,0,4
GGAACGGCCTGCAGCC-1_V12D07-332_A1,0,0,0,1,0,1
TAATGAAAGACCCTTG-1_V12D07-332_A1,0,1,0,0,0,1
AGGCTTGCTAGACACC-1_V12D07-332_A1,2,1,0,0,0,3
TTGCGTAGTTTGAGGA-1_V12D07-332_A1,2,0,0,1,0,3
CGCCCTTGAAGGCTGA-1_V12D07-332_A1,1,1,0,0,0,2
CCCGGTGGAAGAACCT-1_V12D07-332_A1,1,1,0,2,0,4
TTAACACCTCGAACAT-1_V12D07-332_A1,2,0,0,0,0,2
GATTCCTATACGGCGC-1_V12D07-332_A1,2,1,0,0,0,3
TTACCCTAACAGTCCT-1_V12D07-332_A1,3,1,0,0,0,4
ACCCACCTACATGCTC-1_V12D07-332_A1,0,0,0,0,0,0
AAAGGGCAGCTTGAAT-1_V12D07-332_A1,3,0,0,0,0,3
CACACAGGGATAGATT-1_V12D07-332_A1,1,1,0,1,0,3
AGAGCGTACAAGCTCG-1_V12D07-332_A1,3,1,0,0,0,4
TCTTACGGCATCCGAC-1_V12D07-332_A1,2,1,0,1,0,4
GCCTATTCCGATATAG-1_V12D07-332_A1,2,0,0,0,0,2
GAAAGTGACTAACTGC-1_V12D07-332_A1,5,0,0,1,0,6
CCGGAATGGTTTCAGT-1_V12D07-332_A1,3,0,0,0,0,3
AGTATAATACTAGGCA-1_V12D07-332_A1,5,0,0,1,0,6
TAACTATCGAAGGTCC-1_V12D07-332_A1,2,1,0,0,0,3
ATGAGGAGTGTTAATC-1_V12D07-332_A1,1,0,0,1,0,2
TGTGTCGCGAGTTGCA-1_V12D07-332_A1,1,2,0,2,0,5
ATCCAACGCAGTCATA-1_V12D07-332_A1,5,0,0,0,0,5
AAGGCGCGTAAAGCTT-1_V12D07-332_A1,4,0,0,0,0,4
AGTCGGCCCAAACGAC-1_V12D07-332_A1,3,2,0,1,0,6
AACGTCAGACTAGTGG-1_V12D07-332_A1,0,3,3,0,0,6
ACTACCAGCTCTCTGG-1_V12D07-332_A1,0,4,3,0,0,7
GCAAGTGCACAGAGAA-1_V12D07-332_A1,5,0,0,1,0,6
ACACCTTAAGTAGGGC-1_V12D07-332_A1,3,0,0,1,0,4
TTCGACGGGAAGGGCG-1_V12D07-332_A1,5,2,0,0,0,7
TTCGCACTCGCGTGCT-1_V12D07-332_A1,2,0,0,0,0,2
TATTTGTTACCCTTTA-1_V12D07-332_A1,4,1,0,1,0,6
CGCTGTGACGCCGCAC-1_V12D07-332_A1,1,3,0,1,0,5
GTTGCACGGAGTTTCG-1_V12D07-332_A1,1,2,0,2,0,5
GTTTCCTGGAGGGTGA-1_V12D07-332_A1,2,1,0,0,0,3
ACACCCAGCATGCAGC-1_V12D07-332_A1,3,1,0,0,0,4
TCAACCATGTTCGGGC-1_V12D07-332_A1,1,1,0,1,0,3
TTACAACTACGCATCC-1_V12D07-332_A1,2,0,0,0,0,2
TCCGATGGTGCGACAT-1_V12D07-332_A1,4,1,0,1,0,6
GGGCGTACATTTATAT-1_V12D07-332_A1,3,0,0,3,0,6
AGCGACCAACGATATT-1_V12D07-332_A1,2,0,0,0,0,2
ACACAAAGACGGGTGG-1_V12D07-332_A1,1,0,0,0,0,1
ATCGCACGCCGGGAGA-1_V12D07-332_A1,5,2,0,0,0,7
GCTCTAAACCCTGACG-1_V12D07-332_A1,3,1,0,0,0,4
AATGCAACCGGGTACC-1_V12D07-332_A1,3,0,0,0,0,3
TCAAACAACCGCGTCG-1_V12D07-332_A1,0,1,0,0,0,1
TATGCTCCCTACTTAC-1_V12D07-332_A1,2,0,0,1,0,3
AAAGGGATGTAGCAAG-1_V12D07-332_A1,6,2,0,0,0,8
ACGATCATACATAGAG-1_V12D07-332_A1,2,0,0,0,0,2
TTGTTCAGTGTGCTAC-1_V12D07-332_A1,1,1,0,0,0,2
ATGCATGATCCAGGAT-1_V12D07-332_A1,2,0,0,2,0,4
AGTCTTCTCCTCAAAT-1_V12D07-332_A1,0,0,0,2,0,2
GATTCCCTTGTCGCAG-1_V12D07-332_A1,2,1,0,0,0,3
CTCGCACCTATATAGT-1_V12D07-332_A1,0,2,0,0,0,2
ACTCAATAAAGGCACG-1_V12D07-332_A1,4,0,0,1,0,5
AACCGAGCTTGGTCAT-1_V12D07-332_A1,1,3,0,0,0,4
TAAGGCAACATAAGAT-1_V12D07-332_A1,3,1,0,1,0,5
CACGCACAGCGCAGCT-1_V12D07-332_A1,1,1,0,0,0,2
GGTTTACAATCTCAAT-1_V12D07-332_A1,3,2,0,1,0,6
TGCAGGATCGGCAAAG-1_V12D07-332_A1,3,0,0,2,0,5
ATAACGGAGTCCAACG-1_V12D07-332_A1,1,1,0,0,0,2
AACGATATGTCAACTG-1_V12D07-332_A1,3,1,0,1,0,5
GACAACGACCATTGAA-1_V12D07-332_A1,2,4,0,2,0,8
TTGACCATGTTCTCCG-1_V12D07-332_A1,1,1,0,0,0,2
AGTACGGGCACCTGGC-1_V12D07-332_A1,7,1,0,0,0,8
CGCCATCCGATTATGA-1_V12D07-332_A1,1,0,0,0,0,1
AAGGTATCCTAATATA-1_V12D07-332_A1,1,4,0,1,0,6
TGTTGTCAAGAAGTCT-1_V12D07-332_A1,0,2,0,1,0,3
CAGTGAATAAATGACT-1_V12D07-332_A1,3,0,0,3,0,6
CACCTTGCGAAACTCG-1_V12D07-332_A1,0,0,0,1,0,1
CATTTAGCGGACCATG-1_V12D07-332_A1,4,1,0,1,0,6
CCAGTCTAGACGGCGC-1_V12D07-332_A1,2,0,0,1,0,3
TCGCTTTAAACGTTTG-1_V12D07-332_A1,4,1,0,2,0,7
GTGAAACGGCGCCACC-1_V12D07-332_A1,2,0,0,3,0,5
GGGCTCATCGAACCCA-1_V12D07-332_A1,3,1,0,1,0,5
TTGATGTGTAGTCCCG-1_V12D07-332_A1,3,1,0,1,0,5
CAGTAGCCCACGCGGT-1_V12D07-332_A1,1,0,0,1,0,2
AGCGCGGGTGCCAATG-1_V12D07-332_A1,2,2,0,0,0,4
TAATCGATCCGTACGT-1_V12D07-332_A1,2,0,0,0,0,2
AGTGGCGGCAATTTGA-1_V12D07-332_A1,2,0,0,0,0,2
CCTTTCAATGAAGAAA-1_V12D07-332_A1,0,0,0,1,0,1
CTCAGTCACGACAAAT-1_V12D07-332_A1,2,0,0,1,0,3
ATAGGCTAGCTTCGCA-1_V12D07-332_A1,8,1,0,0,0,9
CGGTTCAAGTAGGTGT-1_V12D07-332_A1,5,0,0,1,0,6
CAGTCGAGGATGCAAT-1_V12D07-332_A1,1,1,0,1,0,3
TATCACCCAACCGACC-1_V12D07-332_A1,5,1,0,1,0,7
AATGATGCGACTCCTG-1_V12D07-332_A1,7,1,0,2,0,10
TGGAACCACTGACACA-1_V12D07-332_A1,1,0,0,3,0,4
GCCAATAGGGCATCTC-1_V12D07-332_A1,4,0,0,0,0,4
TTCTTTGGTCGCGACG-1_V12D07-332_A1,3,1,0,1,0,5
ATTAGATTCCTCAGCA-1_V12D07-332_A1,1,0,0,1,0,2
CCGTGGAACGATCCAA-1_V12D07-332_A1,1,0,0,0,0,1
GGGTCGTGGCAAGTGT-1_V12D07-332_A1,4,0,0,0,0,4
TCGCTCGGCACCAGCG-1_V12D07-332_A1,3,0,0,0,0,3
ACGCAATCACTACAGC-1_V12D07-332_A1,4,1,0,0,0,5
CTCTAATGCATTGATC-1_V12D07-332_A1,0,0,0,1,0,1
GTCTCGACTAAGTTTG-1_V12D07-332_A1,2,2,0,1,0,5
TGGTTTAAACGTGGGT-1_V12D07-332_A1,2,0,0,2,0,4
CGCAGATCTTCACCCG-1_V12D07-332_A1,4,0,0,0,0,4
TCCAGATGTACGCCAA-1_V12D07-332_A1,1,0,0,0,0,1
CATTGCGGGTCAATTC-1_V12D07-332_A1,1,0,0,0,0,1
GACGTTCGTAAATACA-1_V12D07-332_A1,2,0,0,0,0,2
TACACCGTCGTTAGTC-1_V12D07-332_A1,2,1,0,0,0,3
ACGGGCGTATGCGACA-1_V12D07-332_A1,2,0,0,1,0,3
GAAGGCTACCATTGTT-1_V12D07-332_A1,1,1,2,0,0,4
TAAATCTTTACACCTC-1_V12D07-332_A1,2,1,0,1,0,4
AGTTTATGTAAAGACA-1_V12D07-332_A1,0,1,0,0,0,1
AGGAGACATCCACAGT-1_V12D07-332_A1,0,1,0,0,0,1
CAACCTGAACCTGCCA-1_V12D07-332_A1,2,1,1,0,0,4
AGTCCCTCGCAGAAAG-1_V12D07-332_A1,1,0,0,1,0,2
TGTATACGGATGATGA-1_V12D07-332_A1,1,0,0,0,0,1
TTGTGGTATAGGTATG-1_V12D07-332_A1,0,1,0,0,0,1
TCTGCACCATTAGTAA-1_V12D07-332_A1,0,0,0,0,0,0
AAATGTATCTTATCCC-1_V12D07-332_A1,2,0,0,2,0,4
ACTCTAAACCTGGGAT-1_V12D07-332_A1,2,0,0,0,0,2
GCTGGCAGGTGCCGTG-1_V12D07-332_A1,2,0,0,0,0,2
CTCATTCGTGAACATC-1_V12D07-332_A1,3,1,0,0,0,4
TCGCCGGATGGGCAAG-1_V12D07-332_A1,4,0,0,0,0,4
GGACTAAGTCAGGAGT-1_V12D07-332_A1,1,1,0,1,0,3
TATCAAAGGTCTGTAA-1_V12D07-332_A1,4,2,0,0,0,6
TTCAGTTTGTGGCAGC-1_V12D07-332_A1,2,0,1,0,0,3
TGTTCATAAATGTGCT-1_V12D07-332_A1,4,0,0,2,0,6
CTTAGCCCGGATAGTG-1_V12D07-332_A1,3,0,0,0,0,3
GATGCGAATGGTATTA-1_V12D07-332_A1,0,0,0,1,0,1
TCTAACTGTATGTAAA-1_V12D07-332_A1,3,2,0,1,0,6
TTAAACCTGGTTCCTT-1_V12D07-332_A1,2,0,0,0,0,2
GCTAAGTAAAGGCGAT-1_V12D07-332_A1,1,1,0,1,0,3
AGTTACCGCACATGGT-1_V12D07-332_A1,3,2,0,1,0,6
GACTGCGGCACGTGTA-1_V12D07-332_A1,2,1,0,1,0,4
TGGTGATCGTATTTGT-1_V12D07-332_A1,0,1,0,0,0,1
TTATCGCCTGCGAAGC-1_V12D07-332_A1,1,0,0,3,0,4
TGGAATTAGACGCTTT-1_V12D07-332_A1,0,1,2,0,0,3
TCGTCACACTGTTAGC-1_V12D07-332_A1,1,1,1,0,0,3
TTATGTTTGCGATAGA-1_V12D07-332_A1,2,0,0,1,0,3
GGTGCTGATCACAAAG-1_V12D07-332_A1,1,2,0,2,0,5
CATAGCCGCCCGGGAT-1_V12D07-332_A1,2,0,0,0,0,2
GGTTAGTTACGGCGCC-1_V12D07-332_A1,2,1,0,0,0,3
ATTCCCACATAAACAA-1_V12D07-332_A1,0,1,0,1,0,2
ATTCAGTAGCAGGGTC-1_V12D07-332_A1,0,1,0,0,0,1
CAGTTCCGCGGGTCGA-1_V12D07-332_A1,0,1,0,0,0,1
AAGAGATGAATCGGTA-1_V12D07-332_A1,2,1,0,0,0,3
CGCAATTCTACAATAA-1_V12D07-332_A1,2,0,0,0,0,2
TAACGCTTTGAGAGCG-1_V12D07-332_A1,1,0,0,1,0,2
AGGCTATGGTTAGCTT-1_V12D07-332_A1,6,0,0,1,0,7
GAGGAATGGAGAGGTT-1_V12D07-332_A1,3,0,0,1,0,4
TCCTCTACGAGATGGC-1_V12D07-332_A1,3,2,0,0,0,5
TTGATTATGCAGATGA-1_V12D07-332_A1,3,2,0,1,0,6
TCAGTACTGACCCGCG-1_V12D07-332_A1,2,0,0,0,0,2
TTATGACAAACTGGAT-1_V12D07-332_A1,3,0,0,0,0,3
GTAAGTAGGGTATACC-1_V12D07-332_A1,4,0,0,0,0,4
CGCAAACACGAGTTAC-1_V12D07-332_A1,2,0,0,1,0,3
TGGCCGTATATTGACC-1_V12D07-332_A1,6,0,0,2,0,8
ACTGTAGCACTTTGGA-1_V12D07-332_A1,2,0,0,1,0,3
GCTCTATGTTACGTGC-1_V12D07-332_A1,2,0,0,0,0,2
TGCGCGATTAACGGAG-1_V12D07-332_A1,4,1,0,0,0,5
GAATCGACATGGTCAC-1_V12D07-332_A1,0,4,0,0,0,4
GACTAAGTAGGCTCAC-1_V12D07-332_A1,1,0,0,0,0,1
ATCTTGACCTGCAACG-1_V12D07-332_A1,2,1,0,0,0,3
ATGCACTACCGCATTG-1_V12D07-332_A1,0,5,0,0,0,5
CAGATACTAACATAGT-1_V12D07-332_A1,3,0,0,0,0,3
GATCGACACTATCTGA-1_V12D07-332_A1,5,0,0,1,0,6
ATAGAGTACTGGGACA-1_V12D07-332_A1,5,0,0,0,0,5
CCTACTGCTTACACTT-1_V12D07-332_A1,4,1,1,0,0,6
CCTGCTATTTGAGAAG-1_V12D07-332_A1,3,0,0,0,0,3
CGCGTTCATGAAATAC-1_V12D07-332_A1,1,5,0,2,0,8
CATTATGCTTGTTGTG-1_V12D07-332_A1,4,0,0,1,0,5
CCAGGGACGTGGCCTC-1_V12D07-332_A1,2,1,0,0,0,3
TATGGATGTGCTACGC-1_V12D07-332_A1,2,0,0,0,0,2
GTACTAAGATTTGGAG-1_V12D07-332_A1,3,0,0,0,0,3
AGACCCGCCCTCCTCG-1_V12D07-332_A1,6,2,0,0,0,8
CGCATTAGCTAATAGG-1_V12D07-332_A1,2,0,0,0,0,2
GCTCTCGGGTACCGAA-1_V12D07-332_A1,2,0,0,0,0,2
CACCGCCAGAAGGTTT-1_V12D07-332_A1,3,1,0,1,0,5
TCCCAAAGACGAAGGA-1_V12D07-332_A1,5,1,0,0,0,6
ATGGATTGACCAAACG-1_V12D07-332_A1,4,0,0,1,0,5
GTCATGGACATGACTA-1_V12D07-332_A1,0,0,0,0,0,0
CTACTGCCACCTGACC-1_V12D07-332_A1,4,1,0,0,0,5
TTATATTTGGCAATCC-1_V12D07-332_A1,1,0,0,0,0,1
AGCACCAGTACTCACG-1_V12D07-332_A1,1,1,0,3,0,5
CATGGTCTAGATACCG-1_V12D07-332_A1,3,0,0,0,0,3
TCTACCGTCCACAAGC-1_V12D07-332_A1,1,0,0,1,0,2
CTAGTTGGGCCCGGTA-1_V12D07-332_A1,5,0,0,0,0,5
TCCCGCGTACTCCTGG-1_V12D07-332_A1,3,0,0,2,0,5
CAGAGCATGAGCTTGC-1_V12D07-332_A1,1,4,0,1,0,6
ACACGGGAACTTAGGG-1_V12D07-332_A1,2,0,0,1,0,3
GGCTCTGCTCCAACGC-1_V12D07-332_A1,3,2,0,0,0,5
AGAACGTGGTACATTC-1_V12D07-332_A1,1,3,0,1,0,5
CAATAAACCTTGGCCC-1_V12D07-332_A1,1,4,0,0,0,5
ACTTCGCCATACGCAC-1_V12D07-332_A1,2,1,0,0,0,3
ATCTGGTTAAGACTGT-1_V12D07-332_A1,3,0,0,0,0,3
TCGTAAGACGACATTG-1_V12D07-332_A1,6,3,0,0,0,9
GTGTACCTTGGCTACG-1_V12D07-332_A1,1,0,0,0,0,1
GCCCGTAATACCTTCT-1_V12D07-332_A1,2,2,0,1,0,5
CGGTCAAGTGGGAACC-1_V12D07-332_A1,3,0,0,1,0,4
TTGTAAGGCCAGTTGG-1_V12D07-332_A1,3,1,0,2,0,6
GGAGCACCAAGAACTA-1_V12D07-332_A1,3,2,0,0,0,5
TAATAGTGACGACCAG-1_V12D07-332_A1,1,2,0,3,0,6
CTAAATCCTATTCCGG-1_V12D07-332_A1,3,0,0,0,0,3
CGAGTTCTGTCCCACC-1_V12D07-332_A1,1,1,0,2,0,4
AGGCAGATGCGTAAAC-1_V12D07-332_A1,3,1,0,0,0,4
AAGGATGAGGGACCTC-1_V12D07-332_A1,0,1,0,0,0,1
AGAGAACCGTCTAGGA-1_V12D07-332_A1,1,0,0,0,0,1
GAGGGCGCAGCTCTGC-1_V12D07-332_A1,3,3,0,0,0,6
AAGATTGGCGGAACGT-1_V12D07-332_A1,2,0,0,0,0,2
CCAGTAGTCTGATCCA-1_V12D07-332_A1,3,0,0,1,0,4
AAGGGACAGATTCTGT-1_V12D07-332_A1,4,1,0,0,0,5
ATAGAGTTATCAACTT-1_V12D07-332_A1,3,0,0,0,0,3
AAATTACCTATCGATG-1_V12D07-332_A1,1,0,0,1,0,2
GATCCTAAATCGGGAC-1_V12D07-332_A1,4,2,0,0,0,6
TTACAGACCTAAATGA-1_V12D07-332_A1,4,0,0,0,0,4
CCTCACCTTAGCATCG-1_V12D07-332_A1,1,0,0,1,0,2
CATGCGACCAGTTTAA-1_V12D07-332_A1,1,0,0,1,0,2
AACATATCAACTGGTG-1_V12D07-332_A1,2,2,0,0,0,4
CTATAAGAGCCAATCG-1_V12D07-332_A1,2,1,0,0,0,3
AATATCGAGGGTTCTC-1_V12D07-332_A1,2,1,0,0,0,3
GTACTCCTGGGTATGC-1_V12D07-332_A1,5,1,0,1,0,7
ATAAGTAGGATTCAGA-1_V12D07-332_A1,4,0,0,0,0,4
AGGTCGCGGAGTTACT-1_V12D07-332_A1,2,0,0,0,0,2
CTAATTCTCAGATATT-1_V12D07-332_A1,1,0,0,1,0,2
GCCAACCATTTCCGGA-1_V12D07-332_A1,1,0,0,0,0,1
TGATCCCAGCATTAGT-1_V12D07-332_A1,1,0,0,1,0,2
CGTTGTAAGATTGATT-1_V12D07-332_A1,3,1,0,0,0,4
GAAACCATGGTGCGCT-1_V12D07-332_A1,1,0,0,0,0,1
AATCTATGCCGGAGCC-1_V12D07-332_A1,1,0,0,0,0,1
GACTCCCAGAATAAGG-1_V12D07-332_A1,1,0,0,2,0,3
TATGATCCGGCACGCC-1_V12D07-332_A1,6,2,0,1,0,9
CCGCTTGCTGACATGG-1_V12D07-332_A1,2,3,0,0,0,5
TGGTTAAGGGCGCTGG-1_V12D07-332_A1,2,1,0,1,0,4
TTGATAGTCAATACAT-1_V12D07-332_A1,1,1,0,0,0,2
GGTTTAATTGAGCAGG-1_V12D07-332_A1,3,1,0,1,0,5
CATTACATAGATTGTG-1_V12D07-332_A1,1,0,0,1,0,2
GGTACACCAGATTTAT-1_V12D07-332_A1,2,0,0,0,0,2
GGCCCGTATACCATGC-1_V12D07-332_A1,2,1,0,0,0,3
ATCTTTCGTATAACCA-1_V12D07-332_A1,3,3,0,0,0,6
GAGATGACAATCCTTA-1_V12D07-332_A1,0,1,0,0,0,1
AAAGCTTGCCTACATA-1_V12D07-332_A1,2,2,1,0,0,5
GAACGATAAGTTAAAG-1_V12D07-332_A1,2,0,0,0,0,2
TAATAGCTAAATGATG-1_V12D07-332_A1,0,0,0,0,0,0
TATGGCTAGGCTAATT-1_V12D07-332_A1,1,0,1,0,0,2
AGGAGAGTCTGGCTAC-1_V12D07-332_A1,2,1,0,0,0,3
TGCTCTGCCGGTTCAC-1_V12D07-332_A1,0,0,0,0,0,0
CCAATAGATTTCATCT-1_V12D07-332_A1,2,4,0,0,0,6
GGGCACGAATTGGCCG-1_V12D07-332_A1,4,1,0,0,0,5
TCGTTGACAGGGTCCC-1_V12D07-332_A1,0,0,0,1,0,1
ATCGTATTCCGAGAAC-1_V12D07-332_A1,0,1,0,0,0,1
GGGAATTCTGTCCAGT-1_V12D07-332_A1,2,1,0,2,0,5
ACGCGTTTCTTAAGAG-1_V12D07-332_A1,4,0,0,0,0,4
GAGAGCGCAGTCCCTG-1_V12D07-332_A1,3,1,0,0,0,4
GTCCTATTGTTGTGGT-1_V12D07-332_A1,2,0,0,1,0,3
CATCTGCAGGATCATT-1_V12D07-332_A1,4,0,0,0,0,4
GAGTCGACAGACCCTC-1_V12D07-332_A1,2,3,0,1,0,6
AAGTGCAAAGGTAGAC-1_V12D07-332_A1,2,1,0,0,0,3
AGGGTGGATAGTGCAT-1_V12D07-332_A1,2,1,0,1,0,4
TGATAGCGGGATTCTA-1_V12D07-332_A1,1,2,0,0,0,3
GTCAGTTTGGTAGTCG-1_V12D07-332_A1,2,2,0,1,0,5
GCATTCGAAATGAACA-1_V12D07-332_A1,3,0,0,0,0,3
AAAGACTGGGCGCTTT-1_V12D07-332_A1,3,0,0,0,0,3
TAACAATATTTGTTGC-1_V12D07-332_A1,2,0,0,0,0,2
CCAGCTTCCGCCCGCA-1_V12D07-332_A1,2,1,0,1,0,4
GATATGGATTACGCGG-1_V12D07-332_A1,4,0,0,0,0,4
AGAGCAGTTATGAGAC-1_V12D07-332_A1,0,0,0,0,0,0
TCACATCTTATCTGAT-1_V12D07-332_A1,1,0,0,1,0,2
TATGAAGACAGGTGCG-1_V12D07-332_A1,1,1,0,0,0,2
TACCTGCTGCACTGTG-1_V12D07-332_A1,4,0,0,0,0,4
TAGGTCCAAGTAAGGA-1_V12D07-332_A1,2,2,0,0,0,4
GAAACTCGTGCGATGC-1_V12D07-332_A1,4,0,0,1,0,5
AACAATTACTCTACGC-1_V12D07-332_A1,0,7,0,0,0,7
CCGCACGTGACCTCGG-1_V12D07-332_A1,1,2,0,1,0,4
AACTTGCCCGTATGCA-1_V12D07-332_A1,0,0,0,0,0,0
GGGTATGTATGCACTT-1_V12D07-332_A1,2,1,0,0,0,3
TTCGTACTCCAGAACG-1_V12D07-332_A1,4,0,0,1,0,5
GAATTTCTCGCTGCAG-1_V12D07-332_A1,3,0,1,0,0,4
AACAGGATGGGCCGCG-1_V12D07-332_A1,1,1,1,1,0,4
GACGTGTAGGGATTAT-1_V12D07-332_A1,3,0,0,0,0,3
TAGGTGAGCCCTACTC-1_V12D07-332_A1,1,1,0,0,0,2
CTAATTCGCACGCGCT-1_V12D07-332_A1,3,1,0,0,0,4
GAAGCTTGCTGACCGC-1_V12D07-332_A1,0,0,0,0,0,0
GGTTAGGCTTGGAGAA-1_V12D07-332_A1,2,1,0,1,0,4
ACAAGGACAAGAGGTT-1_V12D07-332_A1,1,0,0,0,0,1
AGGCCACCCGTTATGA-1_V12D07-332_A1,3,0,0,0,0,3
GTGGGCTTAGACACAC-1_V12D07-332_A1,0,1,0,0,0,1
CGTGTCCCATTCGCGA-1_V12D07-332_A1,2,2,0,1,0,5
TGGAGTGATGCGATGA-1_V12D07-332_A1,0,0,0,1,0,1
AACAACTGGTAGTTGC-1_V12D07-332_A1,1,0,0,2,0,3
CCTGGCTAGACCCGCC-1_V12D07-332_A1,3,2,0,1,0,6
CGCAATTAGGGTAATA-1_V12D07-332_A1,1,2,0,0,0,3
TCGAAATTTAGGACCA-1_V12D07-332_A1,1,1,0,1,0,3
AGACTAGCCTTCCAGA-1_V12D07-332_A1,1,1,1,0,0,3
TTGATCTAACTTTGTC-1_V12D07-332_A1,2,1,0,1,0,4
AAGGAGCGGTTGGTGC-1_V12D07-332_A1,0,4,0,0,0,4
ACTTGGGACCCGGTGG-1_V12D07-332_A1,0,0,0,1,0,1
TGATCTCCGGCGCCAG-1_V12D07-332_A1,7,0,0,1,0,8
CAGTTCAAATTGACAC-1_V12D07-332_A1,1,1,0,0,0,2
GTCCGGCTGAATTGCG-1_V12D07-332_A1,5,0,0,0,0,5
CTGGAAATGGATGCTT-1_V12D07-332_A1,2,1,0,0,0,3
TGATCGGTTTGACCCT-1_V12D07-332_A1,6,1,0,0,0,7
TAGAGTCTAAGCGAAC-1_V12D07-332_A1,2,0,0,0,0,2
GAGACTGATGGGTAGA-1_V12D07-332_A1,3,2,0,1,0,6
TAGCTAAGTCCGGGAG-1_V12D07-332_A1,0,1,0,0,0,1
GGGCGATATGTGTGAA-1_V12D07-332_A1,2,1,0,0,0,3
CTCGAGGTCGAACAGT-1_V12D07-332_A1,1,0,0,0,0,1
GATCCCTTTATACTGC-1_V12D07-332_A1,3,0,0,0,0,3
GTCATGCACCTCCGTT-1_V12D07-332_A1,2,3,0,0,0,5
ACTTTCCTATAGCTTC-1_V12D07-332_A1,0,3,0,1,0,4
TCGCTCGATATATTCC-1_V12D07-332_A1,3,0,0,0,0,3
ATAGGTTGGGCAGATG-1_V12D07-332_A1,3,0,0,0,0,3
CAATTAAGGGTGATGA-1_V12D07-332_A1,3,1,0,0,0,4
ACCGACTGAGTCCCAC-1_V12D07-332_A1,1,1,0,0,0,2
CCTGTCACCCGGGCTC-1_V12D07-332_A1,4,1,0,0,0,5
GATCGGTGGCCATAAC-1_V12D07-332_A1,0,0,0,1,0,1
CCTATGGGTTACCGTC-1_V12D07-332_A1,3,0,0,0,0,3
TTGGGACACTGCCCGC-1_V12D07-332_A1,4,1,0,1,0,6
CGAGGCTAAATATGGC-1_V12D07-332_A1,2,0,0,0,0,2
TCAGGGTGTAACGTAA-1_V12D07-332_A1,0,1,0,0,0,1
CGAGAGATGTGAACCT-1_V12D07-332_A1,1,0,0,2,0,3
TCGCTGGGCGGATTGT-1_V12D07-332_A1,5,1,0,0,0,6
AGATCTCAGGTGTGAT-1_V12D07-332_A1,0,2,0,1,0,3
TGGCCAAACTGAAGTA-1_V12D07-332_A1,0,2,0,0,0,2
GCTTCCGTCCCTAGAC-1_V12D07-332_A1,4,1,0,0,0,5
CAGCAGCCCGTTCCTT-1_V12D07-332_A1,2,3,0,0,0,5
TGTATAACAGATCCTG-1_V12D07-332_A1,2,1,0,2,0,5
CGCGGGAATTAGGCAG-1_V12D07-332_A1,2,0,0,0,0,2
TGCATGTGGTAATCTA-1_V12D07-332_A1,4,2,0,0,0,6
ACAATTTGAGCAGTGG-1_V12D07-332_A1,1,2,0,0,0,3
GAGCTAAGGGCATATC-1_V12D07-332_A1,5,1,0,0,0,6
CCAGATAGTTGAGTGA-1_V12D07-332_A1,4,0,0,0,0,4
CCACAATGTACGTCTT-1_V12D07-332_A1,4,0,0,0,0,4
CAATGGATCTCTACCA-1_V12D07-332_A1,0,1,0,2,0,3
TGTGGCAAAGCGTATG-1_V12D07-332_A1,4,1,0,0,0,5
TAAAGCGTTAGGAGAA-1_V12D07-332_A1,5,3,0,2,0,10
TCCGTTTAGCCTTGAA-1_V12D07-332_A1,3,2,0,2,0,7
CAGCTCGACAAGTTAA-1_V12D07-332_A1,2,0,0,1,0,3
GCCTATAGTGTCAGGG-1_V12D07-332_A1,1,0,0,0,0,1
ATAGACAACGGGACCT-1_V12D07-332_A1,2,0,0,1,0,3
CTACTATCTTTCAGAG-1_V12D07-332_A1,6,1,0,2,0,9
GCGCTGCTTTGCATTT-1_V12D07-332_A1,2,0,0,2,0,4
GCGCATCCAGTCAGCA-1_V12D07-332_A1,4,0,0,0,0,4
GACTCGCGGGAATGAC-1_V12D07-332_A1,1,0,0,1,0,2
CTGGTAACGAGCTCTT-1_V12D07-332_A1,1,0,0,0,0,1
TCCGGCCTAGCGTACA-1_V12D07-332_A1,1,3,0,0,0,4
TCTAGGTGGCGACGCT-1_V12D07-332_A1,3,3,0,0,0,6
ACGCTAGTGATACACT-1_V12D07-332_A1,2,0,0,1,0,3
ATCTGCACCTCTGCGA-1_V12D07-332_A1,3,0,0,0,0,3
CCTCACCTGAGGGAGC-1_V12D07-332_A1,1,1,0,1,0,3
AGTGAGCCTCGCCGCC-1_V12D07-332_A1,2,0,0,1,0,3
ACGAGTACGGATGCCC-1_V12D07-332_A1,1,0,0,1,0,2
GGTACCATTAAGACGG-1_V12D07-332_A1,2,0,0,0,0,2
TTCTGCTAGACTCCAA-1_V12D07-332_A1,6,0,0,2,0,8
TAACTATTACGCCAAA-1_V12D07-332_A1,6,0,0,0,0,6
GCATTCAAGGCAACGC-1_V12D07-332_A1,4,0,0,0,0,4
AGTACATCATTTATCA-1_V12D07-332_A1,2,2,0,1,0,5
GTCGTGTCTGGTCATC-1_V12D07-332_A1,1,1,0,0,0,2
AGTCTAAAGTATACTC-1_V12D07-332_A1,1,0,0,2,0,3
CGGCCCAACCTGTAGT-1_V12D07-332_A1,1,3,0,0,0,4
AGGGAGACATACTTCG-1_V12D07-332_A1,3,2,0,0,0,5
TCCCTAGATCAATAGG-1_V12D07-332_A1,4,0,0,0,0,4
TCCCGTCGCGTCATAG-1_V12D07-332_A1,2,0,0,0,0,2
CGCATCCATCAGCCAG-1_V12D07-332_A1,5,0,0,0,0,5
CTGCACCTAGTCCACA-1_V12D07-332_A1,3,0,0,0,0,3
CGAGGATCGGGAACGA-1_V12D07-332_A1,0,0,0,0,0,0
CAATGAGGTTCGACTA-1_V12D07-332_A1,4,0,0,0,0,4
TCTGACGGGCTAACCC-1_V12D07-332_A1,1,0,0,0,0,1
TTCTATGCCTTTCGCA-1_V12D07-332_A1,3,0,0,2,0,5
AGAGTATAGTGTTACG-1_V12D07-332_A1,1,2,1,0,0,4
CCATTGTTTCCTCCAT-1_V12D07-332_A1,3,0,0,1,0,4
CTCATCACTTAGTGAT-1_V12D07-332_A1,0,0,0,1,0,1
CCGAAGGGCGTACCGC-1_V12D07-332_A1,0,0,0,0,0,0
TCAAGCTGCCTTGAAA-1_V12D07-332_A1,1,1,0,0,0,2
CTCATTAACGTTGCCC-1_V12D07-332_A1,2,0,1,0,0,3
GTCTTCCTCACCTAAG-1_V12D07-332_A1,2,1,0,0,0,3
GGTGATGAAGGAAGTG-1_V12D07-332_A1,2,2,0,0,0,4
TCAATACAATTGCTGC-1_V12D07-332_A1,0,0,0,1,0,1
GCAACCCAAGTTGTTT-1_V12D07-332_A1,1,0,0,0,0,1
ATGAAGTGGACCCAGC-1_V12D07-332_A1,1,1,0,0,0,2
GAGAATCTCACGATCA-1_V12D07-332_A1,2,0,0,0,0,2
TATATCATTGATCAGT-1_V12D07-332_A1,4,0,0,2,0,6
AACTTTACGGGAGCTT-1_V12D07-332_A1,2,0,0,1,0,3
TTCTTGTGTCCATCAG-1_V12D07-332_A1,3,1,0,0,0,4
ACAATTTAGGAGGCTC-1_V12D07-332_A1,2,1,0,0,0,3
ATACTTGTTCTCGAGC-1_V12D07-332_A1,5,0,0,0,0,5
CACGGGATTGAGGGTT-1_V12D07-332_A1,4,0,0,0,0,4
GTTAATGTCTATCTTA-1_V12D07-332_A1,3,0,0,0,0,3
GCGTTATATTTGGAAC-1_V12D07-332_A1,2,2,0,1,0,5
CGTCAAGGCTATAAAT-1_V12D07-332_A1,3,1,0,1,0,5
TTAGCTCTGTAATCCG-1_V12D07-332_A1,1,3,0,2,0,6
AATGGTCCACCGTTCA-1_V12D07-332_A1,1,1,0,0,0,2
GTCATTGCATTGACCC-1_V12D07-332_A1,1,3,0,2,0,6
TGTCCGTGGCGCCTTT-1_V12D07-332_A1,0,0,0,1,0,1
TCAACTAACGTATAAC-1_V12D07-332_A1,2,1,0,0,0,3
TCCTCTCCAGTTGTCC-1_V12D07-332_A1,1,0,0,0,0,1
TGTGTTCGTATCCAAG-1_V12D07-332_A1,1,0,0,0,0,1
CCGCGTAGGTAAGGGC-1_V12D07-332_A1,1,0,0,0,0,1
CTGCGGGTGAAATGTT-1_V12D07-332_A1,2,0,0,0,0,2
TATCTACAGAGGTAAT-1_V12D07-332_A1,2,2,0,0,0,4
CTACTCTAGGCCCGGC-1_V12D07-332_A1,5,0,0,1,0,6
ACAAGCAGTGCCTAGC-1_V12D07-332_A1,0,4,0,0,0,4
TACAAGTCTCGTGCAT-1_V12D07-332_A1,3,0,0,0,0,3
TCGGAATGCGCTCTGA-1_V12D07-332_A1,3,0,0,1,0,4
TCGCGTCCAGAAGGTC-1_V12D07-332_A1,1,0,3,0,0,4
TATGGCCCGGCCTCGC-1_V12D07-332_A1,2,0,0,2,0,4
GCTGGCATATTCACCT-1_V12D07-332_A1,4,0,0,0,0,4
GTCAGAATAGTCTATG-1_V12D07-332_A1,3,3,0,0,0,6
GGCGTCCTATCCGCTG-1_V12D07-332_A1,3,2,0,1,0,6
CGGAGTTTGAGAGACA-1_V12D07-332_A1,1,2,0,0,0,3
AGCACTTAAGGACGCC-1_V12D07-332_A1,2,0,0,0,0,2
TCCACAATGGTTTACG-1_V12D07-332_A1,1,2,0,0,0,3
CCAACGATGCACTGAT-1_V12D07-332_A1,5,0,0,0,0,5
ATTTACAGTTTACTGG-1_V12D07-332_A1,0,0,0,0,0,0
CCCTGAAATGAGTTGA-1_V12D07-332_A1,2,1,0,0,0,3
CAAACGGTCGCACTTT-1_V12D07-332_A1,4,0,0,0,0,4
TGATTCGTCTATCACT-1_V12D07-332_A1,1,0,0,0,0,1
TCAGGTTCTTTGAGAA-1_V12D07-332_A1,3,1,0,0,0,4
CACGCAGCGAGGCTTT-1_V12D07-332_A1,1,2,0,1,0,4
TTAAGCGCCTGACCCA-1_V12D07-332_A1,2,1,0,2,0,5
CTTACACGGTATTCCA-1_V12D07-332_A1,1,0,0,0,0,1
AAGGCTGTGCTCATCG-1_V12D07-332_A1,3,0,0,1,0,4
GACCAGAGCCCTGTAG-1_V12D07-332_A1,1,1,0,0,0,2
TCCCAGGCTTAGCTAA-1_V12D07-332_A1,5,2,0,2,0,9
ATTGAAGATCTTAGTG-1_V12D07-332_A1,3,2,0,2,0,7
AGTTCCTACAGAATTA-1_V12D07-332_A1,3,1,0,0,0,4
GGGCTGGTTAGTCGCG-1_V12D07-332_A1,4,0,0,0,0,4
GAAATGGCGGTGTTAG-1_V12D07-332_A1,3,1,0,1,0,5
TACGAACACGACTTCA-1_V12D07-332_A1,2,2,0,1,0,5
ACCACAAGTTTCTATC-1_V12D07-332_A1,3,2,0,0,0,5
ATATTTAACCCTCAAG-1_V12D07-332_A1,3,0,0,1,0,4
GATCATTCCAAACATT-1_V12D07-332_A1,3,0,0,0,0,3
TCCAGGCGAGTACGGT-1_V12D07-332_A1,4,0,0,0,0,4
GTTTGACCAAATCCTA-1_V12D07-332_A1,3,0,0,0,0,3
CACAGCACCCACGGCA-1_V12D07-332_A1,3,1,0,0,0,4
TGCAAGAATGACGTAA-1_V12D07-332_A1,3,0,0,0,0,3
GCGAAGCCATACCCGT-1_V12D07-332_A1,6,0,0,3,0,9
TCCTTTCTTACGCTTA-1_V12D07-332_A1,0,2,0,0,0,2
GCTGCTCTCCGGACAC-1_V12D07-332_A1,5,3,0,0,0,8
ACTGTCTTCTTTAGAA-1_V12D07-332_A1,2,1,0,1,0,4
TCAAACTTAGATTGTT-1_V12D07-332_A1,1,1,0,0,0,2
CTATGTCACTAGCCCA-1_V12D07-332_A1,1,1,0,1,0,3
TGCGCAAAGCATTTGG-1_V12D07-332_A1,3,0,0,0,0,3
TTAATGTAGACCAGGT-1_V12D07-332_A1,3,1,0,0,0,4
GGCGGTAGGATCATTG-1_V12D07-332_A1,4,3,0,0,0,7
GGCAATAGTCAATGAG-1_V12D07-332_A1,0,1,0,2,0,3
ACACGAGACTCCTTCT-1_V12D07-332_A1,4,2,0,0,0,6
GACACAAGGGAAGAAA-1_V12D07-332_A1,3,1,0,1,0,5
TCAGCAAATGCATCTC-1_V12D07-332_A1,5,1,0,3,0,9
GAGATCTGTCACTCCG-1_V12D07-332_A1,1,2,0,2,0,5
ATGCCGGTCTTGCATA-1_V12D07-332_A1,4,3,0,0,0,7
TTGGGCGGCGGTTGCC-1_V12D07-332_A1,3,0,0,0,0,3
TTGTTGTGTGTCAAGA-1_V12D07-332_A1,1,0,0,1,0,2
ACTGTACGATACACAT-1_V12D07-332_A1,2,2,0,0,0,4
TCCACTTTATCTAGGT-1_V12D07-332_A1,6,1,0,1,0,8
GGTCTGAGAATCTGGA-1_V12D07-332_A1,2,0,0,1,0,3
TAGAAAGGTGGCGCTA-1_V12D07-332_A1,4,1,1,2,0,8
TATGTCTCATTGTGCC-1_V12D07-332_A1,1,0,0,0,0,1
GGATTTCACTTCTATA-1_V12D07-332_A1,0,2,0,2,0,4
TGAGTGGTCCGTGACG-1_V12D07-332_A1,1,3,0,0,0,4
CGCTTTCTTGCATTCG-1_V12D07-332_A1,1,2,0,2,0,5
ACCCAACGCCCGTGGC-1_V12D07-332_A1,1,2,0,0,0,3
GAACGTCTCATGGTCG-1_V12D07-332_A1,1,4,0,0,0,5
AGGGTTCCCTTTGGTT-1_V12D07-332_A1,4,5,0,0,0,9
GTAGCTTCCTCTTGTT-1_V12D07-332_A1,3,1,0,0,0,4
GCATGAGGGACGCGGC-1_V12D07-332_A1,2,1,0,0,0,3
CTACCCTAAGGTCATA-1_V12D07-332_A1,2,1,0,0,0,3
TCACCGCTCGGCACTC-1_V12D07-332_A1,2,0,0,1,0,3
GGCTCGCGTTGAGGTA-1_V12D07-332_A1,3,3,0,0,0,6
CTAACGAAACTTGCTG-1_V12D07-332_A1,3,2,0,2,0,7
TTAAACTCGAATTCAT-1_V12D07-332_A1,2,0,0,0,0,2
TACTTTACTGAGCCGG-1_V12D07-332_A1,1,0,0,2,0,3
GCTTGGATCGATTAGG-1_V12D07-332_A1,2,1,0,0,0,3
CGGTTATCCAACAGTG-1_V12D07-332_A1,5,0,0,0,0,5
CAGACCTGTAAGTGTT-1_V12D07-332_A1,3,1,0,1,0,5
GACGGTCAATAGAAGC-1_V12D07-332_A1,3,0,0,0,0,3
CTGACTGCGCAGCTCG-1_V12D07-332_A1,2,0,0,1,0,3
CCATACCTTTACTTGT-1_V12D07-332_A1,2,1,0,0,0,3
GTAATAAAGGGCTCCC-1_V12D07-332_A1,1,0,0,0,0,1
GTGAACTCCCATTCGA-1_V12D07-332_A1,3,1,0,0,0,4
GTGGTTACTTCTTTCG-1_V12D07-332_A1,1,1,0,1,0,3
TCAGAACCTCCACAGG-1_V12D07-332_A1,4,0,0,0,0,4
TCCCACTCTCTTCCGG-1_V12D07-332_A1,6,2,0,1,0,9
ATCTTGACTTGTCCAA-1_V12D07-332_A1,2,2,0,2,0,6
TCGGGAACGTGCCTAG-1_V12D07-332_A1,3,0,0,0,0,3
GTTAGCCGTAAATCAA-1_V12D07-332_A1,3,0,0,1,0,4
ATTTACTAAGTCCATT-1_V12D07-332_A1,4,0,0,0,0,4
GGGTGCATATGAAAGC-1_V12D07-332_A1,3,0,0,0,0,3
TCCGAATGGTCCTGAG-1_V12D07-332_A1,5,2,0,0,0,7
TGATGGCTGTTTCTGA-1_V12D07-332_A1,0,1,0,0,0,1
AAATAAGGTAGTGCCC-1_V12D07-332_A1,3,1,0,0,0,4
CCACTATCCGGGTCAC-1_V12D07-332_A1,1,3,0,0,0,4
ACACCACATAATTAGC-1_V12D07-332_A1,3,2,0,0,0,5
CGCGGTAAGTCTAGCT-1_V12D07-332_A1,0,0,0,0,0,0
GCGGGCATTACGATGC-1_V12D07-332_A1,2,0,0,0,0,2
AGGATTGCTTACGACA-1_V12D07-332_A1,2,0,0,1,0,3
CTCGGGATAACACCTA-1_V12D07-332_A1,3,2,0,0,0,5
GTCGTCTGGTTGGCTA-1_V12D07-332_A1,4,1,0,0,0,5
GCAATTAGTCGCACCG-1_V12D07-332_A1,2,0,0,0,0,2
GTGACCTAAAGAATAA-1_V12D07-332_A1,3,2,0,0,0,5
CTGAGCGAGACTTATT-1_V12D07-332_A1,1,0,0,1,0,2
CAAGACTCAGAAGCGC-1_V12D07-332_A1,3,6,0,1,0,10
ACTTCGCTAGCGAGTG-1_V12D07-332_A1,4,0,1,0,0,5
CCATACTCGCCTCTCC-1_V12D07-332_A1,2,2,0,0,0,4
ACGATACCTATCCTGA-1_V12D07-332_A1,2,0,0,0,0,2
CTCACCAGTACAAGTG-1_V12D07-332_A1,2,4,0,1,0,7
CGAAGACGGTGAGTGC-1_V12D07-332_A1,2,2,0,1,0,5
AAATTAATAAGCGCGA-1_V12D07-332_A1,4,0,0,1,0,5
GGGCCCTTATCTATAC-1_V12D07-332_A1,0,0,0,0,0,0
CTGCCCACGAAGCGTT-1_V12D07-332_A1,2,2,0,1,0,5
GGACAAGTTGCAGTGA-1_V12D07-332_A1,0,1,0,0,0,1
GTCCGAGAGCAATCAT-1_V12D07-332_A1,4,1,0,0,0,5
ATGGCAGCCGAGAAAC-1_V12D07-332_A1,3,2,0,0,0,5
CCTCGGATGCTACCTG-1_V12D07-332_A1,4,0,0,1,0,5
ATACGGTGAAGATGCA-1_V12D07-332_A1,0,0,0,1,0,1
ACATCAGCTGGGACGC-1_V12D07-332_A1,1,2,0,1,0,4
GGTTGTGTAGCCTGGC-1_V12D07-332_A1,6,0,0,0,0,6
CCTGCGTTCTACGCTT-1_V12D07-332_A1,4,1,0,0,0,5
GAACGTTAGGAAGACG-1_V12D07-332_A1,1,2,0,0,0,3
CTGATAGTGTATCTCA-1_V12D07-332_A1,4,1,0,0,0,5
TTCTGCGAGCGCCCTT-1_V12D07-332_A1,1,0,0,0,0,1
CTTTGGCGCTTTATAC-1_V12D07-332_A1,0,0,0,1,0,1
TCCGAACTTGGCTTAC-1_V12D07-332_A1,0,0,0,1,0,1
TAGATTCCTGGTTATT-1_V12D07-332_A1,4,0,0,0,0,4
CCGACAAAGGGAGTGC-1_V12D07-332_A1,2,0,0,1,0,3
CCATGGCCCTTGTACC-1_V12D07-332_A1,2,1,0,1,0,4
GAAATATCACCATCAG-1_V12D07-332_A1,2,1,0,2,0,5
ACGAAATGGGCGGCAC-1_V12D07-332_A1,1,1,0,1,0,3
GTGAGCGTGCTGCACT-1_V12D07-332_A1,2,0,0,0,0,2
CCGCGGGTACGAAGAA-1_V12D07-332_A1,2,1,0,0,0,3
TCCCTGGCTCGCTGGA-1_V12D07-332_A1,3,1,0,0,0,4
CAGCTTAGTAGGTAGC-1_V12D07-332_A1,4,0,0,0,0,4
CACGAAAGTTAGTCCC-1_V12D07-332_A1,2,0,0,1,0,3
ACCTAATCGACTTCCT-1_V12D07-332_A1,2,1,0,0,0,3
AAGTAGTGACGCGAGG-1_V12D07-332_A1,2,1,0,1,0,4
TCCGATTACATTGCCG-1_V12D07-332_A1,7,1,0,1,0,9
CCTCCGACAATTCAAG-1_V12D07-332_A1,1,1,0,1,0,3
GTTCACAGGAGTCTAG-1_V12D07-332_A1,2,0,0,0,0,2
CGAAGTTGCTCTGTGT-1_V12D07-332_A1,2,0,0,0,0,2
GTCGGATATCTCAGAC-1_V12D07-332_A1,3,1,0,0,0,4
CGCTCTCCGTAGATTA-1_V12D07-332_A1,5,1,0,0,0,6
CAAGCAACGTCGGAGT-1_V12D07-332_A1,2,0,0,1,0,3
CCATTCCCTGCCCACA-1_V12D07-332_A1,1,2,0,0,0,3
CTTTGGCTTTAGTAAA-1_V12D07-332_A1,0,0,0,1,0,1
GGCTATTAAGTTGTAT-1_V12D07-332_A1,3,1,0,0,0,4
CCATTAGCGATAATCC-1_V12D07-332_A1,7,1,0,1,0,9
TGTTCTTCCATTGACT-1_V12D07-332_A1,4,1,0,0,0,5
AGATAACTTCAGGGCC-1_V12D07-332_A1,3,1,0,2,0,6
ATAGACGAAGAGAAAG-1_V12D07-332_A1,2,2,0,1,0,5
GGCGGAGTAATATTAG-1_V12D07-332_A1,3,0,0,0,0,3
TGACCCACGTTAGACA-1_V12D07-332_A1,2,1,0,0,0,3
TCACAGGTTATTGGGC-1_V12D07-332_A1,1,1,0,0,0,2
TCACGCATTGTAGATC-1_V12D07-332_A1,2,1,0,2,0,5
TTGAAGAATTCCCAGG-1_V12D07-332_A1,1,1,0,1,0,3
AAATGGTCAATGTGCC-1_V12D07-332_A1,7,0,0,0,0,7
TAGTGCCCTCCAGAGT-1_V12D07-332_A1,4,1,0,0,0,5
GGTATTGCCGAGTTTA-1_V12D07-332_A1,3,1,0,0,0,4
CGTATTAAGAGATCTA-1_V12D07-332_A1,1,3,0,2,0,6
ACTGTCCAGGATTATA-1_V12D07-332_A1,1,1,0,0,0,2
CGGGCAGCTAAACCGC-1_V12D07-332_A1,0,0,0,1,0,1
TTGCTGATCATGTTCG-1_V12D07-332_A1,3,3,1,0,0,7
TATGGGTACGTATCGT-1_V12D07-332_A1,4,1,0,1,0,6
CAGCTCACTGAGACAT-1_V12D07-332_A1,0,0,0,1,0,1
GGGACTGCATAGATAG-1_V12D07-332_A1,3,0,0,0,0,3
ACGCATTCGTGAGTAC-1_V12D07-332_A1,1,1,0,0,0,2
CTCTGGACGCCTGGTG-1_V12D07-332_A1,0,1,0,0,0,1
AGGGTTTAGTTCGGGA-1_V12D07-332_A1,2,0,0,1,0,3
GGGAGAACTCACAGTA-1_V12D07-332_A1,2,1,0,2,0,5
ATCAATCTGGGCTGCA-1_V12D07-332_A1,1,0,0,1,0,2
TCTTCGATACCAATAA-1_V12D07-332_A1,3,0,0,0,0,3
ACGTAGATTGCTGATG-1_V12D07-332_A1,4,1,0,0,0,5
TCTTGATGCGTAGCGA-1_V12D07-332_A1,5,2,0,0,0,7
GGGCTGCCTAGGGCGA-1_V12D07-332_A1,4,1,0,1,0,6
CTCTCACAATCGATGA-1_V12D07-332_A1,2,2,0,1,0,5
CCAAGCGTAACTCGTA-1_V12D07-332_A1,1,2,0,0,0,3
ACAACAGCATGAGCTA-1_V12D07-332_A1,8,0,0,1,0,9
GTCCCAACGTAAAGTA-1_V12D07-332_A1,2,3,0,1,0,6
TCGGAGTACATGAGTA-1_V12D07-332_A1,2,1,0,0,0,3
GGGAGTTAATGAGGCG-1_V12D07-332_A1,0,0,0,0,0,0
CCGGGCGGTCTCGTCA-1_V12D07-332_A1,1,1,0,0,0,2
CCGTAAGTTGGTCCCA-1_V12D07-332_A1,0,1,0,0,0,1
GGAGGGCTTGGTTGGC-1_V12D07-332_A1,4,0,0,0,0,4
TCGGACGCCCAGCCCA-1_V12D07-332_A1,1,2,0,0,0,3
TCTGTGCCATCATAGT-1_V12D07-332_A1,3,1,0,1,0,5
GTACTGGAGTTAGACC-1_V12D07-332_A1,2,2,0,0,0,4
GGAATGCGCTAGCGTG-1_V12D07-332_A1,1,2,0,1,0,4
GTGTGAATAACTTAGG-1_V12D07-332_A1,3,0,0,1,0,4
GGTCGGCCAGGAGCTT-1_V12D07-332_A1,4,1,1,0,0,6
TAGCCGGCGGTCAGCG-1_V12D07-332_A1,1,0,0,2,0,3
CGGGTGTACCCATTTA-1_V12D07-332_A1,1,0,0,0,0,1
AGTGATTCAAGCAGGA-1_V12D07-332_A1,4,0,0,0,0,4
GTTGGATTGAGAACAC-1_V12D07-332_A1,2,1,0,2,0,5
CACACGCGCTGTCTTA-1_V12D07-332_A1,1,2,0,2,0,5
TAGACGCCCGTACCGG-1_V12D07-332_A1,1,1,0,1,0,3
GGTTTCAATCGGTCAG-1_V12D07-332_A1,2,2,0,0,0,4
AATCTGCGTTGGGACG-1_V12D07-332_A1,2,0,0,1,0,3
TTACGGATGGTTCGAG-1_V12D07-332_A1,3,1,0,1,0,5
CGGCAGGGTCGGGTTG-1_V12D07-332_A1,6,0,0,0,0,6
GCTTTCAGAGGAGGTG-1_V12D07-332_A1,3,1,0,0,0,4
TCTTCCCATGGGCACA-1_V12D07-332_A1,3,3,0,0,0,6
TACCGCGGACTTGCAG-1_V12D07-332_A1,4,0,0,2,0,6
AGAATTATGGATTCGA-1_V12D07-332_A1,2,2,0,0,0,4
ATTGATGAGTCCTAAC-1_V12D07-332_A1,3,1,0,2,0,6
TAGGTCGCCGGAACTG-1_V12D07-332_A1,0,1,0,0,0,1
TAACCTACCGTCCGAG-1_V12D07-332_A1,0,2,0,2,0,4
CTTAGTAGGCCTACAG-1_V12D07-332_A1,2,1,0,0,0,3
CTAGATGTGAGTGTAA-1_V12D07-332_A1,5,0,0,1,0,6
ACTCCCGAATTCGTTT-1_V12D07-332_A1,2,0,0,0,0,2
GTTCATCGTTTGGCTG-1_V12D07-332_A1,1,1,0,2,0,4
ACTTTACCCTCATGAA-1_V12D07-332_A1,3,1,0,0,0,4
GCGAGAGTTGCGTCCA-1_V12D07-332_A1,0,0,0,1,0,1
GTTCGGGCGTACCATT-1_V12D07-332_A1,1,0,0,0,0,1
CGACTTTGTATAGCCT-1_V12D07-332_A1,5,1,0,0,0,6
GCCATCGATGCTGCAT-1_V12D07-332_A1,2,0,0,0,0,2
GCATTTCCAAGGCTCC-1_V12D07-332_A1,2,0,0,0,0,2
ATGTAAGGCTGCTCTT-1_V12D07-332_A1,2,0,0,3,0,5
ACGTTCGCAATCAATT-1_V12D07-332_A1,2,0,0,0,0,2
GTGACGAGGGTGACCC-1_V12D07-332_A1,2,1,0,3,0,6
ATTATAGCTACTTTAC-1_V12D07-332_A1,1,0,0,0,0,1
CGTGTGTTAAACCCTG-1_V12D07-332_A1,1,0,0,1,0,2
TTGGTATGGCTTGTGT-1_V12D07-332_A1,5,0,0,0,0,5
CATTCCCATTCCGTCG-1_V12D07-332_A1,2,1,0,2,0,5
TGCCGAAAGCGTATTC-1_V12D07-332_A1,1,1,0,1,0,3
CAACACATCTCCTGCC-1_V12D07-332_A1,4,0,0,1,0,5
CTGCCTCATATGCAAC-1_V12D07-332_A1,4,0,0,1,0,5
TCCCGCCTATGTGCGT-1_V12D07-332_A1,5,2,0,0,0,7
GGTTACCCGACACTTT-1_V12D07-332_A1,5,1,0,2,0,8
CCAGCGGGATCACCAG-1_V12D07-332_A1,1,0,0,0,0,1
ATGTTTCGGCCCGGAG-1_V12D07-332_A1,3,1,0,0,0,4
GCGTCTAACCTCCTAA-1_V12D07-332_A1,3,0,0,1,0,4
ATCAGGTAGCTGACAG-1_V12D07-332_A1,4,0,0,0,0,4
GGTATGAAAGAACTGA-1_V12D07-332_A1,3,2,0,0,0,5
GTGGCCTAATATCATT-1_V12D07-332_A1,3,1,0,0,0,4
CCTGTGAAACCGTAAC-1_V12D07-332_A1,2,0,0,1,0,3
GGCAGAGAGATCGGGA-1_V12D07-332_A1,1,1,0,1,0,3
TAGCGTCGAATATTGA-1_V12D07-332_A1,3,0,0,1,0,4
CGCCGACTATTCGCTA-1_V12D07-332_A1,1,0,1,1,0,3
TCTGGCGCAAGCCGGG-1_V12D07-332_A1,2,0,0,0,0,2
AGTGGTTGCGTATAGG-1_V12D07-332_A1,3,0,0,0,0,3
ATCGGTTACCTAGTAA-1_V12D07-332_A1,3,0,0,1,0,4
CCTGCCCGTTGTCTAG-1_V12D07-332_A1,1,0,0,0,0,1
GCACACGCCCATGGTC-1_V12D07-332_A1,2,1,0,0,0,3
AGTACGGCCCGTATCG-1_V12D07-332_A1,5,1,0,0,0,6
TATCTAGCCTAAAGGA-1_V12D07-332_A1,1,1,0,1,0,3
CACTCGGTTAGGAGGA-1_V12D07-332_A1,2,0,1,0,0,3
ATGTTCGTCGACCCAC-1_V12D07-332_A1,5,0,0,0,0,5
TTCCTCTGCCCGAATA-1_V12D07-332_A1,1,0,0,1,0,2
TTACTATCGGCTTCTC-1_V12D07-332_A1,3,2,0,0,0,5
GCCGCATTAGTCCGGC-1_V12D07-332_A1,2,2,0,0,0,4
TAAGGGCTGGGAGAGG-1_V12D07-332_A1,0,0,0,1,0,1
TAAGCAGGCGACACGC-1_V12D07-332_A1,1,0,0,0,0,1
AGCACTACCGGCCTGT-1_V12D07-332_A1,1,0,0,1,0,2
GAAAGCCCTTTGGACC-1_V12D07-332_A1,2,3,0,0,0,5
GACCGACTGAAGCGTC-1_V12D07-332_A1,0,0,0,1,0,1
CGGTGAAGACTAAAGT-1_V12D07-332_A1,1,1,0,1,0,3
CCCTGCGCTACGCATA-1_V12D07-332_A1,1,0,1,0,0,2
TACTGGACAGCTCGGC-1_V12D07-332_A1,1,0,0,2,0,3
TTAGTAGGGCGGCGGG-1_V12D07-332_A1,1,0,0,0,0,1
GAGGCTATCAAAGTCG-1_V12D07-332_A1,4,1,0,0,0,5
TTACCATTGATTACCC-1_V12D07-332_A1,1,0,0,0,0,1
ATACCACGGGCAACTT-1_V12D07-332_A1,0,1,0,1,0,2
TGTCCTAAGTCACCGC-1_V12D07-332_A1,1,1,0,1,0,3
AGGTAGGTACAAAGCT-1_V12D07-332_A1,2,0,0,0,0,2
GGCATACAGGTAGCGG-1_V12D07-332_A1,1,2,0,1,0,4
TGTAGTGATCTATAAT-1_V12D07-332_A1,3,0,1,1,0,5
TCCCGGGTGTGCTGCT-1_V12D07-332_A1,3,0,0,0,0,3
TACGATGTTGATCATC-1_V12D07-332_A1,2,0,0,1,0,3
CCTCTCTCCCATCTAG-1_V12D07-332_A1,3,0,0,0,0,3
GCAGGACTATAGAATA-1_V12D07-332_A1,2,2,0,0,0,4
CTAGTGAAGGACAGGA-1_V12D07-332_A1,1,2,0,1,0,4
TACGAGAACTTCACGT-1_V12D07-332_A1,4,0,0,0,0,4
CGTTGTTTCAATTCCC-1_V12D07-332_A1,0,1,0,0,0,1
GCAAATATTACGCTTT-1_V12D07-332_A1,1,0,0,0,0,1
CCAATAGTGCCGTCGA-1_V12D07-332_A1,3,0,0,0,0,3
ATTGCTGCTCCTCCAT-1_V12D07-332_A1,2,0,0,0,0,2
GAGATCTGCTTGGCAT-1_V12D07-332_A1,1,0,0,1,0,2
GCCGAAATTCCTACGT-1_V12D07-332_A1,1,1,0,0,0,2
GGCACTCCACTGGGCA-1_V12D07-332_A1,2,1,0,0,0,3
GGGTCACCGTGACGGT-1_V12D07-332_A1,3,0,0,1,0,4
CACTTAATCAGACGGA-1_V12D07-332_A1,1,1,0,1,0,3
CGTTTCGCTCATTACA-1_V12D07-332_A1,1,2,0,0,0,3
ATAAAGGCTCGGTCGT-1_V12D07-332_A1,3,1,0,1,0,5
CACTAAAGTTGCCTAT-1_V12D07-332_A1,2,1,0,0,1,4
GTGCTCAAGTACTGTC-1_V12D07-332_A1,5,0,0,1,0,6
CCATGCCTGTTTAGTA-1_V12D07-332_A1,3,0,0,0,1,4
TCTAGTTATCAGAAGA-1_V12D07-332_A1,2,2,0,0,0,4
TTGTAATCCGTACTCG-1_V12D07-332_A1,4,0,1,0,0,5
TCCCAGCTTTAGTCTG-1_V12D07-332_A1,2,1,0,0,0,3
CTACGCACGGAGTACC-1_V12D07-332_A1,3,1,0,0,0,4
AAATTAACGGGTAGCT-1_V12D07-332_A1,2,1,0,0,0,3
CGGCCACGCACAAAGT-1_V12D07-332_A1,5,3,0,1,0,9
GAAGCGTGAGGAATTT-1_V12D07-332_A1,1,1,0,1,0,3
ATATCTTAGGGCCTTC-1_V12D07-332_A1,1,0,0,0,0,1
ACGCGGGCCAAGGACA-1_V12D07-332_A1,4,2,0,0,0,6
GCGAGTTCTGCAAAGA-1_V12D07-332_A1,1,1,0,1,0,3
TATTCGTGCCAGAATA-1_V12D07-332_A1,3,0,0,1,0,4
AGGGCTGCAGTTACAG-1_V12D07-332_A1,1,0,0,0,0,1
CTAGCATAGTATAATG-1_V12D07-332_A1,1,1,0,0,0,2
TAGGTTCGAGTTCGTC-1_V12D07-332_A1,2,1,0,0,0,3
GAATTATAGTGAAAGG-1_V12D07-332_A1,2,2,0,0,0,4
CTATCGGGTCTCAACA-1_V12D07-332_A1,4,1,0,1,0,6
GCGCTAATTGAATAGA-1_V12D07-332_A1,1,1,0,0,0,2
ATGCGACAGTCCCATT-1_V12D07-332_A1,4,0,0,0,0,4
GGTAGTGCTCGCACCA-1_V12D07-332_A1,4,1,0,0,0,5
AAGCTCGTGCCAAGTC-1_V12D07-332_A1,1,2,0,0,0,3
TATTCAATTCTAATCC-1_V12D07-332_A1,1,2,0,0,0,3
TTCAAAGTCTCTAGCC-1_V12D07-332_A1,1,1,0,0,0,2
TTGAATATGGACTTTC-1_V12D07-332_A1,2,0,0,0,0,2
AAGAGCTCTTTATCGG-1_V12D07-332_A1,1,1,0,0,0,2
TTACTCCGGCCGGGAA-1_V12D07-332_A1,6,2,0,0,0,8
AAACGAGACGGTTGAT-1_V12D07-332_A1,3,0,1,1,0,5
GCTAAGTAGTTTCTCT-1_V12D07-332_A1,0,1,0,0,0,1
ATAACGCCGGAGGGTC-1_V12D07-332_A1,4,3,0,0,0,7
GGATCCGGAATATACT-1_V12D07-332_A1,1,0,0,2,0,3
TGAAAGGACCTGACTC-1_V12D07-332_A1,2,1,0,0,0,3
TCCGCGGCAGCATCTG-1_V12D07-332_A1,2,1,0,0,0,3
TGCATATGTCTGTCAC-1_V12D07-332_A1,3,0,0,2,0,5
TGTAGGAGAAATTTCC-1_V12D07-332_A1,2,2,0,0,0,4
AGTGAGACTTCCAGTA-1_V12D07-332_A1,2,1,0,0,0,3
CCCAAACATGCTGCTC-1_V12D07-332_A1,3,1,0,0,0,4
GCTTATGAAGCAGGAA-1_V12D07-332_A1,4,1,0,0,0,5
TTCTAACCGAAGCTTA-1_V12D07-332_A1,3,1,0,0,0,4
GGATGTCCTTACCGCA-1_V12D07-332_A1,1,1,0,1,0,3
AGGGTGCTCTCGAGGG-1_V12D07-332_A1,2,0,0,0,0,2
AACTCTCAATAGAGCG-1_V12D07-332_A1,2,0,0,0,0,2
TCTGAATTCCGTACAA-1_V12D07-332_A1,1,2,0,0,0,3
GCGTGGTACTGGGTTA-1_V12D07-332_A1,4,0,0,0,0,4
CGTCGGATAGTGTTGA-1_V12D07-332_A1,1,3,0,2,0,6
ATATGTCTCCCTAGCC-1_V12D07-332_A1,6,0,0,1,0,7
TCTTTAAGACTATGAA-1_V12D07-332_A1,1,2,0,0,0,3
TCATTTAAGTCTCCGA-1_V12D07-332_A1,5,2,0,0,0,7
GATATTGAGATTGGCG-1_V12D07-332_A1,2,2,0,1,0,5
TGACATCGAGCGGACC-1_V12D07-332_A1,2,1,0,0,0,3
GCGTAAATGGCCATAA-1_V12D07-332_A1,0,1,0,1,0,2
ATTGTACAACTCGGCT-1_V12D07-332_A1,4,0,0,1,0,5
TACGCTATAGAAACCT-1_V12D07-332_A1,1,1,0,1,0,3
CACCCAAATCTTATGT-1_V12D07-332_A1,4,0,0,0,0,4
AGATGATGGAGTCTGG-1_V12D07-332_A1,4,3,0,0,0,7
CCACGGTGCCCGGTAG-1_V12D07-332_A1,6,1,0,1,0,8
TCAAGAAATACTAGCT-1_V12D07-332_A1,2,0,0,0,0,2
AGGTATAATTGATAGT-1_V12D07-332_A1,3,1,0,0,0,4
CAAGGTCCTATAGGCT-1_V12D07-332_A1,2,0,0,0,0,2
CCGGCACGACCGTTTC-1_V12D07-332_A1,1,0,0,0,0,1
ACCTCCGTTATTCACC-1_V12D07-332_A1,1,1,0,2,0,4
GCAGCCTATATCACAT-1_V12D07-332_A1,4,0,0,0,0,4
GGTATAGTGACACATA-1_V12D07-332_A1,1,0,0,1,0,2
AAATTCCAGGTCCAAA-1_V12D07-332_A1,2,1,0,1,0,4
TCTTTAGCAGGCGAAC-1_V12D07-332_A1,2,0,0,0,0,2
TATTGACATTTCTGCC-1_V12D07-332_A1,0,1,0,1,0,2
TCTGATCGGGTGCTAG-1_V12D07-332_A1,6,0,0,1,0,7
GGCCCGGAGCATGTCT-1_V12D07-332_A1,1,3,0,0,0,4
GGGCGCAGCGTTACTC-1_V12D07-332_A1,0,0,0,2,0,2
TTGGCGATCCGAATAT-1_V12D07-332_A1,3,0,0,0,0,3
CCACGTAAATTAGACT-1_V12D07-332_A1,2,0,0,1,0,3
TCTGATTGGAAATGGA-1_V12D07-332_A1,3,0,0,1,0,4
ATGGCGGAATAGTCGC-1_V12D07-332_A1,5,1,0,1,0,7
ATCGCTTTACGTCTCA-1_V12D07-332_A1,4,1,0,1,0,6
TACGTGCAAGGTTCCT-1_V12D07-332_A1,6,0,0,0,0,6
CAGGACAGCTGCCCTT-1_V12D07-332_A1,2,0,0,0,0,2
CAAACCAGGTCTGCAT-1_V12D07-332_A1,2,1,0,1,0,4
ACAAGCTATATGGAAG-1_V12D07-332_A1,3,2,0,2,0,7
TCGCCCACTGCGAGAG-1_V12D07-332_A1,2,1,0,0,0,3
AGCCGCAAATTCAAAT-1_V12D07-332_A1,3,0,0,1,0,4
TTAACGTTAAAGCCTG-1_V12D07-332_A1,1,0,0,1,0,2
CAGCGCCAACACGATA-1_V12D07-332_A1,3,0,0,1,0,4
ATCCAATGGTACCGAA-1_V12D07-332_A1,1,1,0,0,0,2
GTGCTGCAGATAAGGA-1_V12D07-332_A1,3,1,0,1,0,5
GGCCTTTGCAACTGGC-1_V12D07-332_A1,3,0,0,0,0,3
GTCGTACCTACGATTG-1_V12D07-332_A1,5,0,0,0,0,5
TAGAAATTCACGTATA-1_V12D07-332_A1,4,0,0,0,0,4
AGAATAAATCTTCAGG-1_V12D07-332_A1,1,0,0,0,0,1
CATTGCGAAATGGGCG-1_V12D07-332_A1,8,1,0,1,0,10
GTCTACTCAATTACAA-1_V12D07-332_A1,1,2,0,0,0,3
TGTAATGACCACAATA-1_V12D07-332_A1,2,1,0,0,0,3
AAAGTCGACCCTCAGT-1_V12D07-332_A1,4,2,0,1,0,7
TACTCGGCACGCCGGG-1_V12D07-332_A1,0,0,0,0,0,0
AGGTGTATCGCCATGA-1_V12D07-332_A1,8,0,0,0,0,8
TGTGCTTTACGTAAGA-1_V12D07-332_A1,4,0,0,0,0,4
AAACCTCATGAAGTTG-1_V12D07-332_A1,0,0,0,1,0,1
TATAGGGTACTCATGA-1_V12D07-332_A1,1,0,0,2,0,3
CCAGCTGATGGTACTT-1_V12D07-332_A1,1,1,0,0,0,2
AATATTGGAGTATTGA-1_V12D07-332_A1,2,0,1,0,0,3
GGCCCTCACCCACTTA-1_V12D07-332_A1,3,1,0,0,0,4
AACCAAGACTTCTCTG-1_V12D07-332_A1,4,0,0,0,0,4
TCGTATTACCCATTGC-1_V12D07-332_A1,2,0,1,1,0,4
ATTCGACGCCGGGCCT-1_V12D07-332_A1,3,0,0,0,0,3
GGCGCAGGACATCTTC-1_V12D07-332_A1,2,1,0,0,0,3
GTACTCCCTTATCGCT-1_V12D07-332_A1,0,2,0,0,0,2
TGGTCTGTTGGGCGTA-1_V12D07-332_A1,3,1,0,1,0,5
AATAACAACGCTCGGC-1_V12D07-332_A1,1,0,1,1,0,3
CATACCCGTACCCAGT-1_V12D07-332_A1,2,1,2,1,0,6
ACAATCCATTTAAACC-1_V12D07-332_A1,0,0,0,1,0,1
GTTACAATTGGTGACG-1_V12D07-332_A1,1,1,0,0,0,2
TTGCCCTGATCACGGG-1_V12D07-332_A1,2,1,0,0,0,3
CTAACCGCGCGCCCGT-1_V12D07-332_A1,3,0,0,0,0,3
CTAAAGAATGCCTACT-1_V12D07-332_A1,3,2,0,0,0,5
ACCCATCTTGAGGGTA-1_V12D07-332_A1,0,2,0,1,0,3
GATCTTTGCAGGGTAT-1_V12D07-332_A1,2,0,0,0,0,2
GGGTACTTCATGAACT-1_V12D07-332_A1,5,2,0,0,0,7
GCCGCTTGTGAGAAAC-1_V12D07-332_A1,2,0,0,1,0,3
CCTGTAAGACATGATA-1_V12D07-332_A1,0,2,0,1,0,3
CGACAGTTCGCGTTAT-1_V12D07-332_A1,3,1,0,1,0,5
ACGATGCATATGTTAT-1_V12D07-332_A1,1,1,0,0,0,2
TGTTCCGCTTCCATGA-1_V12D07-332_A1,2,2,0,1,0,5
GGATGACGCGAGTTTA-1_V12D07-332_A1,0,1,0,0,0,1
GAAGTTTCCACTCAAT-1_V12D07-332_A1,1,3,0,1,0,5
GCGAGGCCCGAGCAGA-1_V12D07-332_A1,1,1,0,1,0,3
CATACTATGTAATTGT-1_V12D07-332_A1,1,2,0,0,0,3
CCAATGTCACAGCAAG-1_V12D07-332_A1,2,0,1,1,0,4
GTTGGATTTGCGTTGG-1_V12D07-332_A1,2,0,0,0,0,2
GGGAGGATGCCCGAAA-1_V12D07-332_A1,2,0,0,0,0,2
GATCGCGGGCTCTCCA-1_V12D07-332_A1,2,0,0,2,0,4
GTTCGCCATAAGTGCC-1_V12D07-332_A1,1,0,0,1,0,2
AGATTATAGGACGTTT-1_V12D07-332_A1,4,1,0,1,0,6
TCGAGACCAACACCGT-1_V12D07-332_A1,2,3,0,0,0,5
TATGGGACCGAGCAGG-1_V12D07-332_A1,1,0,0,0,0,1
GATGCGTCCTGCATTC-1_V12D07-332_A1,4,1,0,2,0,7
TATGGTCTGAGTAACA-1_V12D07-332_A1,1,2,0,0,0,3
GCATAGAGCACTCAGG-1_V12D07-332_A1,2,1,0,0,0,3
CTTCATTGTCAGTGGA-1_V12D07-332_A1,5,1,0,1,0,7
GCAGATTAGGGATATC-1_V12D07-332_A1,2,2,0,1,0,5
CCTGTCGCCCGTAAAT-1_V12D07-332_A1,2,0,0,0,0,2
CAATTTCGTATAAGGG-1_V12D07-332_A1,3,3,0,1,0,7
GTACACTTACCTGAAG-1_V12D07-332_A1,1,0,0,0,0,1
CCAGCCTGGACCAATA-1_V12D07-332_A1,6,0,0,0,0,6
ATGGAGCAGGCCGTGA-1_V12D07-332_A1,1,2,0,1,0,4
GTCATTAGAGCGAACG-1_V12D07-332_A1,1,1,0,3,0,5
AAGACTGCAAGCTACT-1_V12D07-332_A1,3,1,0,0,0,4
CTAGTCACGTCTTAAG-1_V12D07-332_A1,2,1,0,1,0,4
ACTCTTGTATAGTAAC-1_V12D07-332_A1,0,1,0,1,0,2
ATTAGGCGATGCTTTC-1_V12D07-332_A1,4,2,0,0,0,6
TTCGGGACTAATCGCG-1_V12D07-332_A1,3,1,0,0,0,4
TGGACTGTTCGCTCAA-1_V12D07-332_A1,5,2,0,0,0,7
AACGTGCGAAAGTCTC-1_V12D07-332_A1,3,1,0,1,0,5
CCACCCAAGGAAAGTG-1_V12D07-332_A1,1,0,0,2,0,3
CCGCACAAAGACCAAC-1_V12D07-332_A1,2,0,0,1,0,3
GCGATTGTTAACGTTA-1_V12D07-332_A1,3,3,0,1,0,7
ACTCGTCAGTAATCCC-1_V12D07-332_A1,2,0,0,1,0,3
GGTGATAAGGAGCAGT-1_V12D07-332_A1,1,1,0,0,0,2
AAGAGGCATGGATCGC-1_V12D07-332_A1,2,3,0,0,0,5
CACGTTCGTGCTCTAG-1_V12D07-332_A1,3,1,0,1,0,5
CTATTTGGTTACGGAT-1_V12D07-332_A1,0,0,1,2,0,3
GTACAGAGGCAAGGGT-1_V12D07-332_A1,3,3,0,1,0,7
GGGCCGGCCGAAGTAC-1_V12D07-332_A1,3,1,0,3,0,7
CCTGAACGATATATTC-1_V12D07-332_A1,0,1,0,1,0,2
CCGGGCTGCTCCATAC-1_V12D07-332_A1,1,0,0,0,0,1
TACTTGTTAGTAGTCC-1_V12D07-332_A1,3,1,0,0,0,4
CCTAGGCGTAGCGATC-1_V12D07-332_A1,1,2,0,0,0,3
CTGGCGCACAGGTCTG-1_V12D07-332_A1,5,1,0,0,0,6
ACTTATACTTACCCGG-1_V12D07-332_A1,2,1,0,1,0,4
GAAGTCTCCCTAGCGA-1_V12D07-332_A1,2,1,0,0,0,3
ACCGATGGTAGCATCG-1_V12D07-332_A1,7,3,0,0,0,10
CGAGTTTATCGGACTG-1_V12D07-332_A1,2,0,0,0,0,2
CATAACGGACAGTCGT-1_V12D07-332_A1,1,0,0,1,0,2
TGACGATGCACTAGAA-1_V12D07-332_A1,1,2,0,0,0,3
TAGGGAGCTTGGGATG-1_V12D07-332_A1,3,1,0,0,0,4
AGGGTCGATGCGAACT-1_V12D07-332_A1,5,1,0,2,0,8
TATATCCCTGGGAGGA-1_V12D07-332_A1,8,1,0,1,0,10
CATCTTACACCACCTC-1_V12D07-332_A1,6,0,0,1,0,7
GTGCGACAGGGAGTGT-1_V12D07-332_A1,6,2,0,1,0,9
CCGATCTCAACCTTAT-1_V12D07-332_A1,3,2,0,0,0,5
ACGATCATCTTGTAAA-1_V12D07-332_A1,0,3,0,0,0,3
GAAAGAACAGCGTTAT-1_V12D07-332_A1,4,0,0,1,0,5
CTAGGTCTGAAGGAAT-1_V12D07-332_A1,4,2,0,1,0,7
ATATCAACCTACAGAG-1_V12D07-332_A1,3,0,0,0,0,3
AAATAGCTTAGACTTT-1_V12D07-332_A1,2,1,0,0,0,3
GCGACATGTAAACATC-1_V12D07-332_A1,2,2,0,0,0,4
ATAAGTAGGGCGACTC-1_V12D07-332_A1,5,1,0,2,0,8
GCGAGCGCATGCTCCC-1_V12D07-332_A1,1,0,0,0,0,1
AGGGACCGGCTGCGTT-1_V12D07-332_A1,9,2,0,1,0,12
CCTATGAAGTGGTGCC-1_V12D07-332_A1,4,2,0,1,0,7
GCTTACGTAGTTAGTA-1_V12D07-332_A1,3,1,0,0,0,4
CATACTTAGGCAATAC-1_V12D07-332_A1,3,1,0,2,0,6
CCTGTCCCTCACGTTA-1_V12D07-332_A1,2,1,0,0,0,3
CAATGTGCCAACCCTT-1_V12D07-332_A1,0,2,0,1,0,3
GTTAAGTTAGAGTGGG-1_V12D07-332_A1,3,0,0,1,0,4
CTGGGATACGCTACCC-1_V12D07-332_A1,2,0,0,1,0,3
AACCTGTCACGGAATT-1_V12D07-332_A1,2,0,0,0,0,2
ACTGCGGACACACCGT-1_V12D07-332_A1,7,0,0,0,0,7
CCGTGAGGCATTCATG-1_V12D07-332_A1,1,1,0,0,0,2
GCCCAGATGCTGGAGA-1_V12D07-332_A1,2,0,0,0,0,2
TCTGGCCGTTCAAGTT-1_V12D07-332_A1,1,0,0,1,0,2
ATACGAAGGCTTTCCA-1_V12D07-332_A1,1,1,0,1,0,3
GATCCGAATATAAGTG-1_V12D07-332_A1,0,1,0,0,0,1
GTGGAGCATGTCGGCC-1_V12D07-332_A1,3,1,0,0,0,4
ACTCTTCAGCTCCCGC-1_V12D07-332_A1,2,1,0,1,0,4
CCCGATAGCCTCGCCT-1_V12D07-332_A1,1,0,0,0,0,1
ACAGGTGTGTTGTTGC-1_V12D07-332_A1,0,0,0,1,0,1
TGAACTGCTATGACTT-1_V12D07-332_A1,2,0,0,2,0,4
TGACATATATGACGAT-1_V12D07-332_A1,4,0,0,0,0,4
AAGTCTTCTGTGGCCT-1_V12D07-332_A1,3,0,1,0,0,4
ACCAGACCATAACAAC-1_V12D07-332_A1,1,1,0,0,0,2
TGAGACGTACCTCTCA-1_V12D07-332_A1,1,1,0,0,0,2
GACCGTTACATGCGAC-1_V12D07-332_A1,1,0,0,1,0,2
GGTTCGGATTATACTA-1_V12D07-332_A1,4,0,0,0,0,4
CCTCCTGAGCCCACAT-1_V12D07-332_A1,1,0,0,1,0,2
CCGCGATTTGGTAGGT-1_V12D07-332_A1,4,0,1,1,0,6
AATCTCTACTGTGGTT-1_V12D07-332_A1,3,0,0,0,0,3
ACTTTGACTGCATCCT-1_V12D07-332_A1,3,2,0,2,0,7
CCCTGACTAACAAATT-1_V12D07-332_A1,1,0,0,3,0,4
ACGCTGTGAGGCGTAG-1_V12D07-332_A1,2,0,0,0,0,2
GCATACGAGGTCTTTA-1_V12D07-332_A1,1,0,0,1,0,2
TCGGGATTCAAACATA-1_V12D07-332_A1,0,0,0,0,0,0
GGGCCCTACGAAAGGG-1_V12D07-332_A1,2,0,0,0,0,2
CGCCAAGAAGCCGAGT-1_V12D07-332_A1,1,2,0,0,0,3
GGTACATCTGGGACGA-1_V12D07-332_A1,2,0,0,0,0,2
GGATGCTGGCGTTCCT-1_V12D07-332_A1,1,1,0,0,0,2
CCGATTCGAGGGACCC-1_V12D07-332_A1,1,1,0,0,0,2
CCACTGGTGGCTGGTT-1_V12D07-332_A1,2,0,0,0,0,2
GACAGGCACACACTAT-1_V12D07-332_A1,0,2,0,0,0,2
TCAACGCGACCGGCAG-1_V12D07-332_A1,2,1,0,0,0,3
CTACGACTAGCTATAA-1_V12D07-332_A1,5,0,0,0,0,5
CGGTTGACCTGGCATA-1_V12D07-332_A1,2,0,1,0,0,3
ATCCTGAATCGCTGCG-1_V12D07-332_A1,1,0,0,0,0,1
GTTTCATATCGTCGCT-1_V12D07-332_A1,1,1,0,0,0,2
ATAAATATTAGCAGCT-1_V12D07-332_A1,6,0,0,1,0,7
AAGAGGATGTACGCGA-1_V12D07-332_A1,4,0,0,0,0,4
TCCTGCGTTGATACTC-1_V12D07-332_A1,2,0,0,0,0,2
CGTGCATTGTCGACGC-1_V12D07-332_A1,0,0,0,0,0,0
CCGGGTTCGAGGTTAC-1_V12D07-332_A1,6,0,0,0,0,6
CCCAATTTCACAACTT-1_V12D07-332_A1,2,1,0,0,0,3
TGATTTATTAGCTGTG-1_V12D07-332_A1,2,1,0,0,0,3
TGGAAGAAGGGAACGT-1_V12D07-332_A1,1,0,0,1,0,2
GACGCTTGCTTCTAAA-1_V12D07-332_A1,3,0,0,1,0,4
GGGAACGGGAGGTTAG-1_V12D07-332_A1,0,0,1,3,0,4
GCGGCTCTGACGTACC-1_V12D07-332_A1,3,0,0,0,0,3
ACGTTAGATTTGCCCG-1_V12D07-332_A1,2,0,0,0,0,2
GAGAGGGCGCGAGGTT-1_V12D07-332_A1,1,0,0,0,0,1
GCGTCTCTGCATTGGG-1_V12D07-332_A1,4,2,0,0,0,6
GCAGCACACAGCCCAG-1_V12D07-332_A1,2,0,0,2,0,4
CAGGCCGTTTGGGTGT-1_V12D07-332_A1,1,1,0,0,0,2
AACTCAAGTTAATTGC-1_V12D07-332_A1,0,1,0,1,0,2
CTTCGTAGATAGGTGA-1_V12D07-332_A1,3,0,0,1,0,4
TGCAGAGTACCGAGCA-1_V12D07-332_A1,1,0,0,1,0,2
GAAGTGATTTATCGTG-1_V12D07-332_A1,1,1,0,0,0,2
CGCTACGGGACATTTA-1_V12D07-332_A1,3,0,1,2,0,6
CCACACTGAGATATTA-1_V12D07-332_A1,2,1,0,2,0,5
CGATCCGACCCAGTGC-1_V12D07-332_A1,2,0,0,1,0,3
CTGTACTTCTTAGCAT-1_V12D07-332_A1,2,2,0,0,0,4
ACTTATTAGGATCGGT-1_V12D07-332_A1,0,4,0,0,0,4
TAGTCCGCAGAGAATG-1_V12D07-332_A1,1,1,0,1,0,3
TTCACGAAAGGATCAC-1_V12D07-332_A1,3,2,0,0,0,5
TACATTTCTAACGTGC-1_V12D07-332_A1,3,0,0,0,0,3
ACCATATCCGCAATAA-1_V12D07-332_A1,1,1,0,0,0,2
CACTCAAGAGCTATGG-1_V12D07-332_A1,2,2,0,0,0,4
TGTACGAACAAATCCG-1_V12D07-332_A1,3,0,0,3,0,6
ATCATCCAATATTTGT-1_V12D07-332_A1,3,1,0,0,0,4
CGCTATTCTTAGGCTC-1_V12D07-332_A1,4,0,0,0,0,4
TGGCAGCAGTAATAGT-1_V12D07-332_A1,1,0,0,2,0,3
TCACGTGCCCGATTCA-1_V12D07-332_A1,0,0,0,0,0,0
CATACGGCGTCTGGGC-1_V12D07-332_A1,1,1,0,2,0,4
CACATGATTCAGCAAC-1_V12D07-332_A1,2,0,0,1,0,3
GCTAGTAGAGCTTGTA-1_V12D07-332_A1,3,0,0,0,0,3
TGCTGTTGAAGAACTC-1_V12D07-332_A1,3,1,0,0,0,4
CGGAGCATGGCGATCC-1_V12D07-332_A1,4,1,0,0,0,5
TAGCGTTGGGTCTTAC-1_V12D07-332_A1,1,1,1,0,0,3
GTAGCGGCTATACACT-1_V12D07-332_A1,4,1,0,0,0,5
TAACATACAATGTGGG-1_V12D07-332_A1,2,2,0,1,0,5
TCTTCGAATAGACGTT-1_V12D07-332_A1,0,1,0,0,0,1
GATCGTGACTGATATC-1_V12D07-332_A1,0,1,0,0,0,1
GATCCGGGAATTAACA-1_V12D07-332_A1,1,1,1,0,0,3
TTATATACGCTGTCAC-1_V12D07-332_A1,2,0,1,2,0,5
GTCGCGTAACCCGTTG-1_V12D07-332_A1,2,1,0,2,0,5
AGCTCTAGACGTTCCA-1_V12D07-332_A1,2,0,0,0,0,2
GTCAAGCGGACTCGGG-1_V12D07-332_A1,2,1,0,0,0,3
CGAGGGACTGCGGTCG-1_V12D07-332_A1,2,0,0,0,0,2
AATCGCCTCAGCGCCA-1_V12D07-332_A1,1,2,0,0,0,3
CTTGTTGCTGAGTCAA-1_V12D07-332_A1,3,1,0,0,0,4
GATATGAGACACTAAC-1_V12D07-332_A1,1,1,0,1,0,3
TTATGATCTTAACGAA-1_V12D07-332_A1,4,1,0,0,0,5
CGCCGCCCATGCCTGT-1_V12D07-332_A1,1,0,0,0,0,1
CTGGGATAAATAATGG-1_V12D07-332_A1,1,1,0,2,0,4
GTGCCCGTTCGGATTC-1_V12D07-332_A1,2,2,0,0,0,4
TTCAATACTCTGAATC-1_V12D07-332_A1,0,0,0,1,0,1
CGCACATGTCCACTAC-1_V12D07-332_A1,4,3,0,0,0,7
AGAAGAGCGCCGTTCC-1_V12D07-332_A1,2,0,0,0,0,2
GATAACTCGCACTGTG-1_V12D07-332_A1,3,1,0,0,0,4
AGTCGACGGTCTCAAG-1_V12D07-332_A1,2,2,0,0,0,4
GTGACCGCACACTACG-1_V12D07-332_A1,1,0,0,1,0,2
GTATGTGGGTCTAGTT-1_V12D07-332_A1,4,0,0,2,0,6
CTTGAGTTAGGGTAAT-1_V12D07-332_A1,1,0,0,1,0,2
TTAGCTGATTTGCCGT-1_V12D07-332_A1,2,0,0,0,0,2
GCTGTTGCTACCGAAC-1_V12D07-332_A1,2,1,0,0,0,3
TATTACCATCCTGCTT-1_V12D07-332_A1,1,1,0,1,0,3
TTGAATTCACGTGAGG-1_V12D07-332_A1,2,1,0,0,0,3
CCATCTCACCAGTGAA-1_V12D07-332_A1,1,2,0,1,0,4
CGCACGTGCGCTATCA-1_V12D07-332_A1,0,3,0,0,0,3
ACCCGGATGACGCATC-1_V12D07-332_A1,4,1,0,1,0,6
CGCTAGAGACCGCTGC-1_V12D07-332_A1,3,0,0,0,0,3
ATAGTTCCACCCACTC-1_V12D07-332_A1,0,4,0,0,0,4
GCAGACCCAGCACGTA-1_V12D07-332_A1,3,0,0,1,0,4
TAGACTACCTAGCGTT-1_V12D07-332_A1,1,0,0,1,0,2
GGTTCTACTCGTCTGA-1_V12D07-332_A1,1,0,0,0,0,1
GACTCACCCACGTGAG-1_V12D07-332_A1,0,0,0,0,0,0
AGCTCTTCGTAACCTT-1_V12D07-332_A1,5,1,0,0,0,6
ACTATCCAGGGCATGG-1_V12D07-332_A1,4,0,0,1,0,5
AAGGATCGATCGCTTG-1_V12D07-332_A1,1,2,0,1,0,4
ATATCGGTAGGGAGAT-1_V12D07-332_A1,2,3,0,0,0,5
TTCCAGACGAGATTTA-1_V12D07-332_A1,1,2,0,0,0,3
GACCGACGTGAAAGCA-1_V12D07-332_A1,2,1,0,1,0,4
CCTGGAAACGTTCTGC-1_V12D07-332_A1,3,3,0,0,0,6
CCGGTAATGGCTAGTC-1_V12D07-332_A1,5,1,0,0,0,6
GCCGTGGAAGAAATGT-1_V12D07-332_A1,5,1,0,0,0,6
GTCTTGAGGAGCAGTG-1_V12D07-332_A1,0,0,0,1,0,1
TCCCAAAGCCCTAAAT-1_V12D07-332_A1,1,0,0,2,0,3
TTGAGCGCCACGTGAT-1_V12D07-332_A1,6,2,0,0,0,8
TTGAGTCCCGCTGCTG-1_V12D07-332_A1,0,1,0,0,0,1
ATGGAACCTTTGCACA-1_V12D07-332_A1,1,1,0,0,0,2
GCTAGCACCTGGGCCA-1_V12D07-332_A1,2,1,0,0,0,3
CGCCGTCTACCCATCG-1_V12D07-332_A1,2,1,0,0,0,3
GATAGGTGTCCCGGGC-1_V12D07-332_A1,4,0,0,0,0,4
AGGTATGCGGACATTA-1_V12D07-332_A1,3,1,0,0,0,4
TTGGTTCGCTCAAAGG-1_V12D07-332_A1,5,0,0,1,0,6
TCTGGAGCGTAAGAGT-1_V12D07-332_A1,1,1,0,0,0,2
TGCCTAAATTTAATAG-1_V12D07-332_A1,2,1,0,0,0,3
TAATTTCCGTCCAGTA-1_V12D07-332_A1,0,2,0,0,0,2
TCCTTCAATCCCTACG-1_V12D07-332_A1,0,3,0,0,0,3
TACCTATCCCTAGAGG-1_V12D07-332_A1,1,0,0,0,0,1
GCATGGGTACTGACGC-1_V12D07-332_A1,2,2,0,0,0,4
GTCGGGAACATGGTAG-1_V12D07-332_A1,0,1,0,1,0,2
GCAAATGAGGACACTT-1_V12D07-332_A1,4,1,0,0,0,5
GAATGGGCTTATCGAC-1_V12D07-332_A1,2,0,0,0,0,2
TGGTCGTGCAAGGCAA-1_V12D07-332_A1,1,0,0,1,0,2
CACCACGCCACACAGA-1_V12D07-332_A1,0,0,0,2,0,2
GAACCTCGACCTACAC-1_V12D07-332_A1,2,1,0,0,0,3
CAATACGCTCTGAGGC-1_V12D07-332_A1,2,2,1,0,0,5
TGGTAAGCAGGATTGA-1_V12D07-332_A1,3,0,0,0,0,3
AGTGGCTCCGTCGGCC-1_V12D07-332_A1,1,0,0,1,0,2
GATCGGATAGAACCAT-1_V12D07-332_A1,4,1,0,3,0,8
GCTACAGTACGGACCG-1_V12D07-332_A1,0,1,0,1,0,2
TCTATTACTAGAGGAT-1_V12D07-332_A1,1,2,0,0,0,3
TTCAGGCGTCAAAGCC-1_V12D07-332_A1,2,0,1,2,0,5
AGACCGGGAAACCCTG-1_V12D07-332_A1,4,0,0,0,0,4
AGAGATCTCTAAAGCG-1_V12D07-332_A1,2,1,0,0,0,3
CCCTGCCCAATCCGCT-1_V12D07-332_A1,5,0,0,0,0,5
GTGGCGGTCCCAGCGT-1_V12D07-332_A1,1,1,0,1,0,3
GCATTGTAATTCATAT-1_V12D07-332_A1,4,0,0,0,0,4
CCGTTCCGAATCTCGG-1_V12D07-332_A1,0,1,0,2,0,3
AGCTTGATCTTAACTT-1_V12D07-332_A1,1,0,0,1,0,2
CCTGTACTCACGCCCA-1_V12D07-332_A1,3,0,0,0,0,3
AAGTGACGACCGAATT-1_V12D07-332_A1,4,1,0,2,0,7
CTCACTTGGCTGGTAA-1_V12D07-332_A1,1,1,0,0,0,2
CGCCTGGCCTACGTAA-1_V12D07-332_A1,4,1,0,0,0,5
CCCGTAAGTCTAGGCC-1_V12D07-332_A1,2,2,0,1,0,5
TTGGACATGTGGCTTA-1_V12D07-332_A1,6,0,0,1,0,7
ATTACGCGCTGGCAGG-1_V12D07-332_A1,1,2,0,0,0,3
ACGCGCTACACAGGGT-1_V12D07-332_A1,1,1,0,1,0,3
TACGTTTACCGGCAAT-1_V12D07-332_A1,2,1,0,1,0,4
CGAAACGCAATTCATG-1_V12D07-332_A1,2,1,0,0,0,3
TAGTCTAACAACGAGA-1_V12D07-332_A1,4,0,1,4,0,9
TTGCATGCTGATCACG-1_V12D07-332_A1,3,1,0,0,0,4
TCTGGGTAGCGCTCAT-1_V12D07-332_A1,0,0,0,0,0,0
ACATCGGTCAGCCGCG-1_V12D07-332_A1,0,1,0,2,0,3
AGATACCGGTGTTCAC-1_V12D07-332_A1,1,2,0,1,0,4
GATTACTGAATTTGGG-1_V12D07-332_A1,0,0,0,1,0,1
TCCAACTTTAAATTCT-1_V12D07-332_A1,3,1,0,0,0,4
TCCTAGCAAAGAAGCT-1_V12D07-332_A1,4,0,0,0,0,4
GTCTATCTGAGTTTCT-1_V12D07-332_A1,4,1,0,1,0,6
GATGTTCAATCCACGA-1_V12D07-332_A1,2,2,0,0,0,4
AGTTAAACACTTGCGA-1_V12D07-332_A1,2,0,0,1,0,3
AGCTCTTTACTCAGTT-1_V12D07-332_A1,1,1,0,0,0,2
ATCCAGGATTCGTGAA-1_V12D07-332_A1,2,0,0,1,0,3
AGTCAACACCACCATC-1_V12D07-332_A1,3,1,0,2,0,6
CGATACCTCGCGGACA-1_V12D07-332_A1,1,0,0,0,0,1
TACAACGCACAACTCA-1_V12D07-332_A1,3,0,0,1,0,4
AATTAAAGGTCGGCGT-1_V12D07-332_A1,3,1,0,0,0,4
TACGCAGTTCTTTCCT-1_V12D07-332_A1,1,2,0,0,0,3
GACCGTGCTGACGGTG-1_V12D07-332_A1,4,2,1,2,0,9
GGCAAATTACTTTACT-1_V12D07-332_A1,1,1,0,1,0,3
GGTACAAACATGCTAT-1_V12D07-332_A1,5,0,0,1,0,6
CGGGCCTTCTTTGTAA-1_V12D07-332_A1,0,0,0,0,0,0
CGTGAAGTTAATTCAC-1_V12D07-332_A1,4,1,0,2,0,7
ATAGTGAAGCGTTCTC-1_V12D07-332_A1,3,1,0,0,0,4
TACGCCATATTCTAAT-1_V12D07-332_A1,7,0,0,1,0,8
GCCGGGTTAGGGTCGC-1_V12D07-332_A1,5,1,0,1,0,7
TACATAGGCATACACC-1_V12D07-332_A1,4,2,0,0,0,6
GCCGATTGGCCAAGCT-1_V12D07-332_A1,0,0,0,1,0,1
CTGCCATGCATCACAT-1_V12D07-332_A1,0,6,0,0,0,6
TTATGAATGAAAGGGA-1_V12D07-332_A1,4,0,0,0,0,4
GCTGAGGCGTGAGTAT-1_V12D07-332_A1,3,0,0,1,0,4
GCGCCGTTCCACGATA-1_V12D07-332_A1,2,0,1,1,0,4
CGCATGGTGCGATGCT-1_V12D07-332_A1,6,2,0,0,0,8
AGGTTTCACACACCTT-1_V12D07-332_A1,0,1,0,1,0,2
CAAGGATCGCATGTTC-1_V12D07-332_A1,3,1,0,0,0,4
ACGTTAATGTCGAAGA-1_V12D07-332_A1,5,0,0,1,0,6
TCCAGAGCACCGGTTC-1_V12D07-332_A1,5,0,0,0,0,5
GATTCGACGGTTCACG-1_V12D07-332_A1,5,0,0,0,0,5
GTTTCTGCAGTCTCCC-1_V12D07-332_A1,5,1,0,0,0,6
GCTGCACGGTTTCTTA-1_V12D07-332_A1,3,0,0,1,0,4
CGTGCAGACTGGGACA-1_V12D07-332_A1,4,0,1,0,0,5
GTGTTACTATGCGTCC-1_V12D07-332_A1,2,2,0,0,0,4
TCCTCGGGCTGGGCTT-1_V12D07-332_A1,5,0,0,2,0,7
GTGAGGACACTTAAGG-1_V12D07-332_A1,1,0,1,0,0,2
ATACGCCGGCGAAACC-1_V12D07-332_A1,2,2,0,1,0,5
TCTGCCAGAAACTGCA-1_V12D07-332_A1,2,3,0,0,0,5
TTCTGCGGGTTAGCGG-1_V12D07-332_A1,2,1,0,1,0,4
CTCGGTACCACTGCTC-1_V12D07-332_A1,2,1,0,1,0,4
GTAAGTAACAGTCTGG-1_V12D07-332_A1,5,1,0,0,0,6
GTGCGTGTATATGAGC-1_V12D07-332_A1,4,0,0,1,0,5
ATTTGTCTTGGGAGCT-1_V12D07-332_A1,2,1,0,0,0,3
CCTCGGACCGGGATAG-1_V12D07-332_A1,0,1,0,0,0,1
TAGGTGCTCGCCTAGC-1_V12D07-332_A1,3,1,0,0,0,4
CTTTAGGAACACTGTT-1_V12D07-332_A1,6,0,0,0,0,6
TCGGGCCGTCGTGGTA-1_V12D07-332_A1,1,1,0,1,0,3
AGTGCTTGCACGAATA-1_V12D07-332_A1,0,0,0,0,0,0
TGCAGTTTCCTCCCAT-1_V12D07-332_A1,1,1,0,2,0,4
TGAGAGATTTACCACG-1_V12D07-332_A1,1,4,0,0,0,5
GAAACAGATGACCACC-1_V12D07-332_A1,5,1,0,1,0,7
AGCAACATATCTTATT-1_V12D07-332_A1,4,0,0,0,0,4
CAAGTGTGGTTGCAAA-1_V12D07-332_A1,3,0,0,0,0,3
GCCTCATCTGGAAATA-1_V12D07-332_A1,3,0,0,0,0,3
AACCCTACTGTCAATA-1_V12D07-332_A1,2,0,0,2,0,4
ACGTATTACTCCGATC-1_V12D07-332_A1,4,0,0,1,0,5
TCTGGGAACCTTTGAA-1_V12D07-332_A1,2,1,0,0,0,3
GCTCGCTCATGTCCAA-1_V12D07-332_A1,0,1,0,1,0,2
GCGCAAGAGCGCGCTG-1_V12D07-332_A1,3,0,0,0,0,3
TTGACGCTCCATGAGC-1_V12D07-332_A1,2,1,0,1,0,4
TATAGATGGTCGCAGT-1_V12D07-332_A1,4,0,0,0,0,4
TTACATGCCACAACTA-1_V12D07-332_A1,1,2,0,0,0,3
ACATGGCGCCAAAGTA-1_V12D07-332_A1,4,0,0,0,0,4
TATGGTTAGTGGGAGA-1_V12D07-332_A1,3,2,0,0,0,5
CATGACTTCGCTGAAT-1_V12D07-332_A1,2,0,0,0,0,2
ACCACCAATGTAACAA-1_V12D07-332_A1,6,0,0,1,0,7
TCTTAGAGCTCCAATT-1_V12D07-332_A1,1,2,0,1,0,4
CCACGAATTTAACCTC-1_V12D07-332_A1,4,0,0,1,0,5
TTCTTGCTAGCATCTC-1_V12D07-332_A1,1,0,0,1,0,2
ACACCTTACTACTTGC-1_V12D07-332_A1,1,3,0,0,0,4
AGTCGGTTGCGTGAGA-1_V12D07-332_A1,5,1,0,0,0,6
ACCTACAGTATGTGGT-1_V12D07-332_A1,1,2,0,0,0,3
GAGGATAAACAGTGCT-1_V12D07-332_A1,2,0,0,0,0,2
TTCCGGTATCTGTGTC-1_V12D07-332_A1,1,0,0,0,0,1
GGAGGCCGAAGTCGTC-1_V12D07-332_A1,4,1,0,0,0,5
TTCGCTAGGAAGTTGT-1_V12D07-332_A1,6,1,0,0,0,7
TAAAGACAACCCTTTA-1_V12D07-332_A1,6,0,0,0,0,6
GTTGCGCTAACATTAC-1_V12D07-332_A1,6,0,0,1,0,7
GCTGAACTCTCCAGGG-1_V12D07-332_A1,0,3,0,2,0,5
AGCCCTGTCGCACCGT-1_V12D07-332_A1,1,5,0,0,0,6
AGCGCTAGAGCGATGT-1_V12D07-332_A1,2,2,0,0,0,4
TGCGCCGTTAATAACG-1_V12D07-332_A1,3,3,0,0,0,6
TGACAACGCATGTCGC-1_V12D07-332_A1,2,1,0,2,0,5
CGTCTTGAGTGTGACG-1_V12D07-332_A1,3,1,0,0,0,4
GATAGGATTAATTACA-1_V12D07-332_A1,2,0,0,1,0,3
GATACCGTGTCGGAGT-1_V12D07-332_A1,0,0,0,0,0,0
TGTGTCGAAGTCGAGG-1_V12D07-332_A1,2,2,0,0,0,4
GGATCAGAGCCATCAG-1_V12D07-332_A1,1,1,1,0,0,3
GTCCCAATCATCCCGC-1_V12D07-332_A1,2,1,2,1,0,6
TGCCACACTAGAGGAA-1_V12D07-332_A1,1,1,0,0,0,2
TGAATTTCACTTGCCT-1_V12D07-332_A1,2,1,0,0,0,3
CTCAGATTGTGATAAG-1_V12D07-332_A1,1,0,0,0,0,1
CGGACGTTACTTGAAG-1_V12D07-332_A1,3,2,0,0,0,5
CCGCCTTGCGATGTCG-1_V12D07-332_A1,2,0,0,0,0,2
CCAGTCAAATCTCTTA-1_V12D07-332_A1,0,0,0,0,0,0
AAACAGCTTTCAGAAG-1_V12D07-332_A1,1,0,2,1,0,4
TAGCTGATGTGAAGCG-1_V12D07-332_A1,0,0,0,0,0,0
CTTATGCGCTCAGGGC-1_V12D07-332_A1,2,0,1,0,0,3
TGGCTCTTGTCGCGTA-1_V12D07-332_A1,2,0,1,0,0,3
TTGTGAGGCATGACGC-1_V12D07-332_A1,4,1,0,1,0,6
CATAAGCTCTCCGTCT-1_V12D07-332_A1,1,1,0,1,0,3
CCTTCTCAGCGTTCCT-1_V12D07-332_A1,3,0,1,0,0,4
TGCAGCTACGTACTTC-1_V12D07-332_A1,2,0,0,1,0,3
CTCTACACTGGCGATT-1_V12D07-332_A1,2,1,0,0,0,3
TGCAGATCGTCCTAGG-1_V12D07-332_A1,4,0,0,0,0,4
TGCCAAAGTCAGACTT-1_V12D07-332_A1,1,0,0,0,0,1
ACAATAGTCGTACGTT-1_V12D07-332_A1,3,0,0,0,0,3
CATGCCAACTCGCAAA-1_V12D07-332_A1,3,2,1,0,0,6
TGCAGAACTATATCGT-1_V12D07-332_A1,2,0,1,0,0,3
TCGTGTCACGCTGACA-1_V12D07-332_A1,3,2,0,1,0,6
TGATCAGGGAACTGCT-1_V12D07-332_A1,2,1,0,0,0,3
CTTGCAACCGCCTCCT-1_V12D07-332_A1,0,1,0,1,0,2
AGCCCATACATGTAAG-1_V12D07-332_A1,3,0,0,0,0,3
ATCCAATGGAGGGTCC-1_V12D07-332_A1,2,0,0,0,0,2
AAACCGGGTAGGTACC-1_V12D07-332_A1,1,3,0,1,0,5
GCAACCACGGCCGCGT-1_V12D07-332_A1,4,1,0,0,0,5
CGCTTATTCCCGGTCG-1_V12D07-332_A1,2,1,0,0,0,3
TTACTCTGGTACGTAC-1_V12D07-332_A1,1,0,0,2,0,3
GTGGTTTCCGCCTTTC-1_V12D07-332_A1,1,0,1,1,0,3
ATAGGCGGCTATAGAA-1_V12D07-332_A1,3,0,0,0,0,3
GTGCCATCACACGGTG-1_V12D07-332_A1,2,2,0,0,0,4
CCCAACATACGTCGCG-1_V12D07-332_A1,6,1,0,1,0,8
CGGTGCAGATAGAACG-1_V12D07-332_A1,0,1,0,0,0,1
GGGCGGGTTCCCTACG-1_V12D07-332_A1,6,1,0,0,0,7
TGAGCCATACAGTCTC-1_V12D07-332_A1,1,2,0,1,0,4
CTCCGCCCACATGAGG-1_V12D07-332_A1,3,1,0,0,0,4
GTTGAACCGGTTCCAT-1_V12D07-332_A1,1,2,0,0,0,3
TTGACTACCATATGGT-1_V12D07-332_A1,4,1,0,0,0,5
ACCATCGTATATGGTA-1_V12D07-332_A1,1,0,0,2,0,3
TGCGTAAGAACCTGAT-1_V12D07-332_A1,2,0,0,1,0,3
AGAAGGTTGCCGAATT-1_V12D07-332_A1,2,0,0,0,0,2
AGGACGACCCATTAGA-1_V12D07-332_A1,2,2,0,0,0,4
GGTGCTGGTACACATT-1_V12D07-332_A1,5,3,0,1,0,9
GCGCTATGCCGAGGCA-1_V12D07-332_A1,3,0,0,1,0,4
ACCCGGTTACACTTCC-1_V12D07-332_A1,1,0,0,1,0,2
TAACTCATCCGCGCGG-1_V12D07-332_A1,5,0,0,0,0,5
CACAATGAGCTGCTAT-1_V12D07-332_A1,5,1,0,0,0,6
GTTACTTTGGGCCTAG-1_V12D07-332_A1,0,0,0,4,0,4
GGGCCCGTCTTAAACA-1_V12D07-332_A1,2,0,0,1,0,3
GAAATTGTCTCTATAA-1_V12D07-332_A1,3,0,0,0,0,3
GGCGCATGAATTGATG-1_V12D07-332_A1,0,0,0,0,0,0
CATATAGGTACAGTCA-1_V12D07-332_A1,2,0,1,0,0,3
TCAACGAGGAGACAAA-1_V12D07-332_A1,2,2,0,0,0,4
TTGCACAATTCAGAAA-1_V12D07-332_A1,3,2,0,0,0,5
CATCGGACGGGTTAAT-1_V12D07-332_A1,4,0,0,1,0,5
ATTAAACATGCGGACC-1_V12D07-332_A1,1,3,0,0,0,4
TATCTACCACAGCGGG-1_V12D07-332_A1,0,0,0,0,0,0
CGAGACCCTAGAGTGT-1_V12D07-332_A1,0,0,8,1,0,9
ACATCGATCGTTTACC-1_V12D07-332_A1,0,0,1,8,0,9
ATCGACCCAATACAGA-1_V12D07-332_A1,7,0,0,1,0,8
GAATCTGAACATTCTC-1_V12D07-332_A1,4,1,0,0,0,5
AGTTCCTATTTATGTT-1_V12D07-332_A1,3,0,0,0,0,3
CAGTCTGTATACTGGG-1_V12D07-332_A1,1,0,0,0,0,1
GGAGACGACACCTTTG-1_V12D07-332_A1,4,0,0,2,0,6
CCTAAATTAACGGTTC-1_V12D07-332_A1,3,0,0,0,0,3
GCTACGACTTATTGGG-1_V12D07-332_A1,1,1,1,1,0,4
CTGTGCAGGGTAGGTC-1_V12D07-332_A1,0,0,0,1,0,1
ACGCCGCTAGACGACC-1_V12D07-332_A1,6,0,0,0,0,6
ACTTGACTCCCTCTTT-1_V12D07-332_A1,1,1,0,0,0,2
CGCCTCCCTCCTCTAT-1_V12D07-332_A1,2,1,0,0,0,3
CTAGATTTACGACGGC-1_V12D07-332_A1,6,0,0,0,0,6
GATGCTGTATTTCATC-1_V12D07-332_A1,0,2,0,0,0,2
TGCGTTTGTTGACACT-1_V12D07-332_A1,4,1,0,1,0,6
CGTGCCCTCCCGAAGA-1_V12D07-332_A1,2,0,0,1,0,3
ACTCTCTGACTTAGGT-1_V12D07-332_A1,7,1,0,0,0,8
CTGGGTAGGCAGTTAA-1_V12D07-332_A1,4,0,0,0,0,4
GTTTGGCCCAAGTTAT-1_V12D07-332_A1,3,0,0,1,0,4
GAATGTGGTCCGGATT-1_V12D07-332_A1,0,1,0,1,0,2
CCCAGTTAAGGCGCCG-1_V12D07-332_A1,4,1,0,1,0,6
CGGTACTAGAATCAAA-1_V12D07-332_A1,1,0,0,1,0,2
GCTTAATGTAACTAAC-1_V12D07-332_A1,3,0,0,1,0,4
AGGACAGTCGAATCCC-1_V12D07-332_A1,1,0,0,2,0,3
GACAGCCAGACCTGAC-1_V12D07-332_A1,1,0,0,1,0,2
GGCGAAATCTAACTTG-1_V12D07-332_A1,2,1,0,1,0,4
CTGGTAACACATAGAA-1_V12D07-332_A1,3,0,0,0,0,3
TAGCCATTTCAAAGTC-1_V12D07-332_A1,1,3,0,0,0,4
GGGATTTACCGCACCT-1_V12D07-332_A1,2,2,0,0,0,4
ATGCCATTTGCGACCA-1_V12D07-332_A1,3,1,0,0,0,4
GAATAGACGCGACCCA-1_V12D07-332_A1,1,0,0,0,0,1
TGTATGGCGCAGACAG-1_V12D07-332_A1,2,2,0,0,0,4
GGATGAAGATCGCTGA-1_V12D07-332_A1,0,1,0,0,0,1
CGACAATTTGATCTAA-1_V12D07-332_A1,2,0,0,1,0,3
AAAGTTGACTCCCGTA-1_V12D07-332_A1,5,0,0,2,0,7
CGCGGCTCAACTTGAA-1_V12D07-332_A1,3,0,0,0,0,3
CACGCGGAACTGTTGC-1_V12D07-332_A1,2,2,0,0,0,4
TCTTAGAGTGAACTCT-1_V12D07-332_A1,3,2,0,1,0,6
AGTCCATTGGCTGATG-1_V12D07-332_A1,5,2,0,0,0,7
TTAAGATAGGATTGAC-1_V12D07-332_A1,1,0,0,1,0,2
ACATCCTGGTAACTGT-1_V12D07-332_A1,3,1,0,1,0,5
CACCTTGGCGCCTTTG-1_V12D07-332_A1,3,0,0,0,0,3
GCTAGACCGTCTACTG-1_V12D07-332_A1,1,1,0,0,0,2
CGGCCCAGGTATATCC-1_V12D07-332_A1,0,2,0,0,0,2
GTCCATTACTGCTACG-1_V12D07-332_A1,2,4,0,0,0,6
GGGTTTAGGATAGGAT-1_V12D07-332_A1,0,2,0,1,0,3
TAATTAGGACATCCGT-1_V12D07-332_A1,2,2,0,0,0,4
GCTCCCAGTCGGTCCA-1_V12D07-332_A1,5,3,0,0,0,8
ATTCGTGCTATCTCTT-1_V12D07-332_A1,3,2,0,1,0,6
GTTAACTATGTTGTCA-1_V12D07-332_A1,3,1,0,1,0,5
GCTCCGCTCGCTTCAG-1_V12D07-332_A1,2,2,0,0,0,4
GCAACGGCTAGTTATG-1_V12D07-332_A1,5,1,0,1,0,7
AATCGCGCAGAGGACT-1_V12D07-332_A1,3,3,0,1,0,7
AGGTTACACCATGCCG-1_V12D07-332_A1,2,2,0,0,0,4
CGAGATTTCGCTCGGG-1_V12D07-332_A1,2,3,0,1,0,6
CGATAATACTCAGGTT-1_V12D07-332_A1,3,2,0,1,0,6
AAGGCAGGCTGTCTCC-1_V12D07-332_A1,1,0,0,0,0,1
GTAAGTCCACACTCTA-1_V12D07-332_A1,1,0,0,1,0,2
ATGAGGGCAGCGGCTA-1_V12D07-332_A1,3,1,0,0,0,4
GCCGCACTCCGTTTCA-1_V12D07-332_A1,3,0,0,0,0,3
GAGCACGGCGCCTCTT-1_V12D07-332_A1,2,1,0,1,0,4
ACAATTTGGCCATATT-1_V12D07-332_A1,0,0,0,0,0,0
CTGGTTCGCGAGCTAC-1_V12D07-332_A1,3,2,1,0,0,6
GACGGTCCTAGGGTGT-1_V12D07-332_A1,2,0,0,0,0,2
ACTCGCGATCTGACGC-1_V12D07-332_A1,0,1,0,0,0,1
GTGTACGAACCGTTCC-1_V12D07-332_A1,2,0,0,0,0,2
CTTTGACGTCGCTTCT-1_V12D07-332_A1,0,4,0,1,0,5
CGTTATCATACTTCCA-1_V12D07-332_A1,1,0,0,0,0,1
GCTATGCCAGCTTATG-1_V12D07-332_A1,4,0,0,1,0,5
CAGTCGGCCTAGATAT-1_V12D07-332_A1,2,1,2,1,0,6
CCCGTGAGGGCGGTGA-1_V12D07-332_A1,0,1,0,1,0,2
TCTCGTGTTACGAGGA-1_V12D07-332_A1,0,1,0,0,0,1
ACGTCTCGTTCCGGGA-1_V12D07-332_A1,3,1,0,0,0,4
CGAGAGCGCGTAGATA-1_V12D07-332_A1,1,0,1,2,0,4
GACAGATTTCTGGCTC-1_V12D07-332_A1,3,0,0,0,0,3
GGGCCTAAATGGGCTA-1_V12D07-332_A1,1,0,0,0,0,1
ACTTGTAGTCCCTTCA-1_V12D07-332_A1,1,2,1,0,0,4
CCCGAAGTTTCGCGAA-1_V12D07-332_A1,1,0,2,0,0,3
ACCATCCGCCAACTAG-1_V12D07-332_A1,2,0,0,2,0,4
TGCGAATATGGGATTT-1_V12D07-332_A1,1,2,0,0,0,3
TACATCCCTATCCCTG-1_V12D07-332_A1,1,0,0,1,0,2
GTGGGAAGACTGAATC-1_V12D07-332_A1,2,0,0,0,0,2
TCAACATCGACCGAGA-1_V12D07-332_A1,2,0,0,1,0,3
CTATGTGAGTCACGGC-1_V12D07-332_A1,0,0,0,0,0,0
CCGAACACTGGGCCTC-1_V12D07-332_A1,2,0,0,0,0,2
AAACTTGCAAACGTAT-1_V12D07-332_A1,1,2,0,0,0,3
AGGGCGAGCAGCTGAT-1_V12D07-332_A1,2,0,0,1,0,3
AACACGAGACGCGGCC-1_V12D07-332_A1,2,2,0,0,0,4
TGACGAATATTTCCCT-1_V12D07-332_A1,1,0,0,2,0,3
TCGGAGAGTATCGGGA-1_V12D07-332_A1,2,0,0,0,0,2
CAAATCTCTCACAAGG-1_V12D07-332_A1,3,0,0,0,0,3
AGGCCCTAGAACGCCA-1_V12D07-332_A1,4,0,0,1,0,5
TAGAGATCATGCAACT-1_V12D07-332_A1,3,0,0,0,0,3
TTGTTTCCATACAACT-1_V12D07-332_A1,1,2,0,0,0,3
GAGAGGTGCATTCTGG-1_V12D07-332_A1,1,3,0,0,0,4
GTGGACCAACCCGATT-1_V12D07-332_A1,1,0,0,1,0,2
CTGGGCCTGCTATATC-1_V12D07-332_A1,0,0,1,2,0,3
CATAGTCCACAAGAAC-1_V12D07-332_A1,3,0,0,0,0,3
TTGACATGAACGTGGA-1_V12D07-332_A1,2,3,0,0,0,5
GGTTACCACCCTCGGG-1_V12D07-332_A1,5,0,0,0,0,5
TACCGGTCGTTTCCAT-1_V12D07-332_A1,0,2,0,0,0,2
CGAGTACTAAAGAGGA-1_V12D07-332_A1,2,0,0,0,0,2
GCAAGAATTCCTTGGC-1_V12D07-332_A1,4,1,1,1,0,7
TCGCCGAAGTTGCGTC-1_V12D07-332_A1,7,0,0,1,0,8
TTGAGAGTACTGCTAA-1_V12D07-332_A1,1,1,0,0,0,2
GCCACAATTTAAGGAC-1_V12D07-332_A1,4,0,0,3,0,7
ATATTCAGTTAAACCT-1_V12D07-332_A1,4,0,0,1,0,5
TGAGTGCCTCTTAAAT-1_V12D07-332_A1,0,3,0,1,0,4
ATCAGACGGCACGCCG-1_V12D07-332_A1,3,0,1,1,0,5
GTGCGAAATCGAACAC-1_V12D07-332_A1,3,0,0,0,0,3
GTGCCGCTTCAAAGGT-1_V12D07-332_A1,1,0,1,2,0,4
GATACGATGGGAGTCA-1_V12D07-332_A1,1,1,0,1,0,3
GACACTGAGTTCAGTG-1_V12D07-332_A1,2,0,0,2,0,4
ATCCTGCGTGGAATGG-1_V12D07-332_A1,6,1,0,0,0,7
ATCCTACCTAAGCTCT-1_V12D07-332_A1,2,0,0,1,0,3
AGTGATATGAGTAGTT-1_V12D07-332_A1,2,1,0,1,0,4
ATGATGCAATGGTACA-1_V12D07-332_A1,1,0,0,0,0,1
GAAACCGAATTACCTT-1_V12D07-332_A1,1,2,0,0,0,3
AGTGACCTACTTTACG-1_V12D07-332_A1,2,0,0,2,0,4
CAAATGTCCTTCCGTG-1_V12D07-332_A1,0,1,0,1,0,2
TTACTGGGATATTTCA-1_V12D07-332_A1,1,0,0,1,0,2
CTTGCCCAGGCTCTAC-1_V12D07-332_A1,5,1,0,0,0,6
AAATCGTGTACCACAA-1_V12D07-332_A1,5,0,0,0,0,5
GTGATCATAGATCTGC-1_V12D07-332_A1,2,2,0,1,0,5
TGGCAGATTACGATCA-1_V12D07-332_A1,1,1,0,2,0,4
TCACCCTCTTAAGATT-1_V12D07-332_A1,2,0,0,1,0,3
CAGGATATATCGTTGT-1_V12D07-332_A1,1,1,1,0,0,3
CCTGACCACCGATGGT-1_V12D07-332_A1,2,0,0,3,0,5
CTAAAGGGAAATAGGA-1_V12D07-332_A1,1,0,0,0,0,1
CCGCTATCAGCACCAG-1_V12D07-332_A1,6,1,0,1,0,8
CTTTAGTGCTATTATT-1_V12D07-332_A1,3,0,0,2,0,5
CGGGAATTTATGTAAA-1_V12D07-332_A1,2,1,0,0,0,3
TACGACTGCCTCTTAG-1_V12D07-332_A1,1,1,0,2,0,4
AAACTGCTGGCTCCAA-1_V12D07-332_A1,5,0,0,2,0,7
GTACGTTTGCCCGTCA-1_V12D07-332_A1,2,0,0,2,0,4
GGCAAGGCGAAATAGC-1_V12D07-332_A1,3,1,1,0,0,5
GATCTTGGAGGGCATA-1_V12D07-332_A1,3,0,0,1,0,4
AGCGTGGTATTCTACT-1_V12D07-332_A1,2,1,1,0,0,4
CTAAGGGAATGATTGG-1_V12D07-332_A1,1,2,0,0,0,3
CATGGTAAGTAGCGTT-1_V12D07-332_A1,1,3,0,1,0,5
CGTTGAGCGACCGTCG-1_V12D07-332_A1,2,1,0,2,0,5
TGCCCGTACCGTTAAA-1_V12D07-332_A1,3,0,0,1,0,4
ACAAGGGCAGGCTCTG-1_V12D07-332_A1,1,0,0,0,0,1
GAGATCTTCCATGACA-1_V12D07-332_A1,2,0,0,1,0,3
AATGACGTAGGATGTC-1_V12D07-332_A1,3,0,0,1,0,4
GTGGTGGCCAAGTGAA-1_V12D07-332_A1,3,0,0,0,0,3
TCCCGTGTGCAATTTG-1_V12D07-332_A1,3,1,0,2,0,6
ACATCGTATGCAATGG-1_V12D07-332_A1,5,0,0,2,0,7
GCGAAACTTAACTGGA-1_V12D07-332_A1,1,0,0,1,0,2
AATTGAACGCTCTGGT-1_V12D07-332_A1,5,1,0,0,0,6
ACAAATGGTAGTGTTT-1_V12D07-332_A1,1,3,0,0,0,4
ATGGTCGCGTGGTTTC-1_V12D07-332_A1,2,2,0,2,0,6
TGTTATTGTATGTGGC-1_V12D07-332_A1,5,1,0,1,0,7
TTCCGGTTACCCACTT-1_V12D07-332_A1,2,1,0,1,0,4
GAGTGTGCGGTACCCA-1_V12D07-332_A1,6,2,0,3,0,11
CAAGATATTATAACGT-1_V12D07-332_A1,2,0,0,0,0,2
ACACACCAGGACCAGT-1_V12D07-332_A1,3,3,0,0,0,6
ATGGGCCTCGGCCTCT-1_V12D07-332_A1,0,1,0,0,0,1
AAGGTGATAAACCAGC-1_V12D07-332_A1,2,1,0,1,0,4
TCTTACTTATGCCTCT-1_V12D07-332_A1,3,0,0,1,0,4
AAAGTGTGATTTATCT-1_V12D07-332_A1,5,2,0,0,0,7
TGCTCCACAGTTCTTA-1_V12D07-332_A1,0,0,0,0,0,0
CTGGCTGATTCATCCT-1_V12D07-332_A1,2,1,0,0,0,3
TAAGGCTGAATCCCTC-1_V12D07-332_A1,7,0,0,0,0,7
TCTAGTGATATCGTGG-1_V12D07-332_A1,1,1,0,3,0,5
TCGAAGAACCGAGCAC-1_V12D07-332_A1,0,0,0,3,0,3
GACAAACATATGCAGG-1_V12D07-332_A1,3,0,0,0,0,3
AAGTCAATTGTCGTCA-1_V12D07-332_A1,4,0,0,1,0,5
AGTGAACAAACTTCTC-1_V12D07-332_A1,1,1,0,1,0,3
CATGATGGAAGTTAGC-1_V12D07-332_A1,1,2,0,1,0,4
AAGTGCCTTGACTGTA-1_V12D07-332_A1,1,0,0,1,0,2
ATCGCCAGTCAACATT-1_V12D07-332_A1,2,1,0,0,0,3
ACCGCGGTGGAAGTCG-1_V12D07-332_A1,1,1,1,0,0,3
TCTTCTATAACCCGCC-1_V12D07-332_A1,2,0,0,3,0,5
CACATTTCTTGTCAGA-1_V12D07-332_A1,0,1,0,2,0,3
TAGCGTCCCTCGATTG-1_V12D07-332_A1,6,2,0,0,0,8
GTTCGGATCGGGAACA-1_V12D07-332_A1,3,1,0,1,0,5
CAAACTCGCGACGCCG-1_V12D07-332_A1,4,0,0,0,0,4
GTCTTGTAGCTATTCA-1_V12D07-332_A1,4,2,0,0,0,6
TCTCGACGTATCGCCG-1_V12D07-332_A1,2,1,1,1,0,5
TTGCCAAGCAGAACCC-1_V12D07-332_A1,3,0,0,1,0,4
AAACCCGAACGAAATC-1_V12D07-332_A1,3,1,0,0,0,4
TTGAGCAGCCCACGGT-1_V12D07-332_A1,0,0,0,0,0,0
CGCCTTTAGCATGCTC-1_V12D07-332_A1,2,1,0,0,0,3
TGTGGCTCCCACCAAC-1_V12D07-332_A1,1,1,0,1,0,3
CCGCCGTTGAGGATAA-1_V12D07-332_A1,5,0,0,0,0,5
CAATACGAGAGTCTGA-1_V12D07-332_A1,0,1,0,0,0,1
CATCTAGTGAAGGGAA-1_V12D07-332_A1,0,1,0,0,0,1
GGTGGAGGTTGATACG-1_V12D07-332_A1,4,0,0,1,0,5
CCGCACACGAACGTGT-1_V12D07-332_A1,0,1,0,0,0,1
AGAACCCAGCGTGACA-1_V12D07-332_A1,0,0,0,1,0,1
GCGCTCGATCACCTGT-1_V12D07-332_A1,0,0,0,1,0,1
ATCATGGACTACCGAC-1_V12D07-332_A1,2,0,0,0,0,2
TACGCCGCCTCAGAAG-1_V12D07-332_A1,5,0,0,2,0,7
CGACCTACTAGACAAT-1_V12D07-332_A1,2,2,0,0,0,4
GAGTCTTGTAAAGGAC-1_V12D07-332_A1,2,0,0,1,0,3
AATATCCTAGCAAACT-1_V12D07-332_A1,1,0,0,1,0,2
CCCTAGGCAACAAGAG-1_V12D07-332_A1,0,0,1,1,0,2
ACAAAGAAGGTAGGCC-1_V12D07-332_A1,0,1,0,1,0,2
CCCTGGCTGTTCCTTC-1_V12D07-332_A1,1,1,0,0,0,2
TCGCCGCACCGCGTGA-1_V12D07-332_A1,1,0,0,0,0,1
TATAGCGCACGTTATC-1_V12D07-332_A1,1,0,0,2,0,3
TTATCTGACATTAGGA-1_V12D07-332_A1,3,2,1,1,0,7
AGTGGTGTTACCCGTG-1_V12D07-332_A1,0,0,1,0,0,1
GCCAAGAATACTTCTG-1_V12D07-332_A1,1,1,0,1,0,3
CCGGCGTGAGACTCTG-1_V12D07-332_A1,2,1,0,0,0,3
TTCCCGGCGCCAATAG-1_V12D07-332_A1,0,0,0,1,0,1
AAACAGGGTCTATATT-1_V12D07-332_A1,2,1,1,0,0,4
ACAGTAATACAACTTG-1_V12D07-332_A1,0,0,1,0,0,1
CGAACGGCCGGACAAC-1_V12D07-332_A1,0,0,0,0,0,0
GCAACACACTAGAACT-1_V12D07-332_A1,3,2,0,0,0,5
ACTCCCATTCCTAAAG-1_V12D07-332_A1,0,0,1,1,0,2
ACCTGCGTGTCATGTT-1_V12D07-332_A1,1,0,0,0,0,1
TACTTTCCGCACGCCA-1_V12D07-332_A1,0,0,0,2,0,2
AGGTCAGGTGAGAGTG-1_V12D07-332_A1,2,2,1,1,0,6
TCCTCCTAAGACATTC-1_V12D07-332_A1,3,3,0,0,0,6
ATGTGAAAGCCTAATG-1_V12D07-332_A1,0,0,0,0,0,0
AGTCGGCTCAACTTTA-1_V12D07-332_A1,0,1,0,1,0,2
CGATCTGTTGGAGGAC-1_V12D07-332_A1,2,1,1,0,0,4
ACGGGAGTGTCGGCCC-1_V12D07-332_A1,2,2,0,0,0,4
TTAACTTCAGGTAGGA-1_V12D07-332_A1,0,1,1,2,0,4
CCACGGAGCCATAAGA-1_V12D07-332_A1,1,0,1,1,0,3
CTTCTATGTTGAAGTA-1_V12D07-332_A1,1,1,0,0,0,2
CACCGTTGCGCGATAT-1_V12D07-332_A1,4,1,0,0,0,5
TCTAGCAATCTCCGCC-1_V12D07-332_A1,1,2,1,2,0,6
AGTTTGGCCAGACCTA-1_V12D07-332_A1,1,1,0,0,0,2
TTGTAAGGACCTAAGT-1_V12D07-332_A1,2,2,0,0,0,4
AAATTTGCGGGTGTGG-1_V12D07-332_A1,2,2,0,2,0,6
AAGTTCGGCCAACAGG-1_V12D07-332_A1,4,0,0,0,0,4
CCGCTTACCTCACTCT-1_V12D07-332_A1,3,2,0,0,0,5
ATCACGTGCTAATTAA-1_V12D07-332_A1,2,1,0,0,0,3
GGTGAAGTACAGGGAT-1_V12D07-332_A1,2,0,0,0,0,2
GCTGTATTACTGGCCC-1_V12D07-332_A1,5,0,0,0,0,5
AACGGCCATCTCCGGT-1_V12D07-332_A1,3,0,0,1,0,4
TAAGTAACATCTTGAC-1_V12D07-332_A1,3,1,0,0,0,4
TTCTTGAGCCGCGCTA-1_V12D07-332_A1,4,1,0,0,0,5
AGTGCGTAGCTCGTAA-1_V12D07-332_A1,2,3,0,0,0,5
GGGATGGTCGTAACCG-1_V12D07-332_A1,3,0,0,0,0,3
GTCTGGGCGGTCGAGA-1_V12D07-332_A1,1,1,0,0,0,2
CGGAACGTAAACATAG-1_V12D07-332_A1,1,1,0,2,0,4
TGCGACACCCTAGTGC-1_V12D07-332_A1,5,1,0,1,0,7
CAAACGAGTATCGCAG-1_V12D07-332_A1,3,0,0,1,0,4
TCAGTAGGGACTATAA-1_V12D07-332_A1,0,0,0,0,0,0
GCGGTTCCCTATCATG-1_V12D07-332_A1,4,1,0,0,0,5
GTGACTTCAGTAGTGC-1_V12D07-332_A1,3,0,0,0,0,3
CGTCACGTCCATTGGT-1_V12D07-332_A1,2,1,0,0,0,3
ATAAGTTACCGCGACG-1_V12D07-332_A1,2,0,0,0,0,2
CTGAATCCGAGACCTC-1_V12D07-332_A1,3,1,0,1,0,5
TACGACGCTTGCTGCG-1_V12D07-332_A1,2,0,0,2,0,4
GAATTCACCCGGGTGT-1_V12D07-332_A1,3,0,0,0,0,3
GGGTGACACCTTAACT-1_V12D07-332_A1,3,1,0,1,0,5
TGAGTAAATTAGCGTA-1_V12D07-332_A1,2,1,1,0,0,4
GAGTCCGCTTACCGGA-1_V12D07-332_A1,0,0,0,0,0,0
GGCGCGTTCGAGTTTA-1_V12D07-332_A1,1,2,0,1,0,4
ATTCATATACTGTCCA-1_V12D07-332_A1,1,0,0,1,0,2
ATAAACGGACCCGTAA-1_V12D07-332_A1,5,0,0,0,0,5
GTCGTACCATCTCGGG-1_V12D07-332_A1,5,0,0,2,0,7
ATAATAGCTGTTGAAT-1_V12D07-332_A1,0,0,0,3,0,3
TTCCGCGTGAGGCGAT-1_V12D07-332_A1,2,1,0,0,0,3
TACCGGCTCACTGCCC-1_V12D07-332_A1,1,0,0,1,0,2
GTATCTTTCATAACCA-1_V12D07-332_A1,1,1,0,0,0,2
GTTACCTACAACTTGC-1_V12D07-332_A1,5,0,0,0,0,5
TGACTATAATCCTTTC-1_V12D07-332_A1,3,1,0,1,0,5
AAATACCTATAAGCAT-1_V12D07-332_A1,1,1,0,2,0,4
TTATTAGAGCGTGTTC-1_V12D07-332_A1,2,0,0,1,0,3
ATGTGGACATCTTGAT-1_V12D07-332_A1,2,0,0,4,0,6
GTACGCTTCATTGCAC-1_V12D07-332_A1,0,0,0,3,0,3
CACATATTAGCAGGAT-1_V12D07-332_A1,1,1,2,1,0,5
CAAGAGGGCGGAGTAC-1_V12D07-332_A1,4,0,0,1,0,5
TCGCAAAGATGCATTT-1_V12D07-332_A1,2,1,0,0,0,3
GTCGTTATTCGCTTAT-1_V12D07-332_A1,4,0,0,0,0,4
TCGTGTACTATGGATG-1_V12D07-332_A1,3,0,0,1,0,4
GCGGAGAGGGAGAACG-1_V12D07-332_A1,2,1,0,3,0,6
TCACAGGGAATCGCAA-1_V12D07-332_A1,1,2,0,0,0,3
GACTGCACCAGCCCAG-1_V12D07-332_A1,4,1,0,2,0,7
TCCGCTGTCATCCCGG-1_V12D07-332_A1,4,1,0,0,0,5
AGATACTCAAGATCGA-1_V12D07-332_A1,2,0,0,2,0,4
ACTGAATGGCGAAAGT-1_V12D07-332_A1,1,1,1,1,0,4
TCCTACATCCACGGCC-1_V12D07-332_A1,2,0,0,0,0,2
TTCAGCCCTGGTCCAC-1_V12D07-332_A1,2,1,0,3,0,6
TTAGAGTTTAGAAGGA-1_V12D07-332_A1,2,2,0,1,0,5
GGTTAGCTATATGTCT-1_V12D07-332_A1,0,0,0,2,0,2
CTGGTTTCGAGCAAGA-1_V12D07-332_A1,3,0,0,5,0,8
TGGGCCCATACTAATT-1_V12D07-332_A1,0,0,0,1,0,1
ACTTATTTATGTGCCA-1_V12D07-332_A1,4,0,0,5,0,9
TTAGTTATTCGTGGCA-1_V12D07-332_A1,4,0,0,0,0,4
AACCGCTAAGGGATGC-1_V12D07-332_A1,4,0,0,0,0,4
ATACGTCCACTCCTGT-1_V12D07-332_A1,1,2,0,0,0,3
CGACACGCTCCGACAG-1_V12D07-332_A1,4,0,0,1,0,5
TCTGAACTCGTACCCG-1_V12D07-332_A1,4,0,0,1,0,5
AGGATATAGGGATTTA-1_V12D07-332_A1,3,0,0,0,0,3
GTGATCACTAACGCCT-1_V12D07-332_A1,2,0,0,1,0,3
ACCGGGCCTTTGTTGA-1_V12D07-332_A1,5,0,0,0,0,5
TTGACAGGAGCTCCCG-1_V12D07-332_A1,4,2,0,1,0,7
CTCTTCTATTGACTGG-1_V12D07-332_A1,2,1,0,0,0,3
CGTGGCCGAATATCTA-1_V12D07-332_A1,3,0,0,0,0,3
GGTTTAGCCTTTCTTG-1_V12D07-332_A1,3,0,0,0,0,3
TCAAGGTTACTACACC-1_V12D07-332_A1,3,0,0,0,0,3
TTGACTATTGTCCGGC-1_V12D07-332_A1,5,0,0,1,0,6
CGGGAATATAGTATAC-1_V12D07-332_A1,3,0,0,1,0,4
GCAACAGCAGTATGCG-1_V12D07-332_A1,1,1,0,2,0,4
ATCAAACACTGTTCCA-1_V12D07-332_A1,3,1,0,0,0,4
TGGGCAATAGTTGGGT-1_V12D07-332_A1,2,2,0,0,0,4
TGAATGTCAGCCGGCC-1_V12D07-332_A1,2,1,0,2,0,5
CGGCTCTAAAGCTGCA-1_V12D07-332_A1,2,1,0,1,0,4
GGACACAAGTTTACAC-1_V12D07-332_A1,4,0,0,1,0,5
CCGAGAAGTCGCATAA-1_V12D07-332_A1,1,3,0,1,0,5
AACTACCCGTTTGTCA-1_V12D07-332_A1,1,1,1,0,0,3
GCACAAACGAGGCGTG-1_V12D07-332_A1,1,1,0,0,0,2
CACACAGCTTGCGCTC-1_V12D07-332_A1,2,1,0,1,0,4
GTGCTTACATCAGCGC-1_V12D07-332_A1,1,1,0,0,0,2
GCAAACGTCGCCAGGT-1_V12D07-332_A1,4,0,0,0,0,4
GAATAGCATTTAGGGT-1_V12D07-332_A1,5,0,0,1,0,6
TACTGTTTCTCTGGTA-1_V12D07-332_A1,1,0,0,0,0,1
TCCTATCATAGGTAAC-1_V12D07-332_A1,3,0,0,0,0,3
TTCGGTGGAGACGCCC-1_V12D07-332_A1,3,0,0,0,0,3
TGTTGCCGTCGTCCCA-1_V12D07-332_A1,4,1,0,0,0,5
CCAACTTGATAGATCC-1_V12D07-332_A1,1,0,0,1,0,2
CAAAGGTCATCTGAAA-1_V12D07-332_A1,3,0,0,0,0,3
CTAGCTTAATGGTCCC-1_V12D07-332_A1,0,0,0,0,0,0
AGGCCACATTGGTTAC-1_V12D07-332_A1,1,0,0,2,0,3
TTAGGATGGGAGGGTA-1_V12D07-332_A1,0,0,0,0,0,0
TATGACCTTGCGCTGG-1_V12D07-332_A1,2,0,0,1,0,3
ATATACATGTATGGTA-1_V12D07-332_A1,0,0,0,0,0,0
TGTGTGACCATGAATC-1_V12D07-332_A1,1,0,1,0,0,2
CCCACTCCACGGTATC-1_V12D07-332_A1,0,1,0,1,0,2
GGGCAGACGTCACTGC-1_V12D07-332_A1,3,0,1,1,0,5
TCAAAGAGCTATCTGT-1_V12D07-332_A1,4,1,0,1,0,6
AGATGCATCCTGTGTC-1_V12D07-332_A1,3,1,1,0,0,5
GTGAAGTCACGACTCG-1_V12D07-332_A1,2,2,1,0,0,5
TGATTCAGGTCCCGCG-1_V12D07-332_A1,0,0,0,1,0,1
CGCCACAGGTCGCGAT-1_V12D07-332_A1,1,2,1,0,0,4
TTGAATCGTTGTATAA-1_V12D07-332_A1,0,0,0,0,0,0
TGGCCAATTTGGTACT-1_V12D07-332_A1,0,2,3,0,0,5
CGACCCTTAACGCCGG-1_V12D07-332_A1,0,1,1,0,0,2
TCGGCGTACTGCACAA-1_V12D07-332_A1,1,0,0,0,0,1
GAGTAAGGCCACGGGA-1_V12D07-332_A1,1,1,1,1,0,4
ATCAGCTCGTCCACTA-1_V12D07-332_A1,5,3,0,1,0,9
AGGATCACGCGATCTG-1_V12D07-332_A1,1,0,0,0,0,1
AAATGGCCCGTGCCCT-1_V12D07-332_A1,1,1,0,1,0,3
CAGTACCAGTTTACGT-1_V12D07-332_A1,0,2,1,0,0,3
GGTCGTAAGCTCGCAC-1_V12D07-332_A1,1,0,0,0,0,1
CGTTCATGGTGCGCGT-1_V12D07-332_A1,0,1,1,1,0,3
GACTACAAAGCGGTGG-1_V12D07-332_A1,1,0,0,0,0,1
CAGCTGGCGTAACCGT-1_V12D07-332_A1,1,0,0,1,0,2
ACTCGTAACCCGTCCT-1_V12D07-332_A1,3,1,0,1,0,5
CATATGTCAGGCTACG-1_V12D07-332_A1,0,2,0,1,0,3
GCCCGACTTCTTCCCG-1_V12D07-332_A1,3,0,0,2,0,5
CTGGCATCCGAATGAG-1_V12D07-332_A1,0,2,0,1,0,3
AAGTGCGTTAGAATCT-1_V12D07-332_A1,1,0,0,1,0,2
AGAAGTGATTCGTGAT-1_V12D07-332_A1,2,0,1,1,0,4
TACCTTAAGATTTCCC-1_V12D07-332_A1,2,0,0,0,0,2
AATGACAGCAATGTCT-1_V12D07-332_A1,3,0,0,0,0,3
TCAACGCAGGAAATAA-1_V12D07-332_A1,2,0,0,1,0,3
TATTCCTCCGCCCACT-1_V12D07-332_A1,0,0,0,1,0,1
ATCAAACGAAGGTTTG-1_V12D07-332_A1,3,0,0,0,0,3
TTGATTAGCTGTTTCT-1_V12D07-332_A1,3,0,0,0,0,3
CTGCTGAGGCCACGAA-1_V12D07-332_A1,2,0,0,1,0,3
CCGTGTTAAATTCCAT-1_V12D07-332_A1,3,0,0,0,0,3
CACGTCGGCAACCTCT-1_V12D07-332_A1,1,1,0,0,0,2
GTATTCTGAGAAACGA-1_V12D07-332_A1,2,0,0,0,0,2
CGGTGCGCGTTGGTCC-1_V12D07-332_A1,3,0,0,1,0,4
GTGATTCGCCGCTCAA-1_V12D07-332_A1,2,0,0,0,0,2
GCCCGCGCGTAAACGG-1_V12D07-332_A1,1,1,0,0,0,2
AACGTACTGTGGGTAC-1_V12D07-332_A1,3,2,0,1,0,6
GAGTATGCCCGCCTTG-1_V12D07-332_A1,7,0,0,2,0,9
TGATTCTGTCGCCGGT-1_V12D07-332_A1,3,0,0,0,0,3
GGGCGGCAAATGAATT-1_V12D07-332_A1,1,2,0,1,0,4
TTCCAATCTGGCTATC-1_V12D07-332_A1,5,0,0,0,0,5
GGAACCGTGTAAATTG-1_V12D07-332_A1,4,0,0,1,0,5
TTGGTCACACTCGTAA-1_V12D07-332_A1,1,0,0,1,0,2
CGAACCCGCATGCGTC-1_V12D07-332_A1,3,0,0,0,0,3
GGGCGTCACCACGTAA-1_V12D07-332_A1,1,0,0,3,0,4
TACCAGAAGTAGGTTC-1_V12D07-332_A1,3,1,0,0,0,4
TTGGATATCGTCTACG-1_V12D07-332_A1,0,1,1,0,0,2
TAGATATGGACTGGAA-1_V12D07-332_A1,0,2,0,1,0,3
GCGACGATAGTTGTAC-1_V12D07-332_A1,4,0,1,0,0,5
CTGGATTTACACTTGA-1_V12D07-332_A1,1,4,0,1,0,6
GTTATATTATCTCCCT-1_V12D07-332_A1,0,1,0,1,0,2
TATTCCACTCAGCTCG-1_V12D07-332_A1,5,0,1,1,0,7
CTGTTACCCAATCTAG-1_V12D07-332_A1,2,2,0,1,0,5
ACGCGAAGTCAGACGA-1_V12D07-332_A1,3,1,0,0,0,4
GATAGGTAACGTTGAC-1_V12D07-332_A1,6,0,0,1,0,7
TGTTCGTATTGCGGTG-1_V12D07-332_A1,3,0,0,1,0,4
GGTCAGTGGGTCCCAC-1_V12D07-332_A1,0,3,0,0,0,3
AATTCTAGAGTTAGGC-1_V12D07-332_A1,1,2,0,0,0,3
GTTTACGTTCCATCTG-1_V12D07-332_A1,1,0,1,3,0,5
AGACCCACCGCTGATC-1_V12D07-332_A1,2,1,0,1,0,4
TCTAGCATGCCCAGAA-1_V12D07-332_A1,2,0,0,2,0,4
CCCGCAGCGCGAACTA-1_V12D07-332_A1,2,0,0,1,0,3
CTCTATTTGGCTGCAG-1_V12D07-332_A1,0,2,0,1,0,3
TTCTGCCGCGCCTAGA-1_V12D07-332_A1,6,0,0,1,0,7
ACTCCCTAGAATAGTA-1_V12D07-332_A1,0,1,0,0,0,1
CCGAACCTTCCCGGCC-1_V12D07-332_A1,2,1,0,0,0,3
TCAGACGCTATAGAAG-1_V12D07-332_A1,1,0,0,1,0,2
CAGGCGCCATGCTAGG-1_V12D07-332_A1,1,1,0,0,0,2
CACTCGAGCTGAACAA-1_V12D07-332_A1,1,0,0,0,0,1
ACAAGGAAATCCGCCC-1_V12D07-332_A1,5,0,1,2,0,8
ACCACGTGCAGCTATA-1_V12D07-332_A1,4,0,0,0,0,4
ACGGCGACGATGGGAA-1_V12D07-332_A1,3,0,1,0,0,4
TTACTAAAGGACTTTA-1_V12D07-332_A1,4,0,0,0,0,4
GGCTGAAATAGCAAAG-1_V12D07-332_A1,2,0,0,0,0,2
TTAGACGAGTCACCTC-1_V12D07-332_A1,1,0,0,0,0,1
GTAGTCGCGGGAATCA-1_V12D07-332_A1,3,1,0,1,0,5
GCAAACCCTACATTAT-1_V12D07-332_A1,0,2,0,0,0,2
GTTAAAGTAGGACTGG-1_V12D07-332_A1,4,0,0,2,0,6
ACCCTCCCTTGCTATT-1_V12D07-332_A1,6,1,0,0,0,7
CATGTCTCATTTATGG-1_V12D07-332_A1,5,0,0,4,0,9
AATAGAATCTGTTTCA-1_V12D07-332_A1,4,2,0,0,0,6
TCTCATGAGATAGGGT-1_V12D07-332_A1,2,0,0,0,0,2
ATGACTATGCGACATT-1_V12D07-332_A1,4,0,0,0,0,4
CCTAACCCAAACAAGT-1_V12D07-332_A1,6,2,0,0,0,8
AGTCAAGATGACACTT-1_V12D07-332_A1,0,2,0,0,0,2
CGGGAGCTTCAGTGTA-1_V12D07-332_A1,6,1,0,1,0,8
CCACAGTACCCATCCT-1_V12D07-332_A1,6,1,0,3,0,10
GAGCGCGCACGAGTAG-1_V12D07-332_A1,1,0,0,0,0,1
ACCAGTGCGGGAGACG-1_V12D07-332_A1,1,0,0,5,0,6
TCCTTACGACGGTCCG-1_V12D07-332_A1,5,0,0,1,0,6
TAGTCGATCACGGGTT-1_V12D07-332_A1,1,1,1,0,0,3
AGACGAAGTGCCGGTC-1_V12D07-332_A1,1,0,0,1,0,2
CGCTGGTGACTACCCT-1_V12D07-332_A1,2,1,0,0,0,3
AGGCATTGTCGTAGGG-1_V12D07-332_A1,0,1,0,1,0,2
TGGTAGAATATATGGG-1_V12D07-332_A1,3,1,0,1,0,5
TTCTTATCCGCTGGGT-1_V12D07-332_A1,4,3,0,1,0,8
AGTTTGGCACGGGTTG-1_V12D07-332_A1,2,0,0,0,0,2
GCATCGGCCGTGTAGG-1_V12D07-332_A1,4,0,0,0,0,4
ATGCGAGTCCCACCAC-1_V12D07-332_A1,4,2,0,0,0,6
TCGGCGAACCCAAACC-1_V12D07-332_A1,0,0,0,1,0,1
AGAGTAAACTTCACTA-1_V12D07-332_A1,2,1,0,1,0,4
AAGCCGAAGCGGTTTA-1_V12D07-332_A1,1,2,1,0,0,4
CCCGAGTTTCTCCGTA-1_V12D07-332_A1,0,3,0,0,0,3
AATATCGAATCAATGC-1_V12D07-332_A1,2,0,0,1,0,3
GCGCCTCCCACTCCGA-1_V12D07-332_A1,2,1,0,0,0,3
CGTTAAACTAGTTAGG-1_V12D07-332_A1,3,0,0,1,0,4
TGAGTTAAAGACATTC-1_V12D07-332_A1,1,1,0,1,0,3
AACAGGTAGTATGGAT-1_V12D07-332_A1,4,0,0,0,0,4
GAACGCGGGTCACACG-1_V12D07-332_A1,3,0,0,0,0,3
TGTTTGAGATCGTCAG-1_V12D07-332_A1,6,2,0,0,0,8
ATCTCGTGAGCGAAAC-1_V12D07-332_A1,2,1,0,0,0,3
CTGAGAAAGTTCGGCG-1_V12D07-332_A1,2,0,0,2,0,4
ATTACCACACTGCCTG-1_V12D07-332_A1,1,3,1,0,0,5
CTGCTGTCTAACGAGC-1_V12D07-332_A1,1,0,0,0,0,1
CGTGGAAGCCTCGTAC-1_V12D07-332_A1,3,0,0,1,0,4
GGACTCACAAATTAGG-1_V12D07-332_A1,4,3,0,1,0,8
CTTTGCTGTCATGGAT-1_V12D07-332_A1,5,0,0,0,0,5
GGTGTTGGGCGTCTTA-1_V12D07-332_A1,4,0,0,0,0,4
TACCATGTATTGATTT-1_V12D07-332_A1,2,3,0,0,0,5
GGTCTCCAAGTAGTGC-1_V12D07-332_A1,2,2,0,0,0,4
ATCCTTCTGAAAGAAC-1_V12D07-332_A1,6,0,0,1,0,7
CCGGAAGTTATCAGTC-1_V12D07-332_A1,3,0,0,1,0,4
TTAGAGGGATATACAG-1_V12D07-332_A1,0,2,0,1,0,3
TTGTACACCTCGAACA-1_V12D07-332_A1,1,1,1,2,0,5
GTGGGTACTGAGCGTA-1_V12D07-332_A1,1,5,0,1,0,7
CTTAAGCAGCGAGCCG-1_V12D07-332_A1,0,0,1,1,0,2
GCATTGACTTGCGGAA-1_V12D07-332_A1,1,1,0,0,0,2
CCATAACCTGTGCAGT-1_V12D07-332_A1,2,0,1,0,0,3
GGGCTACTATTTCGTG-1_V12D07-332_A1,1,0,4,1,0,6
GGCGAGCGAAACGGCA-1_V12D07-332_A1,0,2,1,0,0,3
GGAGACCATCTACATA-1_V12D07-332_A1,2,0,2,1,0,5
AGACCAAACCACACCT-1_V12D07-332_A1,2,2,1,1,0,6
CGACGCATCCGTACCT-1_V12D07-332_A1,0,0,0,0,0,0
CCTAGGTAAAGGTAGC-1_V12D07-332_A1,0,1,1,0,0,2
AGCGGCGGTTAGCGGT-1_V12D07-332_A1,5,0,2,0,0,7
CTGGACGCAGTCCGGC-1_V12D07-332_A1,1,3,0,0,0,4
AGCCTAATACCCACGT-1_V12D07-332_A1,1,1,1,1,0,4
AATCTGGCTTTCTAGT-1_V12D07-332_A1,0,0,2,0,0,2
CACCCTTGGTGAGACC-1_V12D07-332_A1,1,0,2,0,0,3
GGATCTTGACTCAACC-1_V12D07-332_A1,2,0,1,0,0,3
ACGAGGATACCACTCT-1_V12D07-332_A1,1,2,1,1,0,5
GAGTTGATGGCAATTT-1_V12D07-332_A1,1,2,1,0,0,4
GTGGCAAACAGCGGCA-1_V12D07-332_A1,0,0,1,0,0,1
GATGTAACGAACCACC-1_V12D07-332_A1,2,0,0,0,0,2
AGCCGTGGCTAAATGT-1_V12D07-332_A1,2,4,1,0,0,7
CTCCCTCCTTTCGATC-1_V12D07-332_A1,2,0,0,0,0,2
TTGGAAGAATACAGTC-1_V12D07-332_A1,1,0,0,0,0,1
AGTTAAGTCAACCGCT-1_V12D07-332_A1,0,0,0,0,0,0
CTCATGGTAATTTGCG-1_V12D07-332_A1,1,1,0,0,0,2
AAAGTAGCATTGCTCA-1_V12D07-332_A1,2,0,0,0,0,2
TTGTGGTAGGAGGGAT-1_V12D07-332_A1,0,0,0,2,0,2
AGTCGTGGGCATTACG-1_V12D07-332_A1,0,3,1,0,0,4
ACCTAAGTACCTTTCA-1_V12D07-332_A1,0,2,0,0,0,2
GTAGAGGGAGACAAGT-1_V12D07-332_A1,2,0,1,1,0,4
GATCCTCGACACTGGC-1_V12D07-332_A1,1,0,0,0,0,1
CCTACATTCACAGACG-1_V12D07-332_A1,0,0,0,0,0,0
TTGACCGTGTTAATGA-1_V12D07-332_A1,2,2,0,0,0,4
TCTGTTACCCAGCATA-1_V12D07-332_A1,1,0,0,0,0,1
CTAACTGGTCCGGTTC-1_V12D07-332_A1,2,3,2,0,0,7
AGCGACAGGAACGGTC-1_V12D07-332_A1,2,0,1,1,0,4
TAATAGAACAGAGTTA-1_V12D07-332_A1,1,1,0,0,0,2
ACAGGTGGAGGTGAGG-1_V12D07-332_A1,3,0,0,0,0,3
TGCGAGAATATTACCC-1_V12D07-332_A1,1,0,0,1,0,2
TTGCGTCGGCCAACCG-1_V12D07-332_A1,3,1,1,0,0,5
AGGCTTCCCGAAGAAG-1_V12D07-332_A1,1,1,0,1,0,3
GCGGACCGCGTTGTGG-1_V12D07-332_A1,1,0,0,0,0,1
GTAATCTGATTCTTCG-1_V12D07-332_A1,3,0,0,1,0,4
CCGCGGAATGCGTCAC-1_V12D07-332_A1,4,1,0,0,0,5
TTCCACACAGATTTGA-1_V12D07-332_A1,1,0,0,0,0,1
CTTCTATTAATGCTAG-1_V12D07-332_A1,3,2,0,0,0,5
CATTTGAGTGGTACGT-1_V12D07-332_A1,4,1,0,0,0,5
TCACAGCAAACTCGAA-1_V12D07-332_A1,2,1,0,1,0,4
CAGACGAACCTGATAC-1_V12D07-332_A1,4,3,0,1,0,8
TAGCTAGAAGGCATGA-1_V12D07-332_A1,5,0,0,1,0,6
ATCCAGAGCAACAACC-1_V12D07-332_A1,3,1,0,1,0,5
TCCGGTTCGTCCGGTC-1_V12D07-332_A1,1,0,0,0,0,1
CGCGCATGTTTGATTG-1_V12D07-332_A1,3,0,1,0,0,4
TGGCGATCAAGTTATG-1_V12D07-332_A1,2,0,0,1,0,3
CCCTTTGACAGGTCTT-1_V12D07-332_A1,2,2,0,2,0,6
CAGAGACGGTCACCCA-1_V12D07-332_A1,5,0,0,1,0,6
TAGCTCGCCTGATAAC-1_V12D07-332_A1,2,0,0,1,0,3
TTGTGTTTCCCGAAAG-1_V12D07-332_A1,2,1,0,0,0,3
TATACACAGACGCCTT-1_V12D07-332_A1,3,2,0,0,0,5
ACATTAGTTTATATCC-1_V12D07-332_A1,1,0,0,0,0,1
CCATCGCAGTTAAACT-1_V12D07-332_A1,2,1,1,0,0,4
AATTAGCGCTGCAGCG-1_V12D07-332_A1,3,1,0,0,0,4
TCCGCTTATCCCATTA-1_V12D07-332_A1,2,0,0,0,0,2
GTTTGGGCTTGTGAGC-1_V12D07-332_A1,2,1,0,1,0,4
CTTGTCAACATTCGAG-1_V12D07-332_A1,3,1,0,2,0,6
GGACCAACAGGATAAC-1_V12D07-332_A1,5,0,0,2,0,7
AAGCTAGATCGAGTAA-1_V12D07-332_A1,6,1,0,1,0,8
TACCGTGCCTCGGACC-1_V12D07-332_A1,4,1,0,1,0,6
GTAGCCAAACATGGGA-1_V12D07-332_A1,5,0,0,1,0,6
TGCCAGTACGTGGAGA-1_V12D07-332_A1,0,0,0,0,0,0
ATAAGGTGGAGAACAT-1_V12D07-332_A1,6,1,0,0,0,7
CTTTAATATTGGTCGA-1_V12D07-332_A1,4,0,0,1,0,5
TGGTTCAACGGGTAAT-1_V12D07-332_A1,2,0,0,1,0,3
GCTGCTACTGCGTAGC-1_V12D07-332_A1,4,0,0,2,0,6
CTGCACAACTACATAT-1_V12D07-332_A1,3,0,0,0,0,3
ATATTCCACATAGTGA-1_V12D07-332_A1,6,0,0,0,0,6
TGGCAAACTAAATTAC-1_V12D07-332_A1,0,1,0,0,0,1
ACCGCAATAACTGCCT-1_V12D07-332_A1,2,1,0,2,0,5
TCGCACCAGGAGGCAG-1_V12D07-332_A1,2,0,1,2,0,5
ACTTCAGGCTGATCCC-1_V12D07-332_A1,4,1,1,1,0,7
ACAAATCGCACCGAAT-1_V12D07-332_A1,1,0,1,1,0,3
TCTGATGTATTCTGTC-1_V12D07-332_A1,1,1,0,0,0,2
CTTTACCGAATAGTAG-1_V12D07-332_A1,6,0,0,1,0,7
GCAGATCCATAAGACT-1_V12D07-332_A1,5,2,0,1,0,8
TTCCTCGGACTAACCA-1_V12D07-332_A1,4,1,0,1,0,6
TTATCCGGGATCTATA-1_V12D07-332_A1,0,0,0,0,0,0
CTGGAAGACACGGTGG-1_V12D07-332_A1,1,2,1,0,0,4
GTTCGTCTAAAGAACT-1_V12D07-332_A1,4,1,0,1,0,6
GTCTATTGGTTCCGGT-1_V12D07-332_A1,4,1,1,0,0,6
CTAGGCGCCCTATCAG-1_V12D07-332_A1,4,0,0,0,0,4
AACGGACGTACGTATA-1_V12D07-332_A1,3,0,0,2,0,5
AACACACGCTCGCCGC-1_V12D07-332_A1,2,0,0,1,0,3
GCTACTATAGTAGAGT-1_V12D07-332_A1,3,0,0,1,0,4
AGCATATCAATATGCT-1_V12D07-332_A1,3,2,0,0,0,5
CGAACAGTATGGGCGT-1_V12D07-332_A1,3,0,0,1,0,4
ACAATTGTGTCTCTTT-1_V12D07-332_A1,2,0,0,1,0,3
GATCGCTACCCGATTT-1_V12D07-332_A1,3,1,0,2,0,6
ATTGCGATCAGTAACT-1_V12D07-332_A1,2,0,1,3,0,6
CAGCAGTCCAGACTAT-1_V12D07-332_A1,2,1,0,1,0,4
AGAGGCTTCGGAAACC-1_V12D07-332_A1,3,0,0,1,0,4
AAACAAGTATCTCCCA-1_V12D07-332_A1,2,1,0,1,0,4
GGCAGCAAACCTATGC-1_V12D07-332_A1,3,0,0,1,0,4
ACTAGTTGCGATCGTC-1_V12D07-332_A1,6,0,0,1,0,7
TTGGACCATCTGGCAA-1_V12D07-332_A1,2,0,0,0,0,2
CCCTCCTCGCTCGTAT-1_V12D07-332_A1,3,0,0,0,0,3
GAGCGCAAATACTCCG-1_V12D07-332_A1,1,0,0,0,0,1
ATTACATGTCAGTCTT-1_V12D07-332_A1,2,2,0,0,0,4
TTGGGACGTAAGAGTT-1_V12D07-332_A1,3,0,0,0,0,3
CTTCGGCCAATTGTTT-1_V12D07-332_A1,4,1,0,0,0,5
AGACCGCTCCGCGGTT-1_V12D07-332_A1,2,0,0,0,0,2
GACCGCGTCTGACGTG-1_V12D07-332_A1,0,0,0,0,0,0
CCAAATAACAAGATTC-1_V12D07-332_A1,3,0,0,0,0,3
TCTTTAGAGTCTAACA-1_V12D07-332_A1,1,1,1,0,0,3
CTCCCAATGAGTCGCG-1_V12D07-332_A1,2,0,0,1,0,3
TAGTCTTTCCGAATTG-1_V12D07-332_A1,4,4,0,0,0,8
GAGTAAACCGGAAAGT-1_V12D07-332_A1,3,0,0,0,0,3
GATCTCGACGCTGTGG-1_V12D07-332_A1,0,1,0,0,0,1
CTGACATAGAAATAGA-1_V12D07-332_A1,1,0,0,0,0,1
TATACCGAGTGCCACA-1_V12D07-332_A1,2,0,1,0,0,3
TCCGAACGTTGCCGCT-1_V12D07-332_A1,3,0,0,0,0,3
GCAGAAGGTAATCTCC-1_V12D07-332_A1,0,1,0,2,0,3
GGTACTAAGTGCTTTG-1_V12D07-332_A1,1,1,1,2,0,5
CAGAATATTCGTTATC-1_V12D07-332_A1,1,3,0,0,0,4
TAATCAACCAAATGGG-1_V12D07-332_A1,1,0,0,0,0,1
TCTGCTTAGAACAAGC-1_V12D07-332_A1,0,0,0,0,0,0
AACTGAGTTATACTGA-1_V12D07-332_A1,0,1,0,0,0,1
CCTCAACGATCGCTGT-1_V12D07-332_A1,2,0,1,1,0,4
CGGTACGGCAAACCCA-1_V12D07-332_A1,0,1,0,1,0,2
CAGATGTTTGTCCCAA-1_V12D07-332_A1,1,0,0,1,0,2
GTTTGTTAGCCAAGTA-1_V12D07-332_A1,0,1,0,0,0,1
ACGTGACAAAGTAAGT-1_V12D07-332_A1,1,0,0,0,0,1
TTGTCACCGCGGTATC-1_V12D07-332_A1,2,0,0,0,0,2
GATCTAACCGTATTCA-1_V12D07-332_A1,0,1,1,0,0,2
ATGGAAATTTAAGGAG-1_V12D07-332_A1,0,0,0,1,0,1
ATTGATCACCACATTT-1_V12D07-332_A1,1,1,1,1,0,4
ACTGCTCGGAAGGATG-1_V12D07-332_A1,0,0,0,0,0,0
TCTAAAGAACAGTCTC-1_V12D07-332_A1,2,0,0,0,0,2
CTGGGTTGAGTTAAAG-1_V12D07-332_A1,3,1,0,0,0,4
CCCAGTAAACTTGGGA-1_V12D07-332_A1,2,2,0,0,0,4
AGATTCACAACCGATA-1_V12D07-332_A1,1,0,0,1,0,2
AGAAGGTACACTTCAC-1_V12D07-332_A1,3,1,1,0,0,5
GCAGGAACTTAGATCT-1_V12D07-332_A1,3,1,0,0,0,4
AATCTAGGTTTACTTG-1_V12D07-332_A1,1,0,0,0,0,1
CCCGGTGTATCGGAAT-1_V12D07-332_A1,0,0,1,0,0,1
TTATCCTCAAGGAATA-1_V12D07-332_A1,1,1,1,1,0,4
AGCATCATTTCGAAAG-1_V12D07-332_A1,2,1,0,0,0,3
CGCGAGTCTGCCGGGT-1_V12D07-332_A1,2,1,1,2,0,6
TGCGTCATGACTGAGC-1_V12D07-332_A1,5,1,1,0,0,7
GTATGAAATTTCACTC-1_V12D07-332_A1,2,0,0,0,0,2
TTGGTTGCGGTGCGCG-1_V12D07-332_A1,2,0,0,3,0,5
ACAGAACTGAGAACAA-1_V12D07-332_A1,0,0,0,0,1,1
CTACTATCATAGGTTT-1_V12D07-332_A1,0,2,0,0,0,2
CCTCTATCGATTAGCA-1_V12D07-332_A1,1,1,0,0,0,2
CCGTATCTCGTCGTAG-1_V12D07-332_A1,1,0,1,1,0,3
TCACGATGTCCGTGGA-1_V12D07-332_A1,0,1,0,0,0,1
TCAACAAAGATAATTC-1_V12D07-332_A1,0,2,0,1,0,3
ATGACGCGTTCTATCC-1_V12D07-332_A1,1,1,0,2,0,4
ATTTGCGCGAGTAGCT-1_V12D07-332_A1,0,1,0,0,0,1
TTCTTGGACGATCTGC-1_V12D07-332_A1,1,1,1,2,0,5
AGACGACGATGCCGCT-1_V12D07-332_A1,1,1,0,1,0,3
GGTCTCTGAATGGACT-1_V12D07-332_A1,1,2,0,1,0,4
GCTCAATCCGTTTATT-1_V12D07-332_A1,2,0,1,1,0,4
CCAGAAAGCAACTCAT-1_V12D07-332_A1,4,1,0,0,0,5
CACCGTTAGGGATCAC-1_V12D07-332_A1,0,0,0,1,0,1
AATAACACTAGAACAA-1_V12D07-332_A1,2,0,0,0,0,2
CACCCGGTTTGTGACT-1_V12D07-332_A1,2,0,0,0,0,2
CCACCAACTTTACTGT-1_V12D07-332_A1,3,1,0,0,0,4
AACTCTCAGTGTGCTC-1_V12D07-332_A1,4,0,1,0,0,5
AAACCGTTCGTCCAGG-1_V12D07-332_A1,2,0,0,0,0,2
CAGCGATTCCCTTCAA-1_V12D07-332_A1,0,0,0,1,0,1
GCTAGCTTGAATAGCT-1_V12D07-332_A1,3,0,0,0,0,3
TTGCGGCATCAGAAAG-1_V12D07-332_A1,3,0,0,0,0,3
AATAGAACAGAGTGGC-1_V12D07-332_A1,2,1,0,0,0,3
GCCATCGAGCTGCGTG-1_V12D07-332_A1,2,1,0,0,0,3
ACACTGATCAAGGTGT-1_V12D07-332_A1,3,1,0,1,0,5
ACCAACGCTTATTTAT-1_V12D07-332_A1,2,0,0,0,0,2
GACATCGATTTATAAC-1_V12D07-332_A1,3,0,0,1,0,4
CAGACACCGATCGCTG-1_V12D07-332_A1,3,1,0,0,0,4
CCAAGAAAGTGGGCGA-1_V12D07-332_A1,2,0,0,1,0,3
GGTAGACCGTTGGGCG-1_V12D07-332_A1,1,0,0,0,0,1
TCGTTAGGAGTCCCTA-1_V12D07-332_A1,5,0,0,1,0,6
ACGGCCAACATGGACT-1_V12D07-332_A1,2,1,0,1,0,4
GTGAGTGGTACAACGC-1_V12D07-332_A1,6,0,0,0,0,6
GAGACTTCGCGACCGA-1_V12D07-332_A1,3,1,0,0,0,4
GAAGTCAGTTGCACTA-1_V12D07-332_A1,4,0,0,3,0,7
GTTTGGTAGGGTCAAC-1_V12D07-332_A1,4,0,0,1,0,5
ACGGCACTTGCTTGGG-1_V12D07-332_A1,2,0,0,0,0,2
CCTCTGTACTATTCTA-1_V12D07-332_A1,2,0,0,0,0,2
CTATTCATGTGTCCCA-1_V12D07-332_A1,2,0,0,1,0,3
GCCCGATCTGTGGTCG-1_V12D07-332_A1,2,1,0,0,0,3
TTAGAAGAACATGACT-1_V12D07-332_A1,1,1,0,1,0,3
AGGATAAAGTCGGGAT-1_V12D07-332_A1,2,0,0,2,0,4
CGGCAAACATCGTGCG-1_V12D07-332_A1,1,1,0,1,0,3
CTAGTTACAACCCGGT-1_V12D07-332_A1,3,1,0,1,0,5
TTCGACAGAGCCCGTG-1_V12D07-332_A1,3,1,0,4,0,8
AAGCATACTCTCCTGA-1_V12D07-332_A1,3,1,0,0,0,4
GACGACGATCCGCGTT-1_V12D07-332_A1,3,1,0,3,0,7
GGTAGAAGACCGCCTG-1_V12D07-332_A1,2,2,0,0,0,4
GAGATGGGAGTCGACA-1_V12D07-332_A1,0,1,0,2,0,3
AACGATAATGCCGTAG-1_V12D07-332_A1,2,1,0,0,0,3
TGGTCCCACGCTACGG-1_V12D07-332_A1,1,1,0,1,0,3
CTGCTTGGCGATAGCT-1_V12D07-332_A1,1,1,0,0,0,2
ATCGGAGACAGACGGC-1_V12D07-332_A1,4,2,0,0,0,6
TAGCGTCCGGTGTGGT-1_V12D07-332_A1,2,0,0,0,0,2
GTTGAGTCCCGCCGGT-1_V12D07-332_A1,4,1,0,0,0,5
AAATAGGGTGCTATTG-1_V12D07-332_A1,3,0,1,1,0,5
AAGTGTTTGGAGACGG-1_V12D07-332_A1,1,0,0,0,0,1
AGCACTACCTCACCAG-1_V12D07-332_A1,4,0,0,0,0,4
TGCCTTGGCCAGGCAA-1_V12D07-332_A1,1,0,0,1,0,2
TCGTCTTAGGCGTTAA-1_V12D07-332_A1,4,1,0,0,0,5
TTCTGACCGGGCTCAA-1_V12D07-332_A1,7,0,0,0,0,7
CAGAACTTAGCCCTCT-1_V12D07-332_A1,1,2,0,0,0,3
AGCTCCTTCGCACATC-1_V12D07-332_A1,5,1,0,0,0,6
ACAGGCTTGCCCGACT-1_V12D07-332_A1,2,4,0,3,0,9
GCTATACGTCTCGGAC-1_V12D07-332_A1,2,0,0,2,0,4
GAGCCAGCTACCTGTG-1_V12D07-332_A1,3,1,0,3,1,8
TGCTAAGTGTCTATTT-1_V12D07-332_A1,3,0,0,0,0,3
GTCCTACGAATAGTCT-1_V12D07-332_A1,4,0,0,0,0,4
CAGTGTCGGCTGGCCC-1_V12D07-332_A1,2,1,0,0,0,3
CTATCGACGAAATACA-1_V12D07-332_A1,1,0,0,1,0,2
CATCATTACCCTGAGG-1_V12D07-332_A1,2,0,2,1,0,5
TAAGTTGCGACGTAGG-1_V12D07-332_A1,4,1,0,1,0,6
AGTGCACGCTTAAGAA-1_V12D07-332_A1,3,1,0,0,0,4
TGTGCCGGTGCCGGAA-1_V12D07-332_A1,1,1,0,0,0,2
AGGAGGCCTTCGCGCG-1_V12D07-332_A1,0,1,0,1,0,2
TCCGCGGCCCAATGAA-1_V12D07-332_A1,4,2,0,1,0,7
TCCGTTAAGCTAATAT-1_V12D07-332_A1,3,1,0,1,0,5
AAATCTAGCCCTGCTA-1_V12D07-332_A1,2,0,0,1,0,3
CGCAGGCGATCCAAAC-1_V12D07-332_A1,0,0,0,2,0,2
CCATATGGAAACTATA-1_V12D07-332_A1,1,1,0,1,0,3
CACCGTATCCCATCCG-1_V12D07-332_A1,1,1,0,5,0,7
GGTCAAGACTACTTCG-1_V12D07-332_A1,3,0,0,1,0,4
CCCGTTTCGCAGATGT-1_V12D07-332_A1,3,1,0,0,0,4
GTTATAATACGGTGAA-1_V12D07-332_A1,2,0,0,2,0,4
ACTTGTGGATGGAACG-1_V12D07-332_A1,1,0,0,0,0,1
GTTCGCTGAGACGTCT-1_V12D07-332_A1,3,0,0,0,0,3
GACACTGGAACCCGAT-1_V12D07-332_A1,3,1,0,3,0,7
CCCAGGTCTGAAGGCT-1_V12D07-332_A1,2,0,0,2,0,4
TCTCGAGGAGGTTCGC-1_V12D07-332_A1,3,1,0,4,0,8
ACTATCTGCCCGCGTA-1_V12D07-332_A1,3,1,0,1,0,5
CCTAAATTGTATCCTA-1_V12D07-332_A1,1,0,0,0,0,1
AGAAATTATGACTCGC-1_V12D07-332_A1,1,1,0,2,0,4
TCCAGCGCTATAAGCG-1_V12D07-332_A1,3,0,0,1,0,4
TCGTGTATTGGTCACG-1_V12D07-332_A1,1,0,0,2,0,3
CCACATACTGCACCCA-1_V12D07-332_A1,5,0,0,0,0,5
GTTGCGGACGGTCAGG-1_V12D07-332_A1,0,0,0,1,0,1
GTATTTAATGGCATAA-1_V12D07-332_A1,0,4,0,1,0,5
GTCGATAGGTGACTTT-1_V12D07-332_A1,2,1,1,0,0,4
AATAATCTTCGTATCG-1_V12D07-332_A1,3,1,0,0,0,4
ATTGTTCAACGATCCG-1_V12D07-332_A1,4,0,0,0,0,4
GTGCAGCGTAGAGTAG-1_V12D07-332_A1,3,1,0,0,0,4
TGTGGTAGGGTGCCTT-1_V12D07-332_A1,0,0,0,0,0,0
TGTGGACTATCTACGT-1_V12D07-332_A1,0,1,0,1,0,2
GGCGGGCTCTAAGAGT-1_V12D07-332_A1,3,0,0,0,0,3
TGTGCCAGAGGCAAAG-1_V12D07-332_A1,2,0,2,0,0,4
TGGCTTATGTATAATG-1_V12D07-332_A1,0,0,1,0,0,1
GCAAGCTGGAAACCGC-1_V12D07-332_A1,0,0,1,0,0,1
GATATCAAGCAGGAGC-1_V12D07-332_A1,0,1,0,0,0,1
CACCAATCATCCGTCT-1_V12D07-332_A1,1,1,0,1,0,3
CCACATGGCTCTTTAT-1_V12D07-332_A1,2,2,0,0,0,4
GTCCTACTCTACGGGC-1_V12D07-332_A1,0,1,0,0,0,1
CTCGAGACATACGATA-1_V12D07-332_A1,2,0,1,1,0,4
TATCAGTGGCGTAGTC-1_V12D07-332_A1,1,1,0,1,0,3
TGACAGGACAAGTCCA-1_V12D07-332_A1,3,1,0,2,0,6
TATTAACACCAAAGCA-1_V12D07-332_A1,0,2,0,1,0,3
TAGGCGATGAGGTCTC-1_V12D07-332_A1,0,1,0,0,0,1
CCGCCGGAACTTCTCG-1_V12D07-332_A1,2,1,0,0,0,3
GCCATTAGCCTCAAAC-1_V12D07-332_A1,0,1,1,0,0,2
GTTAGGCTACCCGTTT-1_V12D07-332_A1,2,0,1,1,0,4
GGGTATTCTAGCAAAC-1_V12D07-332_A1,1,1,0,2,0,4
GCCCTAGCCGTCGCGA-1_V12D07-332_A1,0,0,1,0,0,1
CAGATCCTGGTTTGAA-1_V12D07-332_A1,1,0,0,0,0,1
CTTCAGTGGTCGCCTA-1_V12D07-332_A1,0,1,1,0,0,2
GGGCAACCGCACGTGC-1_V12D07-332_A1,1,1,0,0,0,2
GACCCAATTATGATAC-1_V12D07-332_A1,2,0,1,0,0,3
GAAGCTCGGACCCGTC-1_V12D07-332_A1,3,0,0,0,0,3
CGTCGGGTCTAAGCGC-1_V12D07-332_A1,0,0,0,0,0,0
GAGGCCCGACTCCGCA-1_V12D07-332_A1,4,1,2,1,0,8
TTGCCATAGCCCGCTC-1_V12D07-332_A1,2,2,0,0,0,4
TAACATACACGCGATC-1_V12D07-332_A1,0,0,0,0,0,0
CCGACGGGCATGAGGT-1_V12D07-332_A1,1,0,0,1,0,2
AATGTGCCCGAGGTGT-1_V12D07-332_A1,1,0,2,0,0,3
AGCTGTAACCTCAATC-1_V12D07-332_A1,1,2,0,0,0,3
CGAGTGAAGGTACCAG-1_V12D07-332_A1,0,3,0,0,0,3
AGTCTCACAAGACTAC-1_V12D07-332_A1,1,0,0,0,0,1
AAATTGATAGTCCTTT-1_V12D07-332_A1,0,0,1,2,0,3
TAAGTCGCCGAGTATC-1_V12D07-332_A1,0,0,0,1,0,1
GCGGAGAAACTTCGCA-1_V12D07-332_A1,1,0,0,1,0,2
GGCAAAGGCGCCAATA-1_V12D07-332_A1,1,2,0,0,0,3
ATTTCCGGGTTCTGCG-1_V12D07-332_A1,3,2,0,0,0,5
TAAACCCAGGAGGGCA-1_V12D07-332_A1,1,1,0,1,0,3
TTCGGGCGCTAGTCTT-1_V12D07-332_A1,3,0,0,0,0,3
GTGGAGTCGGCGGTTG-1_V12D07-332_A1,2,0,0,1,0,3
GCACGCCTACTTAGAT-1_V12D07-332_A1,2,1,0,0,0,3
CAATATTCTTGACCTA-1_V12D07-332_A1,2,0,1,1,0,4
CGTTTGTGTAGAGGGT-1_V12D07-332_A1,0,2,0,0,0,2
CATAGCGTTGCCCACC-1_V12D07-332_A1,1,0,0,1,0,2
TGATACATTTAGCCGT-1_V12D07-332_A1,2,0,0,1,0,3
TTCCGGCCTTGAGGCT-1_V12D07-332_A1,4,0,0,0,0,4
CCTATACCGTCCTGTC-1_V12D07-332_A1,2,2,0,1,0,5
TCGTTGCTATCCGGTC-1_V12D07-332_A1,0,0,0,2,0,2
TGGCGACTGCTCCAAA-1_V12D07-332_A1,1,1,0,3,0,5
CAGAGGCGATGCATGA-1_V12D07-332_A1,3,0,0,0,0,3
TCACAGGAGAATAAGA-1_V12D07-332_A1,0,0,0,0,0,0
GGGTTAACATTTGAGT-1_V12D07-332_A1,6,0,0,0,0,6
GCGGGCGAGCCTTACC-1_V12D07-332_A1,1,0,0,1,0,2
TGCCAATGGGTACTCT-1_V12D07-332_A1,3,1,0,1,0,5
AGGGACTCTACGCGAC-1_V12D07-332_A1,4,0,0,1,0,5
GACGCCGTAAAGGCTA-1_V12D07-332_A1,0,2,0,0,0,2
AAAGGCTCTCGCGCCG-1_V12D07-332_A1,3,0,0,0,0,3
CTGGCTGGTTGTCAGT-1_V12D07-332_A1,1,0,0,0,0,1
ACATCCCGGCCATACG-1_V12D07-332_A1,1,2,0,1,0,4
CTCTTGTCCCGCTTGG-1_V12D07-332_A1,3,1,0,2,0,6
TACGCCTCCATTCCGA-1_V12D07-332_A1,2,1,0,1,0,4
CGGAGCAATTTAATCG-1_V12D07-332_A1,1,1,0,2,0,4
AACTAGGCTTGGGTGT-1_V12D07-332_A1,3,0,0,1,0,4
GCGTCGCCAGGGTGAT-1_V12D07-332_A1,0,1,0,2,0,3
GTTGGTCATGCTATCC-1_V12D07-332_A1,2,1,0,0,0,3
GCTGGCGGCGCATGCT-1_V12D07-332_A1,2,0,0,0,0,2
TGAGCGGAAAGTGTTC-1_V12D07-332_A1,2,4,0,1,0,7
CTTTCTGTGCGGGCTT-1_V12D07-332_A1,2,0,0,1,0,3
ATCTAATATCCTACGG-1_V12D07-332_A1,1,1,0,0,0,2
AACCTTTAAATACGGT-1_V12D07-332_A1,4,1,0,1,0,6
TTCACTCGAGCACCTA-1_V12D07-332_A1,2,2,0,0,0,4
CTGCACTCCAGTACAG-1_V12D07-332_A1,0,0,1,0,0,1
CCATTTCTACCTATTA-1_V12D07-332_A1,5,0,0,1,0,6
CAAGCGGCACATAATT-1_V12D07-332_A1,3,0,0,1,0,4
GTTAACATCACTTAAA-1_V12D07-332_A1,1,1,0,0,0,2
ATATAAATGTAGCTGC-1_V12D07-332_A1,2,1,0,2,0,5
GCCTCTATACATAGCA-1_V12D07-332_A1,1,0,0,3,0,4
GTGTCGTATAGCGTTC-1_V12D07-332_A1,1,1,1,3,0,6
ATACGTACTTAGCCAC-1_V12D07-332_A1,4,0,0,2,0,6
GCTATCATACTCATGG-1_V12D07-332_A1,0,0,0,0,0,0
TATCCAATTGGTTATC-1_V12D07-332_A1,2,2,0,2,0,6
TCTCCCTGGGCAGCGT-1_V12D07-332_A1,1,0,0,1,0,2
CCTATAATGAGTGCCC-1_V12D07-332_A1,0,2,0,3,0,5
CAATGCGAGAAGTATC-1_V12D07-332_A1,6,1,0,0,0,7
TACCAATAAAGTACCA-1_V12D07-332_A1,3,1,0,1,0,5
GCTAGGCACCACGGAG-1_V12D07-332_A1,0,3,0,2,0,5
GGTGGACTGCTCTGGC-1_V12D07-332_A1,6,0,0,0,0,6
TATTCCGAGCTGTTAT-1_V12D07-332_A1,1,0,0,0,0,1
TTGAGAAGTTTAGCAT-1_V12D07-332_A1,3,1,0,1,0,5
GTCCGGACCTGAAATT-1_V12D07-332_A1,1,0,0,0,0,1
CTGTGGTCGGGAGATA-1_V12D07-332_A1,1,3,0,1,0,5
CATGTAAGAGACATTT-1_V12D07-332_A1,3,2,0,0,0,5
CACGTTTCGTACACAC-1_V12D07-332_A1,5,1,0,0,0,6
CATCCTCTCAAAGATC-1_V12D07-332_A1,4,4,0,0,0,8
GATTAACCGAAAGCCC-1_V12D07-332_A1,3,0,0,1,0,4
AACGCTGTTGCTGAAA-1_V12D07-332_A1,8,0,0,1,0,9
TTCAGCTGGCGTGCCC-1_V12D07-332_A1,3,0,0,0,0,3
TAGAGGTTCTACTTGT-1_V12D07-332_A1,3,1,0,2,0,6
GTATCAAACGTTAGCT-1_V12D07-332_A1,2,0,0,1,0,3
AATCATGTAAAGACTC-1_V12D07-332_A1,3,1,0,0,0,4
AGTCACTAGCTCTCGA-1_V12D07-332_A1,1,0,0,3,0,4
GCGAAACGATCGGGAG-1_V12D07-332_A1,2,4,0,3,0,9
CATGGATTGTCTTCCG-1_V12D07-332_A1,3,1,0,0,0,4
ATTGGATTACAGCGTA-1_V12D07-332_A1,3,0,1,0,0,4
CACACACGCTAACGAG-1_V12D07-332_A1,0,0,0,2,0,2
CTATGGGAAGCGGAAT-1_V12D07-332_A1,5,0,0,0,0,5
TGCCTAATTGAAGATT-1_V12D07-332_A1,2,2,0,0,0,4
TGGCAATGGGACGGCG-1_V12D07-332_A1,6,0,0,1,0,7
ACCTCCGCCCTCGCTG-1_V12D07-332_A1,3,0,0,0,0,3
CGGCAATAAGATCGCC-1_V12D07-332_A1,5,0,0,2,0,7
CCTTGACCACTTTATT-1_V12D07-332_A1,4,1,0,0,0,5
TCATTTAGAAGTGTGA-1_V12D07-332_A1,1,1,0,0,0,2
CAGAATAACACACGGA-1_V12D07-332_A1,4,0,0,1,0,5
TCTGAGCAATTGACTG-1_V12D07-332_A1,0,0,0,2,0,2
CAACGTGGTGGAGTCT-1_V12D07-332_A1,3,0,0,1,0,4
CACAGTTCGCTTCCCA-1_V12D07-332_A1,7,0,0,0,0,7
TCTCTCGCCGCACATA-1_V12D07-332_A1,3,0,0,0,0,3
TGGGCAGGCCACCGCA-1_V12D07-332_A1,2,2,0,1,0,5
CTCCTGTTCAAGGCAG-1_V12D07-332_A1,1,2,0,0,0,3
TATTTGATTTGCACAG-1_V12D07-332_A1,3,1,0,1,0,5
GCCACTCCTTACGGTA-1_V12D07-332_A1,2,0,0,2,0,4
ACCGATATTTAATCAT-1_V12D07-332_A1,2,1,0,0,0,3
TTATTATCTGGAAGGC-1_V12D07-332_A1,3,0,0,1,0,4
TACATGCCGGAATTGT-1_V12D07-332_A1,4,0,0,0,0,4
GGCACTCAGCCGACCC-1_V12D07-332_A1,2,3,0,0,0,5
AAACCGGAAATGTTAA-1_V12D07-332_A1,1,1,0,0,0,2
AGACAGGCATCTCAGC-1_V12D07-332_A1,3,0,0,0,0,3
GTGGTGATGGTTTGTG-1_V12D07-332_A1,2,0,0,0,0,2
CCGATATGACGTAAGG-1_V12D07-332_A1,0,1,0,0,0,1
CATACACAAAGTCAGC-1_V12D07-332_A1,4,0,0,0,0,4
TGCCGTTCTTAATCGG-1_V12D07-332_A1,0,0,0,1,0,1
TCGAGTCTACGATTCG-1_V12D07-332_A1,0,0,0,0,0,0
ACTTCCAGTGGAAGCT-1_V12D07-332_A1,0,0,0,2,0,2
CAATTGGGCCGCACTC-1_V12D07-332_A1,2,0,1,0,0,3
AAATCGCGGAAGGAGT-1_V12D07-332_A1,0,1,0,2,0,3
ATATCAATTCCAGCCT-1_V12D07-332_A1,0,2,0,0,0,2
CTTTGTCGAATGCTCC-1_V12D07-332_A1,2,0,2,0,0,4
TGAGGCATGTACTGTG-1_V12D07-332_A1,0,0,0,0,0,0
TTCGCCGCTCGCGCTA-1_V12D07-332_A1,0,0,0,1,0,1
GACTCCTTCCAATTGA-1_V12D07-332_A1,1,0,1,1,0,3
ACCGAAGAGTCTGGTT-1_V12D07-332_A1,0,0,1,0,0,1
TGGCATGAAGTTTGGG-1_V12D07-332_A1,0,0,1,0,0,1
ACGAGGTTTACAACGT-1_V12D07-332_A1,0,0,0,0,0,0
AACCCATCCCATGATC-1_V12D07-332_A1,1,1,0,0,0,2
TCGACAACTGAACCCG-1_V12D07-332_A1,7,3,0,0,0,10
TATCTTGCAATACAAC-1_V12D07-332_A1,1,1,0,1,0,3
TATTATGTTTGCCTGC-1_V12D07-332_A1,2,1,1,1,0,5
GTCAAAGAAGTGGTGT-1_V12D07-332_A1,0,1,0,0,0,1
GGGACAGAGTTACTCC-1_V12D07-332_A1,4,0,1,1,0,6
AGCAACCGAAAGTAAT-1_V12D07-332_A1,2,0,0,0,0,2
CTCTCTAACTGCCTAG-1_V12D07-332_A1,3,3,0,0,0,6
ATACGGAACGTCGTTT-1_V12D07-332_A1,2,3,0,0,0,5
TCGGTCCCGACAATAG-1_V12D07-332_A1,0,0,0,0,0,0
CGCGCAAATGTCCAGA-1_V12D07-332_A1,1,1,2,0,0,4
TCTAATACTGCCTCAG-1_V12D07-332_A1,2,2,1,1,0,6
CTCGGTTGTCGGCCCT-1_V12D07-332_A1,0,0,1,0,0,1
GGTAACCGGGAGGATA-1_V12D07-332_A1,3,0,0,1,0,4
CAGGCGCACGGTGGTC-1_V12D07-332_A1,1,0,0,0,0,1
TCATCGATGGTCCCAA-1_V12D07-332_A1,2,0,1,0,0,3
CAAAGATTATTGGGCC-1_V12D07-332_A1,3,1,0,2,0,6
ACAATGAATACGGAGA-1_V12D07-332_A1,2,0,0,0,0,2
GCTCCTGACATACTGG-1_V12D07-332_A1,0,0,0,0,0,0
GATGACAAGTAGGGCA-1_V12D07-332_A1,5,0,0,0,0,5
TACGCCGAGGGTACCC-1_V12D07-332_A1,2,1,0,0,0,3
AAGCGTCCCTCATCGA-1_V12D07-332_A1,1,0,0,1,0,2
CACTCCTATGTAAGAT-1_V12D07-332_A1,0,1,0,0,0,1
TCGAGCCAGGCAGGCC-1_V12D07-332_A1,2,1,0,0,0,3
TCGTCAAGTACGCGCA-1_V12D07-332_A1,1,2,0,1,0,4
CCCGTAGCTGGGAAGA-1_V12D07-332_A1,0,0,0,2,0,2
ACCCTATGCCATATCG-1_V12D07-332_A1,0,0,0,0,0,0
GTGGTATAGTCTGCCG-1_V12D07-332_A1,1,0,0,0,0,1
CCGGTTTGTAATTGTG-1_V12D07-332_A1,0,0,0,0,0,0
GTCGCCGTTGTGTGTT-1_V12D07-332_A1,1,0,0,1,0,2
TACTGAACAGATTTAG-1_V12D07-332_A1,0,3,0,0,0,3
TATTAACCTGACCGCG-1_V12D07-332_A1,0,0,0,1,0,1
CTGTAGCCATCTCACT-1_V12D07-332_A1,2,0,0,1,0,3
TACTATGGTTCCTCAG-1_V12D07-332_A1,3,0,1,0,0,4
GAGTCAGACCAGAATC-1_V12D07-332_A1,1,0,0,0,0,1
TAAGGCATAACATCAA-1_V12D07-332_A1,0,2,0,0,0,2
CTTCCGCTCCGTGAAG-1_V12D07-332_A1,2,0,2,0,0,4
GGGCTATGATCGATGG-1_V12D07-332_A1,2,1,0,0,0,3
GGTCGGTCGTCCACAG-1_V12D07-332_A1,1,1,0,0,0,2
GGGACCCGTATATCTT-1_V12D07-332_A1,0,0,0,0,0,0
GAAAGCAGTGCACTTT-1_V12D07-332_A1,4,0,0,0,0,4
AGCGCATAATGAATCG-1_V12D07-332_A1,1,1,0,0,0,2
GCTGCTAAGTAGTCGA-1_V12D07-332_A1,6,0,0,0,0,6
AATAGTCCGTCCCGAC-1_V12D07-332_A1,5,1,0,0,0,6
AGCAGCCAGATGAATA-1_V12D07-332_A1,2,0,0,1,0,3
CCTCGCGCTGTGCGAT-1_V12D07-332_A1,4,1,0,1,0,6
TTGTGTATGCCACCAA-1_V12D07-332_A1,2,1,1,0,0,4
TGCTCGGCGAAACCCA-1_V12D07-332_A1,3,1,0,2,0,6
CGATTAAATATCTCCT-1_V12D07-332_A1,4,1,0,0,0,5
TGCCGTGGATCGTCCT-1_V12D07-332_A1,4,0,0,2,0,6
GTGGACGCATTTGTCC-1_V12D07-332_A1,4,1,0,2,0,7
ACCCGGAAACTCCCAG-1_V12D07-332_A1,4,0,0,0,0,4
CCGCATGTGGTACGAT-1_V12D07-332_A1,3,0,0,2,0,5
GCAAACCTTGGCCATA-1_V12D07-332_A1,4,0,1,2,0,7
ATTCACTGATGTTGGA-1_V12D07-332_A1,1,0,0,1,0,2
ACTCCCTAATGCTAAA-1_V12D07-332_A1,1,2,0,3,0,6
TCCTAAATTGGGAAGC-1_V12D07-332_A1,2,0,0,1,0,3
GAACAGATTACTAAAT-1_V12D07-332_A1,3,1,0,1,0,5
ATACAGGCCCTCCAAT-1_V12D07-332_A1,4,0,0,0,0,4
CGATTCGCCTGGCTGC-1_V12D07-332_A1,2,0,0,0,0,2
TCCGCCTGTCTACAAG-1_V12D07-332_A1,2,2,0,0,0,4
CACATCTCACCGACGA-1_V12D07-332_A1,2,1,0,0,0,3
CGTCGTCCTTCGCGAA-1_V12D07-332_A1,3,0,0,1,0,4
CGTTGAATACCGCGCT-1_V12D07-332_A1,4,0,0,0,0,4
ACCAATATGCAAGTTA-1_V12D07-332_A1,2,2,0,3,0,7
ACGGATGGTGCGGATA-1_V12D07-332_A1,2,1,0,3,0,6
CACCCTAACAAGATCT-1_V12D07-332_A1,1,0,0,0,0,1
AAGCTCTTTCATGGTG-1_V12D07-332_A1,1,0,0,1,0,2
CATGGGTATGCCTTAT-1_V12D07-332_A1,2,1,0,0,0,3
GCGCGTCATTGGTACA-1_V12D07-332_A1,3,0,1,2,0,6
TCTGAAGCACGTGGTC-1_V12D07-332_A1,2,2,0,0,0,4
AAGTTCACTCCAAGCT-1_V12D07-332_A1,2,1,0,0,0,3
TTGGACCTATAACAGT-1_V12D07-332_A1,4,0,0,0,0,4
ATCAGCCTCATGCTGC-1_V12D07-332_A1,1,0,0,1,0,2
AGTACTCTTATGCCCA-1_V12D07-332_A1,3,0,1,0,0,4
GCGCTTAAATAATTGG-1_V12D07-332_A1,3,1,0,1,0,5
TTGTGAACCTAATCCG-1_V12D07-332_A1,1,1,0,1,0,3
AGTCGTCGACCACCAA-1_V12D07-332_A1,4,0,0,0,0,4
TCCTTTAAATCCGCTT-1_V12D07-332_A1,2,1,0,1,0,4
ACTGAAACGCCGTTAG-1_V12D07-332_A1,2,0,0,0,0,2
GCACACACTGGTAGCC-1_V12D07-332_A1,3,0,0,0,0,3
TAAGGGCCTGTCCGAT-1_V12D07-332_A1,2,0,0,5,0,7
GCTAGAGTAGAGATGT-1_V12D07-332_A1,2,0,0,1,0,3
CACAGGGCCATATAGT-1_V12D07-332_A1,3,0,0,3,0,6
CCATGCCCTAGATTTC-1_V12D07-332_A1,1,0,0,4,0,5
TCGCGTAGCAGTGTCC-1_V12D07-332_A1,3,1,0,0,0,4
GACGAGGCTAATAAAC-1_V12D07-332_A1,1,0,0,2,0,3
CTACACTCGCAGATGG-1_V12D07-332_A1,4,0,0,0,0,4
ACGCATACGTTTACTA-1_V12D07-332_A1,6,1,0,1,0,8
GGAGCAACATTTCAAG-1_V12D07-332_A1,0,0,0,2,0,2
CGAGAGGGTAGCCGCG-1_V12D07-332_A1,5,0,1,0,0,6
TCGTGTTCGACCACAA-1_V12D07-332_A1,1,0,0,1,0,2
TCTACCCAATAGAGAG-1_V12D07-332_A1,3,0,1,0,0,4
ATAAACGTTGCACCAC-1_V12D07-332_A1,1,1,0,1,0,3
TCAACTGCAGAGTCAG-1_V12D07-332_A1,0,5,0,1,0,6
AGCTCCATATATGTTC-1_V12D07-332_A1,4,1,0,2,0,7
GTAACATCTAAGATAA-1_V12D07-332_A1,3,0,0,0,0,3
CCGACAATAGGCCGCC-1_V12D07-332_A1,3,0,0,0,0,3
ATGCTTAGGAGTTGAT-1_V12D07-332_A1,3,0,0,1,0,4
AACCCGAGCAGAATCG-1_V12D07-332_A1,2,1,0,0,0,3
CGGGTTTGTTAGGGCT-1_V12D07-332_A1,2,1,0,0,0,3
AGGCACGTGACTGTCC-1_V12D07-332_A1,4,0,0,0,0,4
GACAAGAGATGAGATT-1_V12D07-332_A1,4,0,0,0,0,4
AGCCCTTGGACATCCC-1_V12D07-332_A1,0,4,0,0,0,4
GCAGTTCGATCCGAGC-1_V12D07-332_A1,1,1,0,0,0,2
TCGAGGGCAACAGACG-1_V12D07-332_A1,2,0,0,0,0,2
ACTTTGTCGACGCACT-1_V12D07-332_A1,5,1,0,0,0,6
GAGTATCAAAGTTACA-1_V12D07-332_A1,3,0,0,2,0,5
CCAGGCTGGCGTCTGA-1_V12D07-332_A1,3,0,0,1,0,4
GGACTCTTCCGGTTGA-1_V12D07-332_A1,2,1,0,1,0,4
TCCCAGCACACGACAT-1_V12D07-332_A1,2,1,0,3,0,6
GCTCCATGAGTGCAGA-1_V12D07-332_A1,3,0,0,0,0,3
GCAGTGCGGGCGGATG-1_V12D07-332_A1,1,2,0,0,0,3
GCGTTCTGACTAAGCG-1_V12D07-332_A1,2,1,0,1,0,4
ATTTGGAGATTGCGGT-1_V12D07-332_A1,0,0,0,0,0,0
AAGGGTTTGATTTCAG-1_V12D07-332_A1,0,0,3,0,0,3
CCGGCCGCGAGCATAT-1_V12D07-332_A1,2,1,1,0,0,4
GAGTTCTGTGGGTGCT-1_V12D07-332_A1,1,1,2,1,0,5
AAACGAAGATGGAGTA-1_V12D07-332_A1,0,2,1,0,0,3
AATTACGAGACCCATC-1_V12D07-332_A1,1,0,1,0,0,2
CCTTTGAATTATGGCT-1_V12D07-332_A1,1,0,0,0,0,1
CATGGTATTAGTTTGT-1_V12D07-332_A1,0,0,0,0,0,0
AACGAAAGTCGTCCCA-1_V12D07-332_A1,2,1,1,0,0,4
ACATAAGTCGTGGTGA-1_V12D07-332_A1,1,0,0,0,0,1
GCACAACCTCGGGCGT-1_V12D07-332_A1,1,0,0,0,0,1
ATGCACGCGCTGTTCA-1_V12D07-332_A1,0,0,2,1,0,3
CGATGTTGTTATCTAC-1_V12D07-332_A1,1,0,1,0,0,2
GTCTCCTGCCAGTATG-1_V12D07-332_A1,2,0,2,0,0,4
GATGCCTTCTGCGGCA-1_V12D07-332_A1,2,3,0,0,0,5
ACCGGTCAGGTACACC-1_V12D07-332_A1,0,0,1,0,0,1
GTGGAGCGTTTACCGA-1_V12D07-332_A1,0,1,0,0,0,1
AGGCGGTTTGTCCCGC-1_V12D07-332_A1,1,2,1,0,0,4
TCCCTGGCGTATTAAC-1_V12D07-332_A1,1,0,0,0,0,1
AAACACCAATAACTGC-1_V12D07-332_A1,1,1,1,2,0,5
TGGACGCAATCCAGCC-1_V12D07-332_A1,2,1,1,1,0,5
GGAACCTTGACTCTGC-1_V12D07-332_A1,0,1,1,1,0,3
GTATCTCAGTCTTGAC-1_V12D07-332_A1,1,0,0,0,0,1
GCTGAATCTTCCAATC-1_V12D07-332_A1,2,1,0,0,0,3
AGATGCAAGACGTGCA-1_V12D07-332_A1,1,0,0,0,0,1
TTAAGGCCCGTACTTT-1_V12D07-332_A1,2,1,1,2,0,6
AGTATGCTGGAGACCA-1_V12D07-332_A1,1,1,0,1,0,3
GCGGCAAAGTATTGCC-1_V12D07-332_A1,0,0,1,0,0,1
GCGCAAATATATTCAA-1_V12D07-332_A1,2,1,2,1,0,6
GAAGAAACGATATTGT-1_V12D07-332_A1,5,2,2,0,0,9
GGACCTCTAGGCCGCC-1_V12D07-332_A1,1,0,1,0,0,2
AACAGCTGTGTGGCAA-1_V12D07-332_A1,2,1,0,0,0,3
TCGAATATCCCGCAGG-1_V12D07-332_A1,1,3,1,0,0,5
GCGACCCAACCATCTG-1_V12D07-332_A1,2,0,0,0,0,2
AGAGAAGGAGTACAAT-1_V12D07-332_A1,1,1,0,0,0,2
GGCTCCTCCACCTGTT-1_V12D07-332_A1,3,0,0,1,0,4
TCAGTGTATACGTCAT-1_V12D07-332_A1,5,1,0,1,0,7
ATTATTATGTCCGTCA-1_V12D07-332_A1,2,1,0,0,0,3
TTAGGTCATAACCGAC-1_V12D07-332_A1,1,1,0,0,0,2
AAGATGGCACCGGACC-1_V12D07-332_A1,2,2,0,0,0,4
CTACAAGAAATAACCC-1_V12D07-332_A1,1,0,0,1,0,2
ACTATTTCCGGGCCCA-1_V12D07-332_A1,2,0,0,0,0,2
TTGTTTCACATCCAGG-1_V12D07-332_A1,1,0,1,2,0,4
CGCTGTGTGGATGTTG-1_V12D07-332_A1,0,1,0,0,0,1
TCAACATAGCGCCCTA-1_V12D07-332_A1,0,0,0,0,0,0
GGCCGTTTGGGTTTCA-1_V12D07-332_A1,1,1,1,0,0,3
TACTCTTTCGTCTTCA-1_V12D07-332_A1,0,1,0,1,0,2
TTCGCGCGCCATACGA-1_V12D07-332_A1,3,0,3,0,0,6
CGGAAAGAATCAAACG-1_V12D07-332_A1,1,1,1,0,0,3
AGGCAGGGAGCGTACT-1_V12D07-332_A1,0,1,0,0,0,1
CCTTTAAGGGAGCACT-1_V12D07-332_A1,1,0,0,1,0,2
CGCCCAGCACGCCTAG-1_V12D07-332_A1,2,0,0,1,0,3
AGTATTTGGCACGACC-1_V12D07-332_A1,4,2,0,2,0,8
TATCCGCACCGTCGGG-1_V12D07-332_A1,0,0,0,1,0,1
ACCCGTGTCATCAGTA-1_V12D07-332_A1,1,0,0,0,0,1
CAACTGCTCATCCGAT-1_V12D07-332_A1,3,1,0,1,0,5
CCGGAGCGTACTTTCT-1_V12D07-332_A1,3,0,0,0,0,3
TACCGTAGGTTAACTA-1_V12D07-332_A1,4,0,2,0,0,6
TGAGGAGTGCCAGCTT-1_V12D07-332_A1,0,1,1,0,0,2
CCAGTCTTGTCATAGA-1_V12D07-332_A1,0,1,0,3,0,4
GGGCAGAGCAATCGTT-1_V12D07-332_A1,6,0,0,1,0,7
TACCAAATAGCCCAGA-1_V12D07-332_A1,6,0,0,1,0,7
TACCTACTCCCAGTAT-1_V12D07-332_A1,0,1,0,0,0,1
TGTGAGACTAGCCCAA-1_V12D07-332_A1,2,0,0,3,0,5
ATACCTAACCAAGAAA-1_V12D07-332_A1,2,1,0,1,0,4
GTCGGGAAGCAGAAAC-1_V12D07-332_A1,5,1,2,0,0,8
AATTAACGGATTTCCA-1_V12D07-332_A1,2,2,0,3,0,7
GAACCCTCTGTGTTCT-1_V12D07-332_A1,1,1,0,1,0,3
ATATAAAGCGCTCGTG-1_V12D07-332_A1,3,0,1,1,0,5
CCTGGTCGAATGTGGG-1_V12D07-332_A1,1,0,0,2,0,3
CTAGGTTCGGACGTGA-1_V12D07-332_A1,4,3,0,0,0,7
TCGGGAGACAGCGTAC-1_V12D07-332_A1,1,0,0,1,0,2
CATAAGAAGCTTGGCT-1_V12D07-332_A1,0,0,0,1,0,1
AAGCACCCTGCGTATC-1_V12D07-332_A1,4,0,0,0,0,4
AGTTTGCACCTGCCTC-1_V12D07-332_A1,2,0,0,1,0,3
GACTGCAAATCGAGCT-1_V12D07-332_A1,4,0,0,0,0,4
GTGTATATCAGCGGGC-1_V12D07-332_A1,3,0,0,1,0,4
CTTCAACTCCACTTGG-1_V12D07-332_A1,2,2,0,1,0,5
ACTTACGCATCCACGC-1_V12D07-332_A1,0,0,0,3,0,3
CATGAGATGCACTCTC-1_V12D07-332_A1,1,0,0,0,0,1
GAGCACCTGTGTCCAG-1_V12D07-332_A1,4,0,0,0,0,4
CGCGACCGCGACAGAT-1_V12D07-332_A1,2,0,0,0,0,2
GTCCCGCGACGTTATG-1_V12D07-332_A1,6,1,0,2,0,9
GCAGTGTGGCTATAGG-1_V12D07-332_A1,2,0,0,1,0,3
ATACTGCCTTACACCG-1_V12D07-332_A1,1,3,0,0,0,4
TACAGAAACGGTGGGC-1_V12D07-332_A1,4,0,0,0,0,4
GGCGCGGAGATCTTTC-1_V12D07-332_A1,4,0,0,1,0,5
CGTTAATGTCCCGACG-1_V12D07-332_A1,3,4,0,0,0,7
GCTAACTGAAGTCTGA-1_V12D07-332_A1,2,4,0,3,0,9
AGTGATAACCTGCGCG-1_V12D07-332_A1,0,1,0,2,0,3
TATGATCTTCTCTTTA-1_V12D07-332_A1,7,1,0,0,0,8
TGTACCTACACGAGGG-1_V12D07-332_A1,2,0,0,2,0,4
ATATCGTTCCTCGAAC-1_V12D07-332_A1,2,0,0,0,0,2
CGGCGCCATCAATCCC-1_V12D07-332_A1,2,0,0,2,0,4
CCTGTTTGAAGACACG-1_V12D07-332_A1,2,0,0,2,0,4
GCCACTCAGAGCGCGA-1_V12D07-332_A1,1,0,0,2,0,3
TCGGCTTGTATCGACG-1_V12D07-332_A1,1,0,0,1,0,2
TAGATGGTTCCTTACT-1_V12D07-332_A1,0,0,0,3,0,3
ATCGTTAGCTAGCGGA-1_V12D07-332_A1,1,0,0,0,0,1
ACAGCGACATTCTCAT-1_V12D07-332_A1,1,0,0,4,0,5
ATTCAACCATTTAAGG-1_V12D07-332_A1,7,0,0,3,0,10
CACTCTTCTGCTAGCC-1_V12D07-332_A1,6,0,0,1,0,7
CTAACTGATAATCGCC-1_V12D07-332_A1,1,0,0,0,0,1
TGATGTCAATTAAGTG-1_V12D07-332_A1,4,0,0,1,0,5
CGCCGTTCAGCATAGT-1_V12D07-332_A1,4,0,0,1,0,5
ATACTACCCGTACCAC-1_V12D07-332_A1,1,0,0,1,0,2
CCACTGTTTGGATTAA-1_V12D07-332_A1,0,3,0,0,0,3
CACTACGGGAGCTGCC-1_V12D07-332_A1,3,0,0,2,0,5
GACCAAACGTTGACTG-1_V12D07-332_A1,4,0,0,1,0,5
AAGAGGCCCTTTGGAA-1_V12D07-332_A1,3,0,0,2,0,5
ACACGTAGGCCACAAG-1_V12D07-332_A1,2,0,0,0,0,2
TACTCTTACTTTACTG-1_V12D07-332_A1,8,0,0,0,0,8
AGAGCCGCCGAGATTT-1_V12D07-332_A1,2,0,0,0,0,2
GGCCTGCTTCTCCCGA-1_V12D07-332_A1,3,1,0,2,0,6
TCAAGCGCGGACGGTA-1_V12D07-332_A1,3,2,0,0,0,5
ACACTGGGACAGTCGT-1_V12D07-332_A1,4,0,0,0,0,4
TGTGTAGTAGCACGTG-1_V12D07-332_A1,3,1,0,0,0,4
CTAGCCACAGGCGAGC-1_V12D07-332_A1,1,1,0,0,0,2
CTATCGCGTAGAGAAC-1_V12D07-332_A1,2,1,0,0,0,3
GTTCCCGTAAACATAT-1_V12D07-332_A1,1,0,0,0,0,1
TCTTTCCTTCGAGATA-1_V12D07-332_A1,2,0,0,1,0,3
ATATTGGAGAGGCCTT-1_V12D07-332_A1,3,1,0,0,0,4
AGGCGATAACTGGCGT-1_V12D07-332_A1,2,0,0,1,0,3
ACCCGGAGCACCACAA-1_V12D07-332_A1,1,0,0,0,0,1
TGAGCTCAACTGTATA-1_V12D07-332_A1,3,1,0,0,0,4
ACGACCCATGAGTTGC-1_V12D07-332_A1,1,0,0,0,0,1
CGGTCAGTCCATATTT-1_V12D07-332_A1,2,0,0,0,0,2
TCCGGCTGTCGGGTCG-1_V12D07-332_A1,3,0,0,1,0,4
ATTCCCGAAGGTACAG-1_V12D07-332_A1,0,0,1,0,0,1
CTAACAGCACAATAAC-1_V12D07-332_A1,1,0,0,0,0,1
TTGTGCGGAAGCGGAT-1_V12D07-332_A1,3,0,0,1,0,4
GGGCACTATTGACCAT-1_V12D07-332_A1,3,1,0,2,0,6
CCATAGAGGCTGCCAG-1_V12D07-332_A1,1,0,1,2,0,4
CCGAAGCATTGACCAA-1_V12D07-332_A1,2,0,2,1,0,5
TACTGAGGGAAGAAAG-1_V12D07-332_A1,5,1,3,0,0,9
TATGTAGAAACCCGGC-1_V12D07-332_A1,0,2,1,0,0,3
TGGTTAACTTACATTT-1_V12D07-332_A1,1,1,0,1,0,3
AGAACCCTCAATTGGG-1_V12D07-332_A1,2,1,1,0,0,4
CCTATATCGTGTCACG-1_V12D07-332_A1,0,0,0,1,0,1
ACGGCTGGATGTAGAA-1_V12D07-332_A1,0,1,2,0,0,3
CTCGCATTGCATAGCC-1_V12D07-332_A1,0,0,1,0,0,1
ACTTTGGTCGTGCTCC-1_V12D07-332_A1,1,0,2,0,0,3
GCTGGTTTAGGCCATA-1_V12D07-332_A1,2,3,0,0,0,5
TGTCGTTATCACATAT-1_V12D07-332_A1,0,2,1,1,0,4
ACACATGATCAAATCT-1_V12D07-332_A1,0,2,0,2,0,4
TATCCATCTCGGTTAG-1_V12D07-332_A1,0,0,0,0,0,0
CTCGTCGAGGGCTCAT-1_V12D07-332_A1,1,1,0,0,0,2
ATCAATGCCGTGGCTG-1_V12D07-332_A1,1,1,1,0,0,3
GAAACATAGGAAACAG-1_V12D07-332_A1,2,1,0,0,0,3
TAATAGGTCACCAGAA-1_V12D07-332_A1,1,2,2,0,0,5
CACCAGTCAGCATGCA-1_V12D07-332_A1,3,1,1,0,0,5
GAGCGCTGTTAGGTAA-1_V12D07-332_A1,2,0,0,0,0,2
CCCTATGTAGAGCAGA-1_V12D07-332_A1,0,0,0,0,0,0
GATCGCTATATCTCAG-1_V12D07-332_A1,4,0,0,1,0,5
AAGGGACTATGCATTC-1_V12D07-332_A1,0,0,0,0,0,0
CTCGGGTTCTCTGGCC-1_V12D07-332_A1,1,1,0,1,0,3
TATATATCGAGAAATG-1_V12D07-332_A1,0,1,0,1,0,2
ACCCGAGCGAAATTAC-1_V12D07-332_A1,3,0,0,0,0,3
TTGTTTCATTAGTCTA-1_V12D07-332_A1,2,0,1,0,0,3
ATGGGACCTGCTGAAC-1_V12D07-332_A1,0,0,0,1,0,1
TGCGACGGCCGAACGT-1_V12D07-332_A1,0,1,2,1,0,4
AGCTAACAAGCAATGT-1_V12D07-332_A1,5,0,3,0,0,8
CGTGTCTCGTTACGAC-1_V12D07-332_A1,0,0,1,2,0,3
CTAAATCCGGTGTACA-1_V12D07-332_A1,1,1,0,1,0,3
GAATAGTGCTCGATTA-1_V12D07-332_A1,3,0,0,2,0,5
AACAATACATTGTCGA-1_V12D07-332_A1,2,0,0,0,0,2
CACATCGTGCACGCGC-1_V12D07-332_A1,1,0,0,1,0,2
ACCGTGACCACGTGGG-1_V12D07-332_A1,1,1,0,0,0,2
CCCAATGAGATTTGCA-1_V12D07-332_A1,4,0,0,1,0,5
TCAGCAGTAGGCCCTG-1_V12D07-332_A1,1,0,0,1,0,2
CTACTCAAGGTATAGT-1_V12D07-332_A1,6,2,0,0,0,8
TAGTAGCTTATACCAG-1_V12D07-332_A1,3,0,0,0,0,3
ACGTTCGTTCAGGAAA-1_V12D07-332_A1,1,0,0,0,0,1
TTAGAATAAGGGTCGG-1_V12D07-332_A1,2,0,0,0,0,2
TTCTAGAAAGTCTTAT-1_V12D07-332_A1,3,1,1,3,0,8
CCTTCAGTTAAAGTGA-1_V12D07-332_A1,1,0,0,1,0,2
TAGCTAGTGATGATGG-1_V12D07-332_A1,0,0,0,0,0,0
AGCCCGGTAGCCTGTA-1_V12D07-332_A1,1,0,0,2,0,3
TACCTCAGTTGTCTGT-1_V12D07-332_A1,0,2,0,0,0,2
GACGGGTTGGCCCGTA-1_V12D07-332_A1,3,0,0,0,0,3
GAAACCTATACAAATG-1_V12D07-332_A1,1,1,0,1,0,3
TCCACCTCTAGCCTTT-1_V12D07-332_A1,0,1,0,2,0,3
AAGACCCAACTGAACA-1_V12D07-332_A1,2,1,0,1,0,4
CATACACGGTTCCCAC-1_V12D07-332_A1,2,0,0,2,0,4
ACTACGCGTTAGAATT-1_V12D07-332_A1,3,0,0,1,0,4
CTTGGCCAAGCTGGGA-1_V12D07-332_A1,3,0,1,3,0,7
TTACCCTAGGGATTGG-1_V12D07-332_A1,4,1,0,0,0,5
TTCGCACTGTACGACA-1_V12D07-332_A1,3,1,0,1,0,5
TAGGTGTTCCACAGAT-1_V12D07-332_A1,2,0,0,1,0,3
GAAGCCTGCACATTCC-1_V12D07-332_A1,1,0,0,1,0,2
GGCTTTCAATAAGGGT-1_V12D07-332_A1,0,0,2,3,0,5
TCCAGGGTATATACGA-1_V12D07-332_A1,0,0,0,0,0,0
CTCGCCGAATGTAGGG-1_V12D07-332_A1,0,3,1,0,0,4
AGGAAGCTGTCCGCCG-1_V12D07-332_A1,7,0,0,0,0,7
GTCTCAAGGCCCGGCT-1_V12D07-332_A1,3,0,0,0,0,3
ACCGACACATCTCCCA-1_V12D07-332_A1,4,0,0,0,0,4
TATACGCGTCATCACT-1_V12D07-332_A1,1,1,0,0,0,2
ATCTGGGCTGTTCTTG-1_V12D07-332_A1,3,0,0,0,0,3
TCAAATTTGAGACTCA-1_V12D07-332_A1,5,2,0,0,0,7
GTTAAGGGTGCGATGT-1_V12D07-332_A1,0,1,0,1,0,2
AGCAAAGGCCGCTAGT-1_V12D07-332_A1,1,0,0,0,0,1
TTATAGGTAATTGTCT-1_V12D07-332_A1,2,0,1,0,0,3
TTGTGCAGCCACGTCA-1_V12D07-332_A1,4,0,0,0,0,4
ACGGACTCTCAAAGCG-1_V12D07-332_A1,2,2,0,1,0,5
ATGCTCTGGCGCGGTA-1_V12D07-332_A1,2,1,0,1,0,4
ATAATCTTGGAGAACC-1_V12D07-332_A1,5,0,0,1,0,6
CTCATTGCTCTAACAA-1_V12D07-332_A1,4,0,1,0,0,5
TAGGTGACGATAACCT-1_V12D07-332_A1,1,2,0,0,0,3
CGGATCCTCAAGGACT-1_V12D07-332_A1,2,0,0,1,0,3
GGGCGTGGTTTCCCAG-1_V12D07-332_A1,2,0,0,0,0,2
TGGCTATGTGACATAC-1_V12D07-332_A1,1,1,0,3,0,5
CTTAGTGTAGTAGCAT-1_V12D07-332_A1,3,2,0,0,0,5
GGATTGCTGTGACTCC-1_V12D07-332_A1,3,0,0,0,0,3
ACTTCCATGCGGGACA-1_V12D07-332_A1,1,0,0,3,0,4
ACTCAAGTGCAAGGCT-1_V12D07-332_A1,2,0,0,2,0,4
ACAAGGATGCTTTAGG-1_V12D07-332_A1,1,1,0,0,0,2
TTGAACGACGTGCTGA-1_V12D07-332_A1,2,1,0,0,0,3
ATTCATCGTTGAGGCA-1_V12D07-332_A1,2,0,1,1,0,4
TGCAACCCATCTGCGG-1_V12D07-332_A1,3,0,0,1,0,4
AGTGCTAAACACAGCA-1_V12D07-332_A1,3,1,0,2,0,6
AACTCCAGAGCGTGTT-1_V12D07-332_A1,4,0,0,0,0,4
TCTCCACAAGTTGAAT-1_V12D07-332_A1,4,0,0,0,0,4
CTTTGCATCGCTCTTG-1_V12D07-332_A1,1,1,0,3,0,5
TCACAAACCGAGGTAC-1_V12D07-332_A1,5,0,0,1,0,6
CCGTAGGAAATCCCTG-1_V12D07-332_A1,3,1,0,1,0,5
AAACATTTCCCGGATT-1_V12D07-332_A1,7,0,0,0,0,7
GCCTCCGACAATTCAC-1_V12D07-332_A1,4,0,0,3,0,7
TCTGCATACCTTGCTT-1_V12D07-332_A1,2,0,0,0,0,2
ACCCATTTGTCCCTCT-1_V12D07-332_A1,1,0,0,0,0,1
CTGCAGAGAATCAGAG-1_V12D07-332_A1,2,1,0,3,0,6
GGAAACTAAATGGGCC-1_V12D07-332_A1,3,0,0,0,0,3
CAACCTACCGAGCAGT-1_V12D07-332_A1,5,1,0,1,0,7
CCGTAGGGTTGTTTAC-1_V12D07-332_A1,2,0,1,1,0,4
TTCCATCGACAGCGTG-1_V12D07-332_A1,2,1,0,2,0,5
ATCTCCCACGGAATAT-1_V12D07-332_A1,5,1,0,0,0,6
GTTTCAAACGAGTTGT-1_V12D07-332_A1,4,2,0,0,0,6
GGAACTTTGGCGATTA-1_V12D07-332_A1,2,1,0,2,0,5
CTGCAAGCACGTTCCG-1_V12D07-332_A1,5,0,0,0,0,5
CACAGTCCCGCTTCGC-1_V12D07-332_A1,1,1,0,2,0,4
TACGCTCGGTATTGGA-1_V12D07-332_A1,2,0,0,3,0,5
CTGGTAAAGTGTGGGC-1_V12D07-332_A1,3,0,0,0,0,3
CAACCAGTGGCCTACC-1_V12D07-332_A1,2,0,0,0,0,2
TCTTCGCGGTGAGAGG-1_V12D07-332_A1,4,1,0,0,0,5
TTCGGGTTGCCACGGG-1_V12D07-332_A1,8,0,0,0,0,8
ACCGATAGGCATAACC-1_V12D07-332_A1,0,1,0,1,0,2
CTTATAGATGGCTGTT-1_V12D07-332_A1,2,1,0,1,0,4
AGACGCCCACTTCGCC-1_V12D07-332_A1,1,2,0,1,0,4
AGGTCGCCTCCCAACA-1_V12D07-332_A1,6,1,0,0,0,7
CCTCACGTCAGCTAAT-1_V12D07-332_A1,1,1,0,1,0,3
CCACCTGTATGGAATA-1_V12D07-332_A1,3,1,0,0,0,4
GGACTCGAAGCTTTCA-1_V12D07-332_A1,6,0,0,0,0,6
AAGCCGGAGAGCAGGA-1_V12D07-332_A1,2,1,0,0,0,3
GCCTATCAGGTAAGAT-1_V12D07-332_A1,3,0,0,0,0,3
TCAGAGTGTGAGCATG-1_V12D07-332_A1,2,2,0,1,0,5
AAACATGGTGAGAGGA-1_V12D07-332_A1,1,1,0,0,0,2
ATCATTGTACCGCATT-1_V12D07-332_A1,1,1,0,0,0,2
TCAGCTTGAGCTTTCG-1_V12D07-332_A1,3,1,1,0,0,5
CCGCGCAAGATACCCA-1_V12D07-332_A1,3,1,1,0,0,5
CTATACTTAAAGCGAG-1_V12D07-332_A1,2,1,0,0,0,3
ACCGTCCACTGGGCCC-1_V12D07-332_A1,0,2,1,0,0,3
AAGACCAAATAACTCA-1_V12D07-332_A1,1,2,1,0,0,4
TGTTTCTGAAGCGTGC-1_V12D07-332_A1,1,0,0,0,0,1
TTCTCTTACAGGTGAT-1_V12D07-332_A1,2,0,1,2,0,5
AATTCATTGTCATGCA-1_V12D07-332_A1,0,1,0,0,0,1
GCCCGAGAGTCTAAAT-1_V12D07-332_A1,1,2,1,0,0,4
ATATAGAGTATTGGTC-1_V12D07-332_A1,1,0,1,0,0,2
TTGAAGGATGGGCGCC-1_V12D07-332_A1,0,1,0,0,0,1
TAGTACCACAACTTTC-1_V12D07-332_A1,1,0,0,2,0,3
ATCCCATCCACAGCGC-1_V12D07-332_A1,0,1,0,0,0,1
CTTAGGTATAGACCAG-1_V12D07-332_A1,0,0,0,1,0,1
TGACTCCGAATCATAC-1_V12D07-332_A1,1,2,1,2,0,6
ACTACATCCCGACAAG-1_V12D07-332_A1,0,1,0,1,0,2
TTGCCGCAGACCTACA-1_V12D07-332_A1,3,0,1,0,0,4
TAAGAGGGACAGGGAC-1_V12D07-332_A1,0,0,1,0,0,1
CGAATGAAGTCATTGC-1_V12D07-332_A1,0,0,1,0,0,1
AAGGGAACGACTGGCT-1_V12D07-332_A1,1,1,0,0,0,2
CGAATCTGCTCGACGC-1_V12D07-332_A1,0,0,1,1,0,2
ATCGTGGAAAGTCTGG-1_V12D07-332_A1,0,0,0,1,0,1
CCTATGGCTCCTAGTG-1_V12D07-332_A1,3,0,3,0,0,6
CGTCGCTTGGTTATAC-1_V12D07-332_A1,1,0,1,0,0,2
TGCTTAGAGAGAATGC-1_V12D07-332_A1,2,0,0,0,0,2
GATTGCTCCAGTTGCA-1_V12D07-332_A1,0,0,0,0,0,0
CGTGCTTCTACCTAAA-1_V12D07-332_A1,1,0,0,0,0,1
ACTCCAATATCATCAT-1_V12D07-332_A1,0,0,0,0,0,0
GCCGACCCACGACTGC-1_V12D07-332_A1,1,1,0,0,0,2
GAGGGTAGTAACAAAG-1_V12D07-332_A1,0,0,0,0,0,0
GGCCGAGACTCTGGTG-1_V12D07-332_A1,3,0,1,0,0,4
TATATAGGGCTTTACG-1_V12D07-332_A1,0,2,0,0,0,2
TGCCGGATGTACGAGC-1_V12D07-332_A1,1,3,0,0,0,4
AGGTAGATCGAGATAT-1_V12D07-332_A1,1,1,0,3,0,5
GATCAACATAAAGGGA-1_V12D07-332_A1,1,0,0,0,0,1
TAACAGCGTTTGTGCT-1_V12D07-332_A1,2,1,2,0,0,5
CTATAGGCGTTGATGT-1_V12D07-332_A1,6,2,0,0,0,8
GGTTTAATTACCATCG-1_V12D07-332_A1,2,0,1,1,0,4
CTCTTCTGGAAGTTAG-1_V12D07-332_A1,3,0,0,0,0,3
ATCTGACATGGAAGGA-1_V12D07-332_A1,1,1,0,0,0,2
TACGTACTAGTGCTGA-1_V12D07-332_A1,5,0,2,1,0,8
ATGACTATCAGCTGTG-1_V12D07-332_A1,5,0,0,1,0,6
CTTTGGGATTGTTGCA-1_V12D07-332_A1,1,1,0,0,0,2
AGACTGTTACCGGGTC-1_V12D07-332_A1,2,0,0,0,0,2
TCCTAACCGTCGGGCA-1_V12D07-332_A1,0,0,0,0,0,0
ACGCAAACTAATAGAT-1_V12D07-332_A1,2,0,0,1,0,3
AAGTGAGTCGGGTTTA-1_V12D07-332_A1,3,1,0,0,0,4
TAAAGCGGTATTTCCA-1_V12D07-332_A1,2,0,0,1,0,3
CTCCTCCAGCTCACAC-1_V12D07-332_A1,2,0,0,0,0,2
CGGTCCGTCGCAAGCC-1_V12D07-332_A1,0,0,0,1,0,1
CCTATATTTGTCCTGG-1_V12D07-332_A1,2,2,0,0,0,4
TCCAATAAAGGCTACC-1_V12D07-332_A1,2,2,0,0,0,4
AAAGGCTACGGACCAT-1_V12D07-332_A1,5,2,0,0,0,7
CGTGACCAGTCCTCTG-1_V12D07-332_A1,2,0,0,3,0,5
GATCTGCTATCTAAGG-1_V12D07-332_A1,2,1,0,1,0,4
CGAATGACGCATAATG-1_V12D07-332_A1,1,0,0,2,0,3
GCTCAATGTAATACCG-1_V12D07-332_A1,5,0,0,1,0,6
CTATGCCCGAATGCAA-1_V12D07-332_A1,3,0,0,1,0,4
CACAGGGCCGTTGTCA-1_V12D07-332_A1,5,0,0,0,0,5
TCAATACGCCGTCATG-1_V12D07-332_A1,0,0,0,0,0,0
AGCGGACACTTCGTAG-1_V12D07-332_A1,6,1,1,0,0,8
ATACGTTATGCACGGA-1_V12D07-332_A1,0,1,0,1,0,2
GAGTAGATACTAGTTG-1_V12D07-332_A1,0,0,0,0,0,0
CCAGCTCGAACGCATT-1_V12D07-332_A1,4,0,1,0,0,5
TGCTTCCCAAGCAGTA-1_V12D07-332_A1,2,1,0,1,0,4
GTAGACACGCCTGACT-1_V12D07-332_A1,2,1,0,0,0,3
CTCACATTTACTAAAT-1_V12D07-332_A1,1,1,1,0,0,3
GAATGCGAATCGGTTC-1_V12D07-332_A1,5,0,0,0,0,5
TAAGGCCCGTCACCCT-1_V12D07-332_A1,7,0,0,1,0,8
GAGTATGCGCGTGCAT-1_V12D07-332_A1,5,0,0,1,0,6
ATCCACATCGACAGAA-1_V12D07-332_A1,4,1,0,0,0,5
TAGACGAAACGCCAAT-1_V12D07-332_A1,1,2,0,1,0,4
CAGCAGTCTGTGCTGC-1_V12D07-332_A1,4,1,0,0,0,5
CTCACTGTGATACTTA-1_V12D07-332_A1,2,1,0,2,0,5
TTAATTGCTTTGGGTG-1_V12D07-332_A1,3,1,0,2,0,6
GTAGTCTACGATATTG-1_V12D07-332_A1,2,0,0,0,0,2
TTGCCGCTTTCTAGTA-1_V12D07-332_A1,5,0,0,2,0,7
GAACCTTTAACGATCC-1_V12D07-332_A1,2,2,0,0,0,4
TGGACCAATCTAAGAT-1_V12D07-332_A1,2,0,0,0,0,2
CTAGTAGAAAGGGATT-1_V12D07-332_A1,3,0,0,1,0,4
AACCTCGCTTTAGCCC-1_V12D07-332_A1,3,0,0,1,0,4
GAGTGTCAACCAGAAA-1_V12D07-332_A1,1,0,0,1,0,2
GTGATCCTTGTCATGA-1_V12D07-332_A1,4,0,0,0,0,4
CTCAACTAACCCGGAT-1_V12D07-332_A1,3,0,0,1,0,4
AGTGGCGTCTGAAGGT-1_V12D07-332_A1,3,1,0,0,0,4
GGGAAGGGCTTTCTCA-1_V12D07-332_A1,2,0,0,0,0,2
AGGCCTGAGAATCTCG-1_V12D07-332_A1,3,0,0,0,0,3
AGCCACAGGTTACCCG-1_V12D07-332_A1,5,1,0,0,0,6
TGCAATCTAACACGGT-1_V12D07-332_A1,1,1,0,2,0,4
GTTTGGGTTTCGCCCG-1_V12D07-332_A1,5,0,0,1,0,6
CCTATGTCCACTCCAC-1_V12D07-332_A1,3,1,0,0,0,4
CTGCCTTTCTAGTAAA-1_V12D07-332_A1,1,1,0,0,0,2
TTAGTAAACCTGCTCT-1_V12D07-332_A1,2,1,0,1,0,4
TTGTGGTGGTACTAAG-1_V12D07-332_A1,3,0,0,0,0,3
CCTCCTGTTGTGTCGT-1_V12D07-332_A1,5,0,0,2,0,7
ACAAAGCATGACCTAG-1_V12D07-332_A1,1,0,0,1,0,2
ATAGCAACTAGGGAAG-1_V12D07-332_A1,3,0,0,4,0,7
CCGCTCTTCCGAACTA-1_V12D07-332_A1,4,0,0,0,0,4
TAGAATAGCCGATGAA-1_V12D07-332_A1,4,0,0,2,0,6
GGTCTCCGTCCAGGTT-1_V12D07-332_A1,5,0,1,1,0,7
TAATTACGTCAGTAGA-1_V12D07-332_A1,5,1,0,0,0,6
TCAGCCAATCCGTAAA-1_V12D07-332_A1,0,0,0,3,0,3
ATCATAGCCCTATGTA-1_V12D07-332_A1,0,0,0,3,0,3
GAGGCCTGTTGATACA-1_V12D07-332_A1,6,0,0,3,0,9
ATATACGCTCGTGACG-1_V12D07-332_A1,4,0,0,2,0,6
CCCTTTAATGGAGTTC-1_V12D07-332_A1,7,0,0,0,0,7
TTACACGATCTGCGAC-1_V12D07-332_A1,0,0,0,1,0,1
TCGCATAAAGGGCGCA-1_V12D07-332_A1,1,0,0,3,0,4
TGTAGCCATCCCATTC-1_V12D07-332_A1,3,0,0,1,0,4
GGGTCTATCGCTTTCC-1_V12D07-332_A1,2,1,0,0,0,3
GGAGGGTCAAGTAAGA-1_V12D07-332_A1,5,0,0,2,0,7
TACGGCATGGACGCTA-1_V12D07-332_A1,4,0,0,2,0,6
CACGTCAATCAATGGA-1_V12D07-332_A1,1,0,0,0,0,1
CGCTTGGACGGATAGA-1_V12D07-332_A1,7,0,0,0,0,7
CGCGGTACGGTATACA-1_V12D07-332_A1,1,0,1,1,0,3
CCTACTCAACACGATT-1_V12D07-332_A1,5,0,0,2,0,7
CGTTTGGTGTTGTGGG-1_V12D07-332_A1,2,0,0,2,0,4
GTTGTTGCAAGATGGC-1_V12D07-332_A1,0,1,0,0,0,1
CATTCGTCGTAGCGGT-1_V12D07-332_A1,8,1,0,0,0,9
CAGCCTCGATAGCGGT-1_V12D07-332_A1,3,1,0,0,0,4
TCATAAGTCCAAGAAG-1_V12D07-332_A1,2,1,0,4,0,7
AAAGTGCCATCAATTA-1_V12D07-332_A1,0,0,0,1,0,1
GTTGCAGTCGACAACA-1_V12D07-332_A1,5,0,0,0,0,5
TAAATGGGCTACTGAG-1_V12D07-332_A1,2,2,0,0,0,4
GGACAAGCCATGATCG-1_V12D07-332_A1,3,2,1,1,0,7
TCCAATGCGTCGCCGC-1_V12D07-332_A1,1,3,0,1,0,5
AAAGAATGACCTTAGA-1_V12D07-332_A1,0,0,0,0,0,0
CCTATTATTCCGGCCG-1_V12D07-332_A1,3,0,2,0,0,5
CAGTAAGGGACGTCTC-1_V12D07-332_A1,0,0,0,0,0,0
GGGATGGACCCGCGTC-1_V12D07-332_A1,2,0,0,0,0,2
GACGCATACCCGTCGG-1_V12D07-332_A1,1,1,0,1,0,3
GGGCAGGATTTCTGTG-1_V12D07-332_A1,3,0,0,0,0,3
TATCTGAGCCGATATT-1_V12D07-332_A1,0,1,1,0,0,2
AATGTATGGCACTGTA-1_V12D07-332_A1,1,0,2,0,0,3
GCCTTTGTCAGTGGAC-1_V12D07-332_A1,1,0,0,0,0,1
AACCATAGGGTTGAAC-1_V12D07-332_A1,1,0,2,1,0,4
AAACTTAATTGCACGC-1_V12D07-332_A1,0,0,0,2,0,2
TAGGCGGCTGCAAAGA-1_V12D07-332_A1,1,0,2,0,0,3
TCCATCAATACTAATC-1_V12D07-332_A1,1,2,1,1,0,5
ACCTCGAACTTATGCT-1_V12D07-332_A1,0,2,0,2,0,4
ACAAACCATGCGTCCT-1_V12D07-332_A1,0,1,0,0,0,1
ACACCGGTCTGACCGC-1_V12D07-332_A1,3,1,0,1,0,5
ATGGCAGCATTACGAT-1_V12D07-332_A1,0,2,1,0,0,3
CTGGTGAATGGGCCTA-1_V12D07-332_A1,0,0,0,0,0,0
CACAGAGACGAGGACG-1_V12D07-332_A1,1,1,0,0,0,2
GCACAAACCCTAGATG-1_V12D07-332_A1,2,0,1,0,0,3
ACTATGTCCAGCTGCC-1_V12D07-332_A1,2,1,0,0,0,3
AAGCCGCCGTGAAATC-1_V12D07-332_A1,0,1,0,1,0,2
ATGGGTGTATACCTCC-1_V12D07-332_A1,2,0,1,1,0,4
TAAGCGCGAATCAAAT-1_V12D07-332_A1,0,1,0,0,0,1
AGCCCGGCATTAGAGG-1_V12D07-332_A1,1,3,0,0,0,4
GTGATCAAGCGTGCAC-1_V12D07-332_A1,0,1,0,0,0,1
CTGCCTTTAATACCTT-1_V12D07-332_A1,2,0,0,0,0,2
TACCTCCACACCAATG-1_V12D07-332_A1,2,0,0,0,0,2
GAGCATCAACAACTTG-1_V12D07-332_A1,2,0,0,1,0,3
CATACGAACTAGCTGG-1_V12D07-332_A1,0,0,1,0,0,1
GGGAACGGTTTCAGAT-1_V12D07-332_A1,2,0,2,0,0,4
AGGGTGCCGTTCTTTA-1_V12D07-332_A1,2,0,1,1,0,4
ACGACTGGTCATACTC-1_V12D07-332_A1,1,3,1,1,0,6
GGATCTTACTGCCCTT-1_V12D07-332_A1,1,2,0,0,0,3
TACTCCTCTAGTTGAC-1_V12D07-332_A1,0,1,1,0,0,2
GTAGCTCCGGGAGGCT-1_V12D07-332_A1,0,4,1,0,0,5
GGACTCGTGAGTGGTC-1_V12D07-332_A1,2,1,3,2,0,8
GTAGTTCGAAGGCGAA-1_V12D07-332_A1,2,1,0,0,0,3
CTCAAACCACTGCCCG-1_V12D07-332_A1,1,0,0,0,0,1
GAGGGAGTCAGATCGC-1_V12D07-332_A1,0,0,0,0,0,0
GCGTCCCTAAGACATA-1_V12D07-332_A1,0,2,1,1,0,4
TCTCTTACCGCGAACC-1_V12D07-332_A1,2,0,1,1,0,4
GGCTACTATACACTCC-1_V12D07-332_A1,3,2,0,1,0,6
CGTTGCCCGCGTGGGA-1_V12D07-332_A1,2,0,0,0,0,2
TATAGAGTCGCTTGAA-1_V12D07-332_A1,2,0,1,0,0,3
ATGTTGTAGTCTGTTT-1_V12D07-332_A1,1,1,0,2,0,4
AGTATACACAGCGACA-1_V12D07-332_A1,0,0,0,0,0,0
TGTGGTTGCTAAAGCT-1_V12D07-332_A1,4,1,1,1,0,7
TGATTCCCGGTTACCT-1_V12D07-332_A1,4,1,1,0,0,6
CACTGACGATTGTGGA-1_V12D07-332_A1,2,0,0,0,0,2
AACATTGTGACTCGAG-1_V12D07-332_A1,1,3,0,0,0,4
GTCCAATATTTAGCCT-1_V12D07-332_A1,4,1,0,0,0,5
GCTCTTTCCGCTAGTG-1_V12D07-332_A1,4,0,0,3,0,7
GGGTCAGGAGCTAGAT-1_V12D07-332_A1,1,1,1,0,0,3
AGGTGGTGACCTTCGC-1_V12D07-332_A1,3,0,0,0,0,3
CCCGGGTCGTTCAGGG-1_V12D07-332_A1,0,0,0,0,0,0
AGCCAAGCTTTGTGTC-1_V12D07-332_A1,3,1,1,1,0,6
TGTGGCGGGCTTCTGG-1_V12D07-332_A1,1,1,0,1,0,3
CGAGGGTATCCAGGTG-1_V12D07-332_A1,0,0,0,0,0,0
CGTTCAGACCCGCGAA-1_V12D07-332_A1,1,0,0,1,0,2
TCATATGAGCTTTGTT-1_V12D07-332_A1,2,1,0,0,0,3
AGTTGACGGTCCTTGC-1_V12D07-332_A1,3,0,0,0,0,3
ATAATTAGCTAAGTAG-1_V12D07-332_A1,3,0,0,1,0,4
GGTCTTGAGCGCTCTT-1_V12D07-332_A1,0,1,1,1,0,3
CGTTGTCGGCAATTGA-1_V12D07-332_A1,2,0,0,1,0,3
TCTTGCTCCCGATACT-1_V12D07-332_A1,1,0,1,0,0,2
AGCAGAAGGAGAAAGA-1_V12D07-332_A1,4,1,0,2,0,7
GAAGCCACTGATTATG-1_V12D07-332_A1,4,0,0,0,0,4
TGCTCTTGAGAGTTTG-1_V12D07-332_A1,3,0,0,3,0,6
GACATCCGTCGAACTG-1_V12D07-332_A1,3,1,0,1,0,5
AGATATAATACGACTA-1_V12D07-332_A1,0,2,0,2,0,4
TCGCTACTGGCTTTGA-1_V12D07-332_A1,1,1,0,0,0,2
GTGACAGCTTCCCACT-1_V12D07-332_A1,2,0,0,2,0,4
GTGACGCAGGTTTCAT-1_V12D07-332_A1,4,1,0,0,0,5
GGGAAGACGGTCTGTC-1_V12D07-332_A1,3,3,0,0,0,6
CGTCGCATGTGAGCCA-1_V12D07-332_A1,3,0,0,2,0,5
AGAAGGTTGTAGGTCG-1_V12D07-332_A1,4,0,0,0,0,4
GGCCGGCGTCTGCTAT-1_V12D07-332_A1,5,0,0,1,0,6
TTGACCAGGAACAACT-1_V12D07-332_A1,2,0,1,0,0,3
AGTCGTATAAAGCAGA-1_V12D07-332_A1,6,1,0,0,0,7
GGCGTAGGGAAAGCTG-1_V12D07-332_A1,4,0,0,2,0,6
AAACCTAAGCAGCCGG-1_V12D07-332_A1,2,0,1,1,0,4
ATTGCCTTTATGTTTG-1_V12D07-332_A1,3,0,0,0,0,3
CAGGCAGTCTTACCAG-1_V12D07-332_A1,1,0,0,3,0,4
AGCTAAGTACGCAGGC-1_V12D07-332_A1,1,1,0,0,0,2
AAATCCGATACACGCC-1_V12D07-332_A1,2,0,0,4,0,6
CGAGAGCTTTCACTAC-1_V12D07-332_A1,3,0,0,1,0,4
CGCCCAGCGTTTCACG-1_V12D07-332_A1,4,0,0,2,0,6
TTAAGTATTGTTATCC-1_V12D07-332_A1,3,0,0,1,0,4
AAACGGGCGTACGGGT-1_V12D07-332_A1,3,0,0,0,0,3
GTATCCTTTGGTAACC-1_V12D07-332_A1,1,0,0,3,0,4
CATAGTCAAATACATA-1_V12D07-332_A1,4,1,0,1,0,6
TCTATGCTATAACGAC-1_V12D07-332_A1,3,0,0,2,0,5
ACGTTCTGTACAAGTC-1_V12D07-332_A1,1,0,0,3,0,4
CGCGAAGTGGCATACT-1_V12D07-332_A1,1,0,0,1,0,2
ACCAACCGCACTCCAC-1_V12D07-332_A1,0,0,0,1,0,1
GTCATGCGCGAGGGCT-1_V12D07-332_A1,1,0,2,2,0,5
TAGGCTAAAGTGGCAC-1_V12D07-332_A1,0,0,0,0,0,0
TGGCTACACTCTACCT-1_V12D07-332_A1,2,0,0,0,0,2
GTCAACCAGGCCTATA-1_V12D07-332_A1,2,1,0,1,0,4
ATCTTATCGCACACCC-1_V12D07-332_A1,1,0,0,6,0,7
GTCTATTGCATGCTCG-1_V12D07-332_A1,3,1,0,1,0,5
GCACGTGGTTTACTTA-1_V12D07-332_A1,0,3,0,0,0,3
ATTCGCGCCTTGAGAG-1_V12D07-332_A1,1,5,0,1,0,7
AGCGATGCGCCTAATA-1_V12D07-332_A1,4,0,0,3,0,7
TCTATAGGTGGGTAAT-1_V12D07-332_A1,2,1,0,0,0,3
AGATACCAATAGAACC-1_V12D07-332_A1,4,0,0,1,0,5
CGTGTATGGGAGCTGA-1_V12D07-332_A1,5,0,0,0,0,5
ATGTACATGCGGTGAG-1_V12D07-332_A1,4,0,0,1,0,5
TTGGCTCAATATGTGT-1_V12D07-332_A1,2,0,0,3,0,5
GTTCGGAGCACTCAAC-1_V12D07-332_A1,6,1,0,3,0,10
TCCCTCTTCTCAAGGG-1_V12D07-332_A1,3,0,0,1,0,4
TTACGTATCTATGACA-1_V12D07-332_A1,1,2,0,0,0,3
CCCATATAGGTCGATT-1_V12D07-332_A1,1,2,0,2,0,5
GTCCACGTCGCATTCG-1_V12D07-332_A1,2,0,0,1,0,3
AATTGTGGTTGCCAAA-1_V12D07-332_A1,3,0,0,0,0,3
AGGAACGAACGACTTC-1_V12D07-332_A1,1,0,0,3,0,4
TAATTCCAATGCTTCA-1_V12D07-332_A1,2,1,0,0,0,3
AGGGCCCTAATGTTCT-1_V12D07-332_A1,5,0,0,0,0,5
AGGTGTTGCCGACCAC-1_V12D07-332_A1,2,1,0,1,0,4
CTGAGAGTAGAAATAC-1_V12D07-332_A1,4,3,0,0,0,7
TAGAAGAAGGGTTACA-1_V12D07-332_A1,4,0,0,1,0,5
GGTGACTGATAGAGAG-1_V12D07-332_A1,2,0,0,0,0,2
TACCCTCGGTAACCCT-1_V12D07-332_A1,4,1,0,1,0,6
TGTAAGACTGATAAGA-1_V12D07-332_A1,0,1,2,0,0,3
GTCACTCATGAGCGAT-1_V12D07-332_A1,0,2,0,2,0,4
CGGTTTACTGAACATT-1_V12D07-332_A1,0,1,0,0,0,1
GAGATCGATCTTACTC-1_V12D07-332_A1,0,0,0,0,0,0
TCTTTCATCCGTCCTT-1_V12D07-332_A1,0,0,2,0,0,2
TCGGATCTGGATGACC-1_V12D07-332_A1,0,1,0,0,0,1
GTCCTAGGATACCTTA-1_V12D07-332_A1,2,0,0,1,0,3
TGTACCCGACCCTAAT-1_V12D07-332_A1,0,1,0,0,0,1
AGGTTCTCCTTTCCGG-1_V12D07-332_A1,0,0,0,0,0,0
AATTGCGTGGATTACA-1_V12D07-332_A1,2,1,0,0,0,3
CGATAGCGATACAGTG-1_V12D07-332_A1,2,0,0,3,0,5
CGCCCTAATTGTTCAA-1_V12D07-332_A1,3,0,1,2,0,6
ATTATGAGACCCAATT-1_V12D07-332_A1,2,2,1,0,0,5
CCTCCTAGCTAGAGTC-1_V12D07-332_A1,1,0,3,0,0,4
CGAAGGGTTTCAGATT-1_V12D07-332_A1,3,0,1,0,0,4
CACAAGCTAAGAAAGG-1_V12D07-332_A1,1,0,1,0,0,2
CACCGGTAGAGACATT-1_V12D07-332_A1,0,0,1,0,0,1
ACTCATGGCAGCCTTC-1_V12D07-332_A1,1,2,1,0,0,4
CATCCAATATAGTTTG-1_V12D07-332_A1,2,1,1,0,0,4
CAGATATGAAGATGAC-1_V12D07-332_A1,0,0,0,1,0,1
GCAAAGGGCGTTAGCC-1_V12D07-332_A1,1,0,0,1,0,2
CTGTTGTTCAGTCGTA-1_V12D07-332_A1,0,0,1,1,0,2
AAAGGCCCTATAATAC-1_V12D07-332_A1,1,0,1,0,0,2
AACATTGAAGTTGATC-1_V12D07-332_A1,0,0,0,0,0,0
GCTAGCGATAGGTCTT-1_V12D07-332_A1,0,1,0,0,0,1
ATTGCCTATTAGACCG-1_V12D07-332_A1,1,2,0,0,0,3
GGGCGTTTACATTCAT-1_V12D07-332_A1,1,1,0,0,0,2
CCTCTACAAGGATTGG-1_V12D07-332_A1,3,1,0,0,0,4
AGTGACTGTGACACAA-1_V12D07-332_A1,2,2,2,0,0,6
AGCCCTCCCTGGTGGC-1_V12D07-332_A1,1,0,1,0,0,2
CGGTTGAGTATCCTTC-1_V12D07-332_A1,0,3,0,2,0,5
CATTATCCCATTAACG-1_V12D07-332_A1,2,0,1,0,0,3
AATGTGCTAATCTGAG-1_V12D07-332_A1,2,1,0,0,0,3
CTTAGTTGAGGAATCG-1_V12D07-332_A1,2,2,1,0,0,5
CTTCTGGGCGTACCTA-1_V12D07-332_A1,0,0,0,0,0,0
AGTCAAATGATGTGAT-1_V12D07-332_A1,1,1,1,0,0,3
TGAACAAGCAGGGACT-1_V12D07-332_A1,2,1,1,0,0,4
AATACCGGAGGGCTGT-1_V12D07-332_A1,1,2,0,1,0,4
GTTTGGTGATCGGTGC-1_V12D07-332_A1,1,0,0,1,0,2
GACTGCTGGTGAGAAA-1_V12D07-332_A1,2,0,0,0,0,2
CGATCCTCGCAACATA-1_V12D07-332_A1,2,1,0,1,0,4
CCAACCTTATGTAACT-1_V12D07-332_A1,3,1,2,0,0,6
CGTGGTACCCAAAGGC-1_V12D07-332_A1,3,0,2,0,0,5
AACCCGACAACCCGTG-1_V12D07-332_A1,1,0,0,2,0,3
TATGTAAAGTGCTTAA-1_V12D07-332_A1,2,0,0,1,0,3
GCAAGTGTAAAGCATG-1_V12D07-332_A1,2,2,1,1,0,6
GTAACTGCCCAAGGAG-1_V12D07-332_A1,0,0,0,0,0,0
GGTGCATAAATGATTA-1_V12D07-332_A1,2,0,0,0,0,2
TAGTCCCGGAGACCAC-1_V12D07-332_A1,1,0,0,0,0,1
CGGCCAGAGCGACCAT-1_V12D07-332_A1,1,1,1,0,0,3
TGAATGAGTGTTTCCC-1_V12D07-332_A1,2,0,0,2,0,4
TTCACTTCCTAGAACG-1_V12D07-332_A1,1,2,1,0,0,4
CGCTTAGTATTGATAC-1_V12D07-332_A1,2,0,0,1,0,3
AACGCGACCTTGGGCG-1_V12D07-332_A1,3,0,1,0,0,4
GTGCACCAGCTTCAAC-1_V12D07-332_A1,4,1,0,3,0,8
TTCTATTAAACGCAGC-1_V12D07-332_A1,2,0,0,0,0,2
TGGCAAGCACAAGTCG-1_V12D07-332_A1,2,0,0,0,0,2
ATCTGCTGTTATCGCC-1_V12D07-332_A1,5,0,0,1,0,6
AATTCCAAGCATGTAC-1_V12D07-332_A1,4,1,0,2,0,7
AAACGGTTGCGAACTG-1_V12D07-332_A1,2,1,0,1,0,4
GAAGGAGTCGAGTGCG-1_V12D07-332_A1,2,0,0,4,0,6
GGCAAGCCCATAGTGG-1_V12D07-332_A1,0,1,0,0,0,1
TGACCAAATCTTAAAC-1_V12D07-332_A1,3,0,0,0,0,3
TTCGGTACTGTAGAGG-1_V12D07-332_A1,5,1,0,0,0,6
ATGTACGATGACGTCG-1_V12D07-332_A1,2,2,0,0,0,4
ATCTAGCTTGTGAGGG-1_V12D07-332_A1,1,0,0,1,0,2
AGCGGGTCTGACACTC-1_V12D07-332_A1,5,2,0,1,0,8
GAGGTACGCGTGTCCC-1_V12D07-332_A1,2,1,0,2,0,5
GCACTGCCTACCTTTA-1_V12D07-332_A1,4,0,0,1,0,5
GGAGCGAGGCCTACTT-1_V12D07-332_A1,6,0,0,1,0,7
AAACTCGGTTCGCAAT-1_V12D07-332_A1,4,2,0,2,0,8
GGCGCTTCATTCCCTG-1_V12D07-332_A1,4,0,0,4,0,8
TGCTCGGTGGGTCACC-1_V12D07-332_A1,3,0,0,0,0,3
AAGCGCAGGGCTTTGA-1_V12D07-332_A1,1,1,0,2,0,4
GACCTTCCACGTCTAC-1_V12D07-332_A1,4,2,0,2,0,8
GTTAGCCCATGACATC-1_V12D07-332_A1,4,0,0,2,0,6
AATTCGATTCGAGGAT-1_V12D07-332_A1,5,0,0,0,0,5
AGTCTTTAAAGTGTCC-1_V12D07-332_A1,2,1,0,2,0,5
GACTAGGCCGTTAGGT-1_V12D07-332_A1,2,0,0,2,0,4
TCCAAGCCTAGACACA-1_V12D07-332_A1,4,0,0,0,0,4
GATTGGGAAAGGTTGT-1_V12D07-332_A1,1,1,0,3,0,5
GATGAGGAACCTTCGG-1_V12D07-332_A1,4,2,1,2,0,9
TGAATACCGACGCGTA-1_V12D07-332_A1,3,0,0,1,0,4
AATCGTGAGCCGAGCA-1_V12D07-332_A1,1,1,0,0,0,2
GCGAAGAATCTGACGG-1_V12D07-332_A1,3,1,0,0,0,4
GAACAACTGGGATGAA-1_V12D07-332_A1,4,0,0,0,0,4
TCGCCGACATATTCGC-1_V12D07-332_A1,4,0,0,1,0,5
CGTAGAGAGTAATTAT-1_V12D07-332_A1,3,0,0,1,0,4
CGATAGTCGTACTGCA-1_V12D07-332_A1,6,0,0,3,0,9
CGCATGCCGAATGCGT-1_V12D07-332_A1,1,0,3,1,0,5
CTCTAGCCCTCGGAAA-1_V12D07-332_A1,5,0,0,1,0,6
TCCAACTCAGCTATCT-1_V12D07-332_A1,0,0,0,0,0,0
GTCTAGTGAGCCGCTT-1_V12D07-332_A1,1,0,1,2,0,4
TACCGAATAATTGTAA-1_V12D07-332_A1,0,0,0,2,0,2
ATATAACACGGGCGCA-1_V12D07-332_A1,0,0,0,2,0,2
GCATGCTAATAACGAT-1_V12D07-332_A1,4,0,0,0,0,4
TCCGGGCTTGACGGGA-1_V12D07-332_A1,0,0,0,1,0,1
ATTATTCAGAGTCACT-1_V12D07-332_A1,2,0,0,0,0,2
TAGCAGTATGACTAAA-1_V12D07-332_A1,0,0,2,1,0,3
TATGAAGAATTAAGGT-1_V12D07-332_A1,2,0,0,4,0,6
CAAGGCCAGTGGTGCA-1_V12D07-332_A1,6,0,1,0,0,7
TGCGTACGGCTAATTG-1_V12D07-332_A1,3,2,0,0,0,5
CAGATAATGGGCGGGT-1_V12D07-332_A1,0,0,1,4,0,5
GAGAACGGTTCTGACT-1_V12D07-332_A1,4,1,0,1,0,6
CGCTTCGGTCTAAGAC-1_V12D07-332_A1,7,1,0,3,0,11
AGCATTACGAGGCAAG-1_V12D07-332_A1,3,1,0,1,0,5
AAGTTGTGATGTTATA-1_V12D07-332_A1,6,0,0,0,0,6
TTGCTCATAGTACGTG-1_V12D07-332_A1,5,1,0,1,0,7
TACTTAAACATGTACA-1_V12D07-332_A1,1,2,0,0,0,3
AGTGAGTCGAATTAAC-1_V12D07-332_A1,3,0,0,0,0,3
TAGGCCTATATAGTCT-1_V12D07-332_A1,3,0,0,2,0,5
ACTCGCCGTTCGATAA-1_V12D07-332_A1,2,0,0,0,0,2
GGTACGTTGCGGCCGG-1_V12D07-332_A1,4,0,0,1,0,5
TATTGCCGGGCTTGTA-1_V12D07-332_A1,2,1,0,0,0,3
GGTAAACTCTGCGCTG-1_V12D07-332_A1,2,0,1,4,0,7
TCCCTTGTCTGAAACT-1_V12D07-332_A1,3,0,0,1,0,4
CATGATCGCTTTGAGA-1_V12D07-332_A1,3,2,0,2,0,7
GGACGGGCGACCAACC-1_V12D07-332_A1,4,0,0,0,0,4
GAGAGGCCTATGTGTA-1_V12D07-332_A1,4,0,0,0,0,4
TCGTAACTCCCAAGAC-1_V12D07-332_A1,1,1,0,0,0,2
CGTATCTAGAACTAAG-1_V12D07-332_A1,3,1,0,1,0,5
GCACCTTCCCGAAGGT-1_V12D07-332_A1,1,2,0,2,0,5
TACCTCTTTACCATCC-1_V12D07-332_A1,1,1,0,1,0,3
TGACTCTAACTGGTAA-1_V12D07-332_A1,1,1,0,0,0,2
GAGAAACTGGATCCCA-1_V12D07-332_A1,0,0,0,1,0,1
ATCCGGACCAGCCTGA-1_V12D07-332_A1,0,0,0,1,0,1
TTATTTAGGTTCCTTA-1_V12D07-332_A1,4,1,0,1,0,6
CGAATTCCCGGTTCAA-1_V12D07-332_A1,4,2,0,1,0,7
TAGTTTGATCGGTCGC-1_V12D07-332_A1,0,0,1,0,0,1
AGTCGAAACGATTCAG-1_V12D07-332_A1,0,2,0,0,0,2
ACGTCGGGCAACTCGG-1_V12D07-332_A1,1,2,0,0,0,3
ACTTGCTCTATCTACC-1_V12D07-332_A1,1,4,2,0,1,8
ATTACGGGCTACGGTT-1_V12D07-332_A1,4,0,2,1,0,7
GCAAACGTAAGCGACC-1_V12D07-332_A1,2,0,2,2,0,6
TTCGGACTGGGCATGG-1_V12D07-332_A1,2,0,0,1,0,3
GGGCCATTCGTGCTGG-1_V12D07-332_A1,0,2,4,1,0,7
GAGTTGTCACCAGTCT-1_V12D07-332_A1,1,0,0,0,0,1
AGTAATTTGCAAGCGT-1_V12D07-332_A1,0,0,1,1,0,2
GTGGCCGGTTTCTCGG-1_V12D07-332_A1,0,0,0,1,0,1
ATCTTAGGGCATTAAT-1_V12D07-332_A1,0,2,0,0,0,2
CTACATATCGCGGGAC-1_V12D07-332_A1,1,2,1,0,0,4
ATGGTATTTACTGATT-1_V12D07-332_A1,1,0,1,1,0,3
CCGTCAACCTCTGGCG-1_V12D07-332_A1,0,1,0,0,0,1
GCTTCGACGTTCAATC-1_V12D07-332_A1,0,1,1,0,0,2
GACCGATTAAATATGT-1_V12D07-332_A1,1,1,2,2,0,6
GTCGAATTTGGGCGCT-1_V12D07-332_A1,0,1,0,0,0,1
TCACGGCCCAAGAGAG-1_V12D07-332_A1,0,1,0,0,0,1
CTACGATCCTATCCTA-1_V12D07-332_A1,0,0,2,0,0,2
TGCAGTGGTAGGGAAC-1_V12D07-332_A1,1,0,1,1,0,3
TTGCCTAATCCAAAGT-1_V12D07-332_A1,0,1,0,0,0,1
AGCGAGACGTGAAGGC-1_V12D07-332_A1,0,0,0,0,0,0
TTCTACCTCAATCGGT-1_V12D07-332_A1,1,0,0,0,0,1
TACGCTGCTGTGTTAA-1_V12D07-332_A1,0,1,0,2,0,3
TAGTCCTGCACTAAGC-1_V12D07-332_A1,0,0,0,0,0,0
AGCACACGTTTAGACT-1_V12D07-332_A1,1,1,0,0,0,2
GTTCGACAATTGTATA-1_V12D07-332_A1,2,0,0,0,0,2
CCATGTTCATCTATAT-1_V12D07-332_A1,0,8,0,1,0,9
CCCTCGATAATACACA-1_V12D07-332_A1,2,0,0,0,0,2
ACTGCCCGCCATTCTC-1_V12D07-332_A1,3,0,0,0,0,3
CTATATCCAGCCTGGC-1_V12D07-332_A1,0,0,1,0,0,1
CGCACGTCTGTTTATG-1_V12D07-332_A1,1,1,0,0,0,2
AATCAGGTTTCATTTA-1_V12D07-332_A1,4,1,1,2,0,8
AGAGAAACACCAGAAA-1_V12D07-332_A1,2,1,1,1,0,5
ACCCGATTGGTTCCGA-1_V12D07-332_A1,2,0,1,0,0,3
TACCAGGAATCCCGTC-1_V12D07-332_A1,0,0,1,0,0,1
AAGTGCTTCTCTATTG-1_V12D07-332_A1,1,1,0,0,0,2
TGCATGTGACCCATAG-1_V12D07-332_A1,6,0,1,0,0,7
TAGATTCAAAGTGCGG-1_V12D07-332_A1,0,0,1,0,0,1
AGGGTCAGAGCACTCG-1_V12D07-332_A1,3,1,1,1,0,6
GTGAGATAACCTTATA-1_V12D07-332_A1,0,0,0,0,0,0
GTGTCAGTGTACGTGG-1_V12D07-332_A1,1,0,0,1,0,2
CTGTAGTGAGGATCGA-1_V12D07-332_A1,1,1,0,1,0,3
GATAGTGCGAGTAAGT-1_V12D07-332_A1,1,1,0,0,0,2
AGGGTTCAGACGGTCC-1_V12D07-332_A1,3,0,0,2,0,5
GGACTCGACAGCGCAT-1_V12D07-332_A1,0,0,2,0,0,2
CACTCTCAAGCATCGA-1_V12D07-332_A1,2,0,0,0,0,2
GAGCGGAATGCGGTGT-1_V12D07-332_A1,3,0,2,2,0,7
CAGTTCGAGGACCCGA-1_V12D07-332_A1,1,0,0,0,0,1
CGTAACTTCGACACTT-1_V12D07-332_A1,0,0,0,1,0,1
TGATCACCACACTGAC-1_V12D07-332_A1,3,0,1,2,0,6
CATACTTCTTTCTCCG-1_V12D07-332_A1,2,0,0,0,0,2
CAAGTAAGTGATAGAC-1_V12D07-332_A1,2,0,0,1,0,3
AGCCCGCAACAAGCAG-1_V12D07-332_A1,1,0,0,0,0,1
GCTCCATGCAAAGCAA-1_V12D07-332_A1,0,2,0,0,0,2
TCGTACCGACGTCAAG-1_V12D07-332_A1,1,0,0,1,0,2
ATTATCGGAATGTACG-1_V12D07-332_A1,1,1,0,0,0,2
ACCTACTATAAATCTA-1_V12D07-332_A1,0,1,0,3,0,4
TATCCTATCAACTGGT-1_V12D07-332_A1,3,1,0,1,0,5
GCGCGGTCTAGTAACT-1_V12D07-332_A1,2,0,0,0,0,2
CCTTCGTATAGAATCC-1_V12D07-332_A1,2,1,0,0,0,3
TGGGCGATACAATAAG-1_V12D07-332_A1,2,0,0,2,0,4
TGACATGTAACGTGAC-1_V12D07-332_A1,1,0,1,0,0,2
TTGGGAAGACGAGCCG-1_V12D07-332_A1,2,0,0,0,0,2
GGTGTAAATCGATTGT-1_V12D07-332_A1,4,3,0,1,0,8
GAACTGTGGAGAGACA-1_V12D07-332_A1,3,0,0,1,0,4
TCCACATCGTATATTG-1_V12D07-332_A1,3,0,0,0,0,3
CCTATGGTCAAAGCTG-1_V12D07-332_A1,1,0,0,0,0,1
TCCTTGTCCTTTAATT-1_V12D07-332_A1,2,0,0,1,0,3
AAGTTTATGGGCCCAA-1_V12D07-332_A1,0,0,0,0,0,0
GTCCGGGTTCACATTA-1_V12D07-332_A1,2,1,0,2,0,5
ATGTAGCGCGCGTAGG-1_V12D07-332_A1,1,1,0,0,0,2
TACGGAAGCCAAACCA-1_V12D07-332_A1,1,0,0,1,0,2
GCCCTGAGGATGGGCT-1_V12D07-332_A1,4,1,0,1,0,6
CGGGCGATGGATCACG-1_V12D07-332_A1,6,0,0,1,0,7
TGCGGACTTGACTCCG-1_V12D07-332_A1,0,0,0,3,0,3
TAATACTAGAACAGAC-1_V12D07-332_A1,2,2,0,2,0,6
TCAAATTGTTGTGCCG-1_V12D07-332_A1,9,0,0,0,0,9
GGGCAGTCAACGCCAA-1_V12D07-332_A1,7,0,0,2,0,9
TCGCTGCCAATGCTGT-1_V12D07-332_A1,5,1,0,0,0,6
TACGTGGGCCCAGGGC-1_V12D07-332_A1,5,1,0,0,0,6
GCCTACGTTCTGTGCA-1_V12D07-332_A1,2,0,0,0,0,2
TTGCGTGTGTAGGCAT-1_V12D07-332_A1,4,0,0,1,0,5
TCCTAAAGATTCAGAC-1_V12D07-332_A1,1,1,0,1,0,3
TGGGTGCACAAGCCAT-1_V12D07-332_A1,2,1,1,0,0,4
GGGAGCGACCGTAGTG-1_V12D07-332_A1,1,0,1,0,0,2
CATAGAGGAGATACTA-1_V12D07-332_A1,3,0,0,1,0,4
CTTCGATTGCGCAAGC-1_V12D07-332_A1,0,0,0,2,0,2
GTGCCTGAGACCAAAC-1_V12D07-332_A1,2,0,0,2,0,4
TCATCCTCAGCTGCTT-1_V12D07-332_A1,2,0,0,1,0,3
TGCAACTACTGGTTGA-1_V12D07-332_A1,2,0,0,0,0,2
ATGTTGATTAGAGACT-1_V12D07-332_A1,5,0,0,2,0,7
GTTTCTAGAGGCGCGG-1_V12D07-332_A1,5,0,0,2,0,7
TACAAGGGCTTCTTTA-1_V12D07-332_A1,3,0,0,3,0,6
ACAGGCACGGATCCTT-1_V12D07-332_A1,2,0,0,4,0,6
CCCAAGTCATTACACT-1_V12D07-332_A1,1,0,0,1,0,2
ACTCTGACCTAATAGA-1_V12D07-332_A1,4,1,0,0,0,5
GGATGGCTTGAAGTAT-1_V12D07-332_A1,1,0,0,3,0,4
ACCCTCCCGTCAGGGC-1_V12D07-332_A1,5,0,0,1,0,6
AGCTTCTTCTCGAGCA-1_V12D07-332_A1,6,0,0,2,0,8
TTGCGCTTGATCAATA-1_V12D07-332_A1,3,1,0,0,0,4
TGGGTGTAATAGATTT-1_V12D07-332_A1,2,1,0,0,0,3
CATGGTTTATTAATCA-1_V12D07-332_A1,8,0,0,1,0,9
TTGCCTTCTCGCCGGG-1_V12D07-332_A1,1,0,0,0,0,1
TTAAAGTAAGTCGCCA-1_V12D07-332_A1,2,1,0,2,0,5
AGTTGGCAAGGCTAGA-1_V12D07-332_A1,6,0,0,1,0,7
CCGCACTTGCAATGAC-1_V12D07-332_A1,2,0,0,3,0,5
AATGTTGTCGTGAGAC-1_V12D07-332_A1,4,0,0,1,0,5
CCAAGGTTGCCCTTTC-1_V12D07-332_A1,3,1,0,2,0,6
TGTGACTAGAGTTTGC-1_V12D07-332_A1,4,2,0,1,0,7
TTGTGATCTGTTCAGT-1_V12D07-332_A1,0,0,0,0,0,0
GGAGTTGATTCTGTGT-1_V12D07-332_A1,2,1,0,3,0,6
GTAGTGAGCAACCTCA-1_V12D07-332_A1,3,0,0,1,0,4
AAGACATACGTGGTTT-1_V12D07-332_A1,5,2,0,1,0,8
CATCCCGAGATTCATA-1_V12D07-332_A1,1,1,0,1,0,3
GGCCGCAGGAACCGCA-1_V12D07-332_A1,3,0,0,0,0,3
CCAGAAACTGATGCGA-1_V12D07-332_A1,2,0,0,1,0,3
ACCCGTAGTCTAGTTG-1_V12D07-332_A1,6,0,0,0,0,6
AGGGTCTGGACGCAGT-1_V12D07-332_A1,2,0,0,1,0,3
TTGAAACCCTCATTCC-1_V12D07-332_A1,5,0,0,1,0,6
TCAATCCCGCGCCAAA-1_V12D07-332_A1,4,1,0,0,0,5
AGGACATCGGCACACT-1_V12D07-332_A1,3,0,0,0,0,3
GACAAGACGCCCGTGC-1_V12D07-332_A1,1,1,0,1,0,3
GAGTAAATTAAGAACC-1_V12D07-332_A1,2,1,0,1,0,4
TAAGTCGGTGAGCTAG-1_V12D07-332_A1,4,0,0,0,0,4
CTTACTGACTCCTCTG-1_V12D07-332_A1,2,1,0,1,0,4
TTAACTGATCGTTTGG-1_V12D07-332_A1,4,0,0,1,0,5
GGGCGATCCATAGGCC-1_V12D07-332_A1,0,1,0,0,0,1
CGTATTGTTTGGCGCC-1_V12D07-332_A1,2,1,1,0,0,4
CGCGTGGGCCTGTGTT-1_V12D07-332_A1,0,0,0,0,0,0
AAATCTGCCCGCGTCC-1_V12D07-332_A1,3,2,0,1,0,6
GCTGAAGGGTTCTTGG-1_V12D07-332_A1,0,2,0,1,0,3
TAATTGCGCTGATTAC-1_V12D07-332_A1,2,0,0,0,0,2
TCGCGCGTTTACATGA-1_V12D07-332_A1,0,0,0,2,0,2
TAACTGAAATACGCCT-1_V12D07-332_A1,0,0,1,0,0,1
CCTGTCGTGTATGAAG-1_V12D07-332_A1,2,1,1,0,0,4
CGGGAACGCCCTGCAT-1_V12D07-332_A1,1,0,1,2,0,4
AGTTGCGGTCCTCAAC-1_V12D07-332_A1,1,0,0,0,0,1
GGGTCCTTGGAAGAAG-1_V12D07-332_A1,1,1,2,1,0,5
CGGGAAGTACCGTGGC-1_V12D07-332_A1,1,0,0,1,0,2
ACGGTCACCGAGAACA-1_V12D07-332_A1,1,1,0,0,0,2
TAGACTCAGTTGGCCT-1_V12D07-332_A1,0,2,0,1,0,3
CCTTCCGCAACGCTGC-1_V12D07-332_A1,0,2,1,0,0,3
CAGTGTTAATCTCTCA-1_V12D07-332_A1,2,0,2,1,0,5
CAGGCCAGTACCACCT-1_V12D07-332_A1,2,1,0,0,0,3
GATCGCTGTGGTGCGT-1_V12D07-332_A1,2,0,0,1,0,3
GTATCTCGGGCGCTTT-1_V12D07-332_A1,0,0,0,1,0,1
CCGGGCTAAGAATTTC-1_V12D07-332_A1,1,1,1,1,0,4
CTTCACGCCCTGGTAC-1_V12D07-332_A1,0,0,1,0,0,1
CGGATGAATGCTGTGA-1_V12D07-332_A1,1,0,1,0,0,2
CTCTGCAGGCATTCTT-1_V12D07-332_A1,0,0,0,0,0,0
TCAAAGTCACGGCGTC-1_V12D07-332_A1,0,1,1,0,0,2
TGGGTTTCGGGCGTAC-1_V12D07-332_A1,0,0,1,0,0,1
TGCTATGGCAAAGGGA-1_V12D07-332_A1,1,3,0,1,0,5
TTCACGGTCGTCACGT-1_V12D07-332_A1,1,1,0,0,0,2
CGTAAAGCAAGAAATC-1_V12D07-332_A1,1,1,0,1,0,3
CTGATCCCTTTATGCA-1_V12D07-332_A1,0,0,0,0,0,0
GAGTATACCCTAATCA-1_V12D07-332_A1,1,0,1,0,0,2
CCACGGCAGGTGTAGG-1_V12D07-332_A1,1,0,2,1,0,4
ACGTACTTTGGCACGG-1_V12D07-332_A1,1,1,1,1,0,4
CCTGAGAATAAATGCA-1_V12D07-332_A1,1,1,0,0,0,2
TTGATGCCGCTCGTCG-1_V12D07-332_A1,1,0,0,0,0,1
GCCAGGAAAGAACACT-1_V12D07-332_A1,1,1,0,0,0,2
TCCGACCGCTAATCAA-1_V12D07-332_A1,4,0,0,1,0,5
TATATCAAAGTGATCT-1_V12D07-332_A1,1,0,1,0,0,2
CCTCGGTTTCCTTGCC-1_V12D07-332_A1,3,0,1,0,0,4
TAAATTTAGTAACACC-1_V12D07-332_A1,1,1,0,0,0,2
CTCGTTACGGCTACCA-1_V12D07-332_A1,1,0,0,0,0,1
GCCGTCGGTTTCGGGC-1_V12D07-332_A1,1,0,0,0,0,1
GTTCCGTCCGCCTGCA-1_V12D07-332_A1,2,0,1,0,0,3
CTAGGGATAGGGACAA-1_V12D07-332_A1,1,1,0,0,0,2
GTCCAGGCACGTGTGC-1_V12D07-332_A1,1,0,2,0,0,3
GAGGAATATCTCTTTG-1_V12D07-332_A1,3,0,1,3,0,7
CGTTCAAGGAAACGGA-1_V12D07-332_A1,3,0,1,0,0,4
GTGGGAACAAACCGGG-1_V12D07-332_A1,2,0,1,0,0,3
GGGCACGTAGTACTGT-1_V12D07-332_A1,1,0,0,0,0,1
ACTACAAAGAGAGGTG-1_V12D07-332_A1,3,0,1,0,0,4
GGTGTAGGTAAGTAAA-1_V12D07-332_A1,2,0,0,0,0,2
CCTGTTCAACCTCGGG-1_V12D07-332_A1,0,0,0,2,0,2
TGAGGTGTGTGGCGGA-1_V12D07-332_A1,1,0,0,1,0,2
ATTGTCTGTTTCATGT-1_V12D07-332_A1,5,0,1,2,0,8
GCCGGTCGTATCTCTC-1_V12D07-332_A1,1,0,0,1,0,2
ATATGGGATAGCAACT-1_V12D07-332_A1,1,0,0,0,0,1
GATAGAACCCGCTAGG-1_V12D07-332_A1,2,0,1,0,0,3
ATCCCATTTCCGTGGG-1_V12D07-332_A1,2,3,1,0,0,6
GATGCTACCTTCGATG-1_V12D07-332_A1,7,0,0,1,0,8
TGCAAAGTTCGTCTGT-1_V12D07-332_A1,2,1,0,0,0,3
GTTCAGTCGCCAAATG-1_V12D07-332_A1,5,0,0,1,0,6
GTCTCCGCCTCAATAC-1_V12D07-332_A1,0,2,0,1,0,3
AGTAGAAGGCGCCTCA-1_V12D07-332_A1,4,1,0,2,0,7
GTTGTAGATTTATGAG-1_V12D07-332_A1,0,0,0,1,0,1
CTATTTGCTTGGAGGA-1_V12D07-332_A1,3,0,0,0,0,3
AGCCATATAGTATGTG-1_V12D07-332_A1,3,1,1,0,0,5
TGTTCCGGCCTGAGCT-1_V12D07-332_A1,0,0,0,1,0,1
TGCCGTGGGACCCAAT-1_V12D07-332_A1,5,0,0,1,0,6
TTGCAAGAAGACTCCT-1_V12D07-332_A1,2,1,0,1,0,4
CCGCTCCAGGGCGATC-1_V12D07-332_A1,3,1,0,0,0,4
CAAACCCTCCGGCGGG-1_V12D07-332_A1,3,1,0,0,0,4
CGGACCTTTACGTCCC-1_V12D07-332_A1,2,1,0,1,0,4
ACGTAGGAGAGTCGCT-1_V12D07-332_A1,4,0,0,0,0,4
CTGCGACCTCGCCGAA-1_V12D07-332_A1,0,0,0,0,0,0
GGCCCAGCTGGTTTGC-1_V12D07-332_A1,4,0,0,3,0,7
GGATTAATCATGGACC-1_V12D07-332_A1,3,1,0,0,0,4
GAGATGGCTTTAATCA-1_V12D07-332_A1,4,1,0,1,0,6
AGTACAGAAGCTTATA-1_V12D07-332_A1,2,0,0,1,0,3
GCGGCTTTAGCAAGTT-1_V12D07-332_A1,2,0,1,5,0,8
ACCGAGTCTCCTTATT-1_V12D07-332_A1,4,0,0,0,0,4
GACCACACTTCCCTTT-1_V12D07-332_A1,2,2,0,0,0,4
TGTAGCCAATTCCGTT-1_V12D07-332_A1,4,1,0,0,0,5
CTCGTCTGTGCCTTCG-1_V12D07-332_A1,2,0,0,1,0,3
GGACTCTTTGACTAAG-1_V12D07-332_A1,3,2,0,0,0,5
TCATCGACGACCGTCG-1_V12D07-332_A1,2,0,0,0,0,2
TACTACGTGCAATGCG-1_V12D07-332_A1,1,0,0,1,0,2
CCCTACTTGAACAATG-1_V12D07-332_A1,4,0,0,0,0,4
GCAGCTGTCAACGCAT-1_V12D07-332_A1,4,0,0,0,0,4
ATCTACCATCTGCTCC-1_V12D07-332_A1,4,0,0,1,0,5
TCTCAAATCAATCGGG-1_V12D07-332_A1,3,0,0,1,0,4
ACTCCGGCCGACCACT-1_V12D07-332_A1,3,0,0,3,0,6
TACACCTCTTCGAATC-1_V12D07-332_A1,4,0,0,0,0,4
GTGGCTGTTTCTGTTC-1_V12D07-332_A1,5,1,0,1,0,7
ACGACTCTAGGGCCGA-1_V12D07-332_A1,1,2,0,2,0,5
TCGTTTACGCGACCCT-1_V12D07-332_A1,5,1,1,1,0,8
AGGATATCCGACTGCA-1_V12D07-332_A1,0,1,0,3,0,4
GACACTTCCAATTACC-1_V12D07-332_A1,7,0,0,1,0,8
ACGGTACAGTTCAATG-1_V12D07-332_A1,1,1,0,2,0,4
CTTGATGACCATCCAG-1_V12D07-332_A1,3,0,0,2,0,5
CTGGTAAAGACTTACA-1_V12D07-332_A1,2,0,0,0,0,2
CTTGCCCACCCACGCA-1_V12D07-332_A1,2,1,0,2,0,5
CATTACGCAGGAAGGG-1_V12D07-332_A1,1,0,0,2,0,3
GGACAACCATGAAGCC-1_V12D07-332_A1,5,1,0,1,0,7
GTTATCAAGCTATCGA-1_V12D07-332_A1,0,0,0,0,0,0
AGGTGCACGTCCACAT-1_V12D07-332_A1,5,2,0,2,0,9
AAAGAATGTGGACTAA-1_V12D07-332_A1,2,0,0,1,0,3
ACCAAGTCATCGGCAG-1_V12D07-332_A1,0,0,0,1,0,1
AGTAACTATAGCAGCC-1_V12D07-332_A1,2,1,0,0,0,3
GGGAAAGAATGCCAAC-1_V12D07-332_A1,5,0,0,0,0,5
AATCGGTATAGCCCTC-1_V12D07-332_A1,3,0,2,0,0,5
GGCACTGCGGTGGTTT-1_V12D07-332_A1,2,1,0,1,0,4
CGTCCTCATCGCGTGC-1_V12D07-332_A1,6,0,0,1,0,7
CTTAACTTACAGTATA-1_V12D07-332_A1,2,0,0,0,0,2
GTGAGTCGACTAATAG-1_V12D07-332_A1,3,0,0,1,0,4
TGTACTTCCGGGCATG-1_V12D07-332_A1,2,0,0,0,0,2
CACAAACCGCAGAACT-1_V12D07-332_A1,6,0,0,0,0,6
GCTTTACACAACTGGG-1_V12D07-332_A1,4,0,0,0,0,4
CACCGATGATGGGTAC-1_V12D07-332_A1,4,0,1,0,0,5
TCAATATACAGGAGGC-1_V12D07-332_A1,4,1,0,1,0,6
AACGACCTCCTAGCCG-1_V12D07-332_A1,5,1,0,1,0,7
GTTACCAAGGCGTACG-1_V12D07-332_A1,2,0,0,2,0,4
TAGCTCACTGTGTTTG-1_V12D07-332_A1,4,1,0,1,0,6
TCGGCAGGGTTAAGGG-1_V12D07-332_A1,4,0,0,0,0,4
TGTTAACAAAGTGACT-1_V12D07-332_A1,1,1,0,0,0,2
CAGAGCGATGGATGCT-1_V12D07-332_A1,6,1,0,1,0,8
CATAGTGGGCACGCCT-1_V12D07-332_A1,6,1,0,0,0,7
AAACGCTGGGCACGAC-1_V12D07-332_A1,1,2,0,0,0,3
TGTTCTCATACTATAG-1_V12D07-332_A1,1,0,0,0,0,1
TCCGCTGGGTCGATCG-1_V12D07-332_A1,0,0,0,0,0,0
TTAGCATCCCTCACGT-1_V12D07-332_A1,0,2,3,1,0,6
AGCCTTGTCACTGATA-1_V12D07-332_A1,1,0,0,0,0,1
GTTTCTTGTTAGAGCT-1_V12D07-332_A1,1,0,1,0,0,2
TCGGAGTCCTGGTTGC-1_V12D07-332_A1,4,0,2,1,0,7
ACGGGTTGTGACCTGT-1_V12D07-332_A1,1,2,1,0,0,4
TGACAGAAATCTTGCT-1_V12D07-332_A1,4,2,0,0,0,6
TAGCCATGATTGCCTA-1_V12D07-332_A1,0,3,2,1,0,6
CGAAGCCACAGCATGG-1_V12D07-332_A1,0,1,0,0,0,1
ACCCGTAGCAGAGAAT-1_V12D07-332_A1,0,0,1,0,0,1
AGCTTGATCAGGGTAG-1_V12D07-332_A1,1,0,0,0,0,1
CTATAAGTAGGGTTTG-1_V12D07-332_A1,0,0,1,0,0,1
TATAGTTAGGTGTACT-1_V12D07-332_A1,1,0,0,0,0,1
TACGCTGATAGTTGTA-1_V12D07-332_A1,0,0,1,0,0,1
TTCTCAATTGCTACAA-1_V12D07-332_A1,1,2,0,0,0,3
GTTGCCCTAACGGGTG-1_V12D07-332_A1,1,0,0,1,0,2
GACATTTCGCCCAGCC-1_V12D07-332_A1,1,2,1,0,0,4
GTAACTACGTAGACCT-1_V12D07-332_A1,0,0,1,0,0,1
CCAGTGTACAGACCGA-1_V12D07-332_A1,0,0,1,0,0,1
GCCCGATGCCCAGTTC-1_V12D07-332_A1,3,0,0,0,0,3
CGAACCTCTTTCCTAG-1_V12D07-332_A1,1,0,0,0,0,1
CATGCACATGAGAGGC-1_V12D07-332_A1,3,0,1,0,0,4
CCAAATCAAAGGGCAA-1_V12D07-332_A1,1,0,1,0,0,2
GTAGTTTAAGCACACG-1_V12D07-332_A1,0,0,0,0,0,0
TAAGTGAATAGTCTAC-1_V12D07-332_A1,0,0,1,0,0,1
GGTCCACGTCTATTTG-1_V12D07-332_A1,0,0,0,0,0,0
CCCTCAGATCGAGAAC-1_V12D07-332_A1,0,0,0,0,0,0
ACATTCGCGCGGAATA-1_V12D07-332_A1,1,0,1,0,0,2
CTATGAACACCTTGCC-1_V12D07-332_A1,0,0,1,0,0,1
CGAATGGTAGGTCGTC-1_V12D07-332_A1,1,0,0,0,0,1
TCGACATAGCGTAGCG-1_V12D07-332_A1,0,0,0,1,0,1
GACGTTGCTCGGCGGC-1_V12D07-332_A1,1,2,0,0,0,3
CTCGAGGCAAGTTTCA-1_V12D07-332_A1,1,0,0,0,0,1
GCTGGGAGCGCGTCAA-1_V12D07-332_A1,1,2,0,0,0,3
GACGATATCACTGGGT-1_V12D07-332_A1,1,2,0,0,0,3
CAGCTCTGGGCTCACT-1_V12D07-332_A1,1,1,0,1,0,3
TAGTCTGCGGCACATT-1_V12D07-332_A1,2,1,0,0,0,3
TGGTCGATATACCTCT-1_V12D07-332_A1,2,2,0,0,0,4
TTCAGTTCAAGAGGAG-1_V12D07-332_A1,1,0,0,3,0,4
GTCTGTAGGTTGAACA-1_V12D07-332_A1,0,0,0,0,0,0
GAGAGTCTCGGGAGAG-1_V12D07-332_A1,1,1,1,1,0,4
TTGTTTGTATTACACG-1_V12D07-332_A1,1,0,1,2,0,4
GCACAGCACGGGCCGA-1_V12D07-332_A1,0,0,1,1,0,2
AAACAGTGTTCCTGGG-1_V12D07-332_A1,2,0,0,0,0,2
TGGAGAATAATCGTCC-1_V12D07-332_A1,1,1,1,0,0,3
CGCCGCGTTCTGAACG-1_V12D07-332_A1,1,3,0,0,0,4
CATGCGTTGAGAGGAG-1_V12D07-332_A1,2,1,0,3,0,6
TACGCTCCTAGAACTG-1_V12D07-332_A1,0,0,0,0,0,0
CCTTGTGAACGTGGTT-1_V12D07-332_A1,4,2,1,0,0,7
TTAAAGGCGATGCTCG-1_V12D07-332_A1,0,3,0,1,0,4
TAAAGTGCACGTCTCG-1_V12D07-332_A1,3,0,0,2,0,5
TGTCCGCAAACAATTC-1_V12D07-332_A1,5,1,0,1,0,7
AGGCCTATCATACCAA-1_V12D07-332_A1,1,3,0,0,0,4
ACTGGGATGCCAGTGC-1_V12D07-332_A1,1,0,0,1,0,2
CGATCCACCATTGTTG-1_V12D07-332_A1,3,0,0,1,0,4
GGGCATGCATGTCGAG-1_V12D07-332_A1,3,0,0,0,0,3
TCCAGGCAGGACGATC-1_V12D07-332_A1,7,1,1,3,0,12
CAATGACCCTTAATTT-1_V12D07-332_A1,2,0,0,0,0,2
ATCAAGATCCCAGGAC-1_V12D07-332_A1,3,1,0,0,0,4
CTCAGAGCTAATGTCG-1_V12D07-332_A1,3,1,0,0,0,4
CTGCGATTTCGAGATT-1_V12D07-332_A1,0,0,0,0,0,0
ATGGTATTGGGAACCG-1_V12D07-332_A1,0,1,0,0,0,1
TAGGTTCTGCTGAGAA-1_V12D07-332_A1,2,0,1,1,0,4
GCCTGTCCCGGTGCAT-1_V12D07-332_A1,1,0,0,0,0,1
GGCCTGCTCTGATGTT-1_V12D07-332_A1,2,0,0,0,0,2
TAGAGGGAGTTTATCT-1_V12D07-332_A1,1,0,0,1,0,2
CTCTACATCCTGCGTG-1_V12D07-332_A1,1,0,0,0,0,1
ACACATTTCCGTAGAC-1_V12D07-332_A1,1,2,0,1,0,4
TGGGTGTTAAGTAGAA-1_V12D07-332_A1,0,0,0,0,0,0
GAGCTCAACATGAGCG-1_V12D07-332_A1,5,2,0,1,0,8
GCACACAGCTATTACC-1_V12D07-332_A1,1,3,1,1,0,6
GCGACGGTAGTCTCCT-1_V12D07-332_A1,1,0,1,2,0,4
GTATCAAGGTACTTCC-1_V12D07-332_A1,2,0,0,0,0,2
GGAAAGGGAATTGAGC-1_V12D07-332_A1,2,0,1,0,0,3
TACACAGCCGTGGTGC-1_V12D07-332_A1,3,1,0,1,0,5
CGGTTGGGCAGGGTCC-1_V12D07-332_A1,4,1,0,2,0,7
GCACGCCGATTCCCGC-1_V12D07-332_A1,0,1,0,3,0,4
CGCTTTCCGCCAAGGT-1_V12D07-332_A1,4,0,0,0,0,4
TGCCCGATAGTTAGAA-1_V12D07-332_A1,5,0,0,0,0,5
TCAGAACGGCGGTAAT-1_V12D07-332_A1,3,1,0,1,0,5
CCACTCAGATCCGCAA-1_V12D07-332_A1,4,1,0,1,0,6
GAAGGGTCATTAAGAC-1_V12D07-332_A1,2,0,0,0,0,2
GCGGTCTTGCTTTCAC-1_V12D07-332_A1,1,0,0,2,0,3
GGAAGGACACCGTATA-1_V12D07-332_A1,2,0,0,1,0,3
CGCGGGAATTCCTTTC-1_V12D07-332_A1,2,2,1,0,0,5
TCTATCCGATTGCACA-1_V12D07-332_A1,2,0,0,0,0,2
TACTCGTTTGAATCAA-1_V12D07-332_A1,4,2,0,0,0,6
GTCTGCCGACTCGACG-1_V12D07-332_A1,4,1,0,2,0,7
TACGGGTAATAACATA-1_V12D07-332_A1,3,1,0,1,0,5
CCAGTTCGGTAACTCA-1_V12D07-332_A1,1,0,0,1,0,2
CGTGCACACCACTGTA-1_V12D07-332_A1,4,0,0,2,0,6
CTTCAGTTGGACAACG-1_V12D07-332_A1,2,1,0,1,0,4
TGATCTATCACACTCT-1_V12D07-332_A1,3,0,0,0,0,3
TAGCAGATACTTAGGG-1_V12D07-332_A1,1,1,0,1,0,3
CACCGGGCATCACAAG-1_V12D07-332_A1,3,1,0,3,0,7
AGTGGCCCGCAAATGG-1_V12D07-332_A1,7,0,0,0,0,7
CTCGCTAGGTAAGCGA-1_V12D07-332_A1,0,0,0,2,0,2
GATAGATAGTACAGTC-1_V12D07-332_A1,2,0,0,1,0,3
CGAGACTACTGCTGCT-1_V12D07-332_A1,6,0,0,1,0,7
ACATTTGAAACCTAAC-1_V12D07-332_A1,5,0,0,1,0,6
GACACAGCCGGGACTG-1_V12D07-332_A1,1,0,0,1,0,2
ACGGAACACGAGTGCC-1_V12D07-332_A1,4,0,0,2,0,6
ACGCCAGTGCGTTTGC-1_V12D07-332_A1,4,0,0,1,0,5
GCACCTAGGCGAGTCC-1_V12D07-332_A1,4,0,0,0,0,4
TCACTATCCCTTCGGT-1_V12D07-332_A1,1,1,0,0,0,2
TGAGTGTAACAACGGG-1_V12D07-332_A1,1,0,0,3,0,4
ATTGGTTGTGCATTAC-1_V12D07-332_A1,2,0,0,1,0,3
CTGGCGATTTACATGT-1_V12D07-332_A1,0,1,0,0,0,1
TCCACCAAGACATAGG-1_V12D07-332_A1,2,0,0,0,0,2
AACGTCGCTGCACTTC-1_V12D07-332_A1,3,0,0,1,0,4
GTCTCCCGAGTCCCGT-1_V12D07-332_A1,4,0,0,1,0,5
AGCCCGCACTACAATG-1_V12D07-332_A1,3,0,0,0,0,3
GGCACGCTGCTACAGT-1_V12D07-332_A1,2,1,0,1,0,4
GCTTGAGTGACCTCTG-1_V12D07-332_A1,4,0,0,0,0,4
ATAGCCATAACAGTCA-1_V12D07-332_A1,2,1,0,0,0,3
TAGGAGGCTCGAGAAC-1_V12D07-332_A1,1,0,0,1,0,2
GTCGGGTGAAGTACCG-1_V12D07-332_A1,2,2,0,0,0,4
CACCCGCGTTTGACAC-1_V12D07-332_A1,2,0,0,1,0,3
TCTCAGGCTACTCGCT-1_V12D07-332_A1,2,0,0,0,0,2
TAGATTCTCTAGCAAA-1_V12D07-332_A1,3,0,0,2,0,5
CCCATTATTGTATCCT-1_V12D07-332_A1,5,0,0,0,0,5
GTTAATAGCGTCATTA-1_V12D07-332_A1,6,0,0,0,0,6
TACTCATTGACGCATC-1_V12D07-332_A1,0,1,0,0,0,1
TAGTGACAAGCTCTAC-1_V12D07-332_A1,0,4,0,0,0,4
ATCGCCGTGGTTCATG-1_V12D07-332_A1,3,3,0,0,0,6
CTGCTCTCAACACACC-1_V12D07-332_A1,2,1,0,0,0,3
GCATGACACAAAGGAA-1_V12D07-332_A1,3,1,0,0,0,4
CAACGATCGATCCAAT-1_V12D07-332_A1,1,1,0,0,0,2
ATACAGCGTCCACTGA-1_V12D07-332_A1,0,0,0,0,0,0
TCACGATTAATACGTT-1_V12D07-332_A1,2,0,0,0,0,2
CGTGAACTGACCCGAT-1_V12D07-332_A1,1,0,3,2,0,6
TCGATGTTACGGCCGT-1_V12D07-332_A1,2,0,0,1,0,3
GACCGGTGATACTCTC-1_V12D07-332_A1,0,1,2,1,0,4
TCTGTTTAGATTGTTC-1_V12D07-332_A1,0,0,3,1,0,4
GCTACTCGGACGCAGA-1_V12D07-332_A1,2,1,0,0,0,3
AAGAAAGTTTGATGGG-1_V12D07-332_A1,1,0,5,0,0,6
CGCCAGTAGTACCTTG-1_V12D07-332_A1,3,0,2,0,0,5
CTCCCTTGTATCAAGG-1_V12D07-332_A1,0,0,2,0,0,2
ACTTTATACACCACTT-1_V12D07-332_A1,1,0,1,0,0,2
AGATCTGGAGAGGATA-1_V12D07-332_A1,0,2,0,0,0,2
TCATCCATCTGATCAC-1_V12D07-332_A1,1,0,0,0,0,1
AGAACACGGCGATGGT-1_V12D07-332_A1,1,0,0,0,0,1
CCGCTCCGGATAAGCT-1_V12D07-332_A1,0,0,0,1,0,1
TGGTCGGGTACAGGGC-1_V12D07-332_A1,1,0,0,0,0,1
ACGGACGCAGCGACAA-1_V12D07-332_A1,0,1,0,0,0,1
ACATGCTTACGGCAGC-1_V12D07-332_A1,0,0,0,0,0,0
CAGGGAGATAGGCCAG-1_V12D07-332_A1,0,1,0,0,0,1
TCGCCACCCGGATTAC-1_V12D07-332_A1,0,1,2,0,0,3
TCTTGGTCAATGATAC-1_V12D07-332_A1,1,0,1,0,0,2
CATAGGGACACTTGTG-1_V12D07-332_A1,1,2,0,0,0,3
CACGAGCAAACCAGAC-1_V12D07-332_A1,0,0,1,0,0,1
GGGATATTGATCGCCA-1_V12D07-332_A1,0,1,0,0,0,1
TAATGTCGGTTCATGG-1_V12D07-332_A1,0,0,1,0,0,1
CGATTTGTCATTAATG-1_V12D07-332_A1,0,2,0,0,0,2
TTAAGATACCCAGAGA-1_V12D07-332_A1,1,2,1,0,0,4
CGACCGTTGGTATTCG-1_V12D07-332_A1,1,0,1,0,0,2
ACTACCATCCGAGGGC-1_V12D07-332_A1,1,0,0,0,0,1
TCTACGCACGATCTCC-1_V12D07-332_A1,0,2,0,0,0,2
AAGCCACTTGCAGGTA-1_V12D07-332_A1,2,1,0,0,0,3
ACGTTGTCGTTGAAAG-1_V12D07-332_A1,1,0,0,0,0,1
ACCGCTAGTCATTGGT-1_V12D07-332_A1,2,0,1,0,0,3
CATGAGTCCATCACGG-1_V12D07-332_A1,1,1,0,1,0,3
ATGTCTTGTTTGACTC-1_V12D07-332_A1,0,0,0,0,0,0
TCCCAAACATCCTCTA-1_V12D07-332_A1,2,1,0,0,0,3
CAACGCGATGAGCCAA-1_V12D07-332_A1,2,0,0,0,0,2
GACACCCAAAGACGCG-1_V12D07-332_A1,2,0,0,0,0,2
ACGTTCACTATGCCGC-1_V12D07-332_A1,2,0,0,0,0,2
ATGGACTGCTTAGTTG-1_V12D07-332_A1,0,0,2,0,0,2
CCATGGCAAACGCTCA-1_V12D07-332_A1,4,0,0,0,0,4
TTGTCTCGGCAAGATG-1_V12D07-332_A1,0,0,0,0,0,0
TTCGAACGAAACATGC-1_V12D07-332_A1,0,0,1,1,0,2
GGAAAGTCTTGATTGT-1_V12D07-332_A1,0,0,0,0,0,0
ATCATAGATCGACGAG-1_V12D07-332_A1,2,2,1,2,0,7
GATTAGAAACAAGCGT-1_V12D07-332_A1,1,0,0,0,0,1
GCTGCGAAGAATTATT-1_V12D07-332_A1,1,0,0,0,0,1
TTCCAGTGGGTTTCGT-1_V12D07-332_A1,2,2,0,0,0,4
GCTCATTGATCATATC-1_V12D07-332_A1,2,1,0,0,0,3
ATACGAGGTTTGTAAG-1_V12D07-332_A1,0,1,0,0,0,1
GTCTATACACGCATGG-1_V12D07-332_A1,1,1,0,1,0,3
GATTTGCGCTAACACC-1_V12D07-332_A1,1,1,0,1,0,3
TGGTGCCCTGCCTTAC-1_V12D07-332_A1,1,1,0,0,0,2
TCGAATCGCAGGGTAG-1_V12D07-332_A1,2,1,1,2,0,6
GGTAGGCCAATATCAC-1_V12D07-332_A1,1,1,0,0,0,2
CGTAAATAACAAAGGG-1_V12D07-332_A1,1,0,0,0,0,1
GACTCTAGAGTTCCAA-1_V12D07-332_A1,1,2,0,0,0,3
ACTTGTTACCGGATCA-1_V12D07-332_A1,3,0,1,0,0,4
GGCATTGAACATCTCA-1_V12D07-332_A1,5,0,1,0,0,6
AACCCGCTGTATTCCA-1_V12D07-332_A1,0,7,0,0,0,7
TAACAGGTTCCCTTAG-1_V12D07-332_A1,2,1,0,1,1,5
GTTCTTGTAACTCAAT-1_V12D07-332_A1,2,1,0,1,0,4
GATTCTGTTAATGAGT-1_V12D07-332_A1,2,1,0,2,0,5
GGACACCTCGGTGTTG-1_V12D07-332_A1,2,0,0,0,0,2
CGATCGAGAAGCACCA-1_V12D07-332_A1,0,1,0,0,0,1
CTGCTCTGACGGCAAA-1_V12D07-332_A1,5,0,0,0,0,5
CCCAGGAAGAATTCGA-1_V12D07-332_A1,1,0,0,2,0,3
TGTCGTGGGTATAGGC-1_V12D07-332_A1,0,0,0,0,0,0
ATATGTCTAGAGCGTG-1_V12D07-332_A1,1,1,0,0,0,2
GCGGGCAGACGGGTGA-1_V12D07-332_A1,2,0,0,1,0,3
CGAAGATCAGTTTCAT-1_V12D07-332_A1,1,1,0,0,0,2
ACGCCACTCGAAACAG-1_V12D07-332_A1,2,0,0,1,0,3
CTTAGATGTTTCATCC-1_V12D07-332_A1,2,1,1,1,0,5
GCGAATGGACTAGCGA-1_V12D07-332_A1,3,0,0,1,0,4
TAAATTGTGGGTAAAG-1_V12D07-332_A1,1,3,0,1,0,5
ATTTATACTGGTAAAG-1_V12D07-332_A1,3,0,0,4,0,7
GCGTCGTAACATGGTC-1_V12D07-332_A1,5,0,0,1,0,6
CGGTATGGGCACTCTG-1_V12D07-332_A1,5,1,0,0,0,6
CTATCACAACGCTGGA-1_V12D07-332_A1,4,1,0,2,0,7
ACCACACGGTTGATGG-1_V12D07-332_A1,0,1,0,1,0,2
TCAGCGCACGCCGTTT-1_V12D07-332_A1,2,0,0,2,0,4
AATGTTAAGACCCTGA-1_V12D07-332_A1,3,0,0,2,0,5
CTTACATAGATTTCTT-1_V12D07-332_A1,0,1,0,0,0,1
AACATAGCGTGTATCG-1_V12D07-332_A1,3,1,0,0,0,4
AGCAGTCGAAGCATGC-1_V12D07-332_A1,3,1,0,0,0,4
GTACTACGGCCTCGTT-1_V12D07-332_A1,2,0,0,1,0,3
TTGGCCAAATTGTATC-1_V12D07-332_A1,6,0,1,1,0,8
TCAGAGGACGCGTTAG-1_V12D07-332_A1,1,2,0,0,0,3
AGTAATCTAAGGGTGG-1_V12D07-332_A1,4,1,0,4,0,9
AATTATACCCAGCAAG-1_V12D07-332_A1,5,1,0,2,0,8
CCCTACCCACACCCAG-1_V12D07-332_A1,6,2,0,0,0,8
CTCTGTCCATGCACCA-1_V12D07-332_A1,4,0,0,0,0,4
TCGCCTCCTTCGGCTC-1_V12D07-332_A1,6,1,1,1,0,9
CCTGATTCGCGAAGAA-1_V12D07-332_A1,1,2,0,1,0,4
GACTTCAACGCATCAA-1_V12D07-332_A1,2,0,0,0,0,2
GCTTCCCGTAAGCTCC-1_V12D07-332_A1,2,0,0,3,0,5
AGAACTGTACTTTGTA-1_V12D07-332_A1,1,1,0,2,0,4
CCTTAAGTACGCAATT-1_V12D07-332_A1,3,1,0,1,0,5
GGCCAATTGTATAGAC-1_V12D07-332_A1,1,0,0,0,0,1
AGAATACAGGCTATCC-1_V12D07-332_A1,1,3,0,4,0,8
AATACCTGATGTGAAC-1_V12D07-332_A1,1,1,0,1,0,3
TAGAGTGTTCCGGGTA-1_V12D07-332_A1,5,0,0,0,0,5
GCTTCCATGTAACCGC-1_V12D07-332_A1,2,0,0,1,0,3
GGTTCGCATTTGCCGT-1_V12D07-332_A1,4,0,0,0,0,4
TCAATCCGGGAAGTTT-1_V12D07-332_A1,3,0,1,2,0,6
CCGGAAGTGCAATATG-1_V12D07-332_A1,3,0,0,0,0,3
CTCATAAATGTGTATA-1_V12D07-332_A1,2,0,0,0,0,2
GACGGGCATCGAATTT-1_V12D07-332_A1,3,0,0,0,0,3
GCTAAGCCCAGTATGC-1_V12D07-332_A1,0,2,0,2,0,4
GCTATAAGGGCCAGGA-1_V12D07-332_A1,2,1,0,1,0,4
GCGGATTACTTGTTCT-1_V12D07-332_A1,1,2,0,2,0,5
TACAACAGCGCATACA-1_V12D07-332_A1,3,0,0,1,0,4
TCTAACCTAGCCTGCG-1_V12D07-332_A1,3,0,0,2,0,5
TCTACCCGCATCATTT-1_V12D07-332_A1,1,0,1,1,0,3
GTCTTACCACGCCAAG-1_V12D07-332_A1,4,0,0,2,0,6
AATAACGTCGCGCCCA-1_V12D07-332_A1,4,0,0,2,0,6
CGTTTCGGTTATATGC-1_V12D07-332_A1,5,0,0,0,0,5
TACGCTGCACGGTCGT-1_V12D07-332_A1,3,0,0,0,0,3
CGTTAAATACGACCAG-1_V12D07-332_A1,4,1,0,0,0,5
TCGACTGACGATGGCT-1_V12D07-332_A1,4,2,0,0,0,6
ACGCTACTGAATGGGC-1_V12D07-332_A1,2,0,0,2,0,4
AAGGGTTAGCCATGCG-1_V12D07-332_A1,3,0,0,2,0,5
ACGTTTCGGTGCACTT-1_V12D07-332_A1,4,1,0,2,0,7
TTAACCCGAGGCGTGT-1_V12D07-332_A1,2,1,0,1,0,4
GCCCGTCAAGCCCAAT-1_V12D07-332_A1,2,1,0,0,0,3
ATTCGTCCCGAGGTTA-1_V12D07-332_A1,2,1,0,0,0,3
TCAAATTATGTTCGAC-1_V12D07-332_A1,4,0,0,0,0,4
AACGTTCTACCATTGT-1_V12D07-332_A1,3,0,0,2,0,5
CTGTCCTGCGCACTAC-1_V12D07-332_A1,0,0,0,0,0,0
GCCCAGCGACACAAAG-1_V12D07-332_A1,0,1,0,0,0,1
TATAGCTATTATCTCT-1_V12D07-332_A1,0,0,0,0,0,0
AAGCTATGGATTGACC-1_V12D07-332_A1,0,0,4,1,0,5
CCGAAACACGACCTCT-1_V12D07-332_A1,0,0,1,2,0,3
ATCAGAAGCTGGTTGC-1_V12D07-332_A1,1,0,3,1,0,5
TGAACCTGAATGTGAG-1_V12D07-332_A1,0,1,3,1,0,5
TCAGAGCATGTCAACG-1_V12D07-332_A1,0,1,1,0,0,2
ATACCCTCCCGGCCAA-1_V12D07-332_A1,1,1,0,0,0,2
GCCACCTTATTCGCGA-1_V12D07-332_A1,1,1,0,0,0,2
CAACGAGCTTATTATG-1_V12D07-332_A1,0,0,0,0,0,0
GATCCAACCTTTAAAC-1_V12D07-332_A1,0,0,0,0,0,0
TTGTGGAGACAGCCGG-1_V12D07-332_A1,2,3,0,0,0,5
AGATAATCACACCTAT-1_V12D07-332_A1,0,0,0,0,0,0
GGTTAGGGATGCTAAT-1_V12D07-332_A1,1,1,1,1,0,4
TCATGAAGCGCTGCAT-1_V12D07-332_A1,1,3,1,0,0,5
CCAGGCGAGATGGTCT-1_V12D07-332_A1,1,1,0,0,0,2
CGACTTGCCGGGAAAT-1_V12D07-332_A1,4,0,2,1,0,7
GTGCCAAACGTTTCGA-1_V12D07-332_A1,0,0,0,1,0,1
TGCTCAAAGGATGCAC-1_V12D07-332_A1,0,0,1,1,0,2
GCCTCAGGTACCGGTC-1_V12D07-332_A1,1,1,0,0,0,2
ACAAGTAATTGTAAGG-1_V12D07-332_A1,0,2,1,0,0,3
TTAGAGTATTGTCGAG-1_V12D07-332_A1,2,1,1,0,0,4
GTCATCCCAAACTCAC-1_V12D07-332_A1,3,0,1,0,0,4
CTCCTAGTAATCGTGA-1_V12D07-332_A1,2,2,1,0,0,5
CCCTCATCACAGAGTA-1_V12D07-332_A1,1,1,0,0,0,2
GGAAACAGAGCTTGGG-1_V12D07-332_A1,2,0,1,0,0,3
ACATCGCAATATTCGG-1_V12D07-332_A1,0,0,2,0,0,2
TTAGCCATAGGGCTCG-1_V12D07-332_A1,2,0,0,1,0,3
CGGATTCTGCCTTATG-1_V12D07-332_A1,0,0,0,2,0,2
TTGTTGGCAATGACTG-1_V12D07-332_A1,1,0,0,0,0,1
GGATCTACCGTTCGTC-1_V12D07-332_A1,0,0,0,0,0,0
GGTGGGATTAGGTCCC-1_V12D07-332_A1,0,1,0,1,0,2
AATAGGCACGACCCTT-1_V12D07-332_A1,3,2,0,0,0,5
GAGGTCCGTTCGCTGT-1_V12D07-332_A1,0,2,1,1,0,4
TGACAACTTAAAGGTG-1_V12D07-332_A1,3,1,0,0,0,4
AGCTAAGCTCCGTCCG-1_V12D07-332_A1,4,0,0,0,0,4
CTAGCCCGGGAGACGA-1_V12D07-332_A1,2,1,0,0,0,3
CCCAGATTCCCGTGAC-1_V12D07-332_A1,0,0,0,1,0,1
GCCCGTTCACACAATT-1_V12D07-332_A1,0,1,1,1,0,3
ACAAACTCCATCAGAG-1_V12D07-332_A1,1,1,0,1,0,3
GGTTCCGTACGACTAA-1_V12D07-332_A1,1,0,0,2,0,3
TTGCGGAAAGCTGCCC-1_V12D07-332_A1,0,0,0,0,0,0
GGAACTCGTGAATACG-1_V12D07-332_A1,0,0,1,1,0,2
GGTTACCGCTCCCTAC-1_V12D07-332_A1,0,1,0,0,0,1
AGCGACTTTGAAGACA-1_V12D07-332_A1,3,0,0,2,0,5
CCGTTTCCTTTCCGTG-1_V12D07-332_A1,2,1,2,0,0,5
TGGATGGCATCTTGGA-1_V12D07-332_A1,2,0,0,1,0,3
CAAGTCGTTGAAATCT-1_V12D07-332_A1,2,0,0,0,0,2
TGCAAACGTACTAGTT-1_V12D07-332_A1,1,1,0,2,0,4
GGCTGTCCTACTGCGG-1_V12D07-332_A1,3,1,0,0,0,4
TACTGCATGATTAAAT-1_V12D07-332_A1,3,0,0,2,0,5
CGGACCTCTGTAGTTA-1_V12D07-332_A1,2,0,0,0,0,2
CCCTAGCTCTAAGGTC-1_V12D07-332_A1,3,0,0,0,0,3
GTAACAGGTTAACGGC-1_V12D07-332_A1,2,0,0,1,0,3
CCCGCAAATAATCATC-1_V12D07-332_A1,3,1,0,0,0,4
AATCCCGCTCAGAGCC-1_V12D07-332_A1,5,2,0,0,0,7
AACGTCATCCGGCTTG-1_V12D07-332_A1,4,1,1,1,0,7
CTCGTGGCACTGAAAG-1_V12D07-332_A1,2,0,0,1,0,3
CTTTATCCGACGCATG-1_V12D07-332_A1,0,1,0,1,0,2
AAATGACTGATCAAAC-1_V12D07-332_A1,1,1,1,1,0,4
TTCGTGCATGTTATAG-1_V12D07-332_A1,5,0,1,0,0,6
ATCAAAGAGCCGTGGT-1_V12D07-332_A1,1,0,1,0,0,2
ATGTCATAATAAACGA-1_V12D07-332_A1,2,2,0,0,0,4
CTTAATCGACTTAGTA-1_V12D07-332_A1,3,1,0,1,0,5
CTAAAGGATGAGATAC-1_V12D07-332_A1,2,1,0,1,0,4
GTGCTATCCAGCTGGA-1_V12D07-332_A1,3,0,0,0,0,3
GACAGAGGTCTTCAGT-1_V12D07-332_A1,1,1,0,0,0,2
TCGATTTACGAAACGA-1_V12D07-332_A1,3,0,0,0,0,3
AGGCTTAAGTTGCACA-1_V12D07-332_A1,4,0,0,2,0,6
TAGGATCTTAACCGCA-1_V12D07-332_A1,1,0,0,2,0,3
GACTTTCGAGCGGTTC-1_V12D07-332_A1,2,1,0,1,0,4
CCCTGGGAGGGATCCT-1_V12D07-332_A1,1,0,0,1,0,2
TAGTAGTTGCCGGACA-1_V12D07-332_A1,5,0,0,0,0,5
GCCCTAAGTGCAGGAT-1_V12D07-332_A1,1,1,0,0,0,2
ACTTGGGCTTTCGCCA-1_V12D07-332_A1,0,1,0,1,0,2
CATGATACGGTGAAAC-1_V12D07-332_A1,5,0,0,0,0,5
TCCTGCAGCCGCCAAT-1_V12D07-332_A1,4,1,0,0,0,5
GTCCGTTAGAGGGCCT-1_V12D07-332_A1,0,0,0,1,0,1
GCTTTATTAAGTTACC-1_V12D07-332_A1,0,1,0,0,0,1
AATCGAGGTCTCAAGG-1_V12D07-332_A1,1,0,0,0,0,1
GTGCTGTTAGAACATA-1_V12D07-332_A1,1,0,1,1,0,3
GGCTTCTCGTGGGTGG-1_V12D07-332_A1,7,0,0,1,0,8
CCTACAGTTGAGGGAG-1_V12D07-332_A1,2,0,0,1,0,3
TATCCCTCGATCTGCA-1_V12D07-332_A1,5,0,0,1,0,6
CCGGTATCTGGCGACT-1_V12D07-332_A1,3,0,0,0,0,3
CTCTAACACCGGCAGC-1_V12D07-332_A1,2,0,0,0,0,2
CTTCATCACCAGGGCT-1_V12D07-332_A1,2,1,0,0,0,3
GGCTGGCAATCCCACG-1_V12D07-332_A1,4,0,0,0,0,4
CAAACCATAAGCGTAT-1_V12D07-332_A1,2,1,0,1,0,4
CATGTGGGCTCATCAC-1_V12D07-332_A1,7,0,0,0,0,7
CCCGTGACAGTGCCTT-1_V12D07-332_A1,2,1,1,1,0,5
GATTATCTTGCATTAT-1_V12D07-332_A1,2,0,0,3,0,5
GAGTCCACCAGGTTTA-1_V12D07-332_A1,1,1,0,0,0,2
TGTACTATCGCTCGTT-1_V12D07-332_A1,1,1,0,2,0,4
TTAGCGAATAGATAGG-1_V12D07-332_A1,0,1,1,1,0,3
ACATACAATCAAGCGG-1_V12D07-332_A1,2,2,0,1,0,5
ATTCGTGTACCCATTC-1_V12D07-332_A1,4,0,0,1,0,5
GCTAGCAACGCACCTA-1_V12D07-332_A1,2,0,0,0,0,2
ACCTCAGCGAGGCGCA-1_V12D07-332_A1,3,1,0,0,0,4
TCCGGGCCACTAACGG-1_V12D07-332_A1,4,0,0,0,0,4
TCCCAATATCGACGAC-1_V12D07-332_A1,1,1,0,0,0,2
GGATTGAAGTAGCCTC-1_V12D07-332_A1,4,0,0,1,0,5
GGCGCACAGTTTACCT-1_V12D07-332_A1,3,1,0,2,0,6
CCCGGCACGTGTCAGG-1_V12D07-332_A1,2,1,0,0,0,3
AGTAAGGGACAGAATC-1_V12D07-332_A1,6,0,0,3,0,9
TTGCGCACAACCACGT-1_V12D07-332_A1,5,0,1,0,0,6
CCTGCTACAACCATAC-1_V12D07-332_A1,2,1,0,0,0,3
CTGGGCTACTGGAGAG-1_V12D07-332_A1,4,1,0,1,0,6
AGCTACGAATGGTGGT-1_V12D07-332_A1,2,0,0,0,0,2
ATTCGTTTATCGTATT-1_V12D07-332_A1,2,1,0,0,0,3
GGCATTCCCTCCCTCG-1_V12D07-332_A1,2,0,0,2,0,4
AGTTATTCAGACTGTG-1_V12D07-332_A1,10,0,0,0,0,10
CCACTTTCCTTCTAGG-1_V12D07-332_A1,4,0,0,1,0,5
CGCAGTTCTATCTTTC-1_V12D07-332_A1,6,1,0,1,0,8
AGGAGCGTTTATTATC-1_V12D07-332_A1,5,0,0,1,0,6
GACAGGTAATCCGTGT-1_V12D07-332_A1,4,0,0,0,0,4
TTCCCAAAGTACTGAT-1_V12D07-332_A1,3,0,0,0,0,3
CTGCAGGGTGACGCTC-1_V12D07-332_A1,2,4,0,0,0,6
TCATGGAGGCCTTTGT-1_V12D07-332_A1,2,1,0,0,0,3
ATGGCCCGAAAGGTTA-1_V12D07-332_A1,3,1,0,1,0,5
CGTAATATGGCCCTTG-1_V12D07-332_A1,1,1,0,1,0,3
AGAGTCTTAATGAAAG-1_V12D07-332_A1,1,0,0,0,0,1
GAACGTTTGTATCCAC-1_V12D07-332_A1,1,1,0,0,0,2
ATTGAATTCCCTGTAG-1_V12D07-332_A1,1,1,0,0,0,2
TACCTCACCAATTGTA-1_V12D07-332_A1,2,1,0,1,0,4
AGTCGAATTAGCGTAA-1_V12D07-332_A1,4,3,0,0,0,7
TTGAAGTGCATCTACA-1_V12D07-332_A1,1,1,0,2,0,4
